endDate,researchDevelopment,effectOfAccountingCharges,incomeBeforeTax,minorityInterest,netIncome,sellingGeneralAdministrative,grossProfit,ebit,operatingIncome,otherOperatingExpenses,interestExpense,extraordinaryItems,nonRecurring,otherItems,incomeTaxExpense,totalRevenue,totalOperatingExpenses,costOfRevenue,totalOtherIncomeExpenseNet,discontinuedOperations,netIncomeFromContinuingOps,netIncomeApplicableToCommonShares,stockId,ticker
2020-12-31,827129000,,615701000,,613670000,533835000,1957816000,596852000,596852000,,,,,,2031000,2175536000,1578684000,217720000,18849000,,613670000,613670000,49352,SGEN
2019-12-31,827129000,,-158650000,,-158650000,373932000,153387000,-220545000,-220545000,,,,,,0,916713000,1137258000,763326000,61895000,,-158650000,-158650000,49352,SGEN
2018-12-31,565309000,,-246346000,,-222693000,252596000,1098000,-251498000,-251498000,,,,,,-23653000,654700000,906198000,653602000,5152000,,-222693000,-222693000,49352,SGEN
2017-12-31,565309000,,-158887000,,-125530000,167233000,-28568000,-195801000,-195801000,,,,,,-33357000,482250000,678051000,510818000,36914000,,-125530000,-125530000,49352,SGEN
2020-12-31,,,25884000,,19266000,15223000,43476000,0,26390000,1863000,,,,,6618000,43476000,17086000,0,-506000,,19266000,19266000,49355,BSVN
2019-12-31,,,15069000,,8225000,26562000,43501000,0,15195000,1744000,,,,,6844000,43501000,28306000,0,-126000,,8225000,8225000,49355,BSVN
2018-12-31,,,25797000,,25000000,12630000,40762000,0,26339000,1793000,,,,,797000,40762000,14423000,0,-542000,,25000000,25000000,49355,BSVN
2017-12-31,,,23789000,,23789000,12140000,38320000,0,24239000,1941000,,,,,0,38320000,14081000,0,-450000,,23789000,23789000,49355,BSVN
2019-12-31,492204000,,1033319000,2805856000,604914000,1806042000,3105841000,1146081000,1146081000,-338486000,-131796000,,,,172619000,18016085000,16870004000,14910244000,-98513000,,860700000,604914000,49357,CYD
2018-12-31,447668000,,1181067000,2751705000,695266000,1554512000,3122194000,1152456000,1152456000,-32442000,-71513000,,,,206667000,16263248000,15110792000,13141054000,28611000,,974400000,695266000,49357,CYD
2017-12-31,608181000,,1514028000,2627617000,888809000,1505123000,3376896000,1285368000,1285368000,-21776000,-53893000,,,,194172000,16197819000,14912451000,12820923000,228660000,,1319856000,888809000,49357,CYD
2017-01-01,588007000,,896232000,2317982000,525177000,1487409000,2975749000,957302000,957302000,-56969000,-62063000,,,,160270000,13643195000,12685893000,10667446000,-61070000,,735962000,525177000,49357,CYD
2019-12-28,,,14962000,,15271000,83811000,86777000,2227000,2227000,739000,-6444000,,,,-657000,374582000,372355000,287805000,12735000,-348000,15619000,14803000,49359,DXYN
2018-12-29,,,-22310000,,-21384000,92458000,89691000,-4146000,-4146000,1379000,-6491000,,,,-831000,405033000,409179000,315342000,-18164000,95000,-21479000,-21384000,49359,DXYN
2017-12-30,,,-1813000,,-9555000,96171000,101213000,4699000,4699000,343000,-5739000,,,,7509000,412462000,407763000,311249000,-6512000,-233000,-9322000,-9555000,49359,DXYN
2016-12-31,,,-8829000,,-5278000,97137000,95425000,-1908000,-1908000,196000,-5392000,,,,-3622000,397453000,399361000,302028000,-6921000,-71000,-5207000,-5278000,49359,DXYN
2020-12-31,,,-344622000,,-344615000,86281000,89113000,-121580000,-121580000,2860000,-14432000,,,,-7000,1467592000,1589172000,1378479000,-223042000,,-344615000,-344615000,49362,ARCH
2019-12-31,,,234047000,,233799000,97834000,421335000,220762000,220762000,-8882000,-16485000,,,,248000,2274352000,2053590000,1853017000,13285000,,233799000,233799000,49362,ARCH
2018-12-31,,,260101000,,312577000,103502000,526585000,268689000,268689000,23724000,-20471000,,,,-52476000,2451787000,2183098000,1925202000,-8588000,,312577000,312577000,49362,ARCH
2017-12-31,,,203195000,,238450000,89892000,484630000,208069000,208069000,10220000,-26905000,,,,-35255000,2324623000,2116554000,1839993000,-4874000,,238450000,238450000,49362,ARCH
2019-12-31,8582000,,-16891000,,-16902000,41359000,39526000,-10415000,-10415000,,-8009000,,,,11000,64649000,75064000,25123000,-6476000,,-16902000,-16902000,49363,NEOS
2018-12-31,8508000,,-51675000,,-51675000,58048000,23060000,-43496000,-43496000,,-8974000,,,,0,49988000,93484000,26928000,-8179000,,-51675000,-51675000,49363,NEOS
2017-12-31,8957000,,-65772000,,-65772000,60686000,13102000,-56541000,-56541000,,-10085000,,,,0,27132000,83673000,14030000,-9231000,,-65772000,-65772000,49363,NEOS
2016-12-31,12207000,,-82751000,,-82751000,61916000,-1701000,-75824000,-75824000,,-6937000,,,,0,10033000,85857000,11734000,-6927000,,-82751000,-82751000,49363,NEOS
2020-07-31,,,-544000,,-559000,7110000,8275000,-403000,-403000,,,,,,15000,9470000,9873000,1195000,-141000,,-559000,-559000,49364,ZDGE
2019-07-31,,,-3328000,,-3344000,8897000,7437000,-2887000,-2887000,,,,,,16000,8816000,11703000,1379000,-441000,,-3344000,-3344000,49364,ZDGE
2018-07-31,,,-1333000,,-1563000,9209000,9315000,-927000,-927000,,,,,,230000,10833000,11760000,1518000,-406000,,-1563000,-1563000,49364,ZDGE
2017-07-31,,,-627000,,-611000,8468000,8464000,-647000,-647000,,,,,,-16000,10031000,10678000,1567000,20000,,-611000,-611000,49364,ZDGE
2020-05-31,3386000,,-2766000,-21000,-2802000,7530000,8371000,-2545000,-2545000,,,,,,36000,22291000,24836000,13920000,-221000,,-2802000,-2802000,49366,AEHR
2019-05-31,4153000,,-5208000,-19000,-5235000,7724000,7602000,-4275000,-4275000,,-252000.0,,,,27000,21056000,25331000,13454000,-933000,,-5235000,-5235000,49366,AEHR
2018-05-31,4181000,,455000,-20000,528000,7290000,12386000,915000,915000,,-399000.0,,,,-73000,29555000,28640000,17169000,-460000,,528000,528000,49366,AEHR
2017-05-31,4657000,,-5628000,-19000,-5653000,7052000,6780000,-4929000,-4929000,,-678000.0,,,,25000,18898000,23827000,12118000,-699000,,-5653000,-5653000,49366,AEHR
2019-12-31,,,27084000,,20882000,97247000,123962000,26715000,26715000,,-244000,,,,6202000,304011000,277296000,180049000,369000,,20882000,20882000,49367,WEYS
2018-12-31,,,25757000,,20484000,94502000,120080000,25578000,25578000,,-45000,,,,5798000,298375000,272797000,178295000,179000,,19959000,20484000,49367,WEYS
2017-12-31,,,23922000,7122000.0,16491000,87713000,110693000,22980000,22980000,,-15000,,,,7223000,283749000,260769000,173056000,942000,,16699000,16491000,49367,WEYS
2016-12-31,,,22077000,6692000.0,16472000,87378000,112043000,24665000,24665000,,-436000,,,,5084000,296933000,272268000,184890000,-2588000,,16993000,16472000,49367,WEYS
2019-12-31,43123000,,-42562000,,-42590000,82944000,85080000,-40987000,-40987000,,-1612000,,,,28000,112103000,153090000,27023000,-1575000,,-42590000,-49898000,49368,BIGC
2018-12-31,42485000,,-38868000,,-38878000,65425000,69930000,-37980000,-37980000,,-1489000,,,,10000,91867000,129847000,21937000,-888000,,-38878000,-43590000,49368,BIGC
2019-12-31,,,-11481245,,-11481245,7413593,1339402,-6074191,-6074191,,-807205,,,,0,5907899,11982090,4568497,-5407054,,-11481245,-14861534,49370,GNUS
2018-12-31,,,-9003901,,-9003901,5720901,-543270,-6264171,-6264171,,-1019376,,,,0,993452,7257623,1536722,-2739730,,-9003901,-9357234,49370,GNUS
2017-12-31,,,-4908736,,-4908736,5992091,1078301,-4913790,-4913790,,-3227,,,,0,5335728,10249518,4257427,5054,,-4908736,-4908736,49370,GNUS
2016-12-31,,,-6213135,,-6213135,7052519,587658,-6464861,-6464861,,-11178,,,,0,866875,7331736,279217,251726,,-6213135,-6213135,49370,GNUS
2019-12-31,6558000,,-329619000,,-321169000,136462000,-21455000,-207924000,-207924000,,-34690000,,,,-8450000,153843000,361767000,175298000,-121695000,,-321169000,-321169000,49372,TLRY
2018-12-31,4264000,,-72174000,,-67723000,44827000,14275000,-57402000,-57402000,,-9110000,,,,-4451000,41930000,99332000,27655000,-14772000,,-67723000,-67723000,49372,TLRY
2017-12-31,3171000,,-7809000,,-7809000,14663000,11377000,-7498000,-7498000,,-1686000,,,,0,20538000,28036000,9161000,-311000,,-7809000,-7809000,49372,TLRY
2016-12-31,1136000,,-7883000,,-7883000,8489000,2670000,-7049000,-7049000,,-1019000,,,,0,12644000,19693000,9974000,-834000,,-7883000,-7883000,49372,TLRY
2019-12-31,,,37700000,,41400000,103700000,597900000,76500000,76500000,,-82000000,,,,-3700000,981300000,904800000,383400000,-38800000,,41400000,40700000,49373,CONE
2018-12-31,,,1800000,,1200000,98600000,529000000,96300000,96300000,,-94700000,,,,600000,821400000,725100000,292400000,-94500000,,1200000,100000,49373,CONE
2017-12-31,,,-80500000,,-83500000,84000000,436900000,94000000,94000000,,-68100000,,,,3000000,672000000,578000000,235100000,-174500000,,-83500000,-84400000,49373,CONE
2016-12-31,,,21700000,,19900000,77600000,341600000,80100000,80100000,,-48800000,,,,1800000,529100000,449000000,187500000,-58400000,,19900000,19200000,49373,CONE
2020-09-30,,,-130511000,,-122233000,308275000,296790000,-20101000,-20101000,8616000,-71179000,,,,-8278000,899259000,919360000,602469000,-110410000,,-122233000,-122233000,49374,AZEK
2019-09-30,,,-24151000,,-20196000,191272000,258460000,58112000,58112000,9076000,-83205000,,,,-3955000,794203000,736091000,535743000,-82263000,,-20196000,-20196000,49374,AZEK
2018-09-30,,,-16367000,,6745000,144688000,204464000,59776000,59776000,9076000,-68742000,,,,-23112000,681805000,622029000,477341000,-76143000,,6745000,6745000,49374,AZEK
2010-12-31,,,12922000,,9353000,56489000,100865000,44376000,44376000,9076000,-30854000,,,,3569000,327535000,283159000,226670000,-31454000,,9353000,9353000,49374,AZEK
2020-12-31,,,12307000,,10259000,30305000,46440000,0,10662000,5473000,,,,,2048000,46440000,35778000,0,1645000,,10259000,10259000,49375,OVBC
2019-12-31,,,11720000,,9907000,31898000,49962000,0,12556000,5508000,,,,,1813000,49962000,37406000,0,-836000,,9907000,9907000,49375,OVBC
2018-12-31,,,14199000,,11944000,31409000,51625000,0,15019000,5197000,,,,,2255000,51625000,36606000,0,-820000,,11944000,11944000,49375,OVBC
2017-12-31,,,11995000,,7509000,30021000,48604000,0,13115000,5468000,,,,,4486000,48604000,35489000,0,-1120000,,7509000,7509000,49375,OVBC
2019-12-28,,,380434000,77531000,312600000,367152000,774820000,82158000,82158000,,-78674000,,,,59467000,3363905000,3281747000,2589085000,298276000,,320967000,312600000,49377,DAR
2018-12-29,,,117975000,62773000,101496000,311106000,741352000,109054000,109054000,,-86429000,,,,12031000,3387726000,3278672000,2646374000,8921000,,105944000,101496000,49377,DAR
2017-12-30,,,64200000,82764000,128468000,347895000,786571000,136576000,136576000,,-88926000,,,,-69154000,3662251000,3525675000,2875680000,-72376000,,133354000,128468000,49377,DAR
2016-12-31,,,122539000,103228000,102313000,318604000,756595000,148083000,148083000,,-94187000,,,,15315000,3391928000,3243845000,2635333000,-25544000,,107224000,102313000,49377,DAR
2019-12-31,,,207439467,,207439467,12609948,28876573,16266625,16266625,,,,,,0,28876573,12609948,0,191172842,,207439467,207439467,49380,BXMX
2018-12-31,,,-79096808,,-79096808,12877125,28760224,15883099,15883099,,,,,,0,28760224,12877125,0,-94979907,,-79096808,-79096808,49380,BXMX
2017-12-31,,,180788871,,180788871,13248327,29457510,16209183,16209183,,,,,,0,29457510,13248327,0,164579688,,180788871,180788871,49380,BXMX
2016-12-31,,,114590526,,114590526,12680388,30976687,18296299,18296299,,,,,,0,30976687,12680388,0,96294227,,114590526,114590526,49380,BXMX
2020-12-31,273900000,,1657900000,,1298400000,459200000,2301000000,1567900000,1567900000,,,,,,359500000,18728500000,17160600000,16427500000,90000000,,1298400000,1298400000,49382,PCAR
2019-12-31,326600000,,3099200000,,2387900000,502400000,3863000000,3034000000,3034000000,,-9600000.0,,,,711300000,25599700000,22565700000,21736700000,65200000,,2387900000,2387900000,49382,PCAR
2018-12-31,306100000,,2810200000,,2195100000,470200000,3519500000,2743200000,2743200000,,-9600000.0,,,,615100000,23495700000,20752500000,19976200000,67000000,,2195100000,2195100000,49382,PCAR
2017-12-31,264700000,,2173300000,,1675200000,412000000,2820300000,2143600000,2143600000,,-1700000.0,,,,498100000,19456400000,17312800000,16636100000,29700000,,1675200000,1675200000,49382,PCAR
2019-12-31,5692000,,-19450000,,-19450000,16534000,2867000,-19359000,-19359000,,-1480000,,,,0,9131000,28490000,6264000,-91000,,-19450000,-23030000,49383,AVGR
2018-12-31,6009000,,-27558000,,-27558000,18404000,1384000,-23029000,-23029000,,-5692000,,,,0,7915000,30944000,6531000,-4529000,,-27558000,-35692000,49383,AVGR
2017-12-31,11319000,,-48732000,,-48732000,25120000,-3068000,-39507000,-39507000,,-6299000,,,,0,9934000,49441000,13002000,-9225000,,-48732000,-48732000,49383,AVGR
2016-12-31,15536000,,-56128000,,-56128000,39950000,4769000,-50717000,-50717000,,-5524000,,,,0,19214000,69931000,14445000,-5411000,,-56128000,-56128000,49383,AVGR
2019-12-31,,,3962537,,2718274,7135847,18728444,3686477,3686477,5226392,,,,,1244263,59226857,55540380,40498413,276060,,2718274,2718274,49385,CPHC
2018-12-31,,,7708444,,5718444,6991064,20059056,5376019,5376019,5128394,,,,,1990000,59141570,53765551,39082514,2332425,,5718444,5718444,49385,CPHC
2017-12-31,,,4570781,,4090781,7091665,19214719,4382803,4382803,5210814,,,,,480000,56952776,52569973,37738057,187978,,4090781,4090781,49385,CPHC
2016-12-31,,,7119980,,4195980,6459737,16482117,2086678,2086678,5387930,-51059.0,,,,2924000,52460203,50373525,35978086,5033302,,4195980,4195980,49385,CPHC
2019-12-31,,,86719000,690242000,51188000,61063000,393005000,156706000,156706000,-4352000,-79246000,,,,2429000,726991000,570285000,333986000,-69987000,,84290000,49400000,49387,ESRT
2018-12-31,,,121895000,744623000,66539000,52674000,388392000,190857000,190857000,-23647000,-79623000,,,,4642000,707864000,517007000,319472000,-68962000,,117253000,65565000,49387,ESRT
2017-12-31,,,124926000,801451000,63583000,50315000,390377000,192903000,192903000,-13551000,-68473000,,,,6673000,695975000,503072000,305598000,-67977000,,118253000,62611000,49387,ESRT
2016-12-31,,,113396000,820723000,52392000,49078000,380509000,183896000,183896000,-7676000,-70595000,,,,6146000,669677000,485781000,289168000,-70500000,,107250000,51420000,49387,ESRT
2020-03-31,59500000,,10400000,5700000,-2200000,193100000,307500000,54900000,54900000,,-22700000,,,,12400000,1975500000,1920600000,1668000000,-44500000,,-2000000,-2200000,49391,MOD
2019-03-31,69800000,,80800000,7200000,84800000,177200000,365500000,118500000,118500000,,-24800000,,,,-5100000,2212700000,2094200000,1847200000,-37700000,,85900000,84400000,49391,MOD
2018-03-31,65800000,,63300000,8400000,22200000,183300000,356500000,107400000,107400000,,-25600000,,,,39500000,2103100000,1995700000,1746600000,-44100000,,23800000,22000000,49391,MOD
2017-03-31,64400000,,20800000,7200000,14200000,124900000,258700000,69400000,69400000,,-17200000,,,,5900000,1503000000,1433600000,1244300000,-48600000,,14900000,14000000,49391,MOD
2019-12-31,,,27408851,,26438186,20593151,58911889,38318738,38318738,,-14530606,,,,970665,58911889,20593151,0,-10909887,,26438186,26438186,49393,SCM
2018-12-31,,,26805612,,26194578,18015940,53266338,35250398,35250398,,-11902277,,,,611034,53266338,18015940,0,-8444786,,26194578,26194578,49393,SCM
2017-12-31,,,22604664,,22613257,13405497,39648193,26242696,26242696,,-7497370,,,,-8593,39648193,13405497,0,-3638032,,22613257,22613257,49393,SCM
2016-12-31,,,22825931,,23199062,14185811,39490197,25304386,25304386,,-7868214,,,,-373131,39490197,14185811,0,-2478455,,23199062,23199062,49393,SCM
2019-12-31,69099000,,147487000,,113056000,158425000,376095000,148571000,148571000,,-22707000,,,,34431000,392755000,244184000,16660000,-1084000,,113056000,113056000,49394,SUPN
2018-12-31,75209000,,140176000,,110993000,159888000,393541000,158444000,158444000,,-18111000,,,,29183000,408897000,250453000,15356000,-18268000,,110993000,110993000,49394,SUPN
2017-12-31,49577000,,100618000,,57284000,137905000,287023000,99541000,99541000,,-1568000,,,,43334000,302238000,202697000,15215000,1077000,,57284000,57284000,49394,SUPN
2016-12-31,42791000,,50369000,,91221000,106010000,203017000,54216000,54216000,,-5091000,,,,-40852000,215003000,160787000,11986000,-3847000,,91221000,91221000,49394,SUPN
2019-12-31,,,25149648,,25149648,2467213,2661629,122416,122416,72000,,,,,0,2661629,2539213,0,25027232,,25149648,25149648,49396,SWZ
2018-12-31,,,-27600085,,-27600085,4305428,7813505,3418077,3418077,90000,,,,,0,7813505,4395428,0,-31018162,,-27600085,-27600085,49396,SWZ
2017-12-31,,,68404212,,68404212,4806445,8316895,3420450,3420450,90000,,,,,0,8316895,4896445,0,64983762,,68404212,68404212,49396,SWZ
2016-12-31,,,-8472938,,-8472938,3843029,8110419,4177390,4177390,90000,,,,,0,8110419,3933029,0,-12650328,,-8472938,-8472938,49396,SWZ
2019-12-31,,,-472758000,,-293113000,189211000,842704000,186875000,186875000,215521000,-118056000,,,,-179645000,2739189000,2552314000,1896485000,-659633000,,-293113000,-293113000,49399,AAWW
2018-12-31,,,309374000,,270567000,166487000,874407000,295027000,295027000,195553000,-114651000,,,,38727000,2677724000,2382697000,1803317000,14347000,-80000.0,270647000,270567000,49399,AAWW
2017-12-31,,,143372000,,223473000,144699000,726613000,246558000,246558000,168643000,-92298000,,,,-80966000,2156460000,1909902000,1429847000,-103186000,-865000.0,224338000,223473000,49399,AAWW
2016-12-31,,,89416000,,41516000,127748000,619868000,200511000,200511000,142733000,-81337000,,,,46791000,1839627000,1639116000,1219759000,-111095000,-1109000.0,42625000,41516000,49399,AAWW
2019-12-31,,,-15452000,,-15213000,17169000,22749000,-16246000,-16246000,,-435000,,,,-239000,145773000,162019000,123024000,794000,,-15213000,-15213000,49402,DWSN
2018-12-31,,,-25205000,,-24407000,16287000,21219000,-25027000,-25027000,,-408000,,,,-798000,154156000,179183000,132937000,-178000,,-24407000,-24407000,49402,DWSN
2017-12-31,,,-37104000,,-31790000,16189000,17460000,-37964000,-37964000,,-158000,,,,-5314000,156532000,194496000,139072000,860000,,-31790000,-31790000,49402,DWSN
2016-12-31,,,-44293000,,-38333000,16822000,13617000,-47488000,-47488000,,-260000,,,,-5960000,137640000,185128000,124023000,3195000,,-38333000,-38333000,49402,DWSN
2019-12-31,9674000,,-16395000,,-16395000,6854000,0,-16528000,-16528000,,,,,,0,0,16528000,0,133000,,-16395000,-16395000,49403,ACHV
2018-12-31,5868000,,-12687000,,-12687000,6945000,0,-12813000,-12813000,,,,,,0,0,12813000,0,126000,,-12687000,-12687000,49403,ACHV
2017-12-31,3101000,,-13634000,,-10583000,3531000,0,-6632000,-6632000,,,,,,-3051000,0,6632000,0,-7002000,,-10583000,-10583000,49403,ACHV
2016-12-31,286000,,-1738000,,-1234000,1428000,0,-1714000,-1714000,,,,,,-504000,0,1714000,0,-24000,,-1234000,-1234000,49403,ACHV
2020-02-01,,,672000000,,491000000,2673000000,3565000000,713000000,713000000,4000000,-10000000,,,,181000000,8005000000,7292000000,4440000000,-41000000,,491000000,491000000,49404,FL
2019-02-02,,,713000000,,541000000,2366000000,3278000000,734000000,734000000,4000000,-11000000,,,,172000000,7939000000,7205000000,4661000000,-21000000,,541000000,541000000,49404,FL
2018-02-03,,,578000000,,284000000,2235000000,3191000000,783000000,783000000,4000000,-12000000,,,,294000000,7782000000,6999000000,4591000000,-205000000,,284000000,284000000,49404,FL
2017-01-28,,,1004000000,,664000000,2164000000,3326000000,1004000000,1004000000,4000000,-11000000,,,,340000000,7766000000,6762000000,4440000000,0,,664000000,664000000,49404,FL
2019-12-31,9276000,,21679000,,17934000,49394000,79853000,21183000,21183000,,,,,,3745000,117232000,96049000,37379000,496000,,17934000,17934000,49405,LMAT
2018-12-31,8197000,,28444000,,22943000,45007000,73939000,20735000,20735000,,-2000.0,,,,5501000,105568000,84833000,31629000,7709000,,22943000,22943000,49405,LMAT
2017-12-31,6636000,,21106000,,17177000,42958000,70697000,21103000,21103000,,-21000.0,,,,3929000,100867000,79764000,30170000,3000,,17177000,17177000,49405,LMAT
2016-12-31,6141000,,16242000,,10590000,40459000,62936000,16336000,16336000,,-14000.0,,,,5652000,89151000,72815000,26215000,-94000,,10590000,10590000,49405,LMAT
2019-12-31,,,1457000000,20000000,1239000000,3686000000,4965000000,1408000000,1408000000,-129000000,-513000000,,,,218000000,64317000000,62909000000,59352000000,49000000,,1239000000,1151000000,49408,AEG
2018-12-31,,,751000000,22000000,710000000,3538000000,4689000000,1009000000,1009000000,142000000,-507000000,,,,40000000,17987000000,16978000000,13298000000,-258000000,,711000000,597000000,49408,AEG
2018-01-01,,,2534000000,20000000,2469000000,3658000000,5941000000,2189000000,2189000000,94000000,-435000000,,,,65000000,53867000000,51678000000,47926000000,345000000,,2469000000,2338000000,49408,AEG
2016-12-31,,,609000000,23000000,437000000,3560000000,4968000000,1390000000,1390000000,18000000,-347000000,,,,172000000,49791000000,48401000000,44823000000,-781000000,,437000000,304000000,49408,AEG
2020-12-31,560400000,,-495400000,1100000,-495100000,1079200000,2158100000,315800000,315800000,,-91300000,,,,-1300000,3316700000,3000900000,1158600000,-811200000,,-494100000,-495100000,49409,GDDY
2019-12-31,492600000,,126400000,10100000,137000000,1035700000,1961300000,223300000,223300000,,-92100000,,,,-12000000,2988100000,2764800000,1026800000,-96900000,,138400000,137000000,49409,GDDY
2018-12-31,434000000,,73000000,31800000,77100000,936600000,1766200000,161500000,161500000,,-98400000,,,,-9000000,2660100000,2498600000,893900000,-88500000,,82000000,77100000,49409,GDDY
2017-12-31,355800000,,106800000,60000000,136400000,809300000,1456400000,85500000,85500000,11700000.0,-83000000,,,,-18900000,2231900000,2146400000,775500000,21300000,14100000.0,125700000,136400000,49409,GDDY
2019-12-31,,,-1922870,,6794226,15628620,14678454,-1670201,-1670201,,-39814,,,,-455006,38502482,40172683,23824028,-252669,8262090,-1467864,6794226,49414,SSNT
2018-12-31,,,-1202785,,262432,14366526,13854850,-1161103,-1161103,,-41682,,,,-281212,36103818,37264921,22248968,-41682,1184005,-921573,262432,49414,SSNT
2017-12-31,,,907562,,-486469,12204197,13865440,939258,939258,,-31696,,,,1394031,34852028,33912770,20986588,-31696,1184005,-486469,-486469,49414,SSNT
2016-12-31,,,1212665,,3436399,10732444,12727242,1267343,1267343,,-64678,,,,-2223734,34121970,32854627,21394728,-54678,1184005,3436399,3436399,49414,SSNT
2020-03-31,47110000,,-72190000,,-72628000,22061000,0,-69171000,-69171000,,-4377000,,,,438000,0,69171000,0,-3019000,,-72628000,-72628000,49415,SIOX
2019-03-31,87552000,,-128932000,,-129065000,39466000,0,-127018000,-127018000,,-7530000,,,,133000,0,127018000,0,-1914000,,-129065000,-129065000,49415,SIOX
2018-03-31,141412000,,-220652000,,-221573000,71906000,0,-213318000,-213318000,,-7545000,,,,921000,0,213318000,0,-7334000,,-221573000,-221573000,49415,SIOX
2017-03-31,134778000,,-182011000,,-180951000,45721000,0,-180499000,-180499000,,-1143000,,,,-1060000,0,180499000,0,-1512000,,-180951000,-180951000,49415,SIOX
2019-12-31,,,85758226,,85758226,3077752,10781542,7703790,7703790,,,,,,0,10781542,3077752,0,78054436,,85758226,85758226,49418,RFI
2018-12-31,,,-14826126,,-14826126,2878739,10859011,7980272,7980272,,,,,,0,10859011,2878739,0,-22806398,,-14826126,-14826126,49418,RFI
2017-12-31,,,26747665,,26747665,3064910,10939813,7874903,7874903,,,,,,0,10939813,3064910,0,18872762,,26747665,26747665,49418,RFI
2016-12-31,,,18446385,,18446385,3037387,11630703,8593316,8593316,,,,,,0,11630703,3037387,0,9853069,,18446385,18446385,49418,RFI
2020-12-31,,,685200000,41900000,520100000,1322500000,2390100000,676800000,676800000,,-141600000,,,,159000000,4127500000,3450700000,1737400000,8400000,,526200000,520100000,49419,EFX
2019-12-31,,,-433000000,44300000,-398800000,1185900000,1985900000,468900000,468900000,,-111700000,,,,-40200000,3507600000,3038700000,1521700000,-901900000,,-392800000,-398800000,49419,EFX
2018-12-31,,,356300000,47900000,299800000,1232900000,1971700000,428400000,428400000,,-103500000,,,,50000000,3412100000,2983700000,1440400000,-72100000,,306300000,299800000,49419,EFX
2017-12-31,,,746600000,64600000,587300000,1089200000,2151500000,774500000,774500000,,-92800000,,,,148600000,3362200000,2587700000,1210700000,-27900000,,598000000,587300000,49419,EFX
2020-12-31,,,32359000,,21298000,100045000,147869000,47824000,47824000,,-7022000,,,,11576000,916498000,868674000,768629000,-15465000,515000,20783000,21298000,49421,GLT
2019-12-31,,,-34453000,,-21541000,88879000,147542000,57943000,57943000,,-10408000,,,,-9242000,927673000,869730000,780131000,-92396000,3670000,-25211000,-21541000,49421,GLT
2018-12-31,,,7275000,,-177604000,99344000,130407000,30368000,30368000,,-15609000,,,,7723000,866286000,835918000,735879000,-23093000,-177156000,-448000,-177604000,49421,GLT
2017-12-31,,,19467000,,7914000,117803000,143589000,25938000,25938000,,-13317000,,,,25079000,800362000,774424000,656773000,-6471000,13526000,-5612000,7914000,49421,GLT
2020-08-31,,,-1939000,3729000,-4145000,187876000,208618000,20742000,20742000,,-8669000,,,,166000,1712343000,1691601000,1503725000,-22681000,-95000,-2105000,-4145000,49422,SCHN
2019-08-31,,,76240000,4332000,56345000,191405000,274246000,82841000,82841000,,-8266000,,,,17670000,2132781000,2049940000,1858535000,-6601000,-248000,58570000,56345000,49422,SCHN
2018-08-31,,,141853000,4032000,156451000,210877000,354230000,143353000,143353000,,-8983000,,,,-17590000,2364715000,2221362000,2010485000,-1500000,346000,159443000,156451000,49422,SCHN
2017-08-31,,,48690000,3907000,44511000,171570000,223083000,51513000,51513000,,-8081000,,,,1322000,1687591000,1636078000,1464508000,-2823000,-390000,47368000,44511000,49422,SCHN
2019-12-31,,,1525651000,16756000,1520534000,70783000,2119587000,1534686000,1534686000,1200000,-45641000,,,,0,2916370000,1381684000,796783000,-9035000,,1525651000,1272767000,49424,PSA
2018-12-31,,,1717223000,25250000,1711031000,117620000,2118053000,1515687000,1515687000,1100000,-32542000,,,,0,2857775000,1342088000,739722000,201536000,,1717223000,1488900000,49424,PSA
2017-12-31,,,1448465000,24360000,1442217000,82182000,2036205000,1498797000,1498797000,700000,-12690000,,,,0,2744183000,1245386000,707978000,-50332000,,1448465000,1171609000,49424,PSA
2016-12-31,,,1460439000,29744000,1453576000,82256000,1945122000,1428152000,1428152000,1400000,-4210000,,,,0,2614205000,1186053000,669083000,32287000,,1460439000,1183879000,49424,PSA
2020-10-31,,,203081190,,203081190,10042332,52213983,42171651,42171651,,-7464558,,,,0,52213983,10042332,0,160909539,,203081190,203081190,49425,CHI
2019-10-31,,,80769214,,80769214,9676899,57184826,47507927,47507927,,-11883720,,,,0,57184826,9676899,0,33261287,,80769214,80769214,49425,CHI
2018-10-31,,,16735460,,16735460,10095594,60183425,50087831,50087831,,-9757217,,,,0,60183425,10095594,0,-33352371,,16735460,16735460,49425,CHI
2017-10-31,,,123412539,,123412539,9538846,54471043,44932197,44932197,,-4992298,,,,0,54471043,9538846,0,78480342,,123412539,123412539,49425,CHI
2019-12-31,1933112,,3567561,,2021492,13273297,19528359,3763075,3763075,,,,,,1546069,38981313,35218238,19452954,-195514,,2021492,2021492,49431,PFIE
2018-12-31,1397440,,8597962,,6080762,13029228,22901180,7973958,7973958,,,,,,2517200,45614535,37640577,22713355,624004,,6080762,6080762,49431,PFIE
2017-12-31,1221211,,7123229,,4449535,11676693,20263907,6839420,6839420,,,,,,2673694,38286376,31446956,18022469,283809,,4449535,4449535,49431,PFIE
2016-12-31,911402,,-1084951,,-686564,9868182,10399933,-1004500,-1004500,,,,,,-398387,20530840,21535340,10130907,-80451,,-686564,-686564,49431,PFIE
2019-12-31,,,-2900,,-2900,,0,0,,,,,,,0,0,0,0,-2900,,-2900,-2900,49432,VTAQ
2020-07-31,,,15778323,,15778323,4327605,30887355,26559750,26559750,,-5384527,,,,0,30887355,4327605,0,-10781427,,15778323,15778323,49433,MUJ
2019-07-31,,,39294426,,39294426,4251071,31266304,27015233,27015233,,-7244025,,,,0,31266304,4251071,0,12279193,,39294426,39294426,49433,MUJ
2018-07-31,,,13613766,,13613766,4316470,31781686,27465216,27465216,,-6075573,,,,0,31781686,4316470,0,-13851450,,13613766,13613766,49433,MUJ
2017-07-31,,,-5163137,,-5163137,4286709,32164604,27877895,27877895,,-4604216,,,,0,32164604,4286709,0,-33041032,,-5163137,-5163137,49433,MUJ
2019-12-31,,,-5351000,,-5386000,3614000,3342000,-6395000,-6395000,134000,,,,,35000,7730000,14125000,4388000,1044000,,-5386000,-5386000,49434,AUMN
2018-12-31,,,-1932000,,-1945000,3355000,3662000,-5215000,-5215000,216000,,,,,13000,7217000,12432000,3555000,3283000,,-1945000,-1945000,49434,AUMN
2017-12-31,,,-3879000,,-3892000,3512000,3680000,-2987000,-2987000,-1184000,,,,,13000,6691000,9678000,3011000,-892000,,-3892000,-3892000,49434,AUMN
2016-12-31,,,-10659000,,-10659000,3890000,3846000,-6096000,-6096000,193000,-515000.0,,,,0,6400000,12496000,2554000,-4563000,,-10659000,-10659000,49434,AUMN
2020-10-31,321000000,,-388000000,4000000,-347000000,981000000,1139000000,-163000000,-163000000,,-199000000,,,,-59000000,7503000000,7666000000,6364000000,-225000000,,-329000000,-347000000,49436,NAV
2019-10-31,319000000,,262000000,3000000,221000000,816000000,1835000000,700000000,700000000,,-207000000,,,,19000000,11251000000,10551000000,9416000000,-438000000,,243000000,221000000,49436,NAV
2018-10-31,297000000,,420000000,5000000,340000000,820000000,1764000000,647000000,647000000,,-235000000,,,,52000000,10250000000,9603000000,8486000000,-227000000,,368000000,340000000,49436,NAV
2017-10-31,251000000,,64000000,4000000,30000000,743000000,1374000000,380000000,380000000,,-265000000,,,,10000000,8570000000,8190000000,7196000000,-316000000,1000000.0,54000000,30000000,49436,NAV
2020-12-31,,,324117000,,243439000,572375000,1053830000,481455000,481455000,,,,,,74590000,6129320000,5647865000,5075490000,-157338000,,249527000,243439000,49442,TMHC
2019-12-31,,,322272000,8006000.0,254652000,490271000,876607000,386336000,386336000,,,,,,67358000,4762059000,4375723000,3885452000,-64064000,,254914000,254652000,49442,TMHC
2018-12-31,,,273516000,3543000.0,206364000,410443000,787124000,376681000,376681000,,,,,,63036000,4227393000,3850712000,3440269000,-103165000,,210480000,206364000,49442,TMHC
2017-12-31,,,355656000,750428000.0,91220000,390440000,738929000,348489000,348489000,,,,,,179006000,3885290000,3536801000,3146361000,7167000,,176650000,91220000,49442,TMHC
2020-08-31,,,-2254223,,-2275532,1420705,604390,-2155823,-2155823,,-107105,,,,21309,2417173,4572996,1812783,-98400,,-2275532,-2275532,49444,VMAR
2019-08-31,,,297453,,233066,946422,1285364,333700,333700,,-34457,,,,64387,2869377,2535677,1584013,-36247,,233066,233066,49444,VMAR
2018-08-31,,,-34115,,-185848,507350,501727,-6123,-6123,,-39951,,,,151733,1271566,1277689,769839,-27992,,-185848,-185848,49444,VMAR
2019-12-31,18355403,,105333552,,102204472,41806638,173013581,112851540,112851540,,-11940346,,,,3129080,319181424,206329884,146167843,-7517988,,102204472,102204472,49445,WIMI
2018-12-31,8020082,,97293388,,89217792,31034826,139857503,100802595,100802595,,-5171453,,,,8075596,225271564,124468969,85414061,-3509207,,89217792,89217792,49445,WIMI
2017-12-31,9696322,,73865982,,73337971,25854671,112849337,77298344,77298344,,-4228995,,,,528011,192029524,114731180,79180187,-3432362,,73337971,73337971,49445,WIMI
2020-02-01,,,119774000,,94497000,857027000,999670000,142643000,142643000,,-7355000,,,,25277000,3492687000,3350044000,2493017000,-22869000,,94497000,94497000,49450,DBI
2019-02-02,,,9367000,,-20466000,1014915000,1187724000,172809000,172809000,,-2433000,,,,29833000,3183738000,3010929000,1996014000,-163442000,,-20466000,-20466000,49450,DBI
2018-02-03,,,127019000,,67452000,837853000,1028861000,191008000,191008000,,-488000,,,,59567000,2810720000,2619712000,1781859000,-63989000,,67452000,67452000,49450,DBI
2017-01-28,,,203197000,,124419000,815762000,995588000,179826000,179826000,,-238000,,,,78778000,2718299000,2538473000,1722711000,23371000,,124419000,124419000,49450,DBI
2019-12-31,,,-23877000,,-23877000,11616000,-12297000,-23913000,-23913000,,-2096000,,,,0,7917000,31830000,20214000,36000,,-23877000,-13603000,49451,BBI
2018-12-31,,,-9236000,,-9236000,6379000,-2072000,-8451000,-8451000,,-1090000,,,,0,10888000,19339000,12960000,-782000,,-9236000,-15172000,49451,BBI
2017-12-31,,,-11116000,,-11116000,5693000,-4318000,-10011000,-10011000,,-1049000,,,,0,7567000,17578000,11885000,-1105000,,-11116000,-23041000,49451,BBI
2019-12-31,,,612600000,,450000000,2558600000,3523000000,782500000,782500000,1400000,-245100000,,,,161800000,21335700000,20553200000,17812700000,-169900000,-800000,450800000,450000000,49454,AN
2018-12-31,,,529400000,,396000000,2509800000,3397300000,720100000,720100000,1200000,-249800000,,,,133500000,21412800000,20692700000,18015500000,-190700000,100000,395900000,396000000,49454,AN
2017-12-31,,,636500000,,434600000,2436200000,3359000000,774400000,774400000,-10200000,-217200000,,,,201500000,21534600000,20760200000,18175600000,-137900000,-400000,435000000,434600000,49454,AN
2016-12-31,,,702300000,,430500000,2349400000,3313200000,821800000,821800000,-1400000,-192000000,,,,270600000,21609000000,20787200000,18295800000,-119500000,-1200000,431700000,430500000,49454,AN
2019-12-31,,,28600000,26200000,14900000,130000000,291100000,67900000,67900000,,-46100000,,,,12300000,1478700000,1410800000,1187600000,-39300000,,16300000,14900000,49456,USCR
2018-12-31,,,48100000,24800000,30000000,125800000,294200000,76600000,76600000,,-46400000,,,,16800000,1506400000,1429800000,1212200000,-28500000,,31300000,30000000,49456,USCR
2017-12-31,,,38600000,21700000,25500000,119200000,279400000,92400000,92400000,,-42100000,,,,12400000,1336000000,1243600000,1056600000,-53800000,-600000.0,26200000,25500000,49456,USCR
2016-12-31,,,30800000,21700000,8900000,100000000,245900000,91000000,91000000,,-27700000,,,,21200000,1168200000,1077200000,922300000,-60200000,-700000.0,9600000,8900000,49456,USCR
2020-12-31,,,855100000,,744300000,1008900000,2013000000,1004100000,1004100000,,-118500000,,,,110800000,4835000000,3830900000,2822000000,-149000000,,744300000,744300000,49457,WU
2019-12-31,,,1321400000,,1058300000,1206700000,2245400000,1038700000,1038700000,,-152000000,,,,263100000,5292100000,4253400000,3046700000,282700000,,1058300000,1058300000,49457,WU
2018-12-31,,,991400000,,851900000,1178700000,2289100000,1110400000,1110400000,,-149600000,,,,139500000,5589900000,4479500000,3300800000,-119000000,,851900000,851900000,49457,WU
2017-12-31,,,347500000,,-557100000,1184100000,2207000000,1022900000,1022900000,,-142100000,,,,904600000,5524300000,4501400000,3317300000,-675400000,,-557100000,-557100000,49457,WU
2019-12-31,,,136102000,,113890000,189573000,329098000,139525000,139525000,,-2594000,,,,22212000,2222559000,2083034000,1893461000,-3423000,,113890000,113890000,49459,MANT
2018-12-31,,,110627000,,82097000,167715000,280457000,112742000,112742000,,-2378000,,,,28530000,1958557000,1845815000,1678100000,-2115000,,82097000,82097000,49459,MANT
2017-12-31,,,97282000,,114141000,155225000,253419000,98194000,98194000,,-1375000,,,,-16859000,1717018000,1618824000,1463599000,-912000,,114141000,114141000,49459,MANT
2016-12-31,,,90177000,,56391000,140858000,231821000,90963000,90963000,,-1097000,,,,33786000,1601596000,1510633000,1369775000,-2286000,,56391000,56391000,49459,MANT
2019-12-31,46318000,,-41090000,,-41068000,248978000,369948000,46435000,46435000,,-8216000,,,,-22000,539501000,493066000,169553000,-87525000,,-41068000,15995000,49461,GOCO
2018-12-31,16197000,,28160000,,28117000,101663000,146623000,28763000,28763000,,-224000,,,,46000,226205000,197442000,79582000,-603000,,28114000,28117000,49461,GOCO
2020-01-31,77576000,,43155000,,39664000,104512000,325909000,109117000,109117000,,-24772000,,,,3491000,531993000,422876000,206084000,-65962000,,39664000,39664000,49462,HQY
2019-01-31,35057000,,75818000,,73899000,62537000,181193000,77670000,77670000,,-270000,,,,1919000,287243000,209573000,106050000,-1852000,,73899000,73899000,49462,HQY
2018-01-31,27385000,,52189000,,47362000,48250000,134916000,54418000,54418000,,-274000,,,,4827000,229525000,175107000,94609000,-2229000,,47362000,47362000,49462,HQY
2017-01-31,22375000,,40120000,,26376000,38471000,106355000,41212000,41212000,,-275000,,,,13744000,178370000,137158000,72015000,-1092000,,26376000,26376000,49462,HQY
2019-12-31,,,61734000,,61330000,59563000,221298000,161735000,161735000,,-52205000,,,,404000,221298000,59563000,0,-100001000,,61330000,61330000,49463,CGBD
2018-12-31,,,39345000,,39115000,58764000,207526000,148762000,148762000,,-38702000,,,,230000,207526000,58764000,0,-109417000,,39115000,39115000,49463,CGBD
2017-12-31,,,84464000,,84200000,46093000,165001000,118908000,118908000,,-25255000,,,,264000,165001000,46093000,0,-34444000,,84200000,84200000,49463,CGBD
2016-12-31,,,69885000,,69809000,32239000,110971000,78732000,78732000,,-17675000,,,,76000,110971000,32239000,0,-8847000,,69809000,69809000,49463,CGBD
2019-12-31,50294000,,-128344000,,-128389000,33169000,0,-83463000,-83463000,,,,,,45000,0,83463000,0,-44881000,,-128389000,-128389000,49464,CERE
2018-12-31,454652000,,-463636000,,-463636000,28672000,0,-483324000,-483324000,,,,,,0,0,483324000,0,19688000,,-463636000,-463636000,49464,CERE
2020-11-30,,,11241791,,11241791,1129278,4551015,3421737,3421737,,,,,,0,4551015,1129278,0,7820054,,11241791,11241791,49466,MGF
2019-11-30,,,14507919,,14507919,1149789,4938869,3789080,3789080,,,,,,0,4938869,1149789,0,10718839,,14507919,14507919,49466,MGF
2018-11-30,,,-2544518,,-2544518,1183499,5227348,4043849,4043849,,,,,,0,5227348,1183499,0,-6588367,,-2544518,-2544518,49466,MGF
2017-11-30,,,3629524,,3629524,1283413,5782565,4499152,4499152,,,,,,0,5782565,1283413,0,-869628,,3629524,3629524,49466,MGF
2020-12-31,,,1556000000,,1343000000,3367000000,5665000000,0,1691000000,607000000,,,,,227000000,5665000000,3974000000,0,-135000000,14000000,1329000000,1237000000,49467,KEY
2019-12-31,,,2022000000,,1717000000,3212000000,6062000000,0,2344000000,503000000,,,,,314000000,6062000000,3718000000,0,-322000000,9000000,1708000000,1620000000,49467,KEY
2018-12-31,,,2203000000,1000000.0,1866000000,3292000000,6178000000,0,2426000000,457000000,,,,,344000000,6178000000,3752000000,0,-223000000,7000000,1859000000,1800000000,49467,KEY
2017-12-31,,,1928000000,2000000.0,1296000000,3352000000,6026000000,0,2116000000,558000000,,,,,637000000,6026000000,3910000000,0,-188000000,7000000,1291000000,1226000000,49467,KEY
2019-12-31,,,12921000,10564000,925000,193147000,308125000,97993000,97993000,,-81400000,,,,10864000,436929000,338936000,128804000,-85072000,,2057000,925000,49469,UONEK
2018-12-31,,,3406000,10232000,137442000,183250000,313734000,97295000,97295000,,-76667000,,,,-135199000,439098000,341803000,125364000,-93889000,,138605000,137442000,49469,UONEK
2017-12-31,,,-10701000,10780000,111887000,193967000,309624000,81641000,81641000,,-79420000,,,,-123163000,440041000,358400000,130417000,-92342000,,112462000,111887000,49469,UONEK
2016-12-31,,,10296000,12410000,-423000,198541000,322219000,89431000,89431000,,-81636000,,,,9580000,456219000,366788000,134000000,-79135000,,716000,-423000,49469,UONEK
2020-08-02,92000000,,766000000,6000000,1628000000,1519000000,3008000000,1291000000,1291000000,106000000,-345000000,,,,174000000,8691000000,7400000000,5683000000,-525000000,1036000000,592000000,1628000000,49470,CPB
2019-07-28,88000000,,625000000,9000000,211000000,1383000000,2711000000,1117000000,1117000000,123000000,-356000000,,,,151000000,8107000000,6990000000,5396000000,-492000000,-263000000,474000000,211000000,49470,CPB
2018-07-29,91000000,,830000000,9000000,261000000,1177000000,2461000000,1404000000,1404000000,-211000000,-183000000,,,,106000000,6615000000,5211000000,4154000000,-574000000,-463000000,724000000,261000000,49470,CPB
2017-07-30,93000000,,1316000000,8000000,887000000,1090000000,2446000000,1503000000,1503000000,-240000000,-115000000,,,,392000000,5837000000,4334000000,3391000000,-187000000,-37000000,924000000,887000000,49470,CPB
2019-12-31,3920000,,-4316000,,-4316000,403000,0,-4323000,-4323000,,,,,,0,0,4323000,0,7000,,-4316000,-4316000,49472,OLMA
2018-12-31,1693000,,-2197000,,-2197000,386000,0,-2079000,-2079000,,-28000.0,,,,0,0,2079000,0,-118000,,-2197000,-2197000,49472,OLMA
2020-12-31,,,510100000,,409900000,1003400000,1787500000,689900000,689900000,94200000,-36000000,,,,100200000,5111100000,4421200000,3323600000,-179800000,,409900000,409500000,49473,KMPR
2019-12-31,,,661600000,,531100000,922900000,1815400000,799000000,799000000,93500000,-42500000,,,,130500000,5003700000,4204700000,3188300000,-137400000,,531100000,529400000,49473,KMPR
2018-12-31,,,199100000,,190100000,826800000,1216400000,318600000,318600000,71000000,-43400000,,,,10700000,3682900000,3364300000,2466500000,-119500000,1700000.0,188400000,189100000,49473,KMPR
2017-12-31,,,161100000,,120900000,592200000,886000000,243100000,243100000,50700000,-34900000,,,,41200000,2723400000,2480300000,1837400000,-82000000,1000000.0,119900000,120100000,49473,KMPR
2019-12-31,,,-437600,-1060600,235600,3466800,3308400,-158400,-158400,,-358300,,,,-634600,30953500,31111900,27645100,-279200,,197000,235600,49474,HCDI
2018-12-31,,,-841100,-789400,-1390400,2765900,793600,-1972300,-1972300,,-117700,,,,517800,5730300,7702600,4936700,1131200,,-1358900,-1390400,49474,HCDI
2017-12-31,,,2069100,310900,1080000,696400,2857100,2160700,2160700,,-108700,,,,0,9185000,7024300,6327900,-91600,,2069100,1080000,49474,HCDI
2019-12-31,,,14850000,139554000,13886000,10073000,44740000,26343000,26343000,4000,-19588000,,,,0,53564000,27221000,8824000,-11493000,,14850000,1324000,49475,FPI
2018-12-31,,,14040000,165195000,12254000,9682000,48110000,29873000,29873000,11000,-18799000,,,,0,56069000,26196000,7959000,-15833000,,14040000,-420000,49475,FPI
2017-12-31,,,9158000,167023000,7914000,8711000,39961000,23458000,23458000,361000,-13561000,,,,0,46219000,22761000,6258000,-14300000,,9158000,907000,49475,FPI
2016-12-31,,,6010000,173607000,4302000,8470000,28622000,18153000,18153000,445000,-9959000,,,,11000,31001000,12848000,2379000,-12143000,,5999000,1178000,49475,FPI
2020-12-31,,,371358000,,312321000,441470000,947894000,0,389706000,116718000,,,,,59037000,947894000,558188000,0,-18348000,,312321000,304725000,49476,PNFPP
2019-12-31,,,497537000,,400881000,416136000,1002685000,0,514873000,71676000,,,,,96656000,1002685000,487812000,0,-17336000,,400881000,400881000,49476,PNFPP
2018-12-31,,,449948000,,359440000,365476000,902835000,0,469479000,67880000,,,,,90508000,902835000,433356000,0,-19531000,,359440000,359440000,49476,PNFPP
2017-12-31,,,297986000,,173979000,277811000,664546000,0,339724000,47011000,,,,,124007000,664546000,324822000,0,-41738000,,173979000,173979000,49476,PNFPP
2019-12-31,,,233137000,156047000,224884000,10251000,370781000,265125000,265125000,,-76823000,,,,41000,532777000,267652000,161996000,-31988000,,233096000,224884000,49477,HEP
2018-12-31,,,186413000,134287000,178847000,11040000,359790000,251258000,251258000,,-71899000,,,,26000,506220000,254962000,146430000,-64845000,,186387000,178847000,49477,HEP
2017-12-31,,,202160000,134247000,159993000,14323000,316757000,223456000,223456000,,-58448000,,,,249000,454362000,230906000,137605000,-21296000,,201911000,159993000,49477,HEP
2016-12-31,,,168532000,1044000,101068000,12532000,278057000,195697000,195697000,,-52552000,,,,285000,402043000,206346000,123986000,-27165000,,168247000,101018000,49477,HEP
2019-12-31,,,-1766448,,-1766448,1852248,0,-1852248,-1852248,,,,,,0,0,1852248,0,85800,,-1766448,-1766448,49479,WRN
2018-12-31,,,-2856160,,-2856160,2134250,0,-2134250,-2134250,,,,,,0,0,2134250,0,-721910,,-2856160,-2856160,49479,WRN
2017-12-31,,,-2661589,,-2661589,1832698,0,-1832698,-1832698,,,,,,0,0,1832698,0,-828891,,-2661589,-2661589,49479,WRN
2016-12-31,,,-2088400,,-2088400,1846163,0,-1846163,-1846163,,,,,,0,0,1846163,0,-242237,,-2088400,-2088400,49479,WRN
2020-12-31,,,1171000000,999000000,958000000,5652000000,7040000000,1388000000,1388000000,,-709000000,,,,196000000,14852000000,13464000000,7812000000,-217000000,,975000000,958000000,49480,FISV
2019-12-31,,,1112000000,1878000000,893000000,3042000000,4878000000,1836000000,1836000000,,-507000000,,,,198000000,10187000000,8351000000,5309000000,-724000000,,914000000,893000000,49480,FISV
2018-12-31,,,1565000000,1878000000,1187000000,1228000000,2754000000,1526000000,1526000000,,-193000000,,,,378000000,5823000000,4297000000,3069000000,39000000,,1187000000,1187000000,49480,FISV
2017-12-31,,,1390000000,1878000000,1246000000,1150000000,2672000000,1522000000,1522000000,,-176000000,,,,158000000,5696000000,4174000000,3024000000,-132000000,14000000.0,1232000000,1246000000,49480,FISV
2020-12-31,24317000,,45479000,,34686000,67787000,139063000,46959000,46959000,,-3272000,,,,10793000,424066000,377107000,285003000,-1480000,,34686000,34686000,49481,CTS
2019-12-31,25967000,,50266000,,36146000,70408000,157575000,61200000,61200000,,-2648000,,,,14120000,468999000,407799000,311424000,-10934000,,36146000,36146000,49481,CTS
2018-12-31,25304000,,58103000,,46532000,73569000,164973000,66100000,66100000,,-2085000,,,,11571000,470483000,404383000,305510000,-7997000,,46532000,46532000,49481,CTS
2017-12-31,25146000,,40253000,,14448000,71943000,140431000,43342000,43342000,,-3343000,,,,25805000,422993000,379651000,282562000,-3089000,,14448000,14448000,49481,CTS
2019-12-31,114904000,,-132993000,,-132993000,154557000,158030000,-112229000,-112229000,,-24935000,,,,0,173317000,285546000,15287000,-20764000,,-132993000,-132993000,49483,RDUS
2018-12-31,97997000,,-221337000,,-221337000,186078000,91612000,-193262000,-193262000,10801000.0,-22955000,,,,0,99239000,292501000,7627000,-28075000,,-221337000,-221337000,49483,RDUS
2017-12-31,80918000,,-254237000,,-254237000,188835000,21180000,-248973000,-248973000,10801000.0,-8298000,,,,0,22112000,271085000,932000,-5264000,,-254237000,-254237000,49483,RDUS
2016-12-31,105189000,,-182804000,,-182804000,79759000,0,-184948000,-184948000,10801000.0,-8298000,,,,0,0,184948000,0,2144000,,-182804000,-182804000,49483,RDUS
2019-12-31,,,151742000,,114324000,341605000,501943000,160338000,160338000,,-9317000,,,,37418000,2615277000,2454939000,2113334000,-8596000,,114324000,114324000,49484,FIX
2018-12-31,,,148676000,,112903000,296986000,446279000,149293000,149293000,,-3710000,,,,35773000,2182879000,2033586000,1736600000,-617000,,112903000,112903000,49484,FIX
2017-12-31,,,100938000,,55272000,266586000,366281000,99695000,99695000,,-3156000,,,,45666000,1787922000,1688227000,1421641000,1243000,,55272000,55272000,49484,FIX
2016-12-31,,,101061000,,64896000,235001000,344009000,100808000,100808000,,-2345000,,,,36165000,1634340000,1533532000,1290331000,253000,,64896000,64896000,49484,FIX
2020-12-31,,,127554000,,96951000,181780000,355282000,0,138292000,35210000,,,,,30603000,355282000,216990000,0,-10738000,,96951000,96951000,49485,PFS
2019-12-31,,,147088000,,112633000,163695000,348667000,0,151144000,33828000,,,,,34455000,348667000,197523000,0,-4056000,,112633000,112633000,49485,PFS
2018-12-31,,,143917000,,118387000,155052000,335652000,0,149526000,31074000,,,,,25530000,335652000,186126000,0,-5609000,,118387000,118387000,49485,PFS
2017-12-31,,,140477000,,93949000,152469000,328299000,0,147034000,28796000,,,,,46528000,328299000,181265000,0,-6557000,,93949000,93949000,49485,PFS
2020-04-30,,,1026700000,,779500000,1474300000,3002000000,1292000000,1292000000,-600000,-189200000,,,,247200000,7801000000,6509000000,4799000000,-265300000,,779500000,779500000,49487,SJM
2019-04-30,,,701600000,,514400000,1508600000,2915700000,1170100000,1170100000,-3300000,-207900000,,,,187200000,7838000000,6667900000,4922300000,-468500000,,514400000,514400000,49487,SJM
2018-04-30,,,861000000,,1338600000,1362900000,2840000000,1270200000,1270200000,100000,-174100000,,,,-477600000,7357100000,6086900000,4517100000,-409200000,,1338600000,1338600000,49487,SJM
2017-04-30,,,878400000,,592300000,1340000000,2841000000,1298000000,1298000000,-4300000,-163100000,,,,286100000,7392300000,6094300000,4551300000,-419600000,,592300000,592300000,49487,SJM
2019-12-31,58733000,,-21257000,,-15671000,188758000,298624000,29073000,29073000,,-4941000,,,,-5586000,495175000,466102000,196551000,-50330000,,-15671000,-15671000,49488,NTUS
2018-12-31,61482000,,-32260000,,-22935000,207279000,312939000,12669000,12669000,,-6794000,,,,-9325000,530891000,518222000,217952000,-44929000,,-22935000,-22935000,49488,NTUS
2017-12-31,51822000,,5150000,,-20293000,200590000,287594000,9631000,9631000,,-5081000,,,,25443000,500970000,491339000,213376000,-4481000,,-20293000,-20293000,49488,NTUS
2016-12-31,33443000,,54903000,,42594000,135711000,237260000,56796000,56796000,,-430000,,,,12309000,381892000,325096000,144632000,-1893000,,42594000,42594000,49488,NTUS
2019-12-31,,,-33038000,,-27052000,34467000,83931000,44516000,44516000,1826000,-63361000,,,,-5986000,264035000,219519000,180104000,-77554000,,-27052000,-27052000,49491,NSCO
2018-12-31,,,-13821000,,-15526000,32718000,79377000,43604000,43604000,10000,-56698000,,,,1705000,246297000,202693000,166920000,-57425000,,-15526000,-15526000,49491,NSCO
2017-12-31,,,-30588000,,-27095000,27555000,55495000,24300000,24300000,784000,-53710000,,,,-3493000,203767000,179467000,148272000,-54888000,,-27095000,-27095000,49491,NSCO
2016-12-31,,,-46699000,,-48027000,25166000,29586000,1569000,1569000,35000,-48203000,,,,1328000,187098000,185529000,157512000,-48268000,,-48027000,-48027000,49491,NSCO
2020-12-31,,,870900000,46500000,818800000,878300000,2510500000,1121500000,1121500000,,-196400000,,,,12800000,6781800000,5660300000,4271300000,-250600000,,858100000,818800000,49492,AJG
2019-12-31,,,626100000,60000000,668800000,1031500000,2272200000,766400000,766400000,,-179800000,,,,-89700000,6894200000,6127800000,4622000000,-143200000,,715800000,668800000,49492,AJG
2018-12-31,,,479400000,70800000,633500000,903700000,1868900000,556800000,556800000,,-138400000,,,,-196500000,6711200000,6154400000,4842300000,-77400000,,675900000,633500000,49492,AJG
2017-12-31,,,359800000,64100000,481300000,790400000,1706600000,536600000,536600000,,-124100000,,,,-157100000,6050900000,5514300000,4344300000,-176800000,,516900000,481300000,49492,AJG
2019-12-31,,,48492000,,48492000,3984000,27400000,23416000,23416000,,-2505000,,,,0,27400000,3984000,0,25076000,,48492000,44279000,49495,PMF
2018-12-31,,,6067000,,6067000,3958000,28650000,24692000,24692000,,-1743000,,,,0,28650000,3958000,0,-18625000,,6067000,1826000,49495,PMF
2017-12-31,,,32529000,,32529000,3976000,27899000,23923000,23923000,,-515000,,,,0,27899000,3976000,0,8606000,,32529000,29907000,49495,PMF
2016-12-31,,,5213000,,5213000,4058000,27333000,23275000,23275000,,-255000,,,,0,27333000,4058000,0,-18062000,,5213000,3803000,49495,PMF
2019-12-31,8055000,,-1673000,,-1747000,57171000,87249000,8083000,8083000,,-6892000,,,,74000,281684000,273601000,194435000,-9756000,,-1747000,-1747000,49497,FLNT
2018-12-31,5279000,,3238000,,-17932000,49346000,88720000,20921000,20921000,,-8134000,,,,46000,250280000,229359000,161560000,-25391000,-21124000.0,3192000,-17932000,49497,FLNT
2017-12-31,2578000,,-31706000,,-53206000,61526000,65308000,-11851000,-11851000,,-9683000,,,,0,211690000,223541000,146382000,-19855000,-21500000.0,-31706000,-53206000,49497,FLNT
2016-12-31,2578000,,-43128000,,-29086000,67314000,53038000,-26907000,-26907000,,-7593000,,,,-14042000,186836000,213743000,133798000,-16221000,-21500000.0,-29086000,-29086000,49497,FLNT
2019-12-31,,,443636000,29702000,436482000,66483000,1403006000,742562000,742562000,,-290991000,,,,6158000,1491591000,749029000,88585000,-298926000,,437478000,436482000,49499,O
2018-12-31,,,369938000,32236000,363614000,65497000,1261512000,656235000,656235000,,-266020000,,,,5340000,1327838000,671603000,66326000,-286297000,,364598000,363614000,49499,O
2017-12-31,,,325362000,19207000,318798000,58446000,1146288000,589054000,589054000,,-247413000,,,,6044000,1215768000,626714000,69480000,-263692000,,319318000,301514000,49499,O
2016-12-31,,,319739000,20249000,315571000,51966000,1040307000,538398000,538398000,,-219974000,,,,3262000,1103172000,564774000,62865000,-218659000,,316477000,288491000,49499,O
2019-12-31,25739000,,-93165000,75748000,-62917000,509145000,1098726000,73077000,73077000,,-251016000,,,,20488000,1886081000,1813004000,787355000,-166242000,39401000,-113653000,-62917000,49500,SATS
2018-12-31,27570000,,-125786000,15275000,-40475000,436088000,1022131000,101357000,101357000,,-219288000,,,,6576000,1762638000,1661281000,740507000,-227143000,93729000,-132362000,-40475000,49500,SATS
2017-12-31,31745000,,-32200000,14822000,392561000,370500000,829231000,41324000,41324000,,-184389000,,,,-155107000,1525155000,1483831000,695924000,-73524000,270582000,122907000,393770000,49500,SATS
2016-12-31,31170000,,216626000,86740000,179930000,325044000,1085281000,296163000,296163000,,-123481000,,,,80254000,1810466000,1514303000,725185000,-79537000,44320000,136372000,181673000,49500,SATS
2020-12-31,,,823200000,326400000,617000000,,1413900000,1038600000,1038600000,17400000,-150900000,,,,204100000,2632600000,1594000000,1218700000,-215400000,,619100000,616800000,49501,KSU
2019-12-31,,,788400000,323400000,538900000,,1419700000,1050100000,1050100000,18900000,-115900000,,,,247600000,2866000000,1815900000,1446300000,-261700000,,540800000,538700000,49501,KSU
2018-12-31,,,886900000,319700000,627400000,,1295200000,968400000,968400000,-19900000,-110000000,,,,257500000,2714000000,1745600000,1418800000,-81500000,,629400000,627200000,49501,KSU
2017-12-31,,,874300000,316500000,962000000,,1215400000,921600000,921600000,-27100000,-100200000,,,,-89600000,2582900000,1661300000,1367500000,-47300000,,963900000,961800000,49501,KSU
2019-12-31,,,60016000,,52741000,9861000,114566000,83228000,83228000,,-27692000,,,,7275000,145436000,62208000,30870000,-23212000,,52741000,38891000,49504,HMLP
2018-12-31,,,85927000,,77622000,8916000,120766000,90704000,90704000,,-22133000,,,,8305000,144961000,54257000,24195000,-4777000,,77622000,65319000,49504,HMLP
2017-12-31,,,63068000,,48782000,9910000,119589000,88625000,88625000,,-27622000,,,,3878000,143531000,54906000,23942000,-25557000,,59190000,46302000,49504,HMLP
2016-12-31,,,45249000,,41377000,9718000,74712000,54442000,54442000,,-23339000,,,,3872000,91107000,36665000,16395000,-9193000,,41377000,41377000,49504,HMLP
2019-12-31,,,163500000,,106800000,382100000,633500000,216000000,216000000,,-43200000,,,,56700000,1955700000,1739700000,1322200000,-52500000,,106800000,106800000,49507,ACCO
2018-12-31,,,157900000,,106700000,378500000,627800000,212600000,212600000,,-41200000,,,,51200000,1941200000,1728600000,1313400000,-54700000,,106700000,106700000,49507,ACCO
2017-12-31,,,158100000,,131700000,402000000,657300000,219700000,219700000,,-41100000,,,,26400000,1948800000,1729100000,1291500000,-61600000,,131700000,131700000,49507,ACCO
2016-12-31,,,125100000,,95500000,307800000,514900000,185500000,185500000,,-49300000,,,,29600000,1557100000,1371600000,1042200000,-60400000,,95500000,95500000,49507,ACCO
2020-04-30,,,-4024600,,-4024600,1268315,7580544,6312229,6312229,,-1466529,,,,0,7580544,1268315,0,-10336829,,-4024600,-4024600,49508,BSD
2019-04-30,,,6440836,,6440836,1212012,7837142,6625130,6625130,,-1635143,,,,0,7837142,1212012,0,-184294,,6440836,6440836,49508,BSD
2018-04-30,,,3740978,,3740978,1262499,7876691,6614192,6614192,,-1321850,,,,0,7876691,1262499,0,-2873214,,3740978,3740978,49508,BSD
2017-04-30,,,-316709,,-316709,1238477,7901507,6663030,6663030,,-990737,,,,0,7901507,1238477,0,-6979739,,-316709,-316709,49508,BSD
2019-12-31,,,462431000,381733000,419967000,114524000,979408000,645027000,645027000,,-191268000,,,,11308000,1319728000,674701000,340320000,-182596000,,451123000,419287000,49511,EXR
2018-12-31,,,456324000,371698000,415289000,97409000,909807000,603348000,603348000,,-183123000,,,,9244000,1211056000,607708000,301249000,-147024000,,447080000,414566000,49511,EXR
2017-12-31,,,517847000,373056000,479013000,93371000,843603000,556936000,556936000,,-158614000,,,,3625000,1120340000,563404000,276737000,-39089000,,514222000,478038000,49511,EXR
2016-12-31,,,412936000,351274000,366127000,90673000,752077000,478844000,478844000,,-138459000,,,,15847000,1004770000,525926000,252693000,-65908000,,397089000,365335000,49511,EXR
2019-12-31,8413224000,,16383333000,11587756000,21237516000,9351425000,31555300000,13790651000,13790651000,,,,,,2914726000,59241145000,45450494000,27685845000,2592682000,7962519000,13468607000,21237516000,49514,NTES
2018-12-31,7378460000,,11076749000,6179945000,6152407000,9990345000,27346149000,9977344000,9977344000,,,,,,2460650000,51178575000,41201231000,23832426000,1099405000,-2138682000,8616099000,6152407000,49514,NTES
2017-12-31,4161673000,,13839579000,1317829000,10707939000,7886455000,25043041000,12994913000,12994913000,,,,,,2155988000,44437355000,31442442000,19394314000,844666000,-834454000,11683591000,10707939000,49514,NTES
2016-12-31,3046979000,,13895361000,271860000,11604520000,5987969000,21663812000,12628864000,12628864000,,,,,,2102498000,38178844000,25549980000,16515032000,1266497000,-834454000,11792863000,11604520000,49514,NTES
2019-12-31,24510000,,-171443000,,-174443000,280333000,242789000,-62054000,-62054000,,-102290000,,,,-1742000,853010000,915064000,610221000,-109389000,,-169701000,-174443000,49516,CD
2018-12-31,24510000,,-140920000,,-138161000,63072000,-36776000,-99848000,-99848000,,-24344000,,,,-2759000,98484000,198332000,135260000,-41072000,,-138161000,-138161000,49516,CD
2020-03-31,,,-20289000,,-22351000,15909000,62039000,46130000,46130000,,-15836000,,,,2062000,62039000,15909000,0,-66419000,,-22351000,-22351000,49517,CSWC
2019-03-31,,,34106000,,33058000,14945000,51881000,36936000,36936000,,-12178000,,,,1048000,51881000,14945000,0,-2830000,,33058000,33058000,49517,CSWC
2018-03-31,,,39502000,,39307000,13306000,35126000,21820000,21820000,,-4875000,,,,195000,35126000,13306000,0,17682000,,39307000,39307000,49517,CSWC
2017-03-31,,,25253000,,23474000,12128000,23474000,11346000,11346000,,-989000,,,,1779000,23474000,12128000,0,13907000,,23474000,23474000,49517,CSWC
2020-09-30,,,46872170,,46872170,11979674,66375774,54396100,54396100,,-11092841,,,,0,66375774,11979674,0,-7523930,,46872170,46872170,49518,EIM
2019-09-30,,,120190417,,120190417,11712633,68257531,56544898,56544898,,-15779878,,,,0,68257531,11712633,0,63645519,,120190417,120190417,49518,EIM
2018-09-30,,,-14558378,,-14558378,9752747,60117760,50365013,50365013,,-11334849,,,,0,60117760,9752747,0,-64923391,,-14558378,-14558378,49518,EIM
2017-09-30,,,-6701899,,-6701899,10028009,62348453,52320444,52320444,,-8690150,,,,0,62348453,10028009,0,-59022343,,-6701899,-6701899,49518,EIM
2019-12-31,,,57081030,,47151744,,60080660,58660329,58660329,1420331,-1579299,,,,9929286,812451471,753791142,752370811,-1579299,,47151744,47151744,49519,DGICB
2018-12-31,,,-48236849,,-32760340,,-44217254,-45934767,-45934767,1717513,-2302082,,,,-15476509,771828320,817763087,816045574,-2302082,,-32760340,-32760340,49519,DGICB
2017-12-31,,,12114462,,7116100,,15140428,13707899,13707899,1432529,-1593437,,,,4998362,739026537,725318638,723886109,-1593437,,7116100,7116100,49519,DGICB
2016-12-31,,,41328407,,30801137,,44398998,42986054,42986054,1412944,-1657647,,,,10527270,688423020,645436966,644024022,-1657647,,30801137,30801137,49519,DGICB
2020-12-31,,,144245000,,155215000,297115000,892480000,236204000,236204000,179517000,-96812000,,,,-10970000,1198670000,962466000,306190000,-91959000,,155215000,155215000,49521,NWE
2019-12-31,,,182195000,,202120000,325829000,939890000,269250000,269250000,171888000,-95068000,,,,-19925000,1257910000,988660000,318020000,-87055000,,202120000,202120000,49521,NWE
2018-12-31,,,178250000,,196960000,306905000,919126000,266486000,266486000,171259000,-91988000,,,,-18710000,1192009000,925523000,272883000,-88236000,,196960000,196960000,49521,NWE
2017-12-31,,,176071000,,162703000,304884000,895303000,261668000,261668000,162614000,-92263000,,,,13368000,1305652000,1043984000,410349000,-85597000,,162703000,162703000,49521,NWE
2019-12-31,,,-80100000,17700000,-156300000,409100000,731200000,112600000,112600000,,-90000000,,,,-24400000,3923400000,3810800000,3192200000,-192700000,-100600000,-55700000,-156300000,49522,QUAD
2018-12-31,,,27500000,17700000,8500000,359700000,781000000,212000000,212000000,-5600000.0,-73200000,,,,-2400000,3985800000,3773800000,3204800000,-184500000,-22000000,29900000,8500000,49522,QUAD
2017-12-31,,,108900000,17700000,107200000,399100000,859900000,242300000,242300000,-5600000.0,-70900000,,,,-9200000,3951200000,3708900000,3091300000,-133400000,-10900000,118100000,107200000,49522,QUAD
2016-12-31,,,57900000,17700000,44900000,461600000,934700000,196000000,196000000,-5600000.0,-77200000,,,,13000000,4329500000,4133500000,3394800000,-138100000,-10900000,44900000,44900000,49522,QUAD
2020-03-31,1716000,,12621000,,12462000,22062000,37279000,13501000,13501000,,-522000,,,,159000,150841000,137340000,113562000,-880000,,12462000,12462000,49523,OESX
2019-03-31,1374000,,-6660000,,-6674000,19292000,14552000,-6114000,-6114000,,-594000,,,,14000,65754000,71868000,51202000,-546000,,-6674000,-6674000,49523,OESX
2018-03-31,1805000,,-13143000,,-13128000,23038000,14706000,-10137000,-10137000,,-425000,,,,-15000,60300000,70437000,45594000,-3006000,,-13128000,-13128000,49523,OESX
2017-03-31,2004000,,-12549000,,-12288000,27610000,17337000,-12277000,-12277000,,-273000,,,,-261000,70211000,82488000,52874000,-272000,,-12288000,-12288000,49523,OESX
2020-12-31,,,661000000,1130000000,119000000,648000000,6680000000,3492000000,3492000000,376000000,-1595000000,,,,481000000,11700000000,8208000000,5020000000,-2831000000,,180000000,106000000,49524,KMI
2019-12-31,,,3165000000,1147000000,2190000000,590000000,7355000000,3857000000,3857000000,423000000,-1801000000,,,,926000000,13209000000,9352000000,5854000000,-692000000,,2239000000,2178000000,49524,KMI
2018-12-31,,,2506000000,1519000000,1609000000,601000000,7201000000,3882000000,3882000000,342000000,-1917000000,,,,587000000,14144000000,10262000000,6943000000,-1376000000,,1919000000,1473000000,49524,KMI
2017-12-31,,,2161000000,1488000000,183000000,673000000,6891000000,3560000000,3560000000,397000000,-1832000000,,,,1938000000,13705000000,10145000000,6814000000,-1399000000,,223000000,22000000,49524,KMI
2020-12-31,,,55971000,,45534000,105909000,183465000,0,67981000,9575000,,,,,10437000,183465000,115484000,0,-12010000,,45534000,45534000,49529,ABTX
2019-12-31,,,66386000,,52959000,101567000,187021000,0,75528000,9926000,,,,,13427000,187021000,111493000,0,-9142000,,52959000,52959000,49529,ABTX
2018-12-31,,,45257000,,37309000,74720000,132044000,0,51042000,6282000,,,,,7948000,132044000,81002000,0,-5785000,,37309000,37309000,49529,ABTX
2017-12-31,,,26379000,,17632000,61079000,96341000,0,29433000,5829000,,,,,8747000,96341000,66908000,0,-3054000,,17632000,17632000,49529,ABTX
2019-12-31,,,2225448000,33263000,1448018000,1063072000,4761109000,3014720000,3014720000,,-598859000,,,,644422000,7788741000,4774021000,3027632000,-789272000,,1581026000,1448018000,49530,HHR
2018-12-31,,,1542447000,29449000,949307000,1024355000,3831597000,2221111000,2221111000,,-644326000,,,,509602000,6117773000,3896662000,2286176000,-678664000,,1032845000,949307000,49530,HHR
2017-12-31,,,1283305000,21874000,400189000,693246000,2767755000,1513548000,1513548000,,-706036000,,,,820503000,4732539000,3218991000,1964784000,-230243000,,462802000,400189000,49530,HHR
2016-12-31,,,534300000,12953000,40845000,693246000,1684067000,1215603000,1215603000,,-632308000,,,,456950000,3739596000,2523993000,2055529000,-681303000,,77350000,-86370000,49530,HHR
2019-12-31,,,-27475000,,-27475000,12404000,-12489000,-24893000,-24893000,,-495000,,,,0,198000,25091000,12687000,-2582000,,-27475000,-27475000,49531,WINT
2018-12-31,,,-20533000,,-20533000,7421000,-8774000,-16195000,-16195000,,-1409000,,,,0,1788000,17983000,10562000,-4338000,,-20533000,-34756000,49531,WINT
2017-12-31,,,-18446000,,-18446000,6657000,-15891000,-22548000,-22548000,,-1863000,,,,0,1485000,24033000,17376000,4102000,,-18446000,-24816000,49531,WINT
2016-12-31,,,-39490000,,-39490000,7173000,-29663000,-36836000,-36836000,,-2518000,,,,0,2042000,38878000,31705000,-2654000,,-39490000,-39490000,49531,WINT
2019-12-31,5338267,,-10944842,731303,-10948197,6275409,651159,-10962517,-10962517,,-7712,,,,707,657826,11620343,6667,17675,-2665,-10945549,-10948197,49532,NAVB
2018-12-31,4221881,,-16168571,668321,-16113937,6598135,1072715,-9747301,-9747301,,-161799,,,,-9753,1169351,10916652,96636,-6421270,44502,-16158818,-16113937,49532,NAVB
2017-12-31,4513842,,-17789686,668700,74946066,10691951,1806786,-13399007,-13399007,,-159029,,,,-4062489,1810437,15209444,3651,-4390679,88673053,-13727197,74946066,49532,NAVB
2016-12-31,7138080,,-7377894,468910,-14308383,7920036,4909374,-10148742,-10148742,,-4866,,,,0,4971634,15120376,62260,2770848,-6931137,-7377894,-14308383,49532,NAVB
2020-09-30,44574000,,-3445000,27403000,-3221000,276557000,456588000,76148000,76148000,,-46385000,,,,-6380000,1476235000,1400087000,1019647000,-79593000,436000,2935000,-3221000,49533,CUB
2019-09-30,50132000,,52346000,18919000,49694000,262869000,431415000,76308000,76308000,,-42053000,,,,11040000,1496475000,1420167000,1065060000,-23962000,-1423000,41306000,49694000,49533,CUB
2018-09-30,52398000,,14886000,24075000,12310000,233515000,367506000,54529000,54529000,,-10424000,,,,7093000,1202898000,1148369000,835392000,-39643000,4243000,7793000,12310000,49533,CUB
2017-09-30,52652000,,-11082000,24075000,-11209000,209674000,328386000,35815000,35815000,,-15027000,,,,14658000,1107709000,1071894000,779323000,-46897000,14531000,-25740000,-11209000,49533,CUB
2020-12-31,,,1620000000,1587000000,1274000000,-31000000,3936000000,2539000000,2539000000,,-1083000000,,,,231000000,8935000000,6396000000,4999000000,-919000000,,1389000000,1209000000,49534,FTS
2019-12-31,,,2141000000,1582000000,1722000000,-11000000,3811000000,2472000000,2472000000,,-1075000000,,,,289000000,8783000000,6311000000,4972000000,-331000000,,1852000000,1655000000,49534,FTS
2018-12-31,,,1451000000,1923000000,1166000000,2000000,3608000000,2363000000,2363000000,,-1005000000,,,,165000000,8390000000,6027000000,4782000000,-912000000,,1286000000,1100000000,49534,FTS
2017-12-31,,,1713000000,1746000000,1028000000,11000000,3662000000,2472000000,2472000000,,-952000000,,,,588000000,8301000000,5829000000,4639000000,-759000000,,1125000000,963000000,49534,FTS
2019-12-31,,,5867000,,13920000,154222000,183369000,12142000,12142000,,-4910000,,,,-8053000,521922000,509780000,338553000,-6275000,,13920000,13920000,49535,ZAGG
2018-12-31,,,49529000,,39189000,120617000,185873000,53374000,53374000,,-1684000,,,,10340000,538231000,484857000,352358000,-3845000,,39189000,39189000,49535,ZAGG
2017-12-31,,,43352000,,15100000,116499000,168998000,40452000,40452000,,-2081000,,,,28252000,519495000,479043000,350497000,2900000,,15100000,15100000,49535,ZAGG
2016-12-31,,,-23559000,,-15587000,108669000,130188000,8134000,8134000,,-1851000,,,,-7972000,401857000,393723000,271669000,-31693000,,-15587000,-15587000,49535,ZAGG
2020-05-31,,,-6132721,,-6519086,4271559,2230281,-4993454,-4993454,,-914258,,,,386365,3611101,8604555,1380820,-1139267,,-6519086,-6519086,49536,MTA
2019-05-31,,,-2087058,,-2443489,2802556,4853714,-1449255,-1449255,,-489458,,,,356431,7852661,9301916,2998947,-637803,,-2443489,-2443489,49536,MTA
2018-05-31,,,-2364442,,-2561756,1751345,4435570,-1838359,-1838359,,-356798,,,,197314,7368331,9206690,2932761,-526083,,-2561756,-2561756,49536,MTA
2017-05-31,,,-3238684,,-3238684,509275,0,-2747590,-2747590,,-274730,,,,0,0,2747590,0,-491094,,-3238684,-3238684,49536,MTA
2020-12-31,,,1132700000,,859100000,1427400000,2567800000,1140400000,1140400000,,-9700000,,,,273600000,5647300000,4506900000,3079500000,-7700000,,859100000,859100000,49538,FAST
2019-12-31,,,1043700000,,790900000,1459400000,2515400000,1056000000,1056000000,,-13900000,,,,252800000,5333700000,4277700000,2818300000,-12300000,,790900000,790900000,49538,FAST
2018-12-31,,,987000000,,751900000,1400200000,2398900000,998700000,998700000,,-12600000,,,,235100000,4965100000,3966400000,2566200000,-11700000,,751900000,751900000,49538,FAST
2017-12-31,,,873100000,,578600000,1282800000,2163600000,880800000,880800000,,-9100000,,,,294500000,4390500000,3509700000,2226900000,-7700000,,578600000,578600000,49538,FAST
2020-12-31,50807000,,249564000,,187000000,273546000,576384000,252031000,252031000,,-2799000,,,,62564000,1267945000,1015914000,691561000,-2467000,,187000000,187000000,49539,SSD
2019-12-31,47058000,,178357000,,133982000,269842000,492130000,175230000,175230000,,-2096000,,,,44375000,1136539000,961309000,644409000,3127000,,133982000,133982000,49539,SSD
2018-12-31,43056000,,172128000,,126633000,264699000,480287000,172532000,172532000,,-1064000,,,,45495000,1078809000,906277000,598522000,-404000,,126633000,126633000,49539,SSD
2017-12-31,47616000,,144418000,,92617000,257652000,443381000,138113000,138113000,,-1177000,,,,51801000,977025000,838912000,533644000,6305000,,92617000,92617000,49539,SSD
2019-12-31,133028000,,-176905000,,-176813000,45796000,0,-178824000,-178824000,,-5744000,,,,-92000,0,178824000,0,1919000,,-176813000,-176813000,49540,TCDA
2018-12-31,85594000,,-102808000,,-102808000,18001000,0,-103595000,-103595000,,-3137000,,,,0,0,103595000,0,787000,,-102808000,-102808000,49540,TCDA
2017-12-31,35906000,,-41290000,,-41290000,11216000,0,-47122000,-47122000,,-3137000,,,,0,0,47122000,0,5832000,,-41290000,-41290000,49540,TCDA
2016-12-31,21820000,,-28651000,,-28651000,5363000,0,-27183000,-27183000,,-3137000,,,,0,0,27183000,0,-1468000,,-28651000,-28651000,49540,TCDA
2020-04-30,,,-23648737,,-23648737,5887865,45457074,39569209,39569209,,-8474011,,,,0,45457074,5887865,0,-63217946,,-23648737,-23648737,49543,MYD
2019-04-30,,,42651801,,42651801,5926903,49427348,43500445,43500445,,-9293746,,,,0,49427348,5926903,0,-848644,,42651801,42651801,49543,MYD
2018-04-30,,,22639132,,22639132,6166378,50749144,44582766,44582766,,-7666086,,,,0,50749144,6166378,0,-21943634,,22639132,22639132,49543,MYD
2017-04-30,,,-1650581,,-1650581,6360320,51703070,45342750,45342750,,-6070589,,,,0,51703070,6360320,0,-46993331,,-1650581,-1650581,49543,MYD
2019-12-31,,,15286000,,12066000,109318000,128929000,19611000,19611000,,-4399000,,,,3220000,376701000,357090000,247772000,-4325000,,12066000,12066000,49544,SGC
2018-12-31,,,21395000,,16975000,96111000,121697000,25586000,25586000,,-3207000,,,,4420000,346350000,320764000,224653000,-4191000,,16975000,16975000,49544,SGC
2017-12-31,,,24782000,,15022000,71616000,96352000,24736000,24736000,,-802000,,,,9760000,266814000,242078000,170462000,46000,,15022000,15022000,49544,SGC
2016-12-31,,,19898000,,14638000,65296000,86982000,21686000,21686000,,-688000,,,,5260000,252596000,230910000,165614000,-1788000,,14638000,14638000,49544,SGC
2019-12-31,,,-14218527,-317698,-12929706,15909840,6806612,-9103228,-9103228,,-1298168,,,,-19547,19629062,28732290,12822450,-5115299,,-14198980,-12929706,49545,BBIG
2018-12-31,,,-5040102,951576,-5330126,9718286,5076590,-4641696,-4641696,,-501221,,,,303915,16502209,21143905,11425619,-398406,,-5344017,-5330126,49545,BBIG
2017-12-31,,,1666536,951576,1533431,2379104,3942825,1563721,1563721,,-501221,,,,133105,14960450,13396729,11017625,102815,,1533431,1533431,49545,BBIG
2016-12-31,,,539738,951576,499366,4535920,4967005,431085,431085,,-501221,,,,40372,16022000,15590915,11054995,108653,,499366,499366,49545,BBIG
2020-09-30,,,7685590,,5542590,75051227,87733932,9566256,9566256,,-1693251,,,,2143000,1127978763,1118412507,1040244831,-1880666,,5542590,5542590,49546,DIT
2019-09-30,,,4811943,,3202943,72182883,84023431,9222957,9222957,,-1598864,,,,1609000,1022188157,1012965200,938164726,-4411014,,3202943,3202943,49546,DIT
2018-09-30,,,4778610,,3614610,66781234,76931198,7831818,7831818,,-1194373,,,,1164000,953906658,946074840,876975460,-3053208,,3614610,3614610,49546,DIT
2017-09-30,,,5438576,,2949576,64173895,72448123,6224753,6224753,,-825690,,,,2489000,906184408,899959655,833736285,-786177,,2949576,2949576,49546,DIT
2019-12-31,315167000,,-140554000,10690000,-125762000,2430832000,2422550000,-298402000,-298402000,-25047000,,,,,-16720000,11672024000,11970426000,9249474000,157848000,,-123834000,-1657775000,49547,YJ
2018-12-31,143645000,,-43980000,6362000,-59688000,2264387000,2308629000,-99403000,-99403000,-25047000,,,,,12346000,13015225000,13114628000,10706596000,55423000,,-56326000,-2308010000,49547,YJ
2017-12-31,58159000,,-109055000,6362000,-105724000,1327298000,1271229000,-114228000,-114228000,-25047000,,,,,-3331000,6444071000,6558299000,5172842000,5173000,,-105724000,-1734380000,49547,YJ
2016-12-31,18207000,,-45218000,6362000,-24668000,334606000,305756000,-47057000,-47057000,-25047000,-98000.0,,,,-20550000,1284444000,1331501000,978688000,1839000,,-24668000,-101715000,49547,YJ
2019-12-31,,,190900000,,159100000,436400000,911700000,349100000,349100000,1900000,-88900000,,,,31800000,2451900000,2102800000,1540200000,-158200000,,159100000,159100000,49548,IR
2018-12-31,,,349500000,,269400000,442800000,1012500000,444800000,444800000,-900000,-99600000,,,,80100000,2689800000,2245000000,1677300000,-95300000,,269400000,269400000,49548,IR
2017-12-31,,,-112700000,,18400000,446200000,897900000,129500000,129500000,28300000,-140700000,,,,-131200000,2375400000,2245900000,1477500000,-242200000,,18500000,18400000,49548,IR
2016-12-31,,,-63200000,5900000.0,-36600000,415100000,716700000,160700000,160700000,16700000,-170300000,,,,-31900000,1939400000,1778700000,1222700000,-223900000,,-31300000,-36600000,49548,IR
2019-12-31,26415000,,-82663000,,-82764000,62485000,-17004000,-79489000,-79489000,,-3644000,,,,101000,9481000,88970000,26485000,-3174000,,-82764000,-82764000,49549,NBRV
2018-12-31,26415000,,-114731000,,-114780000,41743000,-40584000,-82327000,-82327000,,-133000,,,,49000,9656000,91983000,50240000,-32404000,,-114780000,-114780000,49549,NBRV
2017-12-31,26415000,,-73001000,,-74356000,29472000,-44296000,-73768000,-73768000,,-43000,,,,1355000,5319000,79087000,49615000,767000,,-74356000,-74356000,49549,NBRV
2016-12-31,26415000,,-55562000,,-54890000,13535000,-41512000,-55047000,-55047000,,-75000,,,,-672000,6482000,61529000,47994000,-515000,,-54890000,-54890000,49549,NBRV
2020-09-30,83900000,,2423800000,363300000,1886700000,731000000,2998200000,2247200000,2247200000,-63900000,-109300000,,,,478400000,8856300000,6609100000,5858100000,176600000,-14300000,1945400000,1886700000,49550,APD
2019-09-30,72900000,,2289500000,334700000,1760000000,729700000,2943400000,2219900000,2219900000,-79100000,-137000000,,,,480100000,8918900000,6699000000,5975500000,69600000,-14300000,1809400000,1760000000,49550,APD
2018-09-30,64500000,,2015000000,318800000,1497800000,801200000,2740700000,1925200000,1925200000,-50200000,-130500000,,,,524300000,8930200000,7005000000,6189500000,89800000,42200000,1490700000,1497800000,49550,APD
2017-09-30,57600000,,1416100000,99300000,3000400000,630400000,2436100000,1844800000,1844800000,-96700000,-120600000,,,,260900000,8187600000,6342800000,5751500000,-428700000,1866000000,1155200000,3000400000,49550,APD
2019-12-31,,,72726000,,70589000,51284000,409752000,109485000,109485000,74414000,-35811000,,,,2137000,449437000,339952000,39685000,-36759000,,70589000,70589000,49551,PVAC
2018-12-31,,,225308000,,224785000,21854000,365885000,250569000,250569000,-34499000,-26462000,,,,523000,420390000,169821000,54505000,-25261000,,224785000,224785000,49551,PVAC
2017-12-31,,,27719000,,32662000,16881000,120039000,35409000,35409000,19100000,-6392000,,,,-4943000,152557000,117148000,32518000,-7690000,,32662000,32662000,49551,PVAC
2016-12-31,,,1049306000,,1049306000,22245000,90370000,-13844000,-13844000,26447000,-58897000,,,,0,127605000,141449000,37235000,1063150000,,1049306000,1043334000,49551,PVAC
2020-12-31,334000000,,-24000000,,129000000,669000000,1033000000,30000000,30000000,,,,,,-153000000,1836000000,1806000000,803000000,-54000000,,129000000,129000000,49552,TDC
2019-12-31,327000000,,-13000000,,-20000000,618000000,966000000,21000000,21000000,,-26000000.0,,,,7000000,1899000000,1878000000,933000000,-34000000,,-20000000,-20000000,49552,TDC
2018-12-31,317000000,,27000000,,30000000,666000000,1031000000,48000000,48000000,,-22000000.0,,,,-3000000,2164000000,2116000000,1133000000,-21000000,,30000000,30000000,49552,TDC
2017-12-31,305000000,,58000000,,-67000000,651000000,1028000000,72000000,72000000,,-15000000.0,,,,125000000,2156000000,2084000000,1128000000,-14000000,,-67000000,-67000000,49552,TDC
2020-12-31,,,581000000,1033000000,3301000000,49501000000,58211000000,0,2080000000,6630000000,,,,,-3005000000,58211000000,56131000000,0,-1499000000,,3586000000,1710000000,49557,WFC
2019-12-31,,,24198000000,838000000,19549000000,42758000000,82458000000,0,25097000000,14603000000,,,,,4157000000,82458000000,57361000000,0,-899000000,,20041000000,17938000000,49557,WFC
2018-12-31,,,28538000000,900000000,22393000000,40547000000,84696000000,0,30706000000,13443000000,,,,,5662000000,84696000000,53990000000,0,-2168000000,,22876000000,20689000000,49557,WFC
2017-12-31,,,27377000000,1143000000,22183000000,40422000000,85989000000,0,29816000000,15751000000,,,,,4917000000,85989000000,56173000000,0,-2439000000,,22460000000,20554000000,49557,WFC
2020-06-30,7127614,,-19361130,-120459,-19674324,21080778,14934262,-18310594,-18310594,,-2525931,,,,385968,79582198,97892792,64647936,-1050536,,-19747098,-19674324,49558,SANW
2019-06-30,6272758,,-9501674,-47685,-9305242,16289595,40708021,14017122,14017122,,-3226924,,,,-148747,109722511,95705389,69014490,-23518796,,-9352927,-9305242,49558,SANW
2018-06-30,3887723,,-4582041,-47685,-4725090,10503020,14753458,-3076572,-3076572,,-2032333,,,,143049,64085510,67162082,49332052,-1505469,,-4725090,-4725090,49558,SANW
2017-06-30,3032112,,-4194337,-47685,-11822042,11794026,16140964,-2010917,-2010917,,-2500968,,,,7627705,75373810,77384727,59232846,-2183420,,-11822042,-11822042,49558,SANW
2019-12-31,,,-16491000,,-32723000,50210000,239875000,18895000,18895000,17093000,-35724000,,,,16232000,415976000,397081000,176101000,-35386000,,-32723000,-32723000,49560,VIST
2018-12-31,,,17569000,,-29850000,32773000,192402000,68837000,68837000,15383000,-15746000,,,,47419000,331336000,262499000,138934000,-51268000,,-29850000,-29850000,49560,VIST
2017-12-31,,,20266000,,13905000,20038000,84394000,19157000,19157000,-17061000,-18000,,,,6361000,198075000,178918000,113681000,1109000,,13905000,13905000,49560,VIST
2019-12-31,,,-123504000,2089730000,-310577000,81444000,758508000,386392000,386392000,,-295233000,,,,25482000,1945391000,1558999000,1186883000,-509896000,,-148986000,-310577000,49565,TK
2018-12-31,,,-38023000,2058037000,-79237000,96555000,594939000,222077000,222077000,,-234324000,,,,19724000,1728488000,1506411000,1133549000,-260100000,,-57747000,-79237000,49565,TK
2017-12-31,,,-516840000,2102465000,-163276000,106150000,874523000,282544000,282544000,,-305316000,,,,12232000,1880332000,1597788000,1005809000,-799384000,,-529072000,-163276000,49565,TK
2016-12-31,,,111132000,3439030000,-123182000,119889000,1215061000,523347000,523347000,,-307840000,,,,24468000,2328569000,1805222000,1113508000,-412215000,,86664000,-128175000,49565,TK
2020-09-30,,,740000000,4000000,699000000,685000000,2694000000,1840000000,1840000000,,-1029000000,,,,87000000,5103000000,3263000000,2409000000,-1100000000,47000000,653000000,514000000,49566,TDG
2019-09-30,,,1063000000,10000000,890000000,665000000,2899000000,2099000000,2099000000,,-859000000,,,,222000000,5223000000,3124000000,2324000000,-1036000000,51000000,841000000,779000000,49566,TDG
2018-09-30,,,986000000,10000000,957000000,450000000,2184000000,1662000000,1662000000,,-663000000,,,,24000000,3811000000,2149000000,1627000000,-676000000,-5000000,962000000,901000000,49566,TDG
2017-09-30,,,837430000,10000000,596887000,414392000,2005248000,1501630000,1501630000,,-602589000,,,,208889000,3504286000,2002656000,1499038000,-664200000,-31654000,628541000,437630000,49566,TDG
2020-03-31,,,-14411000,-1277000,-14734000,16344000,22145000,-4349000,-4349000,,-7258000,,,,313000,39291000,43640000,17146000,-10062000,,-14724000,-15090000,49568,CIDM
2019-03-31,,,-15970000,-1287000,-16233000,27661000,37414000,-5618000,-5618000,,-10292000,,,,295000,53534000,59152000,16120000,-10352000,,-16265000,-16589000,49568,CIDM
2018-03-31,,,-18094000,-1255000,-18454000,28454000,48160000,723000,723000,,-14250000,,,,401000,67683000,66960000,19523000,-18817000,,-18495000,-18810000,49568,CIDM
2017-03-31,,,-14945000,-1214000,-15129000,23776000,65273000,6844000,6844000,,-19068000,,,,252000,90394000,83550000,25121000,-21789000,,-15197000,-15485000,49568,CIDM
2019-12-31,,,-11938000,6767000,-10420000,7481000,48053000,3191000,3191000,,-14948000,,,,0,75290000,72099000,27237000,-15129000,,-11938000,-24523000,49570,PLYM
2018-12-31,,,-21175000,14467000,-18716000,6080000,31768000,-1100000,-1100000,,-15734000,,,,0,49217000,50317000,17449000,-20075000,,-21175000,-23216000,49570,PLYM
2017-12-31,,,-14027000,7115000,-8707000,5189000,16613000,-2574000,-2574000,,-11581000,,,,0,24818000,27392000,8205000,-11453000,,-14027000,-9558000,49570,PLYM
2016-12-31,,,-39288000,60450000,-36987000,3709000,13961000,-1422000,-1422000,,-40679000,,,,0,19888000,21310000,5927000,-37866000,,-39288000,-36987000,49570,PLYM
2020-12-26,52538000,,161253000,,129986000,202207000,501172000,206388000,206388000,,-21077000,,,,31267000,1445695000,1239307000,944523000,-45135000,,129986000,129986000,49571,LFUS
2019-12-28,80539000,,165884000,131000.0,139082000,213314000,541449000,207570000,207570000,,-22266000,,,,26802000,1503873000,1296303000,962424000,-41686000,,139082000,139082000,49571,LFUS
2018-12-29,87301000,,204942000,131000.0,164565000,278165000,689468000,271812000,271812000,,-22569000,,,,40377000,1718468000,1446656000,1029000000,-66870000,,164565000,164565000,49571,LFUS
2017-12-30,50489000,,204037000,137000.0,119519000,210918000,506533000,220426000,220426000,,-13380000,,,,84518000,1221534000,1001108000,715001000,-16389000,,119519000,119519000,49571,LFUS
2020-12-31,16470000,,-32434000,,-30015000,82121000,119831000,9221000,9221000,,-1073000,,,,-2419000,136878000,127657000,17047000,-41655000,,-30015000,-30015000,49572,DHX
2019-12-31,17216000,,16324000,,12551000,86912000,133133000,19262000,19262000,,-703000,,,,3773000,149370000,130108000,16237000,-2938000,,12551000,12551000,49572,DHX
2018-12-31,20212000,,9602000,,7174000,96310000,143226000,16942000,16942000,,-2054000,,,,2428000,161570000,144628000,18344000,-7340000,,7174000,7174000,49572,DHX
2017-12-31,24984000,,19397000,,15978000,121257000,177976000,18211000,18211000,1634000.0,-3445000,,,,3419000,207950000,189739000,29974000,1186000,,15978000,15978000,49572,DHX
2020-12-31,,,17339000,,13889000,45105000,74470000,0,18401000,10964000,,,,,3450000,74470000,56069000,0,-1062000,,13889000,13889000,49573,ISTR
2019-12-31,,,20958000,,16839000,37751000,69126000,0,23048000,8327000,,,,,4119000,69126000,46078000,0,-2090000,,16839000,16675000,49573,ISTR
2018-12-31,,,17236000,,13606000,32778000,59118000,0,18681000,7659000,,,,,3630000,59118000,40437000,0,-1445000,,13606000,13414000,49573,ISTR
2017-12-31,,,12450000,,8202000,24758000,44792000,0,14318000,5716000,,,,,4248000,44792000,30474000,0,-1868000,,8202000,8092000,49573,ISTR
2020-12-31,,,17100000,,13800000,490000000,854500000,294200000,294200000,-400000,-104800000,,,,-32100000,4349700000,4055500000,3495200000,-277100000,-35400000,49200000,13800000,49575,THS
2019-12-31,,,-155800000,,-361000000,480200000,801200000,246900000,246900000,-400000,-149300000,,,,-45500000,4288900000,4042000000,3487700000,-402700000,-250700000,-110300000,-361000000,49575,THS
2018-12-31,,,-57600000,,-64400000,575700000,905500000,249600000,249600000,100000,-128600000,,,,-11400000,4587800000,4338200000,3682300000,-307200000,-18200000,-46200000,-64400000,49575,THS
2017-12-31,,,-28500000,,-279500000,615600000,1013600000,312700000,312700000,-200000,-120900000,,,,-139800000,4852600000,4539900000,3839000000,-341200000,-390800000,111300000,-279500000,49575,THS
2020-12-31,,,136535000,442375000,49074000,709665000,1045997000,210426000,210426000,,-30949000,,,,42046000,2786857000,2576431000,1740860000,-73891000,,94489000,49074000,49577,CIGI
2019-12-31,,,190598000,363573000,102903000,744874000,1086267000,246729000,246729000,,-29452000,,,,53013000,3045811000,2799082000,1959544000,-56131000,,137585000,102903000,49577,CIGI
2018-12-31,,,181834000,347781000,97658000,705798000,1007901000,223373000,223373000,,-20845000,,,,53260000,2825427000,2602054000,1817526000,-41539000,,128574000,97658000,49577,CIGI
2017-12-31,,,155981000,149946000,51362000,614040000,849335000,182303000,182303000,,-11895000,,,,61907000,2435200000,2252897000,1585865000,-26322000,,94074000,51362000,49577,CIGI
2020-03-31,,,185886080000,67947696000,95663078000,224467814000,901037818000,0,185858830000,490597044000,,,,,73631400000,901037818000,715178988000,0,27250000,,112254680000,95663078000,49578,IBN
2019-03-31,,,74082606000,65805358000,42542387000,195301654000,716671406000,0,74082606000,447207900000,,,,,17191000000,716671406000,642588800000,0,0,,56891606000,42542387000,49578,IBN
2018-03-31,,,109784647000,60081860000,77121865000,167183583000,667340939000,0,109784647000,390241581000,,,,,18789200000,667340939000,557556292000,0,0,,90995447000,77121865000,49578,IBN
2017-03-31,,,138093495000,48653128000,101883845000,150379952000,619793200000,0,138093495000,331138850000,,,,,24690200000,619793200000,481699705000,0,0,,113403295000,101883845000,49578,IBN
2019-12-31,,,-34987000,1000,-34969000,23229000,136845000,33777000,33777000,,-62636000,,,,-18000,404177000,370400000,267332000,-68764000,,-34969000,-34969000,49579,UAN
2018-12-31,,,-50073000,1000,-50027000,25137000,103416000,6704000,6704000,,-62588000,,,,-46000,351082000,344378000,247666000,-56777000,,-50027000,-50027000,49579,UAN
2017-12-31,,,-72568000,1000,-72788000,25742000,89683000,-10045000,-10045000,,-62845000,,,,220000,330802000,340847000,241119000,-62523000,,-72788000,-72788000,49579,UAN
2016-12-31,,,-26609000,1000,-26938000,34476000,117499000,24777000,24777000,,-48551000,,,,329000,356284000,331507000,238785000,-51386000,,-26938000,-26938000,49579,UAN
2019-12-29,,,50379000,,42206000,49539000,125714000,52997000,52997000,,-2197000,,,,8173000,468026000,415029000,342312000,-2618000,,42206000,42206000,49580,RUTH
2018-12-30,,,49847000,,41680000,52986000,125964000,52565000,52565000,,-1739000,,,,8247000,452334000,399769000,326370000,-2718000,80000.0,41600000,41680000,49580,RUTH
2017-12-31,,,45914000,,30137000,45424000,113018000,50586000,50586000,,-821000,,,,15669000,414823000,364237000,301805000,-4672000,-108000.0,30245000,30137000,49580,RUTH
2016-12-25,,,46415000,,30465000,42894000,105873000,47559000,47559000,,-1154000,,,,15660000,385947000,338388000,280074000,-1144000,-290000.0,30755000,30465000,49580,RUTH
2020-09-30,16569000,,-16593000,,-19242000,23068000,23432000,-16268000,-16268000,,-38000,,,,2649000,87835000,104103000,64403000,-325000,,-19242000,-19242000,49582,GEOS
2019-09-30,15495000,,2271000,,-146000,23426000,31428000,-7929000,-7929000,,-99000,,,,2417000,95809000,103738000,64381000,10200000,,-146000,-146000,49582,GEOS
2018-09-30,10832000,,-19792000,,-19212000,19574000,11545000,-19870000,-19870000,,-336000,,,,-580000,75748000,95618000,64203000,78000,,-19212000,-19212000,49582,GEOS
2017-09-30,13782000,,-54108000,,-56791000,20238000,-15352000,-48992000,-48992000,,-39000,,,,2683000,73721000,122713000,89073000,-5116000,,-56791000,-56791000,49582,GEOS
2020-12-31,,,1467000000,,1473000000,,4676000000,2116000000,2116000000,612000000,-840000000,,,,-6000000,11526000000,9410000000,6850000000,-649000000,,1473000000,1473000000,49585,XEL
2019-12-31,,,1500000000,,1372000000,247000000.0,4659000000,2078000000,2078000000,569000000,-773000000,,,,128000000,11529000000,9451000000,6870000000,-578000000,,1372000000,1372000000,49585,XEL
2018-12-31,,,1442000000,,1261000000,324000000.0,4373000000,1851000000,1851000000,556000000,-700000000,,,,181000000,11537000000,9686000000,7164000000,-409000000,,1261000000,1261000000,49585,XEL
2017-12-31,,,1690000000,,1148000000,329000000.0,4457000000,2104000000,2104000000,545000000,-663000000,,,,542000000,11404000000,9300000000,6947000000,-414000000,,1148000000,1148000000,49585,XEL
2020-06-30,145000000,,1185000000,,939000000,1654000000,3063000000,1256000000,1256000000,8000000,-99000000,,,,246000000,6721000000,5465000000,3658000000,-71000000,,939000000,939000000,49587,CLX
2019-06-30,136000000,,1024000000,,820000000,1482000000,2728000000,1110000000,1110000000,8000000,-97000000,,,,204000000,6214000000,5104000000,3486000000,-86000000,,820000000,820000000,49587,CLX
2018-06-30,132000000,,1054000000,,823000000,1407000000,2675000000,1125000000,1125000000,11000000,-85000000,,,,231000000,6124000000,4999000000,3449000000,-71000000,,823000000,823000000,49587,CLX
2017-06-30,135000000,,1033000000,,701000000,1409000000,2671000000,1109000000,1109000000,18000000,-88000000,,,,330000000,5973000000,4864000000,3302000000,-76000000,-2000000.0,703000000,701000000,49587,CLX
2020-06-30,,,259084000,,185221000,101859000,402960000,293938000,293938000,,-36324000,,,,73863000,685797000,391859000,282837000,-34854000,,185221000,185221000,49588,MSGN
2019-06-30,,,268897000,,186182000,103030000,420571000,310143000,310143000,,-47589000,,,,82715000,720845000,410702000,300274000,-41246000,,186182000,186182000,49588,MSGN
2018-06-30,,,272524000,,288862000,84783000,405569000,311448000,311448000,,-43312000,,,,-16338000,696651000,385203000,291082000,-38924000,,288862000,288862000,49588,MSGN
2017-06-30,,,275938000,,167342000,80673000,404233000,313264000,313264000,,-40108000,,,,108476000,675352000,362088000,271119000,-37326000,-120000.0,167462000,167342000,49588,MSGN
2020-12-31,,,-361067000,,-184093000,43517000,171927000,-127134000,-127134000,79277000,-56426000,,,,-176974000,990073000,1117207000,818146000,-233933000,,-184093000,-184329000,49589,ALGT
2019-12-31,,,301247000,,232117000,78910000,673557000,355475000,355475000,109320000,-72329000,,,,69130000,1840965000,1485490000,1167408000,-54228000,,232117000,228704000,49589,ALGT
2018-12-31,,,199318000,,161802000,73514000,534339000,245819000,245819000,98155000,-53762000,,,,37516000,1667447000,1421628000,1133108000,-46501000,,161802000,159696000,49589,ALGT
2017-12-31,,,199007000,,198148000,56675000,537111000,276517000,276517000,82206000,-38990000,,,,859000,1511203000,1234686000,974092000,-77510000,,198148000,195183000,49589,ALGT
2019-12-31,20574000,,-66246000,,-66246000,64342000,32248000,-52668000,-52668000,,-9318000,,,,0,52609000,105277000,20361000,-13578000,,-66246000,-66246000,49590,AQST
2018-12-31,23112000,,-61376000,,-61376000,72269000,46442000,-48939000,-48939000,,-7711000,,,,0,67430000,116369000,20988000,-12437000,,-61376000,-61376000,49590,AQST
2017-12-31,22133000,,-11423000,,-11423000,25078000,47098000,-113000,-113000,,-10187000,,,,0,66918000,67031000,19820000,-11310000,,-11423000,-13903000,49590,AQST
2016-12-31,15450000,,-11944000,,-11944000,20804000,35407000,-847000,-847000,,-8485000,,,,0,51785000,52632000,16378000,-11097000,,-11944000,-11944000,49590,AQST
2020-12-31,143961000,,158147000,601000,134675000,188590000,551599000,198919000,198919000,,,,,,22996000,1415826000,1216907000,864227000,-40772000,-421000,135151000,134675000,49591,AEIS
2019-12-31,101503000,,67194000,546000,64941000,142555000,327833000,71607000,71607000,,-3416000.0,,,,10699000,788948000,717341000,461115000,-4413000,8480000,56495000,64941000,49591,AEIS
2018-12-31,76008000,,172376000,512000,147025000,108033000,367504000,177689000,177689000,,-228000.0,,,,25227000,718892000,541203000,351388000,-5313000,-38000,147149000,147025000,49591,AEIS
2017-12-31,57999000,,198191000,512000,137861000,93262000,356381000,200770000,200770000,,-66000.0,,,,62090000,671012000,470242000,314631000,-2579000,1760000,136101000,137861000,49591,AEIS
2020-12-31,,,90390000,,71289000,87231000,211391000,0,111591000,12569000,,,,,19101000,211391000,99800000,0,-21201000,,71289000,71289000,49593,CNOB
2019-12-31,,,94026000,,73395000,70209000,186254000,0,107447000,8598000,,,,,20631000,186254000,78807000,0,-13421000,,73395000,73100000,49593,CNOB
2018-12-31,,,71134000,,60352000,56865000,141588000,0,76211000,8512000,,,,,10782000,141588000,65377000,0,-5077000,,60352000,60213000,49593,CNOB
2017-12-31,,,68514000,,43220000,51693000,147273000,0,88315000,7265000,,,,,25294000,147273000,58958000,0,-19801000,,43220000,43079000,49593,CNOB
2021-01-02,,,1276100000,6800000,1233800000,2913500000,5039100000,1815900000,1815900000,309700000,-205100000,,,,41400000,14534600000,12718700000,9495500000,-539800000,,1234700000,1210400000,49595,SWK
2019-12-28,,,1118800000,5900000,955800000,2868500000,4845200000,1694700000,1694700000,249000000,-284300000,,,,160800000,14442200000,12747500000,9597000000,-575900000,,958000000,955800000,49595,SWK
2018-12-29,,,1022100000,3700000,605200000,2985900000,4916800000,1692000000,1692000000,210900000,-277900000,,,,416300000,13982400000,12290400000,9065600000,-669900000,,605800000,605200000,49595,SWK
2017-12-30,,,1527800000,2800000,1227300000,2945200000,4825100000,1559900000,1559900000,303700000,-222600000,,,,300900000,12966600000,11406700000,8141500000,-32100000,,1226900000,1227300000,49595,SWK
2019-12-31,,,-170237000,,-170295000,68303000,-108839000,-177142000,-177142000,,-492000,,,,58000,23800000,200942000,132639000,6905000,,-170295000,-173235000,49598,EPZM
2018-12-31,,,-123573000,,-123630000,43972000,-84133000,-128105000,-128105000,,-492000,,,,57000,21700000,149805000,105833000,6088000,,-123630000,-123630000,49598,EPZM
2017-12-31,,,-134645000,,-134309000,37181000,-99661000,-136842000,-136842000,,-492000,,,,-336000,10000000,146842000,109661000,1932000,,-134309000,-134309000,49598,EPZM
2016-12-31,,,-110212000,,-110212000,28372000,-83454000,-111826000,-111826000,,-492000,,,,0,8007000,119833000,91461000,1614000,,-110212000,-110212000,49598,EPZM
2019-12-31,,,2115000000,540000000,1930000000,5802000000,8289000000,2487000000,2487000000,,-269000000,,,,477000000,25129000000,22642000000,16840000000,-372000000,310000000,1638000000,1930000000,49599,CRH
2018-12-31,,,1741000000,525000000,2518000000,5608000000,7705000000,2097000000,2097000000,,-352000000,,,,396000000,23241000000,21144000000,15536000000,-356000000,1176000000,1345000000,2518000000,49599,CRH
2017-12-31,,,1685000000,486000000,1896000000,5461000000,7378000000,1917000000,1917000000,,-322000000,,,,12000000,21653000000,19736000000,14275000000,-232000000,246000000,1673000000,1896000000,49599,CRH
2016-12-31,,,1620000000,548000000,1243000000,6327000000,8223000000,1896000000,1896000000,,-358000000,,,,431000000,24789000000,22893000000,16566000000,-276000000,81000000,1189000000,1243000000,49599,CRH
2019-12-31,305563000,,-567271000,,-579646000,747656000,500182000,-553037000,-553037000,,-3061000,,,,12375000,742555000,1295592000,242373000,-14234000,,-579646000,-588127000,49600,PLTR
2018-12-31,285451000,,-570925000,,-580027000,744297000,430008000,-599740000,-599740000,,-3440000,,,,9102000,595409000,1195149000,165401000,28815000,,-580027000,-598125000,49600,PLTR
2019-12-31,,,-55744000,,-55985000,32083000,104065000,-842000,-842000,,-31955000,,,,241000,389496000,390338000,285431000,-54902000,,-55985000,-55985000,49602,GNK
2018-12-31,,,-32861000,,-32940000,31141000,153706000,53589000,53589000,,-33091000,,,,79000,367522000,313933000,213816000,-86450000,,-32940000,-32940000,49602,GNK
2017-12-31,,,-58725000,,-58725000,29849000,86291000,-15334000,-15334000,,-30497000,,,,0,209698000,225032000,123407000,-43391000,,-58725000,-58725000,49602,GNK
2016-12-31,,,-217048000,,-217757000,54106000,8723000,-121687000,-121687000,-26000.0,-28453000,,,,709000,135586000,257273000,126863000,-95361000,,-217757000,-217757000,49602,GNK
2019-12-31,,,13288000,,13288000,20775000,83703000,26110000,26110000,-13904000,-11001000,,,,0,116750000,90640000,33047000,-12822000,,13288000,13288000,49603,GDP
2018-12-31,,,1693000,,1750000,19663000,63899000,13434000,13434000,3993000,-11944000,,,,-57000,87996000,74562000,24097000,-11741000,,1750000,1750000,49603,GDP
2017-12-31,,,-8974000,,-7996000,16696000,26623000,-603000,-603000,-1595000,-9725000,,,,-978000,46153000,46756000,19530000,-8371000,,-7996000,-7996000,49603,GDP
2016-12-31,,,365637000,,365637000,16874000,13014000,-14039000,-14039000,-30000,-13222000,,,,0,27268000,41307000,14254000,379676000,,365637000,-4307000,49603,GDP
2020-03-31,15410000000,,18032000000,,19498000000,50079000000,94009000000,29363000000,29363000000,-843000000,-983000000,,,,-1466000000,174600000000,145237000000,80591000000,-11331000000,,19498000000,19498000000,49604,RDY
2019-03-31,15607000000,,22443000000,,18795000000,48680000000,83430000000,19834000000,19834000000,-691000000,-889000000,,,,3648000000,153851000000,134017000000,70421000000,2609000000,,18795000000,18795000000,49604,RDY
2018-03-31,18265000000,,14341000000,,9806000000,46857000000,76304000000,12025000000,12025000000,-843000000,-788000000,,,,4535000000,141855000000,129830000000,65551000000,2316000000,,9806000000,9806000000,49604,RDY
2017-03-31,19513000000,,14653000000,,12039000000,46300000000,78356000000,13271000000,13271000000,-728000000,-634000000,,,,2614000000,139870000000,126599000000,61514000000,1382000000,,12039000000,12039000000,49604,RDY
2019-12-31,,,7974313,,7974313,998232,0,-998232,-998232,,,,,,0,0,998232,0,8972545,,7974313,7974313,49605,UTZ
2018-12-31,,,2866713,,2866713,205731,0,-205731,-205731,,,,,,0,0,205731,0,3072444,,2866713,2866713,49605,UTZ
2019-12-31,3232000,,-18047000,,-18047000,20099000,8496000,-17200000,-17200000,,-1878000,,,,0,28942000,46142000,20446000,-847000,,-18047000,-18047000,49607,VISL
2018-12-31,7873000,,-14873000,,-14873000,21817000,18629000,-14014000,-14014000,,-2718000,,,,0,38294000,52308000,19665000,-859000,,-14873000,-14873000,49607,VISL
2017-12-31,9799000,,-10353000,,-10353000,27015000,17823000,-23389000,-23389000,,-629000,,,,0,47824000,71213000,30001000,13036000,,-10353000,-10353000,49607,VISL
2016-12-31,6106000,,-20902000,,-20902000,9534000,1024000,-20177000,-20177000,,-925000,,,,0,6574000,26751000,5550000,-725000,,-20902000,-22710000,49607,VISL
2019-12-31,,,-44108000,,-39590000,19599000,141329000,-1673000,-1673000,20742000,-38058000,,,,-4518000,192096000,193769000,50767000,-42435000,,-39590000,-39590000,49610,SNDE
2018-12-31,,,-8976000,,-22933000,18143000,113073000,25313000,25313000,-40364000,-28631000,,,,13957000,155663000,130350000,42590000,-34289000,,-22933000,-22933000,49610,SNDE
2017-12-31,,,-24308000,,-22435000,17045000,75370000,-3098000,-3098000,2894000,-13491000,,,,-1873000,97786000,100884000,22416000,-21210000,,-22435000,-22435000,49610,SNDE
2016-12-31,,,-43989000,,-45694000,12710000,49472000,-35431000,-35431000,12761000,-12219000,,,,1705000,62409000,97840000,12937000,-8558000,,-45694000,-45694000,49610,SNDE
2020-12-31,,,362657000,,275675000,,841114000,391313000,391313000,150572000,-56686000,,,,86982000,3781134000,3389821000,2940020000,-28656000,,275675000,275675000,49611,TFII
2019-12-31,,,425979000,,310283000,,1048865000,449716000,449716000,206857000,-76841000,,,,101503000,5178864000,4729148000,4129999000,-23737000,-14193000.0,324476000,310283000,49611,TFII
2018-12-31,,,382218000,,291994000,,955237000,414987000,414987000,279657000,-54563000,,,,90224000,5123208000,4708221000,4167971000,-32769000,-14193000.0,291994000,291994000,49611,TFII
2017-12-31,,,117346000,,157988000,,780314000,241058000,241058000,268499000,-56393000,,,,-40642000,4837414000,4596356000,4057100000,-123712000,-14193000.0,157988000,157988000,49611,TFII
2020-05-02,,,148700000,,123400000,110200000,283500000,154300000,154300000,,-10100000,,,,25300000,1023900000,869600000,740400000,-5600000,,123400000,123400000,49614,MEI
2019-04-27,,,103600000,,91600000,125600000,274200000,132500000,132500000,,-8300000,,,,12000000,1000300000,867800000,726100000,-28900000,,91600000,91600000,49614,MEI
2018-04-28,,,123800000,,57200000,101600000,240400000,133200000,133200000,,-900000,,,,66600000,908300000,775100000,667900000,-9400000,,57200000,57200000,49614,MEI
2017-04-29,,,115900000,,92900000,94200000,218300000,121800000,121800000,,-900000,,,,23000000,816500000,694700000,598200000,-5900000,,92900000,92900000,49614,MEI
2019-12-31,6886251,,-34128031,,-34128031,30047981,2838942,-34095290,-34095290,,,,,,0,61302801,95398091,58463859,-32741,,-34128031,-34128031,49616,RMTI
2018-12-31,5642317,,-32125858,,-32125858,23082304,-1584540,-30309161,-30309161,,,,,,0,63388617,93697778,64973157,-1816697,,-32125858,-32125858,49616,RMTI
2017-12-31,6321400,,-25921284,,-25921284,23303409,3701891,-25922918,-25922918,,,,,,0,57300281,83223199,53598390,1634,,-25921284,-25921284,49616,RMTI
2016-12-31,5840346,,-19398389,,-19802916,21120901,6952518,-20208729,-20208729,200000.0,,,,,404527,53284166,73492895,46331648,810340,,-19802916,-19802916,49616,RMTI
2020-12-31,,,3728000000,,3189000000,3249000000,7478000000,4229000000,4229000000,,-593000000,,,,539000000,36799000000,32570000000,29321000000,-501000000,,3189000000,3189000000,49618,NOC
2019-12-31,,,2548000000,,2248000000,4290000000,7259000000,2969000000,2969000000,,-528000000,,,,300000000,33841000000,30872000000,26582000000,-421000000,,2248000000,2248000000,49618,NOC
2018-12-31,,,3742000000,,3229000000,2617000000,6820000000,4203000000,4203000000,,-562000000,,,,513000000,30095000000,25892000000,23275000000,-461000000,,3229000000,3229000000,49618,NOC
2017-12-31,,,4229000000,,2869000000,1477000000,5930000000,4453000000,4453000000,,-360000000,,,,1360000000,26004000000,21551000000,20074000000,-224000000,,2869000000,2869000000,49618,NOC
2019-12-31,2176000,,-12013000,,-12038000,28702000,21579000,-9299000,-9299000,,-3491000,,,,25000,40387000,49686000,18808000,-2714000,,-12038000,-30279000,49621,XGN
2018-12-31,2125000,,-7954000,,-8012000,19675000,17061000,-4880000,-4880000,,-2868000,,,,58000,32440000,37320000,15379000,-3074000,,-8012000,-18482000,49621,XGN
2017-12-31,1551000,,-26180000,,-25631000,18820000,12670000,-7887000,-7887000,,-2948000,,,,-549000,26807000,34694000,14137000,-18293000,,-25631000,-32774000,49621,XGN
2015-12-31,1367000,,-18930000,,-19183000,17406000,8413000,-10568000,-10568000,,-4501000,,,,253000,17946000,28514000,9533000,-8362000,,-19183000,-21294000,49621,XGN
2020-12-31,12037000,,-88964000,,-56054000,90052000,440746000,35483000,35483000,,-95400000,,,,-32910000,583439000,547956000,142693000,-124447000,,-56054000,-56054000,49622,IRDM
2019-12-31,14310000,,-218119000,,-161999000,93165000,415300000,10120000,10120000,,-125000000,,,,-56120000,560444000,550324000,145144000,-228239000,,-161999000,-166193000,49622,IRDM
2018-12-31,22429000,,-20649000,,-13384000,97846000,380135000,41653000,41653000,,-142700000,,,,-7265000,523008000,481355000,142873000,-62302000,,-13384000,-23533000,49622,IRDM
2017-12-31,15247000,,119572000,,233856000,84405000,323205000,138087000,138087000,,-142700000,,,,-114284000,448046000,309959000,124841000,-18515000,,233856000,218420000,49622,IRDM
2019-12-31,14851000,,-12599000,,-12599000,81220000,83845000,-13627000,-13627000,,-677000,,,,0,120368000,133995000,36523000,1028000,,-12599000,-12599000,49623,VCYT
2018-12-31,14820000,,-22999000,,-22999000,65276000,58930000,-22233000,-22233000,,-1963000,,,,0,92008000,114241000,33078000,-766000,,-22999000,-22999000,49623,VCYT
2017-12-31,13881000,,-31003000,,-31003000,55348000,43758000,-26538000,-26538000,,-4941000,,,,0,71953000,98491000,28195000,-4465000,,-31003000,-31003000,49623,VCYT
2016-12-31,15324000,,-31358000,,-31358000,52035000,39623000,-28803000,-28803000,,-2757000,,,,0,65085000,93888000,25462000,-2555000,,-31358000,-31358000,49623,VCYT
2019-12-31,,,-6754000,,-6755000,11104000,10265000,-7620000,-7620000,2094000,-3412000,,,,1000,73411000,81031000,63146000,866000,,-6755000,-6755000,49624,MP
2018-12-31,,,-13465000,,-13466000,14565000,10134000,-8884000,-8884000,1998000,-5420000,,,,1000,67418000,76302000,57284000,-4581000,,-13466000,-13466000,49624,MP
2019-12-31,,,172477000,-704000,173736000,36366000,211992000,0,175626000,,,,,,-419000,225461000,49835000,13469000,-3149000,,172896000,144835000,49627,NYMT
2018-12-31,,,103738000,904000,102886000,28234000,132408000,0,104174000,44050000.0,,,,,-1057000,145644000,41470000,13236000,-436000,,104795000,79186000,49627,NYMT
2017-12-31,,,91922000,4136000,91980000,22874000,114796000,0,91922000,44050000.0,,,,,3355000,132999000,41077000,18203000,0,,88567000,76320000,49627,NYMT
2016-12-31,,,70655000,3087000,67551000,24507000,95097000,0,70590000,44050000.0,,,,,3095000,105811000,35221000,10714000,65000,,67560000,54651000,49627,NYMT
2019-12-31,,,116675000,4436000,103469000,61411000,273995000,144502000,144502000,,-28811000,,,,12975000,487374000,342872000,213379000,-27827000,,103700000,103466000,49631,EVTC
2018-12-31,,,99165000,4147000,86270000,68717000,256912000,125128000,125128000,,-30044000,,,,12596000,453869000,328741000,196957000,-25963000,,86569000,86266000,49631,EVTC
2017-12-31,,,60199000,3864000,55054000,56161000,217994000,97583000,97583000,,-29861000,,,,4780000,407144000,309561000,189150000,-37384000,,55419000,55044000,49631,EVTC
2016-12-31,,,83397000,3499000,75036000,46986000,213698000,107145000,107145000,,-24617000,,,,8271000,389507000,282362000,175809000,-23748000,,75126000,75024000,49631,EVTC
2019-12-31,,,64787000,-106000,48274000,204501000,491453000,107015000,107015000,,-40051000,,,,16522000,1349405000,1242390000,857952000,-42228000,,48265000,48274000,49632,CATM
2018-12-31,,,14113000,-97000,3676000,170490000,447460000,97860000,97860000,,-50316000,,,,10457000,1345243000,1247383000,897783000,-83747000,,3656000,3676000,49632,CATM
2017-12-31,,,-154643000,-79000,-145350000,175737000,508479000,152840000,152840000,,-47610000,,,,-9292000,1507599000,1354759000,999120000,-307483000,,-145351000,-145350000,49632,CATM
2016-12-31,,,114532000,-80000,87991000,153782000,451277000,169720000,169720000,,-28889000,,,,26622000,1265364000,1095644000,814087000,-55188000,,87910000,87949000,49632,CATM
2019-12-31,,,-87908000,5410000,-87914000,20530000,116953000,15391000,15391000,,-56059000,,,,399000,374914000,359523000,257961000,-103299000,,-88307000,-88087000,49634,HTIA
2018-12-31,,,-52781000,7797000,-52762000,17275000,118036000,17549000,17549000,,-49471000,,,,197000,362406000,344857000,244370000,-70330000,,-52978000,-52762000,49634,HTIA
2017-12-31,,,-42065000,8505000,-42548000,15673000,99653000,6339000,6339000,,-30264000,,,,647000,311173000,304834000,211520000,-48404000,,-42712000,-42548000,49634,HTIA
2016-12-31,,,-23054000,8870000,-20874000,12105000,106605000,-4386000,-4386000,,-19881000,,,,-2084000,302428000,306814000,195823000,-18668000,,-20970000,-20874000,49634,HTIA
2019-12-31,,,-61988515,,-61995758,1993959,-56575246,-58569328,-58569328,123,,,,,7243,1366417,59935745,57941663,-3419187,,-61995758,-61995758,49636,HUSN
2018-12-31,3512512.0,,-5520864,,-3818737,12240920,6497468,-9352985,-9352985,97021,,,,,-1702127,14402329,23755314,7904861,3832121,,-3818737,-3818737,49636,HUSN
2017-12-31,92683.0,,24681499,,24048184,3541238,24579044,20752466,20752466,192657,,,,,633315,25116139,4363673,537095,3929033,,24048184,24048184,49636,HUSN
2016-12-31,92683.0,,16341589,,13888767,1594108,15571215,13847800,13847800,129307,,,,,2452822,15821980,1974180,250765,2493789,,13888767,13888767,49636,HUSN
2020-12-31,,,509100000,,386100000,171100000,893800000,559400000,559400000,2300000,-51200000,,,,123000000,9504300000,8944900000,8610500000,-50300000,,386100000,386100000,49637,MUSA
2019-12-31,,,202400000,,154800000,159100000,581700000,268300000,268300000,2100000,-54900000,,,,47600000,12101300000,11833000000,11519600000,-65900000,,154800000,154800000,49637,MUSA
2018-12-31,,,273900000,,213600000,136200000,548000000,275800000,275800000,2000000,-52900000,,,,60300000,12524000000,12248200000,11976000000,-1900000,,213600000,213600000,49637,MUSA
2017-12-31,,,240100000,,245300000,141200000,547100000,287200000,287200000,1800000,-46700000,,,,-5200000,10853500000,10566300000,10306400000,-47100000,,245300000,245300000,49637,MUSA
2020-02-02,,,-252370000,,-252370000,1396786000,1144060000,-252726000,-252726000,,,,,,0,4846743000,5099469000,3702683000,356000,,-252370000,-252370000,49640,CHWY
2019-02-03,,,-267890000,,-267890000,982571000,714805000,-267766000,-267766000,,-124000.0,,,,0,3532837000,3800603000,2818032000,-124000,,-267890000,-267890000,49640,CHWY
2018-01-28,,,-338057000,,-338057000,643408000,367550000,-275858000,-275858000,,-206000.0,,,,0,2104287000,2380145000,1736737000,-62199000,,-338057000,-699577000,49640,CHWY
2017-01-31,,,-167484000,,-167484000,418464000,250776000,-167688000,-167688000,,-360000.0,,,,0,1437840000,1605528000,1187064000,204000,,-167484000,-1252044000,49640,CHWY
2020-04-30,,,1093134,,443102,22292309,25104890,2812581,2812581,,-1839060,,,,650032,281042482,278229901,255937592,-1719447,,443102,443102,49644,SGMA
2019-04-30,,,866301,,-865114,23263117,26341769,3078652,3078652,,-2413297,,,,1731415,290553951,287475299,264212182,-2212351,,-865114,-865114,49644,SGMA
2018-04-30,,,-4302322,,-3241870,23174283,26602918,3428635,3428635,,-1537446,,,,-1060452,278131709,274703074,251528791,-7730957,,-3241870,-3241870,49644,SGMA
2017-04-30,,,2497683,,1390206,22262701,25175308,2912607,2912607,,-1135853,,,,1107477,253370175,250457568,228194867,-414924,,1390206,1390206,49644,SGMA
2020-12-31,,,255556000,,226409000,443042000,778185000,0,303469000,31674000,,,,,29147000,778185000,474716000,0,-47913000,,226409000,226409000,49645,ONB
2019-12-31,,,290356000,,238206000,448653000,796094000,0,313297000,34144000,,,,,52150000,796094000,482797000,0,-22941000,,238206000,238206000,49645,ONB
2018-12-31,,,208680000,,190830000,425443000,702992000,0,233760000,43789000,,,,,17850000,702992000,469232000,0,-25080000,,190830000,190830000,49645,ONB
2017-12-31,,,168664000,,95725000,378411000,605767000,0,189985000,37371000,,,,,72939000,605767000,415782000,0,-21321000,,95725000,95725000,49645,ONB
2019-12-31,,,-5526000,,966000,63218000,108792000,28995000,28995000,,-850000,,,,-573000,1509944000,1480949000,1401152000,-34521000,5919000,-4953000,-3437000,49646,MODV
2018-12-31,,,22912000,,-18981000,66964000,131357000,48580000,48580000,,-1783000,,,,4684000,1384965000,1336385000,1253608000,-25668000,-37209000,18228000,-25257000,49646,MODV
2017-12-31,,,55088000,-2165000.0,53369000,69907000,121009000,37484000,37484000,,-1204000,,,,4003000,1318220000,1280736000,1197211000,17604000,2284000,51085000,42636000,49646,MODV
2016-12-31,,,44853000,-2420000.0,91928000,37927000,101879000,51172000,51172000,,-1515000,,,,17972000,1233842000,1182670000,1131963000,-6319000,65047000,26881000,76940000,49646,MODV
2020-07-31,,,102928870,,102928870,12122166,93377974,81255808,81255808,,-16090940,,,,0,93377974,12122166,0,21673062,,102928870,102928870,49648,BTT
2018-07-31,,,45468262,,45468262,11584237,89312058,77727821,77727821,,-17977197,,,,0,89312058,11584237,0,-32259559,,45468262,45468262,49648,BTT
2017-07-31,,,-42171311,,-42171311,11356158,88282045,76925887,76925887,,-13486931,,,,0,88282045,11356158,0,-119097198,,-42171311,-42171311,49648,BTT
2016-07-31,,,254495200,,254495200,10292512,91050464,80757952,80757952,,-8182843,,,,0,91050464,10292512,0,173737248,,254495200,254495200,49648,BTT
2019-12-25,,,149199000,,117410000,69018000,202132000,73803000,73803000,39465000,-18717000,,,,31789000,541389000,467586000,339257000,75396000,,117410000,117410000,49649,DENN
2018-12-26,,,52250000,,43693000,63828000,220048000,76234000,76234000,52947000,-20891000,,,,8557000,630179000,553945000,410131000,-23984000,,43693000,43693000,49649,DENN
2017-12-27,,,56801000,,39594000,66415000,211473000,69780000,69780000,51558000,-15746000,,,,17207000,529169000,459389000,317696000,-12979000,,39594000,39594000,49649,DENN
2016-12-28,,,35876000,,19402000,67960000,206870000,73909000,73909000,42823000,-12348000,,,,16474000,506948000,433039000,300078000,-38033000,,19402000,19402000,49649,DENN
2019-12-31,,,11526000,,11526000,7940000,20915000,12561000,12561000,,,,,,0,29410000,16849000,8495000,-1035000,,11526000,11526000,49651,PICO
2018-12-31,,,-3319000,,-3329000,11048000,9117000,-2007000,-2007000,,,,,,53000,14363000,16370000,5246000,-1312000,43000.0,-3372000,-3329000,49651,PICO
2017-12-31,,,10341000,,464000,12414000,14173000,1454000,1454000,,,,,,3082000,27389000,25935000,13216000,8887000,-5645000.0,7259000,464000,49651,PICO
2016-12-31,,,-26288000,99575000.0,-21865000,22430000,307000,-23189000,-23189000,,,,,,-1135000,633000,23822000,326000,-3099000,12124000.0,-25153000,-21865000,49651,PICO
2019-12-31,,,-20759000,,-20759000,25803000,6970000,-27052000,-27052000,8219000,-204000,,,,0,85814000,112866000,78844000,6293000,,-20759000,-20759000,49652,IPHA
2018-12-31,,,2716000,,3049000,18142000,24397000,5146000,5146000,1109000,-102000,,,,-333000,93952000,88806000,69555000,-2430000,,3049000,3049000,49652,IPHA
2017-12-31,,,-48017000,,-48385000,17015000,-22967000,-39982000,-39982000,1109000,-113000,,,,368000,44033000,84015000,67000000,-8035000,,-48385000,-48385000,49652,IPHA
2016-12-31,,,12941000,,12640000,9522000,17093000,7571000,7571000,1109000,-124000,,,,301000,65721000,58150000,48628000,5370000,,12640000,12640000,49652,IPHA
2019-12-31,,,4673000000,2688000000,3006000000,1093000000,16940000000,5617000000,5617000000,1881000000,-1378000000,,,,1447000000,42238000000,36621000000,25298000000,-944000000,,3226000000,2738000000,49654,ORAN
2018-12-31,,,3467000000,2580000000,1954000000,2031000000,15775000000,4759000000,4759000000,1938000000,-1395000000,,,,1309000000,41381000000,36622000000,25606000000,-1292000000,,2158000000,1661000000,49654,ORAN
2017-12-31,,,3063000000,2537000000,1843000000,1993000000,15897000000,5342000000,5342000000,1716000000,-1357000000,,,,1052000000,40859000000,35517000000,24962000000,-2279000000,29000000.0,2011000000,1576000000,49654,ORAN
2016-12-31,,,1820000000,2604000000,2813000000,2050000000,15706000000,5308000000,5308000000,1620000000,-1468000000,,,,951000000,40708000000,35400000000,25002000000,-3488000000,2253000000.0,869000000,2526000000,49654,ORAN
2020-10-31,,,-178858935,,-178858935,17895069,57414747,39519678,39519678,,-6707231,,,,0,57414747,17895069,0,-218378613,,-178858935,-178858935,49657,UTG
2019-10-31,,,334051400,,334051400,18187835,65899077,46573474,46573474,1137768.0,-14703356,,,,0,65899077,19325603,0,287477926,,334051400,334051400,49657,UTG
2018-10-31,,,29059033,,29059033,17195165,70513890,53318725,53318725,1137768.0,-12420185,,,,0,70513890,17195165,0,-24259692,,29059033,29059033,49657,UTG
2017-10-31,,,166968514,,166968514,12951433,54950207,41998774,41998774,1137768.0,-6756321,,,,0,54950207,12951433,0,124969740,,166968514,166968514,49657,UTG
2020-03-31,53044000,,-102112000,,-102773000,40480000,14856000,-78668000,-78668000,,-25159000,,,,661000,32656000,111324000,17800000,-23444000,,-102773000,-102773000,49658,QTNT
2019-03-31,50677000,,-105342000,,-105386000,38582000,11904000,-77355000,-77355000,,-20318000,,,,44000,29134000,106489000,17230000,-27987000,,-105386000,-105386000,49658,QTNT
2018-03-31,51202000,,-82987000,,-82338000,33047000,14261000,-69988000,-69988000,,-15565000,,,,-649000,24732000,94720000,10471000,-12999000,,-82338000,-82338000,49658,QTNT
2017-03-31,57064000,,-85069000,,-85069000,28378000,11383000,-74059000,-74059000,,-9903000,,,,0,22227000,96286000,10844000,-11010000,,-85069000,-85069000,49658,QTNT
2020-12-31,,,103131000,,81477000,116531000,264429000,0,107634000,40264000,,,,,21654000,264429000,156795000,0,-4503000,,81477000,81477000,49660,FBNC
2019-12-31,,,116276000,,92046000,114845000,273639000,0,122434000,36040000,,,,,24230000,273639000,151205000,0,-6158000,,92046000,91596000,49660,FBNC
2018-12-31,,,113478000,,89289000,111150000,269961000,0,122618000,35841000,,,,,24189000,269961000,147343000,0,-9140000,,89289000,89289000,49660,FBNC
2017-12-31,,,67739000,,45972000,98789000,212837000,0,79993000,34055000,,,,,21767000,212837000,132844000,0,-12254000,,45972000,45972000,49660,FBNC
2019-12-31,,,88848000,-80758000,31980000,45384000,197014000,143652000,143652000,674000,-23860000,,,,-7125000,529646000,385994000,332632000,-54804000,,95973000,31980000,49662,GSKY
2018-12-31,,,133514000,-60349000,24256000,32459000,191874000,154416000,154416000,521000,-23584000,,,,5534000,414673000,260257000,222799000,-20902000,,127980000,24256000,49662,GSKY
2017-12-31,,,138668000,-60349000,138668000,25763000,181529000,148458000,148458000,3325000,-7536000,,,,0,325887000,177429000,144358000,-9790000,,138668000,138668000,49662,GSKY
2016-12-31,,,124464000,-60349000,124464000,19536000,144884000,119962000,119962000,1678000,-7536000,,,,0,263865000,143903000,118981000,4502000,,124464000,124464000,49662,GSKY
2020-12-31,,,-132745000,,-120424000,579790000,626046000,34866000,34866000,,-75049000,,,,-12321000,4841954000,4807088000,4215908000,-167611000,,-120424000,-150674000,49663,AXS
2019-12-31,,,347165000,,323473000,634831000,1077325000,430897000,430897000,,-68107000,,,,23692000,5173427000,4742530000,4096102000,-83732000,,323473000,282361000,49663,AXS
2018-12-31,,,13535000,,43021000,627389000,758952000,117749000,117749000,,-67432000,,,,-29486000,5090406000,4972657000,4331454000,-104214000,,43021000,396000,49663,AXS
2017-12-31,,,-376511000,,-368969000,579428000,415084000,-166887000,-166887000,,-54811000,,,,-7542000,4576551000,4743438000,4161467000,-209624000,,-368969000,-415779000,49663,AXS
2020-12-31,,,626200000,,502900000,772700000,1609300000,799100000,799100000,,-174400000,,,,142100000,4903200000,4104100000,3293900000,-172900000,18800000,484100000,502900000,49664,SEE
2019-12-31,,,370300000,,263000000,852200000,1564800000,683700000,683700000,,-196000000,,,,76600000,4791100000,4107400000,3226300000,-313400000,-30700000,293700000,262500000,49664,SEE
2018-12-31,,,457800000,,193100000,757400000,1502100000,729000000,729000000,,-193000000,,,,307500000,4732700000,4003700000,3230600000,-271200000,42800000,150300000,192200000,49664,SEE
2017-12-31,,,393300000,,814900000,743900000,1412100000,655100000,655100000,,-201800000,,,,330500000,4461600000,3806500000,3049500000,-261800000,752100000,62800000,810000000,49664,SEE
2019-12-31,,,85923000,,64081000,458885000,620024000,92584000,92584000,,-4309000,,,,21842000,1614762000,1522178000,994738000,-6661000,,64081000,64081000,49665,SYKE
2018-12-31,,,56917000,,48926000,447630000,605728000,85206000,85206000,,-4743000,,,,7991000,1625687000,1540481000,1019959000,-28289000,,48926000,48926000,49665,SYKE
2017-12-31,,,81307000,,32216000,414089000,582839000,91696000,91696000,,-7689000,,,,49091000,1586008000,1494312000,1003169000,-10389000,,32216000,32216000,49665,SYKE
2016-12-31,,,88884000,,62390000,377413000,540435000,94632000,94632000,,-5570000,,,,26494000,1460037000,1365405000,919602000,-5748000,,62390000,62390000,49665,SYKE
2020-12-31,,,-176958000,,-155861000,535056000,527907000,-148970000,-148970000,,-27988000,,,,-21097000,1819982000,1968952000,1292075000,-27988000,,-155861000,-155861000,49666,GRUB
2019-12-31,,,-26776000,,-18566000,406512000,521383000,-578000,-578000,,-24393000,,,,-8210000,1312151000,1312729000,790768000,-26198000,,-18566000,-18566000,49666,GRUB
2018-12-31,,,81433000,,78481000,287377000,470658000,97341000,97341000,,-7530000,,,,2952000,1007257000,909916000,536599000,-15938000,,78481000,78481000,49666,GRUB
2017-12-31,,,89648000,,98983000,206111000,357351000,99392000,99392000,,-2102000,,,,-9335000,683067000,583675000,325716000,-9746000,,98983000,98983000,49666,GRUB
2019-12-31,,,-33737000,,-33737000,9613000,-27869000,-37482000,-37482000,,-209000,,,,0,6347000,43829000,34216000,3745000,,-33737000,-33737000,49667,NXTC
2018-12-31,,,-22799000,,-22799000,3409000,-19787000,-23196000,-23196000,,-25000,,,,0,0,23196000,19787000,397000,,-22799000,-22799000,49667,NXTC
2017-12-31,12954000.0,,-15469000,,-15469000,2595000,0,-15549000,-15549000,,-30000,,,,0,0,15549000,0,80000,,-15469000,-15469000,49667,NXTC
2019-12-31,,,-57410000,,-57410000,18952000,-40661000,-59613000,-59613000,,,,,,0,3669000,63282000,44330000,2203000,,-57410000,-57410000,49668,APTX
2018-12-31,,,-53281000,,-53281000,12674000,-42214000,-54888000,-54888000,,,,,,0,6574000,61462000,48788000,1607000,,-53281000,-53281000,49668,APTX
2017-12-31,,,-32068000,,-32068000,5551000,-26682000,-32233000,-32233000,,,,,,0,4962000,37195000,31644000,165000,,-32068000,-32068000,49668,APTX
2016-12-31,,,-15478000,,-15478000,4766000,-12951000,-17717000,-17717000,,,,,,0,9792000,27509000,22743000,2239000,,-15478000,-15478000,49668,APTX
2019-12-31,182866000,,-213256000,,-213256000,42573000,3335000,-222104000,-222104000,,,,,,0,3335000,225439000,0,8848000,,-213256000,-213256000,49669,MRTX
2018-12-31,93872000,,-98418000,,-98418000,21681000,12926000,-102627000,-102627000,,,,,,0,12926000,115553000,0,8418000,,-98418000,-98418000,49669,MRTX
2017-12-31,58085000,,-70430000,,-70430000,13450000,0,-71535000,-71535000,,,,,,0,0,71535000,0,1110000,,-70430000,-70430000,49669,MRTX
2016-12-31,68487000,,-83118000,,-83118000,15292000,0,-83779000,-83779000,,,,,,0,0,83779000,0,-1878000,,-83118000,-83118000,49669,MRTX
2019-12-31,,,848993000,,672309000,,1261286000,950369000,950369000,302329000,-56310000,,,,176684000,1526955000,576586000,265669000,-101376000,,672309000,672309000,49673,RDN
2018-12-31,,,684186000,,606011000,,1044976000,753329000,753329000,279218000,-61490000,,,,78175000,1273006000,519677000,228030000,-69143000,,606011000,606011000,49673,RDN
2017-12-31,,,346737000,,121088000,,957601000,678409000,678409000,267321000,-62761000,,,,225649000,1221631000,543222000,264030000,-331672000,,121088000,121088000,49673,RDN
2016-12-31,,,483686000,,308253000,,898010000,640412000,640412000,244377000,-81132000,,,,175433000,1238452000,598040000,340442000,-156726000,,308253000,308253000,49673,RDN
2019-12-31,11134716,,-33122888,,-33122888,9558641,0,-20693357,-20693357,,,,,,0,0,20693357,0,-25038339,,-33122888,-33122888,49674,ONCY
2018-12-31,9417888,,-16489183,,-17037225,7244791,0,-16662679,-16662679,,,,,,548042,0,16662679,0,173496,,-17037225,-17037225,49674,ONCY
2017-12-31,8612957,,-15475353,,-15616851,6212831,0,-14825788,-14825788,,,,,,141498,0,14825788,0,-649565,,-15616851,-15616851,49674,ONCY
2016-12-31,8439179,,-15130605,,-15139979,5524500,0,-13963679,-13963679,,,,,,9374,0,13963679,0,-1166926,,-15139979,-15139979,49674,ONCY
2020-12-31,,,-9392000,,-10640000,28204000,47616000,0,14268000,5144000,,,,,1248000,47616000,33348000,0,-23660000,,-10640000,-10640000,49675,CBFV
2019-12-31,,,16056000,,14327000,27507000,51847000,0,18301000,6039000,,,,,1729000,51847000,33546000,0,-2245000,,14327000,14327000,49675,CBFV
2018-12-31,,,8590000,,7052000,25977000,43584000,0,11690000,5917000,,,,,1538000,43584000,31894000,0,-3100000,,7052000,7052000,49675,CBFV
2017-12-31,,,9818000,,6944000,19677000,34933000,0,10733000,4523000,,,,,2874000,34933000,24200000,0,-915000,,6944000,6944000,49675,CBFV
2020-07-31,768100000,,-231800000,,-267000000,1813800000,2408900000,-173000000,-173000000,,-88700000,,,,35200000,3408400000,3581400000,999500000,-58800000,,-267000000,-267000000,49678,PANW
2019-07-31,539500000,,-74600000,,-81900000,1578800000,2091200000,-27100000,-27100000,,-83900000,,,,7300000,2899600000,2926700000,808400000,-47500000,,-81900000,-81900000,49678,PANW
2018-07-31,400700000,,-105300000,,-122200000,1292800000,1628500000,-65000000,-65000000,,-29600000,,,,16900000,2273600000,2338600000,645100000,-40300000,,-122200000,-122200000,49678,PANW
2017-07-31,347400000,,-180100000,,-203000000,1076200000,1278700000,-144900000,-144900000,,-24500000,,,,22900000,1755100000,1900000000,476400000,-35200000,,-203000000,-203000000,49678,PANW
2020-12-31,,,17743000,,13687000,,47607000,0,17743000,29864000,,,,,4056000,47607000,29864000,0,0,,13687000,13687000,49679,OVLY
2019-12-31,,,16689000,,12489000,22800000.0,45536000,0,16959000,5777000,,,,,4200000,45536000,28577000,0,-270000,,12489000,12489000,49679,OVLY
2018-12-31,,,15347000,,11537000,21540000.0,42725000,0,15872000,5313000,,,,,3810000,42725000,26853000,0,-525000,,11537000,11537000,49679,OVLY
2017-12-31,,,15241000,,9094000,19016000.0,38868000,0,14795000,5057000,,,,,6147000,38868000,24073000,0,446000,,9094000,9094000,49679,OVLY
2020-04-30,5853000,,-1845000,,-1975000,10856000,15241000,-1468000,-1468000,,,,,,130000,32123000,33591000,16882000,-377000,,-1975000,-1975000,49683,CSBR
2019-04-30,4798000,,231000,,128000,7734000,12802000,270000,270000,,,,,,103000,27067000,26797000,14265000,-39000,,128000,128000,49683,CSBR
2018-04-30,4401000,,-1443000,,-1476000,6641000,9688000,-1354000,-1354000,,,,,,33000,20241000,21595000,10553000,-89000,,-1476000,-1476000,49683,CSBR
2017-04-30,4293000,,-6865000,,-6884000,8224000,5708000,-6809000,-6809000,,,,,,19000,15411000,22220000,9703000,-56000,,-6884000,-6884000,49683,CSBR
2019-12-31,,,114465266,,114465266,6786515,23704684,16918169,16918169,,,,,,0,23704684,6786515,0,97547097,,114465266,114465266,49684,BGY
2018-12-31,,,-91208975,,-91208975,6948297,25197183,18248886,18248886,,,,,,0,25197183,6948297,0,-109457861,,-91208975,-91208975,49684,BGY
2017-12-31,,,134660631,,134660631,7528283,17186003,9657720,9657720,,,,,,0,17186003,7528283,0,125002911,,134660631,134660631,49684,BGY
2016-12-31,,,-16112407,,-16112407,7249588,17258844,10009256,10009256,,,,,,0,17258844,7249588,0,-26121663,,-16112407,-16112407,49684,BGY
2020-01-31,16050000,,-8873000,,-8921000,27390000,43502000,62000,62000,,,,,,48000,67154000,67092000,23652000,-8935000,,-8921000,-8921000,49686,SEAC
2019-01-31,19705000,,-40020000,,-38002000,34032000,37330000,-16407000,-16407000,,,,,,-2018000,62402000,78809000,25072000,-23613000,,-38002000,-38002000,49686,SEAC
2018-01-31,23444000,,1226000,,13498000,31170000,53944000,-670000,-670000,,,,,,-12272000,80267000,80937000,26323000,1896000,,13498000,13498000,49686,SEAC
2017-01-31,30093000,,-56618000,,-71249000,32331000,41470000,-22627000,-22627000,-4118000.0,,,,,14631000,83795000,106422000,42325000,-33991000,,-71249000,-71249000,49686,SEAC
2019-12-31,,,-134535000,62771000,-121841000,415176000,293093000,-122083000,-122083000,,-342000,,,,185000,1459418000,1581501000,1166325000,-12452000,,-134720000,-120645000,49687,OSTK
2018-12-31,,,-219954000,78960000,-206070000,556514000,353908000,-202606000,-202606000,,-1468000,,,,-2384000,1821592000,2024198000,1467684000,-17348000,,-217570000,-204877000,49687,OSTK
2017-12-31,,,-47734000,-3505000,-109878000,387185000,340551000,-46634000,-46634000,,-2937000,,,,64188000,1744756000,1791390000,1404205000,-1100000,,-111922000,-107134000,49687,OSTK
2016-12-31,,,20545000,-2366000,12522000,342954000,331349000,-11605000,-11605000,,-877000,,,,9297000,1799963000,1811568000,1468614000,32150000,,11248000,12522000,49687,OSTK
2019-12-31,,,-13800,,-13800,9000,0,-13800,-13800,4800,,,,,0,0,13800,0,0,,-13800,-13800,49688,DFPH
2020-12-31,,,36788000,,30165000,33163000,82513000,0,37303000,12047000,,,,,6623000,82513000,45210000,0,-515000,,30165000,30165000,49690,MCBC
2019-12-31,,,39441000,,31979000,36944000,83665000,0,39933000,6788000,,,,,7462000,83665000,43732000,0,-492000,,31979000,31979000,49690,MCBC
2018-12-31,,,32350000,,26379000,36936000,76679000,0,32937000,6806000,,,,,5971000,76679000,43742000,0,-587000,,26379000,26379000,49690,MCBC
2017-12-31,,,27025000,,16292000,36170000,70713000,0,27629000,6914000,,,,,10733000,70713000,43084000,0,-604000,,16292000,16292000,49690,MCBC
2020-02-29,,,40986791,,40986791,3424653,22973087,19548434,19548434,,-5663537,,,,0,22973087,3424653,0,21438357,,40986791,40986791,49697,VPV
2019-02-28,,,11239877,,11239877,3360895,23335093,19930705,19930705,43493.0,-5359068,,,,0,23335093,3404388,0,-8716213,,11239877,11239877,49697,VPV
2018-02-28,,,10819601,,10819601,3436899,25779197,22342298,22342298,43493.0,-4410402,,,,0,25779197,3436899,0,-11522697,,10819601,10819601,49697,VPV
2017-02-28,,,516471,,516471,3229031,22823230,19543569,19543569,50630.0,-2946828,,,,0,22823230,3279661,0,-19027098,,516471,516471,49697,VPV
2019-12-31,,,-23645000,6370000,-20383000,300917000,761606000,79452000,79452000,,-136660000,,,,-3714000,1336542000,1257090000,574936000,-103097000,,-19931000,-20845000,49698,CNSL
2018-12-31,,,-74698000,5918000,-50834000,322076000,787202000,32458000,32458000,,-134578000,,,,-24127000,1399074000,1366616000,611872000,-107156000,,-50571000,-51644000,49698,CNSL
2017-12-31,,,-59628000,5655000,64945000,249399000,613576000,72304000,72304000,,-129786000,,,,-124927000,1059574000,987270000,445998000,-131932000,,65299000,64583000,49698,CNSL
2016-12-31,,,38158000,5301000,14931000,158491000,421765000,89264000,89264000,,-76826000,,,,22962000,743177000,653913000,321412000,-51106000,,15196000,14407000,49698,CNSL
2019-12-31,,,-11056000000,252000000,-7656000000,-36000000,4575000000,1377000000,1377000000,,-948000000,,,,-3400000000,17129000000,15752000000,12554000000,-12433000000,,-7656000000,-7656000000,49700,PCG
2018-12-31,,,-10143000000,252000000,-6851000000,-52000000,5352000000,2368000000,2368000000,,-943000000,,,,-3292000000,16759000000,14391000000,11407000000,-12511000000,,-6851000000,-6851000000,49700,PCG
2017-12-31,,,2157000000,252000000,1646000000,-1000000,5837000000,2984000000,2984000000,,-902000000,,,,511000000,17135000000,14151000000,11298000000,-827000000,,1646000000,1646000000,49700,PCG
2016-12-31,,,1448000000,252000000,1393000000,-12000000,4987000000,2244000000,2244000000,,-843000000,,,,55000000,17666000000,15422000000,12679000000,-796000000,,1393000000,1393000000,49700,PCG
2019-12-31,,,-48095000,-1518000,-16782000,139791000,237762000,-3300000,-3300000,,-32520000,,,,-30893000,900127000,903427000,662365000,-44795000,,-17202000,-16782000,49701,ENV
2018-12-31,,,-9162000,-1098000,5755000,138427000,231775000,15722000,15722000,-590000.0,-25203000,,,,-13172000,812363000,796641000,580588000,-24884000,,4010000,5755000,49701,ENV
2017-12-31,,,-1689000,398000,-3280000,119977000,200250000,17453000,17453000,346000.0,-16347000,,,,1591000,683679000,666226000,483429000,-19142000,,-3280000,-3280000,49701,ENV
2016-12-31,,,-40490000,398000,-55567000,101528000,155990000,-15766000,-15766000,6229000.0,-16600000,,,,15077000,578164000,593930000,422174000,-24724000,,-55567000,-55567000,49701,ENV
2019-12-31,28137000,,-6765000,,-12884000,34111000,52339000,-9909000,-9909000,,,,,,6119000,176619000,186528000,124280000,3144000,,-12884000,-12884000,49702,LASR
2018-12-31,21054000,,17538000,,13938000,28844000,66961000,17063000,17063000,,,,,,3600000,191359000,174296000,124398000,475000,,13938000,9523000,49702,LASR
2017-12-31,15123000,,6695000,,1837000,19353000,44274000,9798000,9798000,,-1269000.0,,,,4858000,138580000,128782000,94306000,-3103000,,13938000,9523000,49702,LASR
2016-12-31,15239000,,-12320000,,-14202000,17265000,23166000,-9338000,-9338000,,-2229000.0,,,,1882000,101325000,110663000,78159000,-3282000,,-14202000,-14202000,49702,LASR
2019-12-31,,,2302000000,750000000,2172000000,,3046000000,2439000000,2439000000,595000000,-67000000,,,,117000000,16258000000,13819000000,13212000000,-137000000,,2185000000,2136000000,49703,ATH
2018-12-31,,,1175000000,750000000,1053000000,,1801000000,1254000000,1254000000,536000000,-57000000,,,,122000000,6637000000,5383000000,4836000000,-79000000,,1053000000,1053000000,49703,ATH
2017-12-31,,,1464000000,750000000,1358000000,,2136000000,1548000000,1548000000,555000000,-16000000,,,,106000000,8788000000,7240000000,6652000000,-84000000,,1358000000,1358000000,49703,ATH
2016-12-31,,,712000000,1000000,773000000,13000000.0,1352000000,743000000,743000000,512000000,-9000000,,,,-61000000,4105000000,3362000000,2753000000,-31000000,,773000000,773000000,49703,ATH
2020-12-31,,,64940000,,64914000,28341000,110355000,82014000,82014000,,-11647000,,,,26000,676378000,594364000,566023000,-17074000,,64914000,60512000,49706,WTRE
2019-12-31,,,62561000,,62541000,30843000,135142000,104299000,104299000,,-33491000,,,,20000,715065000,610766000,579923000,-41738000,,62541000,44745000,49706,WTRE
2018-12-31,,,-34856000,,-34883000,22311000,19344000,-2967000,-2967000,,-26500000,,,,27000,601735000,604702000,582391000,-31889000,,-34883000,-54516000,49706,WTRE
2017-12-31,,,10762000,,10741000,21174000,46416000,25242000,25242000,,-15900000,,,,21000,623544000,598302000,577128000,-14480000,,10741000,-8892000,49706,WTRE
2019-12-31,4585000,,-8599000,,-8599000,4108000,0,-8693000,-8693000,,,,,,0,0,8693000,0,94000,,-8599000,-8599000,49708,BPTH
2018-12-31,4603000,,-8583000,,-8583000,3379000,0,-7982000,-7982000,,,,,,0,0,7982000,0,-601000,,-8583000,-8583000,49708,BPTH
2017-12-31,5480000,,-7023000,,-7023000,3523000,37000,-8966000,-8966000,,,,,,0,37000,9003000,0,1943000,,-7023000,-8061000,49708,BPTH
2016-12-31,5474000,,-6750000,,-6750000,3014000,13000,-8475000,-8475000,,,,,,0,13000,8488000,0,1725000,,-6750000,-6750000,49708,BPTH
2019-12-31,,,-211535000,,-235329000,120444000,162929000,-50315000,-50315000,,,,,,23794000,579920000,630235000,416991000,-161220000,,-235329000,-235329000,49709,FI
2018-12-31,,,-93683000,,-90733000,126638000,143430000,-94500000,-94500000,,,,,,-2950000,522493000,616993000,379063000,817000,,-90733000,-90733000,49709,FI
2017-12-31,,,-86539000,,-159457000,129218000,109887000,-141433000,-141433000,,,,,,72918000,454795000,596228000,344908000,54894000,,-159457000,-159457000,49709,FI
2016-12-31,,,-181722000,,-135338000,171887000,170263000,-115839000,-115839000,,,,,,-25643000,487531000,603370000,317268000,-65883000,,-156079000,-135339000,49709,FI
2019-11-30,,,3455000,,3668000,7677000,32051000,12573000,12573000,,-6408000,,,,-213000,44045000,31472000,11994000,-9118000,,3668000,3668000,49710,INDT
2018-11-30,,,-1148000,,-1653000,7749000,24124000,4971000,4971000,,-6270000,,,,505000,33800000,28829000,9676000,-6119000,,-1653000,-1653000,49710,INDT
2017-11-30,,,7300000,,4627000,8552000,31238000,12622000,12622000,,-5690000,,,,2673000,43884000,31262000,12646000,-5322000,,4627000,4627000,49710,INDT
2016-11-30,,,1311000,,576000,7367000,21791000,5627000,5627000,,-4545000,,,,735000,30851000,25224000,9060000,-4316000,,576000,576000,49710,INDT
2019-12-31,,,3613000,-28000,3613000,9245000,99841000,59916000,59916000,,-57334000,,,,0,130901000,70985000,31060000,-56303000,,3613000,-7950000,49713,DLNG
2018-12-31,,,3613000,-16000,3613000,8556000,91869000,52983000,52983000,,-50145000,,,,0,127135000,74152000,35266000,-49370000,,3613000,-4046000,49713,DLNG
2017-12-31,,,17339000,-16000,17339000,7848000,102111000,63944000,63944000,,-45162000,,,,0,138990000,75046000,36879000,-46605000,,17339000,10589000,49713,DLNG
2016-12-31,,,66854000,-16000,66854000,7884000,140358000,102079000,102079000,,-34871000,,,,0,169851000,67772000,29493000,-35225000,,66854000,60104000,49713,DLNG
2019-12-31,14282000,,-101832000,,-92800000,124837000,110583000,-28536000,-28536000,,-980000,,,,-9537000,309285000,337821000,198702000,-73296000,-505000,-92295000,-92800000,49715,NLS
2018-12-31,16825000,,21001000,,14658000,143946000,181740000,20969000,20969000,,-1051000,,,,5891000,396753000,375784000,215013000,32000,-452000,15110000,14658000,49715,NLS
2017-12-31,15446000,,35705000,,26267000,143333000,203882000,45103000,45103000,,-1552000,,,,8080000,406184000,361081000,202302000,-9398000,-1358000,27625000,26267000,49715,NLS
2016-12-31,13919000,,51581000,,34178000,144212000,211525000,53394000,53394000,,-1928000,,,,16480000,406039000,352645000,194514000,-1960000,-923000,35101000,34178000,49715,NLS
2019-12-31,,,-63591000,,-59747000,12785000,24219000,-55160000,-55160000,3531000,-6817000,,,,-3844000,117019000,172179000,92800000,-8431000,,-59747000,-59747000,49717,MUX
2018-12-31,,,-47640000,,-44870000,11125000,32098000,-35324000,-35324000,3464000,-1619000,,,,-2770000,128175000,163499000,96077000,-12316000,,-44870000,-44870000,49717,MUX
2017-12-31,,,-26003000,,-10634000,11044000,12987000,-24231000,-24231000,2061000,-938000,,,,-15369000,67465000,91696000,54478000,-1772000,,-10634000,-10634000,49717,MUX
2016-12-31,,,17306000,,21055000,12734000,24853000,2396000,2396000,595000,-938000,,,,-3749000,60388000,57992000,35535000,14910000,,21055000,21055000,49717,MUX
2019-12-28,,,105692000,,76389000,145245000,405097000,241309000,241309000,,-98126000,,,,29303000,1660414000,1419105000,1255317000,-135617000,,76389000,76389000,49721,BGS
2018-12-29,,,222277000,,172435000,152906000,425800000,254551000,254551000,,-108334000,,,,49842000,1700764000,1446213000,1274964000,-32274000,,172435000,172435000,49721,BGS
2017-12-30,,,148062000,,217463000,149339000,442958000,276008000,276008000,,-91784000,,,,-69401000,1646387000,1370379000,1203429000,-127946000,,217463000,217463000,49721,BGS
2016-12-31,,,177066000,,109425000,139451000,435236000,281982000,281982000,,-74456000,,,,67641000,1372307000,1090325000,937071000,-104916000,,109425000,109425000,49721,BGS
2020-12-31,,,470340000,123000,377778000,494935000,1031531000,536596000,536596000,,-44746000,,,,92562000,2351646000,1815050000,1320115000,-66256000,,377778000,377778000,49726,IEX
2019-12-31,,,532903000,123000,425521000,526858000,1128374000,601516000,601516000,,-44341000,,,,107382000,2494573000,1893057000,1366199000,-68613000,,425521000,425521000,49726,IEX
2018-12-31,,,528939000,123000,410573000,534462000,1117895000,581233000,581233000,2200000.0,-44134000,,,,118366000,2483666000,1902433000,1365771000,-52294000,,410573000,410573000,49726,IEX
2017-12-31,,,455273000,123000,337257000,527454000,1026678000,499224000,499224000,2200000.0,-44889000,,,,118016000,2287312000,1788088000,1260634000,-43951000,,337257000,337257000,49726,IEX
2020-12-31,,,6900000,,7700000,363000000,442700000,79700000,79700000,,-17200000,,,,-800000,1236400000,1156700000,793700000,-72800000,,7700000,4400000,49728,KNL
2019-12-31,16400000.0,,90900000,,67500000,389900000,549000000,142700000,142700000,,-21700000,,,,23400000,1428100000,1285400000,879100000,-51800000,,67500000,67500000,49728,KNL
2018-12-31,20100000.0,,98200000,200000.0,73300000,331800000,481500000,129600000,129600000,,-20900000,,,,24900000,1302300000,1172700000,820800000,-31400000,,73300000,73300000,49728,KNL
2017-12-31,19200000.0,,78600000,251000.0,80200000,286800000,414600000,108600000,108600000,,-7400000,,,,-1600000,1132900000,1024300000,718300000,-30000000,,80200000,80200000,49728,KNL
2019-12-31,,,2406109000,2279899000,1614085000,940577000,5211238000,2516755000,2516755000,646326000,-631233000,,,,236346000,13823732000,11306977000,8612494000,-110646000,,2169763000,1614085000,49731,ENIA
2018-12-31,,,2104990000,2107892000,1201381000,964536000,4784290000,2297176000,2297176000,545467000,-618791000,,,,437932000,12758074000,10460898000,7973784000,-192186000,,1667058000,1201381000,49731,ENIA
2017-12-31,,,1645648000,1798036000,709043000,907398000,4295950000,2137198000,2137198000,479120000,-432057000,,,,519134000,10242655000,8105457000,5946705000,-491550000,,1126514000,709043000,49731,ENIA
2016-12-31,,,1376069000,1680105000,566497000,678160000,3474110000,1927527000,1927527000,395185000,-485100000,,,,531461000,7407316000,5479789000,3933206000,-551458000,170263000.0,844608000,566497000,49731,ENIA
2019-12-31,44351851,,-62136804,,-60826831,12154702,0,-56506553,-56506553,,-603846,,,,-1309973,0,56506553,0,-5630251,,-60826831,-60826831,49734,ALDX
2018-12-31,29823007,,-38893245,,-38893245,9876144,0,-39699151,-39699151,,-146792,,,,0,0,39699151,0,805906,,-38893245,-38893245,49734,ALDX
2017-12-31,16302568,,-22340589,,-22340589,6185820,0,-22488388,-22488388,,-113453,,,,0,0,22488388,0,147799,,-22340589,-22340589,49734,ALDX
2016-12-31,13175670,,-18699450,,-18699450,5520308,0,-18695978,-18695978,,-105509,,,,0,0,18695978,0,-3472,,-18699450,-18699450,49734,ALDX
2019-12-31,23622830,,-5376101,,-6177438,26585193,44011226,-6088945,-6088945,-107852,,,,,801337,64428690,70517635,20417464,712844,,-6177438,-66853864,49736,API
2018-12-31,14425536,,481194,,376116,17359434,31022389,262567,262567,-1025148,,,,,105078,43656954,43394387,12634565,218627,,376116,-42820168,49736,API
2019-12-31,,,826564000,1103208000,564269000,654487000,1735484000,862311000,862311000,84606000,-88284000,,,,196519000,10192818000,9330507000,8457334000,-35747000,,630045000,564269000,49737,TX
2018-12-31,,,2031567000,1091321000,1506647000,667564000,2966383000,2098851000,2098851000,90936000,-131172000,,,,369435000,11454807000,9355956000,8488424000,-67284000,,1662132000,1506647000,49737,TX
2017-12-31,,,1359809000,842347000,886219000,629129000,2692280000,1858424000,1858424000,113433000,-114583000,,,,336882000,9700296000,7841872000,7008016000,-498615000,,1022927000,886219000,49737,TX
2016-12-31,,,1118457000,775295000,595644000,542380000,1836493000,1142126000,1142126000,99683000,-89971000,,,,411528000,7223975000,6081849000,5387482000,-23669000,,706929000,595644000,49737,TX
2019-12-31,35000,,-173000,878000,-146000,4818000,4417000,-436000,-436000,,-4000,,,,37000,17399000,17835000,12982000,263000,,-210000,-146000,49739,CLWT
2018-12-31,184000,,-373000,956000,88000,4567000,3699000,-1052000,-1052000,,-7000,,,,-312000,20104000,21156000,16405000,679000,,-61000,88000,49739,CLWT
2017-12-31,163000,,395000,1138000,473000,4813000,4413000,-563000,-563000,,-11000,,,,28000,17350000,17913000,12937000,958000,,367000,473000,49739,CLWT
2016-12-31,475000,,386000,1183000,231000,5127000,4951000,-651000,-651000,,-19000,,,,228000,22478000,23129000,17527000,1037000,,158000,231000,49739,CLWT
2020-12-31,,,704802000,,530670000,,3245731000,864142000,864142000,2381589000,-150537000,,,,171817000,8098925000,7234783000,4853194000,-159340000,,532985000,530670000,49740,WRB
2019-12-31,,,852920000,43403000.0,681944000,44107000.0,3368411000,975614000,975614000,2348690000,-153409000,,,,168935000,7902196000,6926582000,4533785000,-122694000,,683985000,681944000,49740,WRB
2018-12-31,,,812094000,41947000.0,640749000,45778000.0,3352500000,942212000,942212000,2364510000,-157185000,,,,163028000,7691651000,6749439000,4339151000,-130118000,,649066000,640749000,49740,WRB
2017-12-31,,,772770000,39819000.0,549094000,52925000.0,3356999000,935334000,935334000,2368740000,-147297000,,,,219433000,7684764000,6749430000,4327765000,-162564000,,553337000,549094000,49740,WRB
2020-02-29,,,-3066950,,-3066950,2015751,6983908,4968157,4968157,,,,,,0,6983908,2015751,0,-8035107,,-3066950,-3066950,49746,IGA
2019-02-28,,,3724317,,3724317,2120527,5879064,3758537,3758537,,-628.0,,,,0,5879064,2120527,0,-34220,,3724317,3724317,49746,IGA
2018-02-28,,,25588534,,25588534,2159366,5566467,3407101,3407101,,-371.0,,,,0,5566467,2159366,0,22181433,,25588534,25588534,49746,IGA
2017-02-28,,,36299987,,36299987,2040783,5265123,3224340,3224340,,-371.0,,,,0,5265123,2040783,0,33075647,,36299987,36299987,49746,IGA
2019-12-31,,,1943927000,551626000,1399512000,1758414000,4267867000,1878876000,1878876000,,-23687000,,,,451358000,12807684000,10928808000,8539817000,65051000,,1492569000,1399512000,49747,DISH
2018-12-31,,,2189175000,458569000,1575091000,1444655000,4304300000,2147621000,2147621000,,-15006000,,,,533684000,13621302000,11473681000,9317002000,41554000,,1655491000,1575091000,49747,DISH
2017-12-31,,,1650087000,383882000,2098689000,1817170000,4644112000,2009378000,2009378000,,-63172000,,,,-515320000,14391375000,12381997000,9747263000,-359291000,,2165407000,2098689000,49747,DISH
2016-12-31,,,2416603000,317408000,1497939000,2048939000,5310550000,2340409000,2340409000,,-53141000,,,,865818000,15212302000,12871893000,9901752000,76194000,,1550785000,1497939000,49747,DISH
2020-07-31,,,-101932000,,-101932000,10329000,144952000,134623000,134623000,,-17619000,,,,0,144952000,10329000,0,-236555000,,-101932000,-106833000,49748,PTY
2019-07-31,,,123001000,,123001000,9921000,133427000,123506000,123506000,,-11492000,,,,0,133427000,9921000,0,-505000,,123001000,112244000,49748,PTY
2018-07-31,,,115526000,,115526000,9759000,119276000,109517000,109517000,,-174000,,,,0,119276000,9759000,0,6009000,,115526000,108640000,49748,PTY
2017-07-31,,,237336000,,237336000,8533000,99003000,90470000,90470000,,15374000,,,,0,99003000,8533000,0,146866000,,237336000,234103000,49748,PTY
2019-12-31,45778000,,-149209000,,-149209000,101212000,16218000,-132341000,-132341000,,-20608000,,,,0,17456000,149797000,1238000,-16868000,,-149209000,-149209000,49749,VSTM
2018-12-31,43648000,,-72434000,,-72434000,77265000,26553000,-94783000,-94783000,,-5810000,,,,0,26718000,121501000,165000,22349000,,-72434000,-72434000,49749,VSTM
2017-12-31,46423000,,-67802000,,-67802000,21381000,0,-67804000,-67804000,,-559000,,,,0,0,67804000,0,2000,,-67802000,-67802000,49749,VSTM
2016-12-31,19779000,,-36440000,,-36440000,17223000,0,-37002000,-37002000,,-559000,,,,0,0,37002000,0,562000,,-36440000,-36440000,49749,VSTM
2020-12-31,,,6955000,,4746000,19855000,95975000,13873000,13873000,20888000,-5605000,,,,2209000,551138000,537265000,455163000,-6918000,,4746000,4746000,49750,USAK
2019-12-31,,,-4854000,,-4698000,27176000,89498000,3047000,3047000,22082000,-6597000,,,,-156000,522631000,519584000,433133000,-7901000,,-4698000,-4698000,49750,USAK
2018-12-31,,,16578000,,12204000,23240000,90318000,18219000,18219000,20535000,-3649000,,,,4374000,534060000,515841000,443742000,-1641000,,12204000,12204000,49750,USAK
2017-12-31,,,-6263000,,7497000,25628000,71414000,-1911000,-1911000,19234000,-3808000,,,,-13760000,446533000,448444000,375119000,-4352000,,7497000,7497000,49750,USAK
2019-12-31,,,-9201835,,-9439894,5194441,36982501,31788060,31788060,,-19619309,,,,238059,36982501,5194441,0,-40989895,,-9439894,-9439894,49751,TEI
2018-12-31,,,-44603304,,-44603304,6438232,46152176,39713944,39713944,,3762108,,,,0,46152176,6438232,0,-84317248,,-44603304,-44603304,49751,TEI
2017-12-31,,,57507026,,57507026,6482801,47321519,40838718,40838718,,-2065131,,,,0,47321519,6482801,0,16668308,,57507026,57507026,49751,TEI
2016-12-31,,,66528366,,66528366,6126105,40441467,34315362,34315362,,41199486,,,,0,40441467,6126105,0,32213004,,66528366,66528366,49751,TEI
2019-12-31,,,-96547000,,-96746000,301628000,203206000,-98422000,-98422000,,-616000,,,,199000,318037000,416459000,114831000,1875000,,-96746000,-100101000,49753,REAL
2018-12-31,,,-75666000,,-75765000,210822000,136918000,-73904000,-73904000,,-1152000,,,,99000,213732000,287636000,76814000,-1762000,,-75765000,-84687000,49753,REAL
2017-12-31,,,-52251000,,-52308000,139426000,87642000,-51784000,-51784000,,-762000,,,,57000,137521000,189305000,49879000,-467000,,-52308000,-54918000,49753,REAL
2020-05-31,68849,,-1856942,,3880575,4061621,1950548,-2179922,-2179922,,-2435,,,,-14638,4189924,6369846,2239376,322980,5722879,-1842304,3880575,49759,SMIT
2019-05-31,56833,,-1459649,,-1210990,3180497,1768762,-1468568,-1468568,,-12160,,,,8783,4729442,6198010,2960680,8919,257442,-1468432,-1210990,49759,SMIT
2018-05-31,327317,,236554,,210639,5582625,6065314,155372,155372,,-1401,,,,25915,13888063,13732691,7822749,81182,257442,210639,210639,49759,SMIT
2017-05-31,256164,,-1045355,,-1073364,5618327,4885807,-988684,-988684,,-2982,,,,28009,12397643,13386327,7511836,-56671,257442,-1073364,-1073364,49759,SMIT
2020-12-31,,,947000000,,695000000,2911000000,4238000000,1327000000,1327000000,,-93000000,,,,192000000,11797000000,10470000000,7559000000,-380000000,,755000000,695000000,49765,GWW
2019-12-31,,,1209000000,205000000.0,849000000,2912000000,4397000000,1407000000,1407000000,,-79000000,,,,314000000,11486000000,10079000000,7089000000,-198000000,,895000000,849000000,49765,GWW
2018-12-31,,,1081000000,172000000.0,782000000,2893000000,4348000000,1363000000,1363000000,,-82000000,,,,258000000,11221000000,9858000000,6873000000,-282000000,,823000000,782000000,49765,GWW
2017-12-31,,,936000000,138000000.0,586000000,2845000000,4098000000,1164000000,1164000000,,-86000000,,,,313000000,10425000000,9261000000,6327000000,-228000000,,623000000,586000000,49765,GWW
2019-12-31,,,172477000,-704000,173736000,36366000,211992000,0,175626000,,,,,,-419000,225461000,49835000,13469000,-3149000,,172896000,144835000,49766,NYMTO
2018-12-31,,,103738000,904000,102886000,28234000,132408000,0,104174000,44050000.0,,,,,-1057000,145644000,41470000,13236000,-436000,,104795000,79186000,49766,NYMTO
2017-12-31,,,91922000,4136000,91980000,22874000,114796000,0,91922000,44050000.0,,,,,3355000,132999000,41077000,18203000,0,,88567000,76320000,49766,NYMTO
2016-12-31,,,70655000,3087000,67551000,24507000,95097000,0,70590000,44050000.0,,,,,3095000,105811000,35221000,10714000,65000,,67560000,54651000,49766,NYMTO
2020-12-31,,,18885000,,15613000,42803000,69768000,0,20383000,6582000,,,,,3272000,69768000,49385000,0,-1498000,,15613000,15613000,49767,COFS
2019-12-31,,,8465000,,7171000,25215000,36653000,0,8575000,2863000,,,,,1294000,36653000,28078000,0,-110000,,7171000,7171000,49767,COFS
2018-12-31,,,8488000,,7333000,17989000,28949000,0,8673000,2287000,,,,,1155000,28949000,20276000,0,-185000,,7333000,7333000,49767,COFS
2017-12-31,,,8555000,,6168000,17287000,27889000,0,8755000,1847000,,,,,2387000,27889000,19134000,0,-200000,,6168000,6168000,49767,COFS
2020-02-29,,,24054155,,24054155,2704762,19686948,16947661,16947661,34525,-6510038,,,,0,19686948,2739287,0,7106494,,24054155,24054155,49770,IHIT
2019-02-28,,,20402692,,20402692,2550763,20766450,18215687,18215687,34525,-3892006,,,,0,20766450,2550763,0,2187005,,20402692,20402692,49770,IHIT
2018-02-28,,,13949679,,13949679,2435722,19227191,16791469,16791469,34525,-1059984,,,,0,19227191,2435722,0,-2841790,,13949679,13949679,49770,IHIT
2017-02-28,,,6159602,,6159602,616269,3501734,2849305,2849305,36160,-1059984,,,,0,3501734,652429,0,3310297,,6159602,6159602,49770,IHIT
2020-10-03,94195000,,-442723000,,-414139000,288798000,410874000,23894000,23894000,,-17037000,,,,-28584000,1228999000,1205105000,818125000,-466617000,,-414139000,-414139000,49771,COHR
2019-09-28,94453000,,60048000,,53825000,296039000,506165000,106613000,106613000,,-19122000,,,,6223000,1430640000,1324027000,924475000,-46565000,,53825000,53825000,49771,COHR
2018-09-29,110486000,,361555000,,247358000,314523000,830691000,394992000,394992000,,-25847000,,,,114195000,1902573000,1507581000,1071882000,-33437000,-2000.0,247360000,247358000,49771,COHR
2017-09-30,102666000,,302055000,,207122000,291092000,776669000,366887000,366887000,,-34362000,,,,93411000,1723311000,1356424000,946642000,-64832000,-1522000.0,208644000,207122000,49771,COHR
2019-12-31,,,6989000,,43539000,59582000,351487000,44630000,44630000,90188000,-34234000,,,,-36550000,597403000,552773000,245916000,-37641000,,43539000,43539000,49776,BRY
2018-12-31,,,190137000,,147102000,47253000,369783000,203625000,203625000,32634000,-35648000,,,,43035000,591178000,387553000,221395000,-13488000,,147102000,49160000,49776,BRY
2017-12-31,,,-520999000,,-524032000,63973000,242068000,-11969000,-11969000,93437000,-26699000,,,,3033000,466401000,478370000,224333000,-509030000,,-524032000,-39316000,49776,BRY
2016-12-31,,,-1283080000,,-1283196000,79236000,179864000,-118489000,-118489000,40894000,-61268000,,,,116000,418804000,537293000,238940000,-1164591000,,-1283196000,-1283196000,49776,BRY
2020-12-31,,,5910000,,5389000,37077000,48415000,0,5947000,5391000,,,,,521000,48415000,42468000,0,-37000,,5389000,5389000,49777,OPOF
2019-12-31,,,8940000,,7860000,35104000,47578000,0,8938000,3536000,,,,,1080000,47578000,38640000,0,2000,,7860000,7860000,49777,OPOF
2018-12-31,,,5198000,,4919000,33584000,43698000,0,5939000,4175000,,,,,279000,43698000,37759000,0,-741000,,4919000,4919000,49777,OPOF
2017-12-31,,,-126000,,-29000,31197000,38519000,0,3375000,3947000,,,,,-97000,38519000,35144000,0,-3501000,,-29000,-29000,49777,OPOF
2020-09-30,,,437300000,,324500000,613600000,1113400000,488800000,488800000,,-59300000,,,,112800000,6856800000,6368000000,5743400000,-51500000,,324500000,324500000,49778,OSK
2019-09-30,,,750700000,,579400000,685600000,1517400000,794900000,794900000,,-54400000,,,,171300000,8382000000,7587100000,6864600000,-44200000,,579400000,579400000,49778,OSK
2018-09-30,,,595700000,,471900000,685800000,1352000000,627900000,627900000,,-71600000,,,,123800000,7705500000,7077600000,6353500000,-32200000,,471900000,471900000,49778,OSK
2017-09-30,,,412800000,,285600000,672000000,1180800000,463000000,463000000,,-59600000,,,,127200000,6829600000,6366600000,5648800000,-50200000,,285600000,285600000,49778,OSK
2020-12-31,,,3761400000,,3775600000,219600000,5719200000,5499600000,5499600000,,-1287400000,,,,-124300000,27199700000,21700100000,21480500000,-1738200000,,3885700000,3774700000,49782,EPD
2019-12-31,,,4732700000,1063500000.0,4591300000,211700000,5778500000,5566800000,5566800000,,-1243000000,,,,45600000,32789200000,27222400000,27010700000,-834100000,,4687100000,4563600000,49782,EPD
2018-12-31,,,4298800000,438700000.0,4172400000,208300000,5183700000,4975400000,4975400000,,-1096700000,,,,60300000,36534200000,31558800000,31350500000,-676600000,,4238500000,4150900000,49782,EPD
2017-12-31,,,2881300000,225200000.0,2799300000,181100000,3721800000,3540700000,3540700000,,-984600000,,,,25700000,29241500000,25700800000,25519700000,-659400000,,2855600000,2783400000,49782,EPD
2020-12-31,,,-129016000,11376000,-129220000,59806000,447344000,74151000,74151000,,-45613000,,,,35000,1328129000,1253978000,880785000,-203167000,,-129051000,-129220000,49783,ARLP
2019-12-31,,,406715000,11935000,399414000,75499000,656760000,272186000,272186000,,-45875000,,,,-211000,1961720000,1689534000,1304960000,134529000,,406926000,392923000,49783,ARLP
2018-12-31,,,367492000,5290000,365044000,73314000,681293000,293454000,293454000,,-40218000,,,,22000,2002857000,1709403000,1321564000,74038000,,367470000,358289000,49783,ARLP
2017-12-31,,,304411000,20207000,281734000,65072000,662665000,328612000,328612000,,-39385000,,,,210000,1796220000,1467608000,1133555000,-24201000,,304201000,276369000,49783,ARLP
2019-12-31,,,-84341000,,-63417000,34172000,4985000,-29390000,-29390000,203000,-46389000,,,,-20924000,365070000,394460000,360085000,-54951000,,-63417000,-96441000,49784,LXU
2018-12-31,,,-70486000,,-72226000,35511000,11435000,-24076000,-24076000,203000,-42164000,,,,1740000,378160000,402236000,366725000,-46410000,,-72226000,-102741000,49784,LXU
2017-12-31,,,-71052000,,-29217000,34990000,5466000,-34691000,-34691000,5167000,-37267000,,,,-40759000,427504000,462195000,422038000,-36361000,1076000.0,-30293000,-59447000,49784,LXU
2016-12-31,,,-130089000,,112168000,40168000,-37206000,-76146000,-76146000,-1228000,-28745000,,,,-41956000,374585000,450731000,411791000,-53943000,200301000.0,-88133000,64760000,49784,LXU
2019-12-31,31933000,,73672000,,47748000,492625000,580944000,56386000,56386000,,,,,,25924000,1549354000,1492968000,968410000,17286000,,47748000,47748000,49785,RLX
2018-12-31,2065000,,2098000,,-287000,54971000,59247000,2211000,2211000,,-107000.0,,,,2385000,132613000,130402000,73366000,-113000,,-287000,-287000,49785,RLX
2019-12-26,,,99100000,258300000,36100000,135000000,310300000,162000000,162000000,,-58000000,,,,12400000,444800000,282800000,134500000,-62900000,,86700000,36100000,49787,NCMI
2018-12-27,,,103700000,278800000,29800000,111400000,309000000,158200000,158200000,,-55400000,,,,23500000,441400000,283200000,132400000,-54500000,,80200000,29800000,49787,NCMI
2017-12-28,,,294800000,287700000,58300000,107500000,301400000,156400000,156400000,,-52800000,,,,180300000,426100000,269700000,124700000,138400000,,114500000,58300000,49787,NCMI
2016-12-29,,,108900000,241500000,32900000,113000000,325400000,176800000,176800000,,-54000000,,,,14400000,447600000,270800000,122200000,-67900000,,94500000,32900000,49787,NCMI
2020-09-03,2600000000,,2990000000,,2687000000,881000000,6552000000,3060000000,3060000000,11000000,-194000000,,,,280000000,21435000000,18375000000,14883000000,-70000000,,2710000000,2687000000,49789,MU
2019-08-29,2441000000,,7051000000,987000000.0,6313000000,836000000,10702000000,7390000000,7390000000,35000000,-128000000,,,,693000000,23406000000,16016000000,12704000000,-339000000,,6358000000,6313000000,49789,MU
2018-08-30,2141000000,,14306000000,967000000.0,14135000000,813000000,17891000000,14926000000,14926000000,11000000,-342000000,,,,168000000,30391000000,15465000000,12500000000,-620000000,,14138000000,14135000000,49789,MU
2017-08-31,1824000000,,5204000000,849000000.0,5089000000,730000000,8436000000,5877000000,5877000000,5000000,-601000000,,,,114000000,20322000000,14445000000,11886000000,-673000000,,5090000000,5089000000,49789,MU
2020-12-31,,,1108000000,265000000,784000000,479000000,1267000000,780000000,780000000,8000000,,,,,295000000,8263000000,7483000000,6996000000,328000000,,813000000,784000000,49791,YUMC
2019-12-31,,,1003000000,98000000,713000000,896000000,1810000000,877000000,877000000,37000000,,,,,260000000,8776000000,7899000000,6966000000,126000000,,743000000,713000000,49791,YUMC
2018-12-31,,,950000000,104000000,708000000,859000000,1718000000,830000000,830000000,29000000,,,,,214000000,8415000000,7585000000,6697000000,120000000,,736000000,708000000,49791,YUMC
2017-12-31,,,803000000,82000000,398000000,897000000,1686000000,758000000,758000000,31000000,,,,,379000000,7769000000,7011000000,6083000000,45000000,,424000000,398000000,49791,YUMC
2019-12-31,,,-43800000,,-36200000,57100000,114100000,20000000,20000000,2100000,-47500000,,,,-7600000,269500000,249500000,155400000,-63800000,,-36200000,-17200000,49792,PACK
2018-12-31,,,-15700000,,-8600000,53200000,114600000,16100000,16100000,2100000,-30900000,,,,-7100000,267900000,251800000,153300000,-31800000,,-8600000,-8600000,49792,PACK
2017-12-31,,,-13700000,,27700000,46300000,112400000,43400000,43400000,-19200000,-30700000,,,,-41400000,244100000,200700000,131700000,-57100000,,27700000,27700000,49792,PACK
2020-06-30,7257000,,10804000,,8520000,23670000,43592000,12665000,12665000,,-9000,,,,2284000,101359000,88694000,57767000,-1861000,,8520000,8520000,49793,NSSC
2019-06-30,7212000,,13445000,,12223000,23212000,43890000,13466000,13466000,,-21000,,,,1222000,102932000,89466000,59042000,-21000,,12223000,12223000,49793,NSSC
2018-06-30,6630000,,8333000,,7649000,22951000,37995000,8414000,8414000,,-81000,,,,684000,91746000,83332000,53751000,-81000,,7649000,7649000,49793,NSSC
2017-06-30,6723000,,6295000,,5599000,23200000,36301000,6378000,6378000,,-83000,,,,696000,87374000,80996000,51073000,-83000,,5599000,5599000,49793,NSSC
2019-12-31,,,-1682671,,-1682671,6115830,12270327,1975611,1975611,,-3222356,,,,0,40023679,38048068,27753352,-3658282,,-1682671,-3459030,49794,ESEA
2018-12-31,,,-663396,,-108890,6101596,10402555,995008,995008,,-2700943,,,,0,34424737,33429729,24022182,-1658404,554506.0,-663396,-1444623,49794,ESEA
2017-12-31,,,-6944261,,-6094560,5134840,6603997,-1617705,-1617705,-499103.0,-1367288,,,,0,23759119,25376824,17155122,-5326556,849701.0,-6944261,-7903371,49794,ESEA
2016-12-31,,,-34079770,,-44221123,5073055,3278023,-6754519,-6754519,-499103.0,-1348101,,,,0,20545336,27299855,17267313,-27325251,-10141353.0,-34079770,-45946822,49794,ESEA
2019-12-31,,,-27474000,,-27474000,6864000,-19835000,-26699000,-26699000,,,,,,0,3977000,30676000,23812000,-775000,,-27474000,26382000,49796,TLIS
2018-12-31,,,-21337000,,-21337000,5432000,-15998000,-21430000,-21430000,,,,,,0,2390000,23820000,18388000,93000,,-21337000,-21337000,49796,TLIS
2020-12-31,197176000,,-106486000,,-108221000,133572000,190589000,-140159000,-140159000,,,,,,2346000,924664000,1064823000,734075000,33673000,,-108832000,-108221000,49800,SOGO
2019-12-31,190402000,,91853000,,89105000,178961000,433798000,64435000,64435000,,,,,,2748000,1172252000,1107817000,738454000,27418000,,89105000,89105000,49800,SOGO
2018-12-31,201739000,,99934000,,98781000,184266000,430688000,44683000,44683000,,,,,,1153000,1124158000,1079475000,693470000,55251000,,98781000,98781000,49800,SOGO
2017-12-31,172829000,,96622000,,82200000,184241000,450956000,93886000,93886000,,,,,,14422000,908357000,814471000,457401000,2736000,,82200000,57812000,49800,SOGO
2020-11-30,,,-792385000,,-784884000,27552000,16064000,-11488000,-11488000,,-38704000,,,,-7501000,16064000,27552000,0,-780897000,,-784884000,-784884000,49801,KYN
2019-11-30,,,-136803000,,-127045000,49492000,48799000,-693000,-693000,,-42114000,,,,-9758000,48799000,49492000,0,-136110000,,-127045000,-127045000,49801,KYN
2018-11-30,,,213323000,,228799000,52513000,25405000,-27108000,-27108000,,-41304000,,,,-15476000,25405000,52513000,0,240431000,,228799000,228799000,49801,KYN
2017-11-30,,,-184469000,,-159125000,55838000,20850000,-34988000,-34988000,,-41734000,,,,-25344000,20850000,55838000,0,-149481000,,-159125000,-159125000,49801,KYN
2020-09-30,,,25701000,,20009000,301592000,331142000,28361000,28361000,,-2048000,,,,5692000,1036842000,1008481000,705700000,-2660000,,20009000,20009000,49804,NGVC
2019-09-30,,,11814000,,9416000,220549000,238753000,17146000,17146000,,-4952000,,,,2398000,903582000,886436000,664829000,-5332000,,9416000,9416000,49804,NGVC
2018-09-30,,,10493000,,12661000,208262000,225573000,15638000,15638000,,-4560000,,,,-2168000,849042000,833404000,623469000,-5145000,,12661000,12661000,49804,NGVC
2017-09-30,,,10305000,,6891000,195839000,212336000,14098000,14098000,,-3793000,,,,3414000,769030000,754932000,556694000,-3793000,,6891000,6891000,49804,NGVC
2019-12-31,8989000,,1089000,,926000,15955000,25324000,380000,380000,,-5000,,,,163000,55739000,55359000,30415000,709000,,926000,926000,49805,AIRG
2018-12-31,9319000,,-2483000,,-2584000,18578000,26511000,-1386000,-1386000,,-31000,,,,101000,60625000,62011000,34114000,-1097000,,-2584000,-2584000,49805,AIRG
2017-12-31,7319000,,1167000,,1141000,15014000,23302000,969000,969000,,-99000,,,,26000,49521000,48552000,26219000,198000,,1141000,1141000,49805,AIRG
2016-12-31,5622132,,2204867,,2196686,10202776,19277075,3452167,3452167,,-1715392,,,,8181,43433867,39981700,24156792,-1247300,,2196686,2196686,49805,AIRG
2019-12-31,,,-8418000,,-8418000,5801000,576000,-8289000,-8289000,577000,-668000,,,,0,32255000,40544000,31679000,-129000,,-8418000,-8418000,49806,URG
2018-12-31,,,4534000,,4534000,5393000,9639000,1307000,1307000,508000,-1002000,,,,0,23496000,22189000,13857000,3227000,,4534000,4534000,49806,URG
2017-12-31,,,76000,,76000,5090000,9627000,1387000,1387000,527000,-1377000,,,,0,38368000,36981000,28741000,-1311000,,76000,76000,49806,URG
2016-12-31,,,-3027000,,-3010000,4740000,8571000,271000,271000,534000,-1977000,,,,-17000,27305000,27034000,18734000,-3298000,,-3010000,-3010000,49806,URG
2019-12-31,701054,,-7783271,,-7783271,13498784,6382041,-7817797,-7817797,,-75883,,,,0,10765153,18582950,4383112,34526,,-7783271,-7835771,49807,AEYE
2018-12-31,194429,,-5019874,,-5019874,7413003,3033612,-4573820,-4573820,,-178002,,,,0,5660427,10234247,2626815,-446054,,-5019874,-5073614,49807,AEYE
2017-12-31,181303,,-5607839,,-5607839,5692637,1355294,-4518646,-4518646,,-917992,,,,0,2739439,7258085,1384145,-1089193,,-5607839,-5683045,49807,AEYE
2016-12-31,343712,,-9578630,,-9578630,3282199,-232056,-4428214,-4428214,,-675997,,,,0,994265,5422479,1226321,-5150416,,-9578630,-9658630,49807,AEYE
2019-12-31,60376000,,-70981000,,-71244000,66205000,41230000,-66226000,-66226000,-19125000,-6065000,,,,263000,74649000,140875000,33419000,-4755000,,-71244000,-71244000,49809,CERS
2018-12-31,42564000,,-57335000,,-57564000,56841000,29274000,-54988000,-54988000,-15143000,-4008000,,,,229000,60908000,115896000,31634000,-2347000,,-57564000,-57564000,49809,CERS
2017-12-31,33710000,,-56698000,,-60585000,52615000,21037000,-57530000,-57530000,-7758000,-3022000,,,,3887000,43568000,101098000,22531000,832000,,-60585000,-60585000,49809,CERS
2016-12-31,31322000,,-62731000,,-62906000,48955000,16888000,-61297000,-61297000,-2092000,-2445000,,,,175000,37183000,98480000,20295000,-1434000,,-62906000,-62906000,49809,CERS
2019-12-31,5917000,,-1786000,,-414000,17851000,22289000,-1479000,-1479000,,-305000,,,,-1372000,48921000,50400000,26632000,-307000,,-414000,-414000,49810,WTT
2018-12-31,4909000,,83000,,35000,17901000,24167000,1357000,1357000,,-575000,,,,48000,52788000,51431000,28621000,-1274000,,35000,35000,49810,WTT
2017-12-31,4395000,,-3246000,,-4493000,16687000,19261000,-1821000,-1821000,,-296000,,,,1247000,46078000,47899000,26817000,-1425000,,-4493000,-4493000,49810,WTT
2016-12-31,4046000,,-2184000,,-1832000,11664000,13162000,-2548000,-2548000,,-296000,,,,-352000,31327000,33875000,18165000,364000,,-1832000,-1832000,49810,WTT
2019-12-31,,,-32282000,12722000,-32653000,9711000,1248000,-24563000,-24563000,210000,-1790000,,,,1958000,58410000,82973000,57162000,-7719000,,-34240000,-32653000,49813,USAS
2018-12-31,,,-10010000,12722000,-10678000,6720000,15168000,-6027000,-6027000,1208000,-1409000,,,,668000,68354000,74381000,53186000,-3983000,,-10678000,-10678000,49813,USAS
2017-12-31,,,-3893000,12722000,-3466000,6651000,13541000,-2730000,-2730000,185000,-723000,,,,-427000,54280000,57010000,40739000,-1163000,,-3466000,-3466000,49813,USAS
2016-12-31,,,-4997000,12722000,-5207000,5355000,11728000,-2848000,-2848000,152000,-2337000,,,,210000,58866000,61714000,47138000,-2149000,,-5207000,-5207000,49813,USAS
2019-12-31,9401000,,24272000,,20950000,141887000,171861000,20573000,20573000,,,,,,3322000,361943000,341370000,190082000,3699000,,20950000,20950000,49814,INGN
2018-12-31,7029000,,40455000,,51845000,133659000,178580000,37892000,37892000,,,,,,-11390000,358111000,320219000,179531000,2563000,,51845000,51845000,49814,INGN
2017-12-31,5313000,,29656000,,21002000,88334000,121237000,27590000,27590000,,,,,,8654000,249438000,221848000,128201000,2066000,,21002000,21002000,49814,INGN
2016-12-31,5113000,,22725000,,20519000,69333000,97310000,22864000,22864000,,-6000.0,,,,2206000,202829000,179965000,105519000,1987000,,20519000,20519000,49814,INGN
2020-12-31,,,193953000,,166830000,86745000,353149000,266404000,266404000,,-29463000,,,,27123000,1040930000,774526000,687781000,-72451000,,166830000,166830000,49815,PCH
2019-12-31,,,56671000,,55661000,61664000,145032000,83368000,83368000,,-30361000,,,,1010000,827098000,743730000,682066000,-26697000,,55661000,55661000,49815,PCH
2018-12-31,,,142079000,,122880000,67509000,268783000,201274000,201274000,,-35227000,,,,19199000,974579000,773305000,705796000,-59195000,,122880000,122880000,49815,PCH
2017-12-31,,,118474000,,86453000,56380000,209202000,148932000,148932000,3890000.0,-27049000,,,,32021000,678595000,529663000,469393000,-30458000,,86453000,86453000,49815,PCH
2019-12-31,,,1016000000,142000000,828000000,-90000000,2743000000,1357000000,1357000000,481000000,-381000000,,,,182000000,5646000000,4289000000,2903000000,-341000000,,834000000,828000000,49822,AEE
2018-12-31,,,1058000000,142000000,815000000,-70000000,2795000000,1427000000,1427000000,483000000,-401000000,,,,237000000,6009000000,4582000000,3214000000,-369000000,,821000000,815000000,49822,AEE
2017-12-31,,,1105000000,142000000,523000000,-44000000,2783000000,1454000000,1454000000,477000000,-391000000,,,,576000000,5909000000,4455000000,3126000000,-349000000,,529000000,523000000,49822,AEE
2016-12-31,,,1041000000,142000000,653000000,-56000000,2634000000,1378000000,1378000000,467000000,-382000000,,,,382000000,5817000000,4439000000,3183000000,-337000000,,659000000,653000000,49822,AEE
2019-12-31,23402000,,12256000,,10913000,31666000,66607000,10964000,10964000,,,,,,1343000,86942000,75978000,20335000,1292000,,10913000,10913000,49823,ERII
2018-12-31,17012000,,11440000,,22093000,28122000,56642000,10878000,10878000,,-1000.0,,,,-10653000,74515000,63637000,17873000,562000,,22093000,22093000,49823,ERII
2017-12-31,13443000,,9929000,,18354000,26745000,50068000,9249000,9249000,,-2000.0,,,,-8425000,69129000,59880000,19061000,680000,,18354000,18354000,49823,ERII
2016-12-31,10136000,,3713000,,3719000,25742000,39935000,3426000,3426000,,-3000.0,,,,-6000,57784000,54358000,17849000,287000,,3719000,3719000,49823,ERII
2019-12-31,14540000,,-18155000,,-18645000,6187000,-4678000,-10865000,-10865000,,-2388000,,,,490000,9862000,20727000,14540000,-7290000,,-18645000,-18645000,49824,VXRT
2018-12-31,14540000,,-17898000,,-18007000,6681000,-13116000,-19797000,-19797000,,-2680000,,,,109000,4159000,23956000,17275000,1899000,,-18007000,-18346000,49824,VXRT
2017-12-31,14540000,,-9582000,,-9582000,2599000,-6516000,-9115000,-9115000,,-3036000,,,,0,5839000,14954000,12355000,-467000,,-9582000,-12460000,49824,VXRT
2016-12-31,14540000,,-16362000,,-16362000,3234000,-9487000,-12721000,-12721000,,-3943000,,,,0,8147000,20868000,17634000,-3641000,,-16362000,-19248000,49824,VXRT
2019-12-31,,,-9386000,,-9386000,3940000,0,-8085000,-8085000,,,,,,0,0,8085000,0,-1301000,,-9386000,-9386000,49825,VGZ
2018-12-31,,,-8714000,,-8714000,4072000,0,-9858000,-9858000,,,,,,0,0,9858000,0,1144000,,-8714000,-8714000,49825,VGZ
2017-12-31,,,-12035000,,-12035000,3527000,0,-11113000,-11113000,,,,,,0,0,11113000,0,-922000,,-12035000,-12035000,49825,VGZ
2016-12-31,,,-3133000,,-3133000,2944000,0,-7865000,-7865000,,,,,,0,0,7865000,0,4732000,,-3133000,-3133000,49825,VGZ
2020-12-31,5956000000,,3916000000,16000000,3196000000,11531000000,21371000000,4663000000,4663000000,-779000000,-1306000000,,,,772000000,26617000000,21954000000,5246000000,-747000000,,3144000000,3196000000,49826,AZN
2019-12-31,5349000000,,1548000000,1469000000,1335000000,11380000000,19536000000,3126000000,3126000000,-319000000,-780000000,,,,321000000,24384000000,21258000000,4848000000,-1578000000,,1227000000,1335000000,49826,AZN
2018-12-31,5299000000,,1993000000,1576000000,2155000000,10790000000,17586000000,1763000000,1763000000,-266000000,-744000000,,,,-57000000,22090000000,20327000000,4504000000,230000000,,2050000000,2155000000,49826,AZN
2017-12-31,5455000000,,2227000000,1682000000,3001000000,9406000000,18328000000,3686000000,3686000000,-219000000,-664000000,,,,-641000000,22465000000,18779000000,4137000000,-1459000000,,2868000000,3001000000,49826,AZN
2019-12-31,,,450889000,646000,325140000,891900000,1355868000,463968000,463968000,,-13821000,,,,125749000,9174611000,8710643000,7818743000,-13079000,,325140000,325140000,49827,EME
2018-12-31,,,395028000,896000,283531000,796414000,1205453000,409039000,409039000,,-13544000,,,,109106000,8130631000,7721592000,6925178000,-14011000,-2345000.0,285922000,283531000,49827,EME
2017-12-31,,,318749000,850000,227196000,757062000,1147012000,389950000,389950000,,-12770000,,,,90699000,7686999000,7297049000,6539987000,-71201000,-857000.0,228050000,227196000,49827,EME
2016-12-31,,,296494000,853000,181935000,721738000,1037862000,316124000,316124000,,-12627000,,,,111199000,7551524000,7235400000,6513662000,-19630000,-3142000.0,185295000,181935000,49827,EME
2017-12-31,,,161844000,76544000,129280000,15210000,355130000,239110000,239110000,,-72488000,,,,16996000,433102000,193992000,77972000,-77266000,,144848000,127200000,49828,GMLPP
2016-12-31,,,202600000,67976000,172171000,8600000,375738000,266670000,266670000,,-69337000,,,,16858000,441598000,174928000,65860000,-64070000,,185742000,172171000,49828,GMLPP
2015-12-31,,,178352000,66765000,162136000,6643000,361719000,255820000,255820000,,-77056000,,,,5669000,434687000,178867000,72968000,-77468000,,172683000,162136000,49828,GMLPP
2014-12-31,,,179688000,67618000,174154000,5757000,330787000,244456000,244456000,,-65598000,,,,-5047000,396026000,151570000,65239000,-64768000,,184735000,174154000,49828,GMLPP
2019-12-31,102426000,,-260415000,,-241965000,191821000,98721000,-195526000,-195526000,,-12412000,,,,-18450000,216824000,412350000,118103000,-64889000,,-241965000,-241965000,49831,NVTA
2018-12-31,63496000,,-132155000,,-129355000,123330000,67594000,-119232000,-119232000,,-7030000,,,,-2800000,147699000,266931000,80105000,-15491000,,-129355000,-129355000,49831,NVTA
2017-12-31,46469000,,-125236000,,-123380000,91089000,18079000,-119479000,-119479000,,-3654000,,,,-1856000,68221000,187700000,50142000,-5757000,,-123380000,-123380000,49831,NVTA
2016-12-31,44630000,,-100256000,,-100256000,51723000,-2830000,-99183000,-99183000,,-421000,,,,0,25048000,124231000,27878000,-1073000,,-100256000,-100256000,49831,NVTA
2019-12-31,,,169519000,,57757000,84279000,470419000,206115000,206115000,30051000,-29610000,,,,111762000,628907000,422792000,158488000,-36596000,,57757000,57757000,49834,GPRK
2018-12-31,,,208907000,,72415000,64029000,436218000,253114000,253114000,-8396000,-30303000,,,,106240000,601161000,348047000,164943000,-44207000,,102667000,72415000,49834,GPRK
2017-12-31,,,25308000,41915000.0,-24228000,48736000,236953000,76217000,76217000,23587000,-29436000,,,,43145000,330122000,253905000,93169000,-50909000,,-17837000,-24228000,49834,GPRK
2016-12-31,,,-48842000,35828000.0,-49092000,41597000,129303000,-31306000,-31306000,7254000,-30316000,,,,11804000,192670000,223976000,63367000,-17536000,,-60646000,-49092000,49834,GPRK
2020-09-30,,,94100000,,72000000,195400000,337700000,133200000,133200000,9100000,-26600000,,,,22100000,964100000,830900000,626400000,-39100000,,72000000,72000000,49836,MWA
2019-09-30,,,82100000,2200000.0,63800000,183100000,327700000,137700000,137700000,6900000,-23500000,,,,18300000,968000000,830300000,640300000,-55600000,,63800000,63800000,49836,MWA
2018-09-30,,,95700000,1500000.0,105600000,167700000,289900000,111700000,111700000,10500000,-25300000,,,,-9900000,916000000,804300000,626100000,-16000000,,105600000,105600000,49836,MWA
2017-09-30,,,78500000,1100000.0,123300000,156800000,267900000,100700000,100700000,10400000,-24200000,,,,24200000,826000000,725300000,558100000,-32600000,69000000.0,54300000,123300000,49836,MWA
2019-12-31,,,-27197000,,-26820000,,35238000,-12449000,-12449000,47687000,-7589000,,,,-377000,150432000,162881000,115194000,-14748000,,-26820000,-26820000,49837,PFMT
2018-12-31,,,-6468000,,-8010000,,59524000,10391000,10391000,49133000,-4699000,,,,1542000,155668000,145277000,96144000,-16859000,,-8010000,-8010000,49837,PFMT
2017-12-31,,,-14054000,,-12729000,,49858000,-6005000,-6005000,55863000,-6972000,,,,-1325000,132049000,138054000,82191000,-8049000,,-12729000,-12729000,49837,PFMT
2016-12-31,,,-15823000,,-11453000,,62497000,7512000,7512000,54985000,-7897000,,,,-4370000,141360000,133848000,78863000,-23335000,,-11453000,-11453000,49837,PFMT
2020-12-31,1679000000,,-3000000,207000000,52000000,841000000,4256000000,523000000,523000000,-114000000,-345000000,,,,-83000000,8612000000,8089000000,4356000000,-526000000,,80000000,52000000,49839,NXPI
2019-12-31,1627000000,,292000000,214000000,243000000,920000000,4629000000,652000000,652000000,-5000000,-370000000,,,,20000000,8877000000,8225000000,4248000000,-360000000,,272000000,243000000,49839,NXPI
2018-12-31,1700000000,,2434000000,185000000,2208000000,996000000,4851000000,706000000,706000000,40000000,-273000000,,,,176000000,9407000000,8701000000,4556000000,1728000000,,2258000000,2208000000,49839,NXPI
2017-12-31,1566000000,,1789000000,189000000,2215000000,1064000000,4622000000,527000000,527000000,40000000,-310000000,,,,-483000000,9256000000,8729000000,4634000000,1262000000,,2272000000,2215000000,49839,NXPI
2019-12-31,,,-90278000,,-91022000,15685000,40721000,-37579000,-37579000,13156000,-5752000,,,,744000,198653000,236232000,157932000,-52699000,,-91022000,-91022000,49840,GPL
2018-12-31,,,-9411000,,-10063000,6278000,11647000,-10809000,-10809000,683000,-20000,,,,652000,59434000,70243000,47787000,1398000,,-10063000,-10063000,49840,GPL
2017-12-31,,,2756000,,1290000,7746000,21567000,-448000,-448000,791000,-171000,,,,1466000,63746000,64194000,42179000,3204000,,1290000,1290000,49840,GPL
2016-12-31,,,-2609000,,-4118000,5673000,27458000,8380000,8380000,23000,-76000,,,,1509000,61881000,53501000,34423000,-10989000,,-4118000,-4118000,49840,GPL
2019-12-31,21505000,,-23967000,,-23967000,2562000,0,-24067000,-24067000,,,,,,0,0,24067000,0,100000,,-23967000,-23967000,49841,SBTX
2018-12-31,14804000,,-17579000,,-17579000,3516000,0,-18320000,-18320000,,,,,,0,0,18320000,0,741000,,-17579000,-17579000,49841,SBTX
2019-12-31,,,275739000,,233290000,2103995000,2694753000,378979000,378979000,,-102831000,,,,42449000,4245321000,3866342000,1550568000,-103240000,,233290000,233290000,49842,IT
2018-12-31,,,181121000,,122456000,1884846000,2506654000,366207000,366207000,,-126774000,,,,58665000,3975454000,3609247000,1468800000,-185086000,,122456000,122456000,49842,IT
2017-12-31,,,-127817000,,3279000,1599759000,1991296000,151366000,151366000,,-127947000,,,,-131096000,3311494000,3160128000,1320198000,-279183000,,3279000,3279000,49842,IT
2016-12-31,,,288431000,,193582000,1089184000,1498892000,347739000,347739000,,-27565000,,,,94849000,2444540000,2096801000,945648000,-59308000,,193582000,193582000,49842,IT
2019-12-31,32853000,,-51047000,,-51109000,44754000,25768000,-51839000,-51839000,,-944000,,,,62000,42927000,94766000,17159000,792000,,-51109000,-51109000,49847,SWAV
2018-12-31,22698000,,-41064000,,-41102000,23515000,5013000,-41200000,-41200000,,-401000,,,,38000,12263000,53463000,7250000,136000,,-41102000,-41102000,49847,SWAV
2017-12-31,17963000,,-30589000,,-30615000,11785000,-1117000,-30865000,-30865000,,-58000,,,,26000,1719000,32584000,2836000,276000,,-30615000,-30615000,49847,SWAV
2019-12-28,32400000,,-31331000,787000,-52365000,1040097000,1099438000,26466000,26466000,,-29932000,,,,18681000,2217712000,2191246000,1118274000,-57797000,,-50012000,-52365000,49849,FOSL
2018-12-29,38200000,,20170000,3088000,-3478000,1184484000,1340137000,117453000,117453000,,-42503000,,,,21108000,2541488000,2424035000,1201351000,-97283000,,-938000,-3478000,49849,FOSL
2017-12-30,42800000,,-453754000,4814000,-478172000,1283716000,1358839000,32323000,32323000,,-43019000,,,,19805000,2788163000,2755840000,1429324000,-486077000,,-473559000,-478172000,49849,FOSL
2016-12-31,42800000,,114308000,9202000,78868000,1422462000,1578186000,155724000,155724000,,-26894000,,,,28705000,3042371000,2886647000,1464185000,-41416000,,85603000,78868000,49849,FOSL
2019-12-31,,,1751000,,1647000,43446000,79120000,13186000,13186000,,-2942000,,,,104000,462411000,449225000,383291000,-11435000,,1647000,1647000,49850,NDLS
2019-01-01,,,-8689000,,-8441000,42392000,72398000,7084000,7084000,,-4305000,,,,-248000,457841000,450757000,385443000,-15773000,,-8441000,-8441000,49850,NDLS
2018-01-02,,,-37689000,,-37482000,39746000,68890000,3596000,3596000,,-3839000,,,,-207000,456492000,452896000,387602000,-41285000,,-37482000,-45449000,49850,NDLS
2017-01-03,,,-70444000,,-71677000,49954000,66702000,-14517000,-14517000,,-2916000,,,,1233000,487474000,501991000,420772000,-55927000,,-71677000,-71677000,49850,NDLS
2019-12-31,55040000,,-28208000,,-28208000,17283000,-12917000,-30200000,-30200000,,-234000,,,,0,42123000,72323000,55040000,1992000,,-28208000,-28208000,49856,MRSN
2018-12-31,55040000,,-64257000,,-64257000,16334000,-49321000,-65655000,-65655000,,-234000,,,,0,10594000,76249000,59915000,2796000,,-64257000,-64257000,49856,MRSN
2017-12-31,55040000,,-38707000,,-38707000,10462000,-29155000,-39617000,-39617000,,-234000,,,,0,17545000,57162000,46700000,910000,,-38707000,-38707000,49856,MRSN
2016-12-31,55040000,,-13700000,,-13700000,6984000,-6837000,-13821000,-13821000,,-234000,,,,0,25171000,38992000,32008000,121000,,-13700000,-13700000,49856,MRSN
2019-12-31,108957,,-925462,,-925462,704199,-11569,-891931,-891931,67206,-6557,,,,0,6455,898386,18024,-33531,,-925462,-925462,49859,JUPW
2018-12-31,99000,,-358404,,-358404,259404,0,-358404,-358404,67206,-6557,,,,0,0,358404,0,0,,-358404,-358404,49859,JUPW
2019-12-31,,,121081000,,99897000,786291000,1106758000,0,119793000,200674000,,,,,21184000,1106758000,986965000,0,1288000,,99897000,99897000,49861,GDOT
2018-12-31,,,123817000,,118703000,736280000,1058977000,0,141537000,181160000,,,,,5114000,1058977000,917440000,0,-17720000,,118703000,118703000,49861,GDOT
2017-12-31,,,103458000,,85887000,639162000,895285000,0,95112000,161011000,,,,,17571000,895285000,800173000,0,8346000,,85887000,85887000,49861,GDOT
2016-12-31,,,61561000,,41600000,550260000,717019000,0,59203000,107556000,,,,,19961000,717019000,657816000,0,2358000,,41600000,40798000,49861,GDOT
2019-12-31,71276000,,169905000,,138304000,59613000,311194000,158343000,158343000,,,,,,31601000,405177000,246834000,93983000,11562000,,138304000,137198000,49864,OLED
2018-12-31,53717000,,64311000,,58840000,46999000,179413000,56735000,56735000,,,,,,5471000,247414000,190679000,68001000,7576000,,58840000,58150000,49864,OLED
2017-12-31,49144000,,149537000,,103885000,46808000,264182000,146247000,146247000,,,,,,45652000,335629000,189382000,71447000,3290000,,103885000,102247000,49864,OLED
2016-12-31,42744000,,68598000,,48070000,32516000,160526000,68773000,68773000,,,,,,20528000,198886000,130113000,38360000,-175000,,48070000,47336000,49864,OLED
2020-03-31,,,65615000,,52335000,76971000,141888000,64870000,64870000,47000,-11859000,,,,14427000,1335769000,1270899000,1193881000,745000,1147000,51188000,52078000,49865,SENEA
2019-03-31,,,-49259000,,5747000,72549000,39496000,-33022000,-33022000,-31000,-15165000,,,,-12776000,1199581000,1232603000,1160085000,-16237000,42230000,-36483000,5678000,49865,SENEA
2018-03-31,,,8734000,,-8480000,70185000,81503000,11348000,11348000,-30000,-12827000,,,,-1315000,1162894000,1151546000,1081391000,-2614000,-18529000,10049000,-8486000,49865,SENEA
2017-03-31,,,25648000,,15895000,72996000,112004000,39000000,39000000,8000,-9690000,,,,9753000,1262198000,1223198000,1150194000,-13352000,-18529000,15895000,15726000,49865,SENEA
2020-12-31,,,-1838000000,29115000000,-1098000000,816000000,3280000000,2145000000,2145000000,,-2592000000,,,,220000000,5844000000,3699000000,2564000000,-3983000000,,-2058000000,-1098000000,49867,BPYPP
2019-12-31,,,3353000000,31241000000,884000000,953000000,7057000000,5763000000,5763000000,,-2924000000,,,,196000000,10172000000,4409000000,3115000000,-2410000000,,3157000000,949000000,49867,BPYPP
2018-12-31,,,3735000000,34387000000,764000000,746000000,5174000000,4120000000,4120000000,,-2464000000,,,,81000000,8186000000,4066000000,3012000000,-385000000,,3654000000,862000000,49867,BPYPP
2017-12-31,,,2660000000,27729000000,136000000,669000000,4455000000,3511000000,3511000000,,-1967000000,,,,192000000,7096000000,3585000000,2641000000,-851000000,,2468000000,158000000,49867,BPYPP
2019-12-31,22302000,,-32141000,,-32141000,11555000,-12801000,-24356000,-24356000,,-4846000,,,,0,10004000,34360000,22805000,-7785000,,-32141000,-32141000,49868,CRIS
2018-12-31,22302000,,-32575000,,-32575000,14785000,-14548000,-29333000,-29333000,,-3926000,,,,0,10428000,39761000,24976000,-3242000,,-32575000,-32575000,49868,CRIS
2017-12-31,22302000,,-53317000,,-53317000,14066000,-35694000,-49760000,-49760000,,-3966000,,,,0,9898000,59658000,45592000,-3557000,,-53317000,-53317000,49868,CRIS
2016-12-31,22302000,,-60411000,,-60411000,15588000,-24462000,-40050000,-40050000,,-2777000,,,,0,7527000,47577000,31989000,-20361000,,-60411000,-60411000,49868,CRIS
2019-12-31,,,-98895000,,-98895000,9601000,-23657000,-33878000,-33878000,-1458000,-64844000,,,,0,13709000,47587000,37366000,-65017000,,-98895000,-98895000,49869,HYMC
2018-12-31,,,-55658000,,-55803000,14303000,-5060000,-8151000,-8151000,-15716000,-50893000,,,,145000,0,8151000,5060000,-47507000,,-55803000,-55803000,49869,HYMC
2017-12-31,,,-74293000,,-74148000,15225000,-4425000,-25201000,-25201000,1164000,-41161000,,,,-145000,0,25201000,4425000,-49092000,,-74148000,-74148000,49869,HYMC
2014-12-31,,,-514099000,,-518925000,20658000,28482000,-56859000,-56859000,1091000,-39839000,,,,4826000,310425000,367284000,281943000,-457240000,,-518925000,-518925000,49869,HYMC
2020-02-29,,,14790859,,14790859,13670484,71887012,58216528,58216528,,-12466929,,,,0,71887012,13670484,0,-43425669,,14790859,14790859,49873,VVR
2019-02-28,,,25525587,,25525587,14086773,69151775,55065002,55065002,,-12770393,,,,0,69151775,14086773,0,-29539415,,25525587,25525587,49873,VVR
2018-02-28,,,41513994,,41513994,14061521,64245551,50075694,50075694,108336.0,-9022835,,,,0,64245551,14169857,0,-8561700,,41513994,41513994,49873,VVR
2017-02-28,,,167182469,,167182469,13377534,72244899,58867365,58867365,108336.0,-6736481,,,,0,72244899,13377534,0,108315104,,167182469,167182469,49873,VVR
2020-12-31,,,660400000,,468200000,364200000,1254300000,707400000,707400000,24200000,-37600000,,,,192200000,3427100000,2719700000,2172800000,-47000000,,468200000,467000000,49874,CBOE
2019-12-31,,,501400000,,374900000,325700000,1136900000,619800000,619800000,14800000,-37800000,,,,130600000,2496100000,1876300000,1359200000,-118400000,,370800000,372700000,49874,CBOE
2018-12-31,,,571200000,9400000.0,426500000,369500000,1216900000,629400000,629400000,14000000,-40500000,,,,146000000,2768800000,2139400000,1551900000,-58200000,,425200000,422100000,49874,CBOE
2017-12-31,,,334400000,9400000.0,401700000,337000000,995600000,456300000,456300000,10100000,-42600000,,,,-66200000,2229100000,1772800000,1233500000,-121900000,,400600000,396700000,49874,CBOE
2020-12-31,,,134981000,,107898000,399676000,621687000,0,149639000,72372000,,,,,27083000,621687000,472048000,0,-14658000,,107898000,97810000,49875,FMBIO
2019-12-31,,,265939000,,199738000,368113000,706455000,0,310226000,28116000,,,,,66201000,706455000,396229000,0,-44287000,,199738000,198057000,49875,FMBIO
2018-12-31,,,197057000,,157870000,338851000,608133000,0,246273000,23009000,,,,,39187000,608133000,361860000,0,-49216000,,157870000,156558000,49875,FMBIO
2017-12-31,,,187954000,,98387000,334595000,603863000,0,229612000,39656000,,,,,89567000,603863000,374251000,0,-41658000,,98387000,97471000,49875,FMBIO
2020-01-31,49445000,,-120447000,,-121544000,291707000,221799000,-119353000,-119353000,,-308000,,,,1097000,298829000,418182000,77030000,-1094000,,-121544000,-121544000,49876,YEXT
2019-01-31,36098000,,-74615000,,-74837000,210417000,170870000,-75645000,-75645000,,-143000,,,,222000,228283000,303928000,57413000,1030000,,-74837000,-74837000,49876,YEXT
2018-01-31,25687000,,-66403000,,-66565000,167059000,126106000,-66640000,-66640000,,-359000,,,,162000,170201000,236841000,44095000,237000,,-66565000,-66565000,49876,YEXT
2017-01-31,19316000,,-43082000,,-43150000,110695000,87311000,-42700000,-42700000,,-150000,,,,68000,124261000,166961000,36950000,-382000,,-43150000,-43150000,49876,YEXT
2015-08-31,,,-4235757,,-3752553,4221234,1140399,-3469638,-3469638,,-882969,,,,127500,2738019,6207657,1597620,-766119,610704,-4363257,-3752553,49879,GYRO
2014-12-31,,,-4278721,15805548.0,-3105366,4331377,1202890,-3580429,-3580429,,-749004,,,,-565000,2798528,6378957,1595638,-698292,608355,-3713721,-3105366,49879,GYRO
2013-12-31,,,-15498237,19058467.0,46063206,15139157,2515439,-13629443,-13629443,52000.0,-5748,,,,-61553442,5029969,18659412,2514530,-1868794,608355,46055205,46063206,49879,GYRO
2012-12-31,,,160697253,19058467.0,99048253,7537953,2681072,-5793976,-5793976,37000.0,-965506,,,,61649000,4989108,10783084,2308036,166491229,608355,99048253,99048253,49879,GYRO
2019-12-31,,,-2352000,,-2352000,412000,-96000,-508000,-508000,,-15000,,,,0,590000,1098000,686000,-1844000,,-2352000,-2352000,49883,GBR
2018-12-31,,,-484000,,-484000,353000,-162000,-515000,-515000,,-18000,,,,0,682000,1197000,844000,31000,,-484000,-484000,49883,GBR
2017-12-31,,,-3241000,,-3246000,408000,-236000,-644000,-644000,,-24000,,,,0,791000,1435000,1027000,-2597000,-5000.0,-3241000,-3246000,49883,GBR
2016-12-31,,,44000,,48000,352000,-417000,-769000,-769000,,-38000,,,,0,764000,1533000,1181000,813000,4000.0,44000,48000,49883,GBR
2019-12-31,,,-6927661,-8572,-6933950,78957,-3390482,0,-3469439,,,,,,14861,2492504,5961943,5882986,-3458222,,-6942522,-6933950,49884,GLG
2018-12-31,,,-2424496,-8572,7647157,65297,-2008014,0,-2073311,,,,,,-104024,467905,2541216,2475919,-351185,9967629.0,-2320472,7647157,49884,GLG
2017-12-31,,,-4461591,-8572,-10699740,821546,0,0,-4230591,3409045.0,,,,,0,0,4230591,0,-231000,-6238149.0,-4461591,-10699740,49884,GLG
2016-12-31,,,-2580136,-8572,-2580136,1359770,1962991,0,-1252121,1855342.0,,,,,0,1962991,3215112,0,-1328015,-6238149.0,-2580136,-2580136,49884,GLG
2020-12-31,,,682253000,154674000,584520000,2534178000,3798331000,1264153000,1264153000,,-343548000,,,,77153000,7423558000,6159405000,3625227000,-581900000,,605100000,584520000,49885,GPN
2019-12-31,,,531466000,199242000,430613000,1847772000,2894789000,1047017000,1047017000,,-301200000,,,,62190000,4911892000,3864875000,2017103000,-515551000,,469276000,430613000,49885,GPN
2018-12-31,,,562155000,194936000,452053000,1478197000,2271352000,793155000,793155000,,-195500000,,,,77488000,3366366000,2573211000,1095014000,-231000000,,484667000,452053000,49885,GPN
2017-12-31,,,392683000,170704000,468425000,1488258000,2047126000,558868000,558868000,,-174300000,,,,-101387000,3975163000,3416295000,1928037000,-166185000,,494070000,468425000,49885,GPN
2020-12-31,,,229950000,445348000,177634000,232187000,487792000,255605000,255605000,,-21100000,,,,75272000,897020000,641415000,409228000,-25655000,,154678000,170682000,49886,SCU
2019-12-31,,,13727000,590779000,7054000,130861000,178997000,48136000,48136000,,-24900000,,,,34112000,597346000,549210000,418349000,-34409000,,-20385000,51418000,49886,SCU
2018-12-31,,,-36402000,997091000,-24284000,150227000,194461000,44234000,44234000,,-24179000,,,,12500000,507184000,462950000,312723000,-80636000,,-48902000,-24284000,49886,SCU
2017-12-31,,,471931000,803519000,21075000,152071000,420691000,268620000,268620000,,-23191000,,,,317559000,857240000,588620000,436549000,203311000,,154372000,18222000,49886,SCU
2019-12-31,,,1524000,,1361000,38416000,46882000,4064000,4064000,,-1904000,,,,163000,81115000,77051000,34233000,-2540000,,1361000,1361000,49889,INFU
2018-12-31,,,-1042000,,-1095000,33736000,39570000,1185000,1185000,,-1420000,,,,53000,67138000,65953000,27568000,-2227000,,-1095000,-1095000,49889,INFU
2017-12-31,,,-5257000,,-20707000,33788000,47095000,-1602000,-1602000,,-1332000,,,,15450000,65462000,67064000,18367000,-3655000,,-20707000,-20707000,49889,INFU
2016-12-31,,,-364000,,-222000,33435000,48660000,1825000,1825000,,-1344000,,,,-142000,64866000,63041000,16206000,-2189000,,-222000,-222000,49889,INFU
2019-12-31,12122000,,-16808000,,-16808000,10210000,0,-22332000,-22332000,,-1469000,,,,0,0,22332000,0,5524000,,-16808000,-16808000,49891,APOP
2018-12-31,13513000,,-20113000,,-20113000,15734000,0,-29247000,-29247000,,-20000,,,,0,0,29247000,0,9134000,,-20113000,-20113000,49891,APOP
2017-12-31,11503000,,-28224000,,-28224000,12930000,0,-24433000,-24433000,,-889000,,,,0,0,24433000,0,-3791000,,-28224000,-28224000,49891,APOP
2016-12-31,8256000,,-15317000,,-15317000,7968000,0,-15944000,-15944000,-280000.0,-33000,,,,0,0,15944000,0,627000,,-15317000,-15317000,49891,APOP
2019-12-31,,,-60910000,,-60788000,16051000,58689000,-2729000,-2729000,,-14415000,,,,-122000,203602000,206331000,144913000,-58181000,,-60788000,-60788000,49893,ICD
2018-12-31,,,-19902000,,-19993000,15907000,47389000,591000,591000,,-7562000,,,,91000,142609000,142018000,95220000,-20493000,,-19993000,-19993000,49893,ICD
2017-12-31,,,-24011000,,-24298000,13213000,22274000,-16783000,-16783000,,-2983000,,,,287000,90007000,106790000,67733000,-7228000,,-24298000,-24298000,49893,ICD
2016-12-31,,,-21976000,,-22178000,14644000,26785000,-11667000,-11667000,,-3045000,,,,202000,70062000,81729000,43277000,-10309000,,-22178000,-22178000,49893,ICD
2020-10-31,,,55403000,835000,50928000,241814000,381025000,138115000,138115000,1096000,-103801000,,,,4475000,2343901000,2205786000,1962876000,-82712000,,50928000,46276000,49896,HOV
2019-10-31,,,-39668000,687000,-42117000,233148000,304889000,70180000,70180000,1561000,-90056000,,,,2449000,2016916000,1946736000,1712027000,-109848000,,-42117000,-42117000,49896,HOV
2018-10-31,,,8146000,687000,4520000,228834000,328865000,98447000,98447000,1584000,-103297000,,,,3626000,1991233000,1892786000,1662368000,-90301000,,4520000,4361000,49896,HOV
2017-10-31,,,-45244000,687000,-332193000,243187000,294579000,49874000,49874000,1518000,-97304000,,,,286949000,2451665000,2401791000,2157086000,-95118000,,-332193000,-332193000,49896,HOV
2019-12-31,,,36217000,,35966000,19346000,61092000,0,39487000,,,,,,0,61092000,21605000,0,-3270000,-251000,36217000,25616000,49898,XAN
2018-12-31,,,26963000,,27427000,21916000,56878000,0,32168000,,,,,,-343000,56878000,24710000,0,-5205000,121000,27306000,6973000,49898,XAN
2017-12-31,,,54070000,,33537000,28963000,41937000,0,10097000,,,,,,6613000,41937000,31840000,0,43973000,-14116000,47457000,5677000,49898,XAN
2016-12-31,,,-342000,-1209000.0,-30365000,27625000,44915000,0,13390000,,,,,,10992000,44915000,31525000,0,-13732000,-19260000,-11334000,-52956000,49898,XAN
2020-12-31,,,27153000,,22540000,47351000,79812000,0,27782000,4679000,,,,,4613000,79812000,52030000,0,-629000,,22540000,22540000,49899,ACBI
2019-12-31,,,35769000,,49855000,47617000,88877000,0,35986000,5274000,,,,,7611000,88877000,52891000,0,-217000,21697000.0,28158000,49855000,49899,ACBI
2018-12-31,,,34357000,,28532000,44618000,84348000,0,34919000,4811000,,,,,6307000,84348000,49429000,0,-562000,482000.0,28050000,28532000,49899,ACBI
2017-12-31,,,18959000,,-3726000,46245000,71793000,0,19960000,5588000,,,,,23715000,71793000,51833000,0,-1001000,1030000.0,-4756000,-3726000,49899,ACBI
2020-12-31,,,1413000000,415000000,1145000000,1302000000,2785000000,1483000000,1483000000,,-265000000,,,,248000000,41404000000,39921000000,38619000000,-70000000,,1165000000,1121000000,49900,BG
2019-12-31,,,-1205000000,514000000,-1280000000,1271000000,2250000000,938000000,938000000,41000000.0,-339000000,,,,86000000,41140000000,40202000000,38890000000,-2143000000,,-1291000000,-1322000000,49900,BG
2018-12-31,,,456000000,629000000,267000000,1332000000,2282000000,939000000,939000000,11000000.0,-339000000,,,,179000000,45743000000,44804000000,43461000000,-483000000,10000000.0,277000000,233000000,49900,BG
2017-12-31,,,230000000,209000000,160000000,1355000000,1800000000,452000000,452000000,-7000000.0,-263000000,,,,56000000,45794000000,45342000000,43994000000,-222000000,10000000.0,174000000,126000000,49900,BG
2020-12-27,259522000,,322062000,24426000,225441000,1664870000,2789518000,720380000,720380000,,-201130000,,,,96621000,5465443000,4745063000,2675925000,-398318000,,225441000,225441000,49905,HAS
2019-12-29,262156000,,594210000,24426000,520454000,1552501000,2412244000,550328000,550328000,,-121478000,,,,73756000,4720227000,4169899000,2307983000,43882000,,520454000,520454000,49905,HAS
2018-12-30,246165000,,270402000,24426000,220434000,1476177000,2336602000,585557000,585557000,,-90826000,,,,49968000,4579646000,3994089000,2243044000,-315155000,,220434000,220434000,49905,HAS
2017-12-31,269020000,,786150000,24426000,396607000,1608606000,2734803000,828359000,828359000,,-98268000,,,,389543000,5209782000,4381423000,2474979000,-42209000,,396607000,396607000,49905,HAS
2020-02-01,41000000,,528000000,,351000000,6923000000,8000000000,1036000000,1036000000,,-76000000,,,,177000000,16383000000,15347000000,8383000000,-508000000,,351000000,351000000,49907,GPS
2019-02-02,50000000,,1322000000,,1003000000,4898000000,6322000000,1374000000,1374000000,,-73000000,,,,319000000,16580000000,15206000000,10258000000,-52000000,,1003000000,1003000000,49907,GPS
2018-02-03,51000000,,1424000000,,848000000,4573000000,6066000000,1442000000,1442000000,,-74000000,,,,576000000,15855000000,14413000000,9789000000,-18000000,,848000000,848000000,49907,GPS
2017-01-28,46000000,,1124000000,,676000000,4147000000,5640000000,1447000000,1447000000,,-75000000,,,,448000000,15516000000,14069000000,9876000000,-323000000,,676000000,676000000,49907,GPS
2019-12-31,,,50808000,12327000,46476000,10108000,243288000,97654000,97654000,,-64199000,,,,4332000,306214000,208560000,62926000,-46846000,,46476000,33875000,49908,GNL
2018-12-31,,,13331000,3258000,10897000,10439000,221691000,89021000,89021000,,-57973000,,,,2434000,282207000,193186000,60516000,-75690000,,10897000,393000,49908,GNL
2017-12-31,,,26726000,1077000,23565000,8648000,205702000,87793000,87793000,,-48450000,,,,3140000,259295000,171502000,53593000,-61067000,,23586000,19989000,49908,GNL
2016-12-31,,,51999000,8203000,47140000,7108000,175385000,70074000,70074000,,-39121000,,,,4422000,214174000,144100000,38789000,-18075000,,47577000,46367000,49908,GNL
2019-12-31,,,-1032000,,-625000,117360000,124206000,4378000,4378000,,-5410000,,,,-407000,486371000,481993000,362165000,-5410000,,-625000,-625000,49909,HALL
2018-12-31,,,12803000,,10347000,103424000,123240000,17348000,17348000,,-4545000,,,,2456000,379268000,361920000,256028000,-4545000,,10347000,10347000,49909,HALL
2017-12-31,,,-16572000,,-11553000,106805000,97213000,-12060000,-12060000,,-4512000,,,,-5019000,385521000,397581000,288308000,-4512000,,-11553000,-11553000,49909,HALL
2016-12-31,,,8478000,,6526000,104969000,122264000,14827000,14827000,,-4549000,,,,1952000,375952000,361125000,253688000,-6349000,,6526000,6526000,49909,HALL
2020-05-31,29099000,,-168135000,,-166787000,117089000,150272000,-14037000,-14037000,,-907000,,,,-1348000,264157000,278194000,113885000,-154098000,,-166787000,-166787000,49910,ANGO
2019-05-31,28258000,,-14702000,,61340000,111731000,156000000,-1045000,-1045000,,-5099000,,,,-3556000,270634000,271679000,114634000,-13657000,72486000.0,-11146000,61340000,49910,ANGO
2018-05-31,24338000,,-17263000,,16335000,104100000,143856000,1512000,1512000,,-3062000,,,,-11036000,261655000,260143000,117799000,-18775000,22562000.0,-6227000,16335000,49910,ANGO
2017-05-31,24148000,,-14295000,,5008000,105998000,145787000,1074000,1074000,,-2839000,,,,-7243000,269788000,268714000,124001000,-15369000,12060000.0,-7052000,5008000,49910,ANGO
2020-10-31,3500000,,-10803000,,-6247000,37616000,36457000,-4659000,-4659000,,-94000,,,,-4556000,170627000,175286000,134170000,-6144000,,-6247000,-6181000,49911,HURC
2019-10-31,4400000,,23324000,,17495000,51768000,77208000,21040000,21040000,,-62000,,,,5829000,263377000,242337000,186169000,2284000,,17495000,17348000,49911,HURC
2018-10-31,4700000,,32496000,,21490000,53310000,91806000,33796000,33796000,,-100000,,,,11006000,300671000,266875000,208865000,-1300000,,21490000,21358000,49911,HURC
2017-10-31,4200000,,20716000,,15115000,45461000,70564000,20903000,20903000,,-91000,,,,5601000,243667000,222764000,173103000,-187000,,15115000,15015000,49911,HURC
2019-12-29,,,-508000,,-1018000,11472000,18394000,6703000,6703000,219000,-8658000,,,,510000,22505000,15802000,4111000,-7211000,,-1018000,-1018000,49912,FATBP
2018-12-30,,,-2073000,,-1798000,10349000,14652000,4236000,4236000,67000,-5895000,,,,-275000,17834000,13598000,3182000,-6309000,,-1798000,-1798000,49912,FATBP
2017-12-31,,,1126000,,241500,2658000,4311000,1630000,1630000,67000,-405000,,,,884500,4311000,2681000,0,-504000,,241500,241500,49912,FATBP
2016-12-25,,,6502000,,4204000,3595000,10061000,6466000,6466000,67000,-405000,,,,2298000,10061000,3595000,0,36000,,4204000,4204000,49912,FATBP
2019-12-31,42829000,,-42711000,,-32600000,101417000,158264000,-18664000,-18664000,,-21900000,,,,-10111000,204027000,222691000,45763000,-24047000,,-32600000,-32600000,49913,JAMF
2018-12-31,31515000,,-48393000,,-36256000,74088000,106228000,-29835000,-29835000,,-18700000,,,,-12137000,146562000,176397000,40334000,-18558000,,-36256000,-36256000,49913,JAMF
2019-12-31,33675000,,-85465000,,-85465000,44333000,27966000,-50042000,-50042000,,-8041000,,,,0,230239000,280281000,202273000,-35423000,,-85465000,-85517000,49914,PLUG
2018-12-31,33907000,,-87332000,,-78115000,38198000,2622000,-69483000,-69483000,,-14457000,,,,-9217000,174632000,244115000,172010000,-17849000,,-78115000,-78167000,49914,PLUG
2017-12-31,28693000,,-127080000,,-127080000,45010000,-28089000,-101792000,-101792000,,-10100000,,,,0,100153000,201945000,128242000,-25288000,,-127080000,-130178000,49914,PLUG
2016-12-31,21177000,,-57879000,,-57487000,34288000,2875000,-51519000,-51519000,-1071000.0,-10704000,,,,-392000,82819000,134338000,79944000,-6360000,,-57487000,-57591000,49914,PLUG
2020-12-31,,,-700052000,,-510935000,46297000,-159495000,-469130000,-469130000,111673000,-37203000,,,,-189117000,844813000,1313943000,1004308000,-230922000,,-510935000,-510935000,49917,HA
2019-12-31,,,304996000,,223984000,130216000,767995000,316904000,316904000,161969000,-23372000,,,,81012000,2832228000,2515324000,2064233000,-11908000,,223984000,223984000,49917,HA
2018-12-31,,,301158000,,233200000,129315000,770253000,354455000,354455000,146617000,-25114000,,,,67958000,2837411000,2482956000,2067158000,-53297000,,233200000,233200000,49917,HA
2017-12-31,,,390821000,,330610000,126750000,855332000,474087000,474087000,141218000,-22464000,,,,60211000,2675145000,2201058000,1819813000,-83266000,,330610000,330610000,49917,HA
2019-12-31,112419000,,-163458000,,-163458000,57182000,0,-169601000,-169601000,,-2590000,,,,0,0,169601000,0,6143000,,-163458000,-163458000,49918,RUBY
2018-12-31,51769000,,-89195000,,-89195000,39894000,0,-91663000,-91663000,,-464000,,,,0,0,91663000,0,2468000,,-89195000,-89195000,49918,RUBY
2017-12-31,21226000,,-43847000,,-43847000,22038000,0,-43264000,-43264000,,-309000,,,,0,0,43264000,0,-583000,,-43847000,-44503000,49918,RUBY
2016-12-31,8403000,,-11016000,,-11016000,2449000,0,-10852000,-10852000,,-149000,,,,0,0,10852000,0,-164000,,-11016000,-11764000,49918,RUBY
2020-12-31,33503000,,15461000,,22579000,279562000,499700000,71710000,71710000,,-56177000,,,,-7118000,667524000,595814000,167824000,-56249000,,22579000,21906000,49919,INOV
2019-12-31,33686000,,5878000,,7775000,263058000,474596000,69602000,69602000,,-65831000,,,,-1897000,642410000,572808000,167814000,-63724000,,7775000,7538000,49919,INOV
2018-12-31,28638000,,-53557000,,-39164000,236860000,382850000,20627000,20627000,,-50898000,,,,-14393000,527676000,507049000,144826000,-74184000,,-39164000,-39164000,49919,INOV
2017-12-31,27383000,,32587000,,34818000,190685000,298312000,27155000,27155000,,-6225000,,,,-2231000,449358000,422203000,151046000,5432000,,34818000,33828000,49919,INOV
2019-12-31,848000,,8796000,,8525000,41381000,56006000,9107000,9107000,113000,-314000,,,,271000,80256000,71149000,24250000,-311000,,8525000,8525000,49921,VMD
2018-12-31,848000,,9670000,,9508000,34304000,47775000,10110000,10110000,71000,-181000,,,,162000,64464000,54354000,16689000,-440000,,9508000,9508000,49921,VMD
2017-12-31,848000,,8191000,,8176000,24561000,34615000,8824000,8824000,71000,-272000,,,,15000,46928000,38104000,12313000,-633000,,8176000,8176000,49921,VMD
2016-12-31,848000,,109000,,1228000,18144000,18859000,383000,383000,71000,-323000,,,,-1119000,31356000,30973000,12497000,-274000,,1228000,1228000,49921,VMD
2020-12-31,,,128206000,,100344000,175123000,362403000,0,141789000,45491000,,,,,27862000,362403000,220614000,0,-13583000,,100344000,100344000,49922,BUSE
2019-12-31,,,134438000,,102953000,193842000,393232000,0,164079000,35311000,,,,,31485000,393232000,229153000,0,-29641000,,102953000,102953000,49922,BUSE
2018-12-31,,,133927000,,98928000,148955000,326970000,0,144964000,33051000,,,,,34999000,326970000,182006000,0,-11037000,,98928000,98928000,49922,BUSE
2017-12-31,,,108111000,,62726000,135915000,282537000,0,121206000,25416000,,,,,45385000,282537000,161331000,0,-13095000,,62726000,62726000,49922,BUSE
2020-06-27,,,293384000,34265000,215475000,8238103000,9901664000,1625276000,1625276000,,-408220000,,,,77909000,52893310000,51268034000,42991646000,-1331892000,,215475000,215475000,49924,SYY
2019-06-29,,,2005836000,35426000,1674271000,8779693000,11408987000,2629294000,2629294000,,-360423000,,,,331565000,60113922000,57484628000,48704935000,-623458000,,1674271000,1674271000,49924,SYY
2018-06-30,,,1956224000,37649000,1430766000,8735275000,11085391000,2350116000,2350116000,,-395483000,,,,525458000,58727324000,56377208000,47641933000,-393892000,,1430766000,1430766000,49924,SYY
2017-07-01,,,1766230000,82839000,1142503000,8504291000,10557507000,2053216000,2053216000,,-302878000,,,,623727000,55371139000,53317923000,44813632000,-286986000,,1142503000,1142503000,49924,SYY
2019-12-31,1968518,,-4224874,,-4224874,2355243,0,-4323761,-4323761,,,,,,0,0,4323761,0,98887,,-4224874,-4224874,49925,MNPR
2018-12-31,1774454,,-3227932,,-3227932,1556693,0,-3331147,-3331147,,,,,,-71615,0,3331147,0,103215,,-3227932,-3227932,49925,MNPR
2017-12-31,935319,,-16554872,,-16554872,1166186,0,-2101505,-2101505,,,,,,0,0,2101505,0,-14453367,,-16554872,-16554872,49925,MNPR
2016-12-31,280355,,-1185597,,-1185597,912474,0,-1192829,-1192829,,,,,,0,0,1192829,0,7232,,-1185597,-1185597,49925,MNPR
2019-12-31,,,-550000,,-550000,3065000,4296000,510000,510000,,-20000,,,,0,6144000,5634000,1848000,-1060000,,-550000,-922000,49928,USEG
2018-12-31,,,-1040000,,-1040000,3594797,3249000,-1234797,-1234797,122000.0,-106000,,,,0,5147000,6381797,1898000,194797,,-1040000,-1369000,49928,USEG
2017-12-31,,,-1361000,,-1361000,3379000,3143000,-1015000,-1015000,26000.0,-513000,,,,0,6046000,7061000,2903000,-346000,,-1361000,-1656000,49928,USEG
2016-12-31,,,-11672000,,-14120000,2847000,3018000,-2552000,-2552000,194000.0,-442000,,,,0,5746000,8298000,2728000,-9120000,-2448000.0,-11672000,-14120000,49928,USEG
2019-12-31,,,-622000000,132000000,-456000000,2601000000,4559000000,1352000000,1352000000,,-374000000,,,,-217000000,13458000000,12106000000,8899000000,-1974000000,,-405000000,-456000000,49929,QRTEP
2018-12-31,,,883000000,120000000,916000000,2795000000,4861000000,1429000000,1429000000,,-381000000,,,,60000000,14070000000,12641000000,9209000000,-546000000,141000000.0,823000000,674000000,49929,QRTEP
2017-12-31,,,1050000000,99000000,2441000000,1788000000,3615000000,1102000000,1102000000,,-355000000,,,,-985000000,10404000000,9302000000,6789000000,-52000000,452000000.0,2035000000,1208000000,49929,QRTEP
2016-12-31,,,1091000000,89000000,1235000000,1897000000,3739000000,968000000,968000000,,-363000000,,,,316000000,10647000000,9679000000,6908000000,123000000,499000000.0,775000000,473000000,49929,QRTEP
2019-12-31,,,-665000,,-5864000,75028000,152386000,21682000,21682000,11303000,-12860000,,,,5199000,424385000,402703000,271999000,-22347000,,-5864000,-5864000,49930,ACEL
2018-12-31,,,15225000,,10803000,58157000,121486000,26633000,26633000,1233000,-9644000,,,,4422000,331993000,305360000,210507000,-11408000,,10803000,10803000,49930,ACEL
2017-12-31,,,10065000,,8311000,45364000,91425000,18865000,18865000,636000,-8105000,,,,1754000,248435000,229570000,157010000,-8800000,,8311000,8311000,49930,ACEL
2016-12-31,,,8391568,,4905080,31032801,63501095,13780714,13780714,-86410,-5386375,,,,3486488,173329965,159549251,109828870,-5389146,,4905080,1651476,49930,ACEL
2020-12-31,,,31981000,,29174000,89808000,137738000,47930000,47930000,,-13653000,,,,2807000,628941000,581011000,491203000,-15949000,,29174000,29174000,49931,DCO
2019-12-31,,,37763000,,32461000,93464000,152197000,58733000,58733000,,-18290000,,,,5302000,721088000,662355000,568891000,-20970000,,32461000,32461000,49931,DCO
2018-12-31,,,10271000,,9035000,84007000,122717000,38710000,38710000,,-13024000,,,,1236000,629307000,590597000,506590000,-28439000,,9035000,9035000,49931,DCO
2017-12-31,,,7609000,,20077000,79139000,103611000,24472000,24472000,,-8870000,,,,-12468000,558183000,533711000,454572000,-16863000,,20077000,20077000,49931,DCO
2020-03-29,,,18014000,,13435000,13829000,43184000,28122000,28122000,,-10601000,,,,4579000,103325000,75203000,60141000,-10108000,,13435000,13435000,49932,NATH
2019-03-31,,,29410000,,21493000,13851000,43039000,27976000,27976000,,-10792000,,,,7917000,101849000,73873000,58810000,1434000,,21493000,21493000,49932,NATH
2018-03-25,,,4112000,,2630000,13491000,41943000,27100000,27100000,,-13591000,,,,1482000,104201000,77101000,62258000,-22988000,,2630000,2630000,49932,NATH
2017-03-26,,,11804000,,7485000,13659000,41236000,26280000,26280000,,-14665000,,,,4319000,96256000,69976000,55020000,-14476000,,7485000,7485000,49932,NATH
2019-12-31,340534,,-1755042,,-1755042,3322828,1904416,-1758946,-1758946,,,,,,0,7682583,9441529,5778167,3904,,-1755042,-1755042,49933,WNW
2018-12-31,205609,,-980098,,-980098,1005728,228050,-983287,-983287,,,,,,0,1076827,2060114,848777,3189,,-980098,-980098,49933,WNW
2019-12-31,,,12439000,1469000,-307969000,117267000,155395000,14319000,14319000,,-21393000,,,,318296000,648651000,634332000,493256000,-1880000,,-305857000,-307969000,49934,ASPS
2018-12-31,,,1399000,1237000,-5382000,140472000,216037000,40367000,40367000,,-26254000,,,,4098000,838202000,797835000,622165000,-38968000,,-2699000,-5382000,49934,ASPS
2017-12-31,,,35375000,1373000,308891000,148097000,242348000,49706000,49706000,,-22253000,,,,-276256000,942213000,892507000,699865000,-14331000,,311631000,308891000,49934,ASPS
2016-12-31,,,44321000,1405000,28693000,156578000,307258000,93103000,93103000,,-24412000,,,,12935000,997303000,904200000,690045000,-48782000,,31386000,28693000,49934,ASPS
2019-12-31,,,-1315500000,182100000,-1067400000,354100000,897300000,400400000,400400000,142800000,-216000000,,,,-224700000,8906300000,8505900000,8009000000,-1715900000,,-1090800000,-1067400000,49935,MOS
2018-12-31,,,547000000,207400000,470000000,341100000,1449200000,1011200000,1011200000,96900000,-215800000,,,,77100000,9587300000,8576100000,8138100000,-464200000,,469900000,470000000,49935,MOS
2017-12-31,,,390700000,21600000,-107200000,301300000,842800000,440200000,440200000,101300000,-171300000,,,,494900000,7409400000,6969200000,6566600000,-49500000,,-104200000,-107200000,49935,MOS
2016-12-31,,,227000000,37900000,297800000,304200000,810000000,450000000,450000000,55800000,-140600000,,,,-74200000,7162800000,6712800000,6352800000,-223000000,,301200000,297800000,49935,MOS
2020-11-30,,,-18963402,,-18963402,5246052,11750097,6504045,6504045,,-1587203,,,,0,11750097,5246052,0,-25467447,,-18963402,-18963402,49936,MGU
2019-11-30,,,58349722,,58349722,5643956,24175703,18531747,18531747,,-2429470,,,,0,24175703,5643956,0,39817975,,58349722,58349722,49936,MGU
2018-11-30,,,-37203130,,-37203130,5667036,23421191,17754155,17754155,,-2729645,,,,0,23421191,5667036,0,-54957285,,-37203130,-37203130,49936,MGU
2017-11-30,,,85294168,,85294168,5695137,22950286,17255149,17255149,,-2390719,,,,0,22950286,5695137,0,68039019,,85294168,85294168,49936,MGU
2020-02-28,50600000,,245200000,,199700000,934800000,1215200000,236400000,236400000,-6600000,-27300000,,,,45500000,3723700000,3487300000,2508500000,8800000,,199700000,195800000,49937,SCS
2019-02-22,53700000,,163900000,,126000000,862200000,1087900000,179500000,179500000,-7500000,-37500000,,,,37900000,3443200000,3263700000,2355300000,-15600000,,126000000,123500000,49937,SCS
2018-02-23,44000000,,161500000,,80700000,816100000,1005200000,155400000,155400000,-10300000,-17500000,,,,80800000,3055500000,2900100000,2050300000,6100000,,80700000,79200000,49937,SCS
2017-02-24,35800000,,196300000,,124600000,781000000,1011800000,204500000,204500000,-9500000,-17200000,,,,71700000,3032400000,2827900000,2020600000,-8200000,,124600000,122200000,49937,SCS
2019-12-31,,,29139000,13353000,18361000,142121000,291392000,49841000,49841000,85861000,-27059000,,,,9017000,765130000,715289000,473738000,-20702000,,20122000,17889000,49940,TIPT
2018-12-31,,,-19796000,12158000,23933000,124671000,211271000,7645000,7645000,66359000,-27013000,,,,-5909000,625826000,618181000,414555000,-27441000,43770000.0,-13887000,23933000,49940,TIPT
2017-12-31,,,-3330000,96697000,3604000,126328000,237853000,37979000,37979000,59705000,-38948000,,,,-12562000,603647000,565668000,365794000,-41309000,-3998000.0,9232000,3537000,49940,TIPT
2016-12-31,,,49140000,96713000,25320000,125727000,303673000,100870000,100870000,62631000,-52043000,,,,12515000,557710000,456840000,254037000,-51730000,-4287000.0,36625000,25096000,49940,TIPT
2019-12-31,12809000,,-68548000,,-68548000,20893000,-38803000,-72505000,-72505000,,,,,,0,460000,72965000,39263000,3957000,,-68548000,-68548000,49942,GERN
2018-12-31,3079000,,-27017000,,-27017000,18707000,-9287000,-31073000,-31073000,,,,,,0,1066000,32139000,10353000,4056000,,-27017000,-27017000,49942,GERN
2017-12-31,2596000,,-27916000,,-27916000,19287000,-7372000,-29255000,-29255000,,,,,,0,1065000,30320000,8437000,1339000,,-27916000,-27916000,49942,GERN
2016-12-31,3352000,,-29537000,,-29537000,18761000,-8533000,-30646000,-30646000,,,,,,0,6162000,36808000,14695000,1109000,,-29537000,-29537000,49942,GERN
2020-10-31,,,8396000000,2376000000,6778000000,14096000000,25252000000,0,8396000000,2760000000,,,,,1543000000,25252000000,16856000000,0,0,,6853000000,6582000000,49949,BNS
2019-10-31,,,11270000000,2670000000,8390000000,14153000000,28007000000,0,11270000000,2584000000,,,,,2472000000,28007000000,16737000000,0,0,,8798000000,8208000000,49949,BNS
2018-10-31,,,11106000000,2452000000,8548000000,12691000000,26164000000,0,11106000000,2367000000,,,,,2382000000,26164000000,15058000000,0,0,,8724000000,8361000000,49949,BNS
2017-10-31,,,10276000000,1592000000,8005000000,12272000000,24906000000,0,10276000000,2358000000,,,,,2033000000,24906000000,14630000000,0,0,,8243000000,7876000000,49949,BNS
2020-12-31,283799000,,-130889000,,-163809000,585948000,774551000,-95196000,-95196000,,-36241000,,,,32920000,1050010000,1145206000,275459000,-35693000,,-163809000,-163809000,49950,PFPT
2019-12-31,230463000,,-110348000,,-130265000,526444000,651976000,-104931000,-104931000,,-12526000,,,,19917000,888190000,993121000,236214000,-8711000,,-130265000,-130265000,49950,PFPT
2018-12-31,185391000,,-116981000,,-103749000,431632000,515233000,-101790000,-101790000,,-16761000,,,,-13232000,716994000,818784000,201761000,-15191000,,-103749000,-103749000,49950,PFPT
2017-12-31,129803000,,-79752000,,-69802000,302962000,376303000,-56462000,-56462000,,-28608000,,,,-9950000,519681000,576143000,143378000,-23290000,,-69802000,-69802000,49950,PFPT
2020-05-31,,,-46792229,,-46792229,7250737,51106193,43855456,43855456,,-8161621,,,,0,51106193,7250737,0,-90647685,,-46792229,-46792229,49953,EFT
2019-05-31,,,19006960,,19006960,7860681,53955357,46094676,46094676,,-10173224,,,,0,53955357,7860681,0,-27087716,,19006960,19006960,49953,EFT
2018-05-31,,,34476594,,34476594,7931987,48947093,41015106,41015106,,-7320237,,,,0,48947093,7931987,0,-6538512,,34476594,34476594,49953,EFT
2017-05-31,,,70472022,,70472022,7989049,49488253,41499204,41499204,,-4946095,,,,0,49488253,7989049,0,28972818,,70472022,70472022,49953,EFT
2019-12-31,110362000,,27504000,,18642000,361724000,852954000,135173000,135173000,,-108071000,,,,8862000,932525000,797352000,79571000,-107669000,,18642000,18441000,49957,SWI
2018-12-31,96272000,,-121710000,,-102066000,306909000,762345000,116385000,116385000,,-142008000,,,,-19644000,833089000,716704000,70744000,-238095000,,-102066000,364635000,49957,SWI
2017-12-31,86618000,,-61468000,,-83866000,272934000,667319000,69654000,69654000,,-169786000,,,,22398000,728017000,658363000,60698000,-131122000,,-83866000,-351873000,49957,SWI
2016-12-31,97989000,,-484212000,,-334405000,352966000,413632000,-246496000,-246496000,,-170373000,,,,-149807000,469421000,715917000,55789000,-237716000,,-334405000,-334405000,49957,SWI
2020-12-31,,,25979000,,19448000,35968000,66366000,0,27112000,3286000,,,,,6531000,66366000,39254000,0,-1133000,,19448000,19448000,49960,FRBA
2019-12-31,,,19013000,,13445000,32189000,58377000,0,23198000,2990000,,,,,5568000,58377000,35179000,0,-4185000,,13445000,13445000,49960,FRBA
2018-12-31,,,21635000,,17589000,28911000,54949000,0,23424000,2614000,,,,,4046000,54949000,31525000,0,-1789000,,17589000,17589000,49960,FRBA
2017-12-31,,,14420000,,6993000,20128000,39104000,0,17570000,1406000,,,,,7427000,39104000,21534000,0,-3150000,,6993000,6993000,49960,FRBA
2019-12-31,,,1940200000,569981000,1878887000,1750892000,5095290000,2098456000,2098456000,,-408513000,,,,32600000,10950661000,8852205000,5855371000,-158256000,,1907600000,1878887000,49963,RCL
2018-12-31,,,1836692000,542020000,1811042000,1260130000,4231642000,1937815000,1937815000,,-333672000,,,,20900000,9493849000,7556034000,5262207000,-101123000,,1815792000,1811042000,49963,RCL
2017-12-31,,,1643433000,542020000,1625133000,1186016000,3881266000,1744056000,1744056000,,-297056000,,,,18300000,8777845000,7033789000,4896579000,-100623000,,1625133000,1625133000,49963,RCL
2016-12-31,,,1303488000,542020000,1283388000,1100290000,3480862000,1485657000,1485657000,,-305923000,,,,20100000,8496401000,7010744000,5015539000,-182169000,,1283388000,1283388000,49963,RCL
2019-12-31,202200000,,73032000,24277000,49006000,323910000,752319000,161923000,161923000,,-52453000,,,,20617000,2502470000,2340547000,1750151000,-88891000,,52415000,49006000,49972,ITRI
2018-12-31,207905000,,-109151000,21385000,-99250000,334544000,730319000,116157000,116157000,,-58203000,,,,-12570000,2376117000,2259960000,1645798000,-225308000,,-96581000,-99250000,49972,ITRI
2017-12-31,169407000,,134575000,19216000,57298000,328716000,676751000,157843000,157843000,,-13845000,,,,74326000,2018197000,1860354000,1341446000,-23268000,,60249000,57298000,49972,ITRI
2016-12-31,167766000,,84627000,18749000,31770000,324553000,662532000,145101000,145101000,,-13521000,,,,49574000,2013186000,1868085000,1350654000,-60474000,,35053000,31770000,49972,ITRI
2019-12-31,,,-6938096,,-6936263,5601181,-553896,-6155077,-6155077,,,,,,0,3465055,9620132,4018951,-783019,1833,-6938096,-6936263,49973,SLRX
2018-12-31,,,-1669637,,-1669637,2348361,663730,-1684631,-1684631,,,,,,0,1951351,3635982,1287621,14994,1833,-1669637,-1793364,49973,SLRX
2017-12-31,,,-1747335,,-1747335,1471067,-277780,-1748847,-1748847,,,,,,0,1851892,3600739,2129672,1512,1833,-1747335,-1840109,49973,SLRX
2016-12-31,,,-1223728,,-1223728,817485,-906740,-1724225,-1724225,,,,,,0,2553084,4277309,3459824,500497,1833,-1223728,-1279399,49973,SLRX
2019-12-31,,,-208000000,2000000,-212000000,126000000,310000000,-65000000,-65000000,68000000,-69000000,,,,4000000,812000000,877000000,502000000,-143000000,,-212000000,-212000000,49974,CPLG
2018-12-31,,,-216000000,3000000,-262000000,142000000,355000000,-7000000,-7000000,64000000,-64000000,,,,21000000,862000000,869000000,507000000,-209000000,-25000000.0,-237000000,-262000000,49974,CPLG
2017-12-31,,,44000000,3000000,152000000,81000000,363000000,91000000,91000000,51000000,-49000000,,,,-109000000,836000000,745000000,473000000,-46000000,-1000000.0,153000000,152000000,49974,CPLG
2016-12-31,,,1000000,2769000,-1000000,59000000,405000000,149000000,149000000,58000000,-48000000,,,,-2000000,871000000,722000000,466000000,-148000000,-4000000.0,3000000,-1000000,49974,CPLG
2019-12-31,,,13347000000,8713000000,7383000000,33930000000,53342000000,0,19412000000,,,,,,4639000000,53342000000,33930000000,0,-6065000000,,8708000000,5969000000,49975,HSBC
2018-12-31,,,19890000000,7996000000,13727000000,33845000000,52113000000,0,18268000000,,,,,,4865000000,52113000000,33845000000,0,1622000000,,15025000000,12608000000,49975,HSBC
2017-12-31,,,17167000000,7580000000,10798000000,34188000000,49676000000,0,15488000000,,,,,,5288000000,49676000000,34188000000,0,1679000000,,11879000000,9683000000,49975,HSBC
2016-12-31,,,7112000000,7192000000,2479000000,35791000000,44562000000,0,8771000000,,,,,,3666000000,44562000000,35791000000,0,-1659000000,,3446000000,1299000000,49975,HSBC
2020-12-31,,,701600000,,572600000,1023400000,1912700000,0,775100000,114200000,,,,,129000000,1912700000,1137600000,0,-73500000,,572600000,558500000,49980,PBCT
2019-12-31,,,652400000,,520400000,959200000,1812900000,0,765300000,88400000,,,,,132000000,1812900000,1047600000,0,-112900000,,520400000,506100000,49980,PBCT
2018-12-31,,,576300000,,468100000,851100000,1571400000,0,645700000,74600000,,,,,108200000,1571400000,925700000,0,-69400000,,468100000,453800000,49980,PBCT
2017-12-31,,,467100000,,337200000,792400000,1426500000,0,567700000,66400000,,,,,129900000,1426500000,858800000,0,-100600000,,337200000,322600000,49980,PBCT
2019-12-31,,,-32797917,,-32797917,14270603,62650388,48379785,48379785,,-9901426,,,,0,62650388,14270603,0,-81177702,,-32797917,-32797917,49982,OXSQ
2018-12-31,,,-9213373,,-9213373,15590041,56277268,40687227,40687227,,-7181009,,,,0,56277268,15590041,0,-49961352,,-9213373,-9213373,49982,OXSQ
2017-12-31,,,43609671,,43609671,17791472,61417017,43625545,43625545,,-12898815,,,,0,61417017,17791472,0,-15874,,43609671,43609671,49982,OXSQ
2016-12-31,,,110361763,,110361763,25298902,69280046,43981144,43981144,,-17202851,,,,0,69280046,25298902,0,66380619,,110361763,110361763,49982,OXSQ
2020-12-31,379000000,,1362000000,,1059000000,3389000000,6057000000,1744000000,1744000000,36000000,-138000000,,,,291000000,13834000000,12090000000,7777000000,-382000000,3000000,1071000000,1059000000,49983,PPG
2019-12-31,432000000,,1661000000,119000000.0,1243000000,3638000000,6527000000,1854000000,1854000000,92000000,-132000000,,,,392000000,15146000000,13292000000,8619000000,-193000000,3000000,1269000000,1243000000,49983,PPG
2018-12-31,441000000,,1693000000,102000000.0,1341000000,3573000000,6373000000,1762000000,1762000000,100000000,-118000000,,,,353000000,15374000000,13612000000,9001000000,-69000000,18000000,1340000000,1341000000,49983,PPG
2017-12-31,451000000,,2005000000,115000000.0,1594000000,3554000000,6539000000,1986000000,1986000000,88000000,-105000000,,,,615000000,14748000000,12762000000,8209000000,19000000,225000000,1390000000,1594000000,49983,PPG
2019-12-31,139694000,,-268851000,,-83993000,674829000,659576000,-170982000,-170982000,,-61599000,,,,-184858000,876293000,1047275000,216717000,-97869000,,-83993000,-83993000,49985,EXAS
2018-12-31,67285000,,-175057000,,-175149000,427464000,337818000,-159471000,-159471000,,-36789000,,,,92000,454462000,613933000,116644000,-15586000,,-175149000,-175149000,49985,EXAS
2017-12-31,42099000,,-114584000,,-114397000,262912000,187684000,-118310000,-118310000,,-206000,,,,-187000,265989000,384299000,78305000,3726000,,-114397000,-114397000,49985,EXAS
2016-12-31,33473000,,-167211000,,-167211000,189724000,54181000,-169016000,-169016000,,-213000,,,,0,99376000,268392000,45195000,1805000,,-167211000,-167211000,49985,EXAS
2019-12-31,,,-56700000,105100000,-31500000,214300000,324800000,84100000,84100000,-5600000,-95100000,,,,-20600000,1984100000,1900000000,1659300000,-140800000,,-36100000,-29700000,49987,HCHC
2018-12-31,,,182300000,113600000,162000000,214200000,194200000,-50600000,-50600000,-1100000,-75700000,,,,2400000,1976700000,2027300000,1782500000,232900000,,179900000,139000000,49987,HCHC
2017-12-31,,,-39800000,116600000,-46900000,177700000,212300000,3300000,3300000,-1100000,-55100000,,,,10700000,1634100000,1630800000,1421800000,-43100000,,-50500000,-49700000,49987,HCHC
2016-12-31,,,-45800000,25750000,-94500000,152900000,180900000,1100000,1100000,2400000,-43400000,,,,51600000,1558100000,1557000000,1377200000,-46900000,,-97400000,-105400000,49987,HCHC
2020-12-31,1002900000,,569000000,,603400000,1378400000,5516400000,2881400000,2881400000,,-104700000,,,,-34400000,6069900000,3188500000,553500000,-2312400000,,603400000,603400000,49990,ALXN
2019-12-31,886000000,,2178800000,,2404300000,1261100000,4596600000,2139900000,2139900000,,-77800000,,,,-225500000,4991100000,2851200000,394500000,38900000,,2404300000,2404300000,49990,ALXN
2018-12-31,730300000,,242200000,,77600000,1092400000,3762700000,1619900000,1619900000,,-98200000,,,,164600000,4131200000,2511300000,368500000,-1377700000,,77600000,77600000,49990,ALXN
2017-12-31,862100000,,547800000,,443300000,1083500000,3249000000,983300000,983300000,,-98400000,,,,104500000,3551100000,2567800000,302100000,-435500000,,443300000,443300000,49990,ALXN
2019-12-31,,,-28137000,21464000,-26920000,17114000,19999000,-10494000,-10494000,,-31816000,,,,-2000000,45212000,55706000,25213000,-17643000,,-26137000,-26920000,49991,TCI
2018-12-31,,,186250000,20681000,181450000,22653000,62664000,17250000,17250000,,-58872000,,,,3210000,122084000,104834000,59420000,169000000,,183040000,180550000,49991,TCI
2017-12-31,,,-15136000,19091000,-15815000,16514000,62203000,20131000,20131000,,-59944000,,,,180000,125259000,105128000,63056000,-35267000,,-15316000,-16715000,49991,TCI
2016-12-31,,,347000,18592000,37000,15223000,56527000,17621000,17621000,,-53088000,,,,24000,118445000,100824000,61918000,-17274000,-1000.0,323000,-863000,49991,TCI
2019-12-31,,,-535537000,125166000,-114513000,1062311000,528139000,-534172000,-534172000,,-15734000,,,,2268000,706529000,1240701000,178390000,-1365000,,-537805000,-114513000,49993,SDC
2018-12-31,,,-74410000,125166000,-74771000,334823000,264159000,-70664000,-70664000,,-13705000,,,,361000,398127000,468791000,133968000,-3746000,,-74771000,-74771000,49993,SDC
2017-12-31,,,-32650000,125166000,-32778000,112445000,76257000,-36188000,-36188000,,-2148000,,,,128000,140268000,176456000,64011000,3538000,,-32778000,-32778000,49993,SDC
2019-12-31,,,186767000,,175266000,52424000,496546000,269057000,269057000,-400000,-101060000,,,,11501000,516027000,246970000,19481000,-82290000,,175266000,164001000,49994,SRC
2018-12-31,,,149283000,,132052000,51152000,403549000,191145000,191145000,-1200000,-97548000,,,,792000,424825000,233680000,21276000,-41862000,-16439000.0,148491000,120551000,49994,SRC
2017-12-31,,,40939000,,77148000,54998000,396337000,172653000,172653000,-5000000,-113394000,,,,511000,426258000,253605000,29921000,-131714000,36720000.0,40428000,73678000,49994,SRC
2016-12-31,,,29506000,,97446000,45022000,397195000,191937000,191937000,-12800000,-118690000,,,,868000,426144000,234207000,28949000,-162431000,68808000.0,28638000,96832000,49994,SRC
2019-12-31,,,-28800000,,-29500000,1332500000,1453200000,67200000,67200000,,-38100000,,,,700000,7659400000,7592200000,6206200000,-96000000,,-29500000,-29500000,49996,VRTV
2018-12-31,,,-10200000,,-15700000,1417700000,1540500000,69300000,69300000,,-42300000,,,,5500000,8696200000,8626900000,7155700000,-79500000,,-15700000,-15700000,49996,VRTV
2017-12-31,,,-1900000,,-13300000,1384200000,1518100000,79700000,79700000,,-31200000,,,,11400000,8364700000,8285000000,6846600000,-81600000,,-13300000,-13300000,49996,VRTV
2016-12-31,,,40800000,,21000000,1325300000,1500200000,120200000,120200000,,-27500000,,,,19800000,8326600000,8206400000,6826400000,-79400000,,21000000,21000000,49996,VRTV
2019-12-31,51723000,,50135000,-279000,48458000,272768000,371964000,47473000,47473000,,,,,,3131000,547405000,499932000,175441000,2662000,,47004000,48458000,49998,PEN
2018-12-31,36165000,,-1493000,175000,6601000,225435000,292533000,30933000,30933000,,,,,,-4403000,444938000,414005000,152405000,-32426000,,2910000,6601000,49998,PEN
2017-12-31,31661000,,1046000,175000,4657000,184207000,217142000,1274000,1274000,,,,,,-3611000,333764000,332490000,116622000,-228000,,4657000,4657000,49998,PEN
2016-12-31,23875000,,-869000,175000,14814000,148304000,170829000,-1350000,-1350000,,,,,,-15683000,263317000,264667000,92488000,481000,,14814000,14814000,49998,PEN
2020-12-31,,,1747088000,4353033000,1481814000,274845000,3566001000,1699177000,1699177000,30010000,-314507000,,,,130458000,4736105000,3036928000,1170104000,47911000,,1616630000,1473122000,50003,PLD
2019-12-31,,,1776363000,3418657000,1572959000,266718000,2611872000,1192126000,1192126000,13149000,-239953000,,,,74517000,3530799000,2338673000,918927000,584237000,,1701846000,1566950000,50003,PLD
2018-12-31,,,1886290000,3502795000,1649361000,238985000,2345021000,1145262000,1145262000,13560000,-229141000,,,,63330000,3102709000,1957447000,757688000,741028000,,1822960000,1643426000,50003,PLD
2017-12-31,,,1815568000,3074583000,1652325000,231059000,2142037000,1019633000,1019633000,12205000,-274486000,,,,54609000,2866701000,1847068000,724664000,795935000,,1760959000,1641931000,50003,PLD
2020-12-31,,,352000000,1068000000,-122000000,2685000000,3196000000,511000000,511000000,,-159000000,,,,-18000000,7649000000,7138000000,4453000000,-159000000,-335000000,370000000,-158000000,50005,VOYA
2019-12-31,,,560000000,822000000,-351000000,2537000000,3527000000,983000000,983000000,7000000.0,-214000000,,,,-205000000,7476000000,6493000000,3949000000,-423000000,-1066000000,765000000,-379000000,50005,VOYA
2018-12-31,,,528000000,792000000,875000000,2527000000,3404000000,869000000,869000000,8000000.0,-262000000,,,,37000000,7163000000,6294000000,3759000000,-341000000,529000000,491000000,875000000,50005,VOYA
2017-12-31,,,385000000,1030000000,-2992000000,2480000000,3218000000,731000000,731000000,7000000.0,-264000000,,,,687000000,7229000000,6498000000,4011000000,-346000000,-2473000000,-302000000,-2992000000,50005,VOYA
2019-12-31,,,-3491000,,-5359000,56231000,64041000,5170000,5170000,,-6808000,,,,1868000,708390000,703220000,644349000,-8661000,,-5359000,-5359000,50007,ORN
2018-12-31,,,-106655000,,-94422000,53197000,16776000,-39811000,-39811000,,-7943000,,,,-12233000,520894000,560705000,504118000,-66844000,,-94422000,-94422000,50007,ORN
2017-12-31,,,-4141000,,400000,56640000,62240000,864000,864000,,-5731000,,,,-4541000,578553000,577689000,516313000,-5005000,,400000,400000,50007,ORN
2016-12-31,,,-2039000,,-3620000,64987000,67482000,2495000,2495000,,-6175000,,,,1581000,578236000,575741000,510754000,-4534000,,-3620000,-3620000,50007,ORN
2020-12-31,,,3265000000,340000000,2634000000,,9561000000,5157000000,5157000000,,-1110000000,,,,792000000,22883000000,17726000000,13322000000,-1892000000,226000000,2473000000,2498000000,50008,BCE
2019-12-31,,,4386000000,334000000,3191000000,249000000.0,10292000000,5645000000,5645000000,,-1132000000,,,,1133000000,23964000000,18319000000,13672000000,-1259000000,226000000,3253000000,3040000000,50008,BCE
2018-12-31,,,3968000000,326000000,2929000000,352000000.0,9818000000,5452000000,5452000000,136000000.0,-1000000000,,,,995000000,23468000000,18016000000,13650000000,-1484000000,226000000,2973000000,2785000000,50008,BCE
2017-12-31,,,4119000000,323000000,2994000000,399000000.0,9609000000,5366000000,5366000000,136000000.0,-955000000,,,,1069000000,22757000000,17391000000,13148000000,-1247000000,226000000,3050000000,2866000000,50008,BCE
2020-03-31,,,-177705000,11762000,-193174000,241583000,497542000,198949000,198949000,,-84118000,,,,14092000,1673805000,1474856000,1176263000,-376654000,,-191797000,-204718000,50009,WMS
2019-03-31,,,111515000,13986000,77772000,184701000,326967000,134386000,134386000,,-20001000,,,,30049000,1384733000,1250347000,1057766000,-22871000,,81466000,70182000,50009,WMS
2018-03-31,,,76203000,25134000,62007000,187656000,302481000,106757000,106757000,,-12461000,,,,11411000,1330354000,1223597000,1027873000,-30554000,,64792000,55586000,50009,WMS
2017-03-31,,,60523000,23134000,32950000,201333000,295810000,85929000,85929000,,-17215000,,,,24615000,1257261000,1171332000,961451000,-25406000,,35908000,27971000,50009,WMS
2020-09-30,136756000,,-35019000,,-36168000,27356000,122473000,-41639000,-41639000,,,,,,1149000,122473000,164112000,0,6620000,,-36168000,-36168000,50017,ENTA
2019-09-30,142213000,,45557000,,46383000,26246000,205197000,36738000,36738000,,,,,,-826000,205197000,168459000,0,8819000,,46383000,46383000,50017,ENTA
2018-09-30,94856000,,93121000,,71956000,23441000,206625000,88328000,88328000,,,,,,21165000,206625000,118297000,0,4793000,,71956000,71956000,50017,ENTA
2017-09-30,57451000,,26947000,,17710000,20749000,102814000,24614000,24614000,,,,,,9237000,102814000,78200000,0,2333000,,17710000,17710000,50017,ENTA
2019-12-31,,,14479000,1293000,39901000,49200000,107794000,44062000,44062000,9837000,-16686000,,,,-26216000,1126278000,1082216000,1018484000,-29583000,,40695000,39901000,50019,STRL
2018-12-31,,,31278000,7859000,25187000,48220000,110332000,44511000,44511000,15201000,-12350000,,,,1738000,1037667000,993156000,927335000,-13233000,,29540000,25187000,50019,STRL
2017-12-31,,,15935000,4856000,11617000,46552000,89092000,27876000,27876000,12865000,-9800000,,,,118000,957958000,930082000,868866000,-11941000,,15817000,11617000,50019,STRL
2016-12-31,,,-7324000,656000,-9238000,36844000,42058000,-3529000,-3529000,8743000,-2628000,,,,88000,690123000,693652000,648065000,-3795000,,-7412000,-9238000,50019,STRL
2020-04-30,12362000,,-59949000,,-61230000,172500000,234705000,49843000,49843000,,-11213000,,,,1281000,678390000,628547000,443685000,-109792000,,-61230000,-61230000,50020,SWBI
2019-04-30,12866000,,28738000,,18410000,164885000,226231000,48480000,48480000,,-9351000,,,,10328000,638277000,589797000,412046000,-19742000,,18410000,18410000,50020,SWBI
2018-04-30,11361000,,17617000,,20128000,157343000,196252000,27548000,27548000,,-11168000,,,,-2511000,606850000,579302000,410598000,-9931000,,20128000,20128000,50020,SWBI
2017-04-30,10238000,,191306000,,127854000,161295000,379972000,208439000,208439000,,-8581000,,,,63452000,903188000,694749000,523216000,-17133000,,127854000,127854000,50020,SWBI
2019-12-31,,,-819000,,-1228000,12352000,12576000,224000,224000,,-1043000,,,,409000,116333000,116109000,103757000,-1043000,,-1228000,-1228000,50023,NSYS
2018-12-31,,,492000,,166000,12062000,13311000,1249000,1249000,,-757000,,,,326000,113370000,112121000,100059000,-757000,,166000,166000,50023,NSYS
2017-12-31,,,-2071000,,-2446000,12833000,12118000,-715000,-715000,,-628000,,,,375000,112335000,113050000,100217000,-1356000,,-2446000,-2446000,50023,NSYS
2016-12-31,,,78774,,43774,12608714,13840250,631536,631536,,-550289,,,,35000,116621719,115990183,102781469,-552762,,43774,43774,50023,NSYS
2020-09-30,,,4266000000,51000000,2290000000,9257000000,17005000000,0,5881000000,1787000000,,,,,1974000000,17005000000,11124000000,0,-1615000000,,2292000000,2288000000,50024,WBK
2019-09-30,,,9749000000,53000000,6784000000,8805000000,19855000000,0,10709000000,233000000,,,,,2959000000,19855000000,9146000000,0,-960000000,,6790000000,6778000000,50024,WBK
2018-09-30,,,11731000000,52000000,8095000000,8379000000,21297000000,0,12604000000,219000000,,,,,3632000000,21297000000,8693000000,0,-873000000,,8099000000,8090000000,50024,WBK
2017-09-30,,,11515000000,54000000,7990000000,8093000000,20797000000,0,12410000000,181000000,,,,,3518000000,20797000000,8387000000,0,-895000000,,7997000000,7984000000,50024,WBK
2020-12-31,,,-1079279000000,,-925479000000,,549974000000,0,-1077940000000,1627914000000,,,,,-140662000000,549974000000,1627914000000,0,-1339000000,,-938617000000,-925479000000,50025,ITCB
2019-12-31,,,179248000000,94283000000.0,127065000000,614290000000.0,877517000000,0,173834000000,89393000000,,,,,46784000000,912730000000,738896000000,35213000000,5414000000,,132464000000,127065000000,50025,ITCB
2019-11-30,,,179248000000,94283000000.0,0,614290000000.0,0,0,173834000000,89393000000,,,,,0,0,0,0,0,,132464000000,127065000000,50025,ITCB
2018-12-31,,,254740000000,223081000000.0,172047000000,611910000000.0,970630000000,0,255498000000,103222000000,,,,,77894000000,1002303000000,746805000000,31673000000,-758000000,,176846000000,172047000000,50025,ITCB
2019-12-31,1765000000,,-11206000000,-4331000000,-6672000000,1924000000,64804000000,37379000000,37379000000,1909000000,-9934000000,,,,-2509000000,148640000000,111261000000,83836000000,-48585000000,,-8697000000,-6672000000,50026,VALE
2018-12-31,1376000000,,25118000000,3280000000,25657000000,1917000000,53282000000,46546000000,46546000000,2459000000,-6181000000,,,,-966000000,134483000000,87937000000,81201000000,-21428000000,-310000000.0,26084000000,25657000000,50026,VALE
2017-12-31,1086000000,,24885000000,4348000000,17627000000,1697000000,41275000000,35949000000,35949000000,798000000,-7483000000,,,,4607000000,108532000000,72583000000,67257000000,-11064000000,-2608000000.0,20278000000,17627000000,50026,VALE
2016-12-31,1098000000,,27022000000,6461000000,13311000000,1755000000,33490000000,27276000000,27276000000,1791000000,-7104000000,,,,9567000000,94633000000,67357000000,61143000000,-254000000,-4159000000.0,17455000000,13311000000,50026,VALE
2020-12-31,595100000,,1207000000,27600000,1060600000,1206200000,2861200000,1059900000,1059900000,,,,,,140200000,4358400000,3298500000,1497200000,147100000,,1066800000,1060600000,50027,ISRG
2019-12-31,557300000,,1502200000,20900000,1379300000,1177900000,3110200000,1375000000,1375000000,,,,,,120400000,4478500000,3103500000,1368300000,127200000,,1381800000,1379300000,50027,ISRG
2018-12-31,418100000,,1279500000,8700000,1127900000,941400000,2604100000,1244600000,1244600000,,,,,,154500000,3724200000,2479600000,1120100000,34900000,,1125000000,1127900000,50027,ISRG
2017-12-31,328600000,,1104800000,1600000,670900000,810500000,2202000000,1062900000,1062900000,,,,,,433900000,3138200000,2075300000,936200000,41900000,,670900000,670900000,50027,ISRG
2019-12-31,8579000,,-11305000,,-11914000,32138000,33182000,-8887000,-8887000,,-753000,,,,609000,41443000,50330000,8261000,-2418000,,-11914000,-11914000,50028,DCBO
2018-12-31,6612000,,-11651000,,-11272000,22570000,21424000,-8180000,-8180000,,-568000,,,,0,27074000,35254000,5650000,-3471000,,-11651000,-11272000,50028,DCBO
2017-12-31,3906327,,-8239884,-1054524.0,-7313530,15102952,12772654,-6573624,-6573624,,-172831,,,,0,17126141,23699765,4353487,-1666260,,-8239884,-7313530,50028,DCBO
2016-12-31,2005016,,-2895244,-1054524.0,-2754523,7948704,7219105,-2955025,-2955025,,-172831,,,,0,9852188,12807213,2633083,59781,,-2895244,-2754523,50028,DCBO
2017-12-31,,,16131000,-150318000,18769000,5286000,50944000,32121000,32121000,,-16724000,,,,-3145000,52625000,20504000,1681000,-15990000,,19276000,12096000,50029,LMRKP
2016-12-31,,,9921000,-135630000,9811000,3755000,37962000,23016000,23016000,,-11617000,,,,0,41171000,18155000,3209000,-13095000,,9921000,7103000,50029,LMRKP
2015-12-31,,,1205000,-47633000,1205000,2923000,29065000,17491000,17491000,,-11404000,,,,0,33597000,16106000,4532000,-16286000,,1205000,736000,50029,LMRKP
2014-12-31,,,2530000,12349,2530000,821000,22571000,15492000,15492000,,-9585000,,,,0,25141000,9649000,2570000,-12962000,,2530000,-2698000,50029,LMRKP
2019-12-29,,,-22237000,,-7903000,155978000,256558000,5417000,5417000,3054000,-10178000,,,,-14334000,1315014000,1309597000,1058456000,-27654000,,-7903000,-7903000,50031,RRGB
2018-12-30,,,-21410000,,-6419000,146458000,272567000,25710000,25710000,2936000,-10704000,,,,-14991000,1338563000,1312853000,1065996000,-47120000,,-6419000,-6419000,50031,RRGB
2017-12-31,,,29020000,,30019000,156656000,300717000,45946000,45946000,2936000,-10955000,,,,-999000,1387566000,1341620000,1086849000,-16020000,,30019000,30019000,50031,RRGB
2016-12-25,,,4788000,,11725000,144633000,290571000,48892000,48892000,3026000,-7239000,,,,-6937000,1303187000,1254295000,1012616000,-44104000,,11725000,11725000,50031,RRGB
2020-12-31,,,32511000,,26463000,61220000,106591000,0,35590000,9781000,,,,,6048000,106591000,71001000,0,-3079000,,26463000,26463000,50033,ORRF
2019-12-31,,,19634000,,16924000,58066000,97006000,0,31220000,7720000,,,,,2710000,97006000,65786000,0,-11586000,,16924000,16924000,50033,ORRF
2018-12-31,,,14445000,,12805000,46784000,72380000,0,18609000,6987000,,,,,1640000,72380000,53771000,0,-4164000,,12805000,12805000,50033,ORRF
2017-12-31,,,12428000,,8090000,42980000,62758000,0,13781000,5997000,,,,,4338000,62758000,48977000,0,-1353000,,8090000,8090000,50033,ORRF
2019-12-31,4824000,,56744000,48079000,503919000,243263000,359452000,111602000,111602000,-237000,-36586000,,,,20214000,1503742000,1392140000,1144290000,-54858000,475688000,36530000,503919000,50034,HSC
2018-12-31,3925000,,114033000,45113000,137057000,198256000,335132000,133382000,133382000,-431000,-21531000,,,,5499000,1347672000,1214290000,1012540000,-19349000,36479000,108534000,137057000,50034,HSC
2017-12-31,2736000,,75402000,44714000,7822000,197501000,309624000,109575000,109575000,-188000,-26862000,,,,78190000,1307470000,1197895000,997846000,-34173000,14632000,-2788000,7822000,50034,HSC
2016-12-31,4280000,,-73785000,41262000,-85667000,198285000,278654000,76556000,76556000,-467000,-51584000,,,,6637000,1451223000,1374667000,1172569000,-150341000,669000,-80422000,-85667000,50034,HSC
2019-12-31,,,47536000,,35537000,32065000,29543000,-9893000,-9893000,,-7174000,,,,11999000,70086000,79979000,40543000,57429000,,35537000,35493000,50035,ADES
2018-12-31,,,45877000,,35454000,15740000,18692000,2229000,2229000,,-2151000,,,,10423000,23945000,21716000,5253000,43648000,,35454000,35342000,50035,ADES
2017-12-31,157000.0,,52025000,,27873000,16829000,13479000,-4139000,-4139000,,-3024000,,,,24152000,45364000,49503000,31885000,56164000,,27873000,27702000,50035,ADES
2016-12-31,-648000.0,,36740000,,97678000,24452000,11605000,-12978000,-12978000,,-5066000,,,,-60938000,50622000,63600000,39017000,49718000,,97678000,96573000,50035,ADES
2019-12-31,,,-457580000,,-355114000,123514000,653780000,377543000,377543000,57197000,-110402000,,,,-102466000,849598000,472055000,195818000,-835123000,,-355114000,-355556000,50036,AM
2018-12-31,,,98919000,,66608000,43851000,0,-43851000,-43851000,57197000,-136000,,,,32311000,0,43851000,0,142770000,,66608000,61372000,50036,AM
2017-12-31,,,28586000,,2325000,41134000,0,-41134000,-41134000,57197000,-136000,,,,26261000,0,41134000,0,69720000,,2325000,6480000,50036,AM
2016-12-31,,,16130000,,9711000,814000,16944000,16130000,16130000,57197000,-136000,,,,6419000,16944000,814000,0,0,,9711000,9711000,50036,AM
2020-12-31,,,327800000,147600000,158500000,581500000,1235800000,593400000,593400000,-5000000,-99600000,,,,93900000,17045500000,16452100000,15809700000,-265600000,,233900000,158500000,50039,LEA
2019-12-31,,,976800000,269800000,753600000,576700000,1911300000,1263000000,1263000000,9300000,-92000000,,,,146100000,19810300000,18547300000,17899000000,-286200000,,830700000,789500000,50039,LEA
2018-12-31,,,1558600000,318000000,1149800000,588100000,2383400000,1716300000,1716300000,27600000,-84100000,,,,311900000,21148500000,19432200000,18765100000,-157700000,,1246700000,1139400000,50039,LEA
2017-12-31,,,1578400000,295500000,1313400000,618700000,2365400000,1675200000,1675200000,23900000,-85700000,,,,197500000,20467000000,18791800000,18101600000,-96800000,,1380900000,1287900000,50039,LEA
2019-12-31,10375991,,-29298097,,-29306769,25287568,6312948,-29350611,-29350611,,-123258,,,,8672,22113869,51464480,15800921,52514,,-29306769,-29306769,50040,ADMP
2018-12-31,18793836,,-39376122,,-39006782,25948062,5288655,-39453243,-39453243,,-157765,,,,-369340,15086643,54539886,9797988,77121,,-39006782,-39006782,50040,ADMP
2017-12-31,7526784,,-25878371,,-25538980,22819224,5653271,-24692737,-24692737,,-231291,,,,-339391,13073259,37765996,7419988,-1185634,,-25538980,-25538980,50040,ADMP
2016-12-31,9697136,,-24012017,,-19437252,17127555,1620314,-25204377,-25204377,,-214396,,,,-4574765,6473978,31678355,4853664,1192360,,-19437252,-20811481,50040,ADMP
2020-08-31,,,-1514477,,-1514477,2582712,15483634,12900922,12900922,,-2559845,,,,0,15483634,2582712,0,-14415399,,-1514477,-1514477,50041,FT
2019-08-31,,,24146593,,24146593,2419391,14566016,12146625,12146625,,-2567555,,,,0,14566016,2419391,0,11999968,,24146593,24146593,50041,FT
2018-08-31,,,3482124,,3482124,2229295,13878670,11649375,11649375,,-1755663,,,,0,13878670,2229295,0,-8167251,,3482124,3482124,50041,FT
2017-08-31,,,23933432,,23933432,2216392,13534549,11318157,11318157,,-1748113,,,,0,13534549,2216392,0,12615275,,23933432,23933432,50041,FT
2020-12-31,,,446057000,236987000,326364000,497539000,944868000,418151000,418151000,29178000,-2678000,,,,110035000,1448268000,1030117000,503400000,27906000,,336022000,313564000,50042,FHI
2019-12-31,,,365271000,212086000,272339000,516710000,884747000,347927000,347927000,20110000,-5037000,,,,88146000,1326894000,978967000,442147000,17344000,,277125000,262105000,50042,FHI
2018-12-31,,,296174000,182513000,220297000,436765000,780912000,330280000,330280000,13867000,-5885000,,,,73875000,1135677000,805397000,354765000,-34106000,,222299000,211742000,50042,FHI
2017-12-31,,,352002000,30163000,291341000,456884000,813709000,341508000,341508000,15317000,-4772000,,,,57101000,1102924000,761416000,289215000,10494000,,294901000,279921000,50042,FHI
2020-12-31,,,-54101000,,-53020000,97901000,46865000,-51036000,-51036000,,-3572000,,,,-1081000,138144000,189180000,91279000,-3065000,,-53020000,-53020000,50043,FLDM
2019-12-31,31640000.0,,-66705000,,-64790000,83178000,64279000,-50539000,-50539000,,-4279000,,,,-1915000,117243000,167782000,52964000,-16166000,,-64790000,-64790000,50043,FLDM
2018-12-31,30030000.0,,-61420000,,-59013000,79783000,61649000,-48164000,-48164000,,-13893000,,,,-2407000,112964000,161128000,51315000,-13256000,,-59013000,-59013000,50043,FLDM
2017-12-31,30826000.0,,-63799000,,-60535000,79516000,51982000,-58360000,-58360000,,-5824000,,,,-3264000,101937000,160297000,49955000,-5439000,,-60535000,-60535000,50043,FLDM
2019-12-31,,,30179000,,30179000,2649000,17117000,14468000,14468000,,-2053000,,,,0,17117000,2649000,0,15711000,,30179000,27716000,50044,PZC
2018-12-31,,,-836000,,-836000,2682000,18835000,16153000,16153000,,-1883000,,,,0,18835000,2682000,0,-16989000,,-836000,-3527000,50044,PZC
2017-12-31,,,22483000,,22483000,2707000,18440000,15733000,15733000,,-928000,,,,0,18440000,2707000,0,6750000,,22483000,20756000,50044,PZC
2016-12-31,,,2768000,,2768000,2738000,17527000,14789000,14789000,,-323000,,,,0,17527000,2738000,0,-12021000,,2768000,1840000,50044,PZC
2019-12-31,,,-10082000,34811000,-9306000,29451000,195447000,57293000,57293000,,-46772000,,,,0,579784000,522491000,384337000,-67375000,,-10082000,-9306000,50045,DSSI
2018-12-31,,,-86577000,34607000,-86106000,16219000,72872000,-31502000,-31502000,,-36679000,,,,0,368617000,400119000,295745000,-55075000,,-86577000,-86106000,50045,DSSI
2018-03-31,,,-31336000,34693203,-30560000,16141000,103855000,1089000,1089000,,-33754000,,,,0,302943000,301854000,199088000,-32425000,,-31336000,-30560000,50045,DSSI
2017-03-31,,,23821237,34693203,23683134,15073846,157453623,61331386,61331386,,-31844533,,,,0,303797183,242465797,146343560,-37510149,,23821237,23683134,50045,DSSI
2019-12-31,16665000,,36121000,,27193000,31702000,85863000,37496000,37496000,,,,,,8928000,114610000,77114000,28747000,-1375000,,27193000,27193000,50046,ANIK
2018-12-31,18190000,,23207000,,18722000,28136000,74275000,27949000,27949000,,,,,,4485000,105555000,77606000,31280000,-4742000,,18722000,18722000,50046,ANIK
2017-12-31,18787000,,46202000,,31816000,21540000,86056000,45729000,45729000,,,,,,14386000,113420000,67691000,27364000,473000,,31816000,31816000,50046,ANIK
2016-12-31,10732000,,50870000,,32547000,18013000,79352000,50607000,50607000,,,,,,18323000,103379000,52772000,24027000,263000,,32547000,32547000,50046,ANIK
2019-12-31,,,-96410922,25178758,-97680615,29890593,43109182,10989936,10989936,,-5616282,,,,417453,44566955,33577019,1457773,-107400858,,-96828375,-98507524,50047,IDEX
2018-12-31,1654491.0,,-28463328,-1030626,-27426356,27221775,3167834,-26060764,-26060764,,-804595,,,,-40244,377742872,403803636,374575038,-2402564,,-28423084,-27426356,50047,IDEX
2017-12-31,406845.0,,-10860317,-1289367,-10503049,16330198,7164447,-9880698,-9880698,,-94618,,,,0,144352840,154233538,137188393,-979619,,-10860317,-10503049,50047,IDEX
2016-12-31,406845.0,,-28831089,-5325481,-26407974,12298462,130777,-12672713,-12672713,,-254725,,,,-330124,35185508,47858221,35054731,-16158376,,-28500965,-26407974,50047,IDEX
2019-12-31,,,7451711000000,13497702000000,3034409000000,7877216000000,17597913000000,0,8308314000000,1412383000000,,,,,2086257000000,17597913000000,9289599000000,0,-856603000000,,5365454000000,3034409000000,50048,AVAL
2018-12-31,,,7334141000000,11764639000000,2912694000000,7365431000000,16533674000000,0,8007485000000,1160758000000,,,,,2149590000000,16533674000000,8526189000000,378433000000,-673344000000,,5184551000000,2912694000000,50048,AVAL
2017-12-31,,,5332765000000,9745829000000,2169839000000,7120994000000,14321551000000,0,5778515000000,1422042000000,,,,,1888542000000,14321551000000,8543036000000,392271000000,-445750000000,,3444223000000,2169839000000,50048,AVAL
2016-12-31,,,5950386000000,9268612000000,2364601000000,7139914000000,13881263000000,0,5989024000000,752325000000,,,,,2156254000000,14193466000000,8204442000000,312203000000,-38638000000,,3794132000000,2364601000000,50048,AVAL
2020-03-31,,,-8473049,,-8286854,25043254,16834640,-8208614,-8208614,,-1824667,,,,-186195,89453031,97661645,72618391,-264435,,-8286854,-8286854,50049,IFMK
2019-03-31,,,-11435920,,-12003443,31899310,20392592,-11506718,-11506718,,-1314295,,,,567523,125431439,136938157,105038847,70798,,-12003443,-12003443,50049,IFMK
2018-03-31,,,-893478,,-791293,30738330,28993582,-1744748,-1744748,,-817227,,,,-102185,136688527,138433275,107694945,851270,,-791293,-791293,50049,IFMK
2017-03-31,,,2853057,,1196723,26087868,27884203,1796335,1796335,,-303894,,,,1656334,130876760,129080425,102992557,1056722,,1196723,1196723,50049,IFMK
2019-12-31,,,-20339538,-413752,-20017568,9431015,-9964500,-19395515,-19395515,,,,,,45178,3049104,22444619,13013604,-944023,,-20384716,-20017568,50050,HTBX
2018-12-31,,,-17576781,-46604,-15733854,7025212,-10439165,-17464377,-17464377,,,,,,-985488,5793849,23258226,16233014,-112404,,-16591293,-15733854,50050,HTBX
2017-12-31,,,-13219406,-1589842,-11841671,5770954,-6747606,-12518560,-12518560,,,,,,-809540,1519943,14038503,8267549,-700846,,-12409866,-11841671,50050,HTBX
2016-12-31,,,-12974799,-1956647,-12573952,4138285,-8989034,-13127319,-13127319,,-549403.0,,,,0,341643,13468962,9330677,152520,,-12974799,-12573952,50050,HTBX
2020-02-29,,,9995053,,9995053,12955789,65476629,52520840,52520840,,-9975243,,,,0,65476629,12955789,0,-42525787,,9995053,9995053,50051,PPR
2019-02-28,,,21130661,,21130661,13440646,66706645,53265999,53265999,,-10581742,,,,0,66706645,13440646,0,-32135338,,21130661,21130661,50051,PPR
2018-02-28,,,26494545,,26494545,13719460,59858659,46139199,46139199,,-7647055,,,,0,59858659,13719460,0,-19644654,,26494545,26494545,50051,PPR
2017-02-28,,,112031410,,112031410,13632645,64558680,50926035,50926035,,-5187151,,,,0,64558680,13632645,0,61105375,,112031410,112031410,50051,PPR
2020-12-31,,,490100000,826000000,203600000,85900000,946900000,717400000,717400000,27600000,-68000000,,,,286500000,1561000000,843600000,614100000,-227300000,,203600000,203600000,50054,AUY
2019-12-31,,,310300000,34700000,225600000,79400000,829400000,221600000,221600000,43100000,-98100000,,,,84700000,1612200000,1390600000,782800000,88700000,,225600000,225600000,50054,AUY
2018-12-31,,,-176700000,34700000,-284600000,91800000,788500000,-22700000,-22700000,37300000,-106000000,,,,121000000,1798500000,1821200000,1010000000,-154000000,,-297700000,-284600000,50054,AUY
2017-12-31,,,-312000000,133900000,-188500000,113600000,761400000,-95600000,-95600000,21000000,-90400000,,,,-113900000,1803800000,1899400000,1042400000,-216400000,,-198100000,-188500000,50054,AUY
2020-06-28,,,-56265000,,-57237000,43814000,39040000,-6513000,-6513000,,-4779000,,,,972000,606509000,613022000,567469000,-49752000,,-57237000,-57237000,50055,UFI
2019-06-30,,,10011000,,2456000,52690000,66308000,12311000,12311000,999000.0,-5414000,,,,7555000,708804000,696493000,642496000,-2300000,,2456000,2456000,50055,UFI
2018-06-24,,,30211000,,31702000,56077000,86428000,30389000,30389000,999000.0,-4935000,,,,-1491000,678912000,648523000,592484000,-178000,,31702000,31702000,50055,UFI
2017-06-25,,,43275000,,32875000,50829000,94164000,43458000,43458000,999000.0,-3578000,,,,10898000,647270000,603812000,553106000,-183000,,32377000,32875000,50055,UFI
2019-12-31,,,1963000,-93000,856000,10091000,6603000,-9404000,-9404000,,-7796000,,,,270000,18935000,28339000,12332000,11367000,,1693000,856000,50057,BRT
2018-12-31,,,25627000,331000,25495000,9383000,7646000,-6664000,-6664000,,-6439000,,,,2000,18341000,25005000,10695000,32291000,,25625000,25495000,50057,BRT
2018-09-30,,,48051000,98498000,23773000,9210000,61582000,13868000,13868000,,-34389000,,,,50000,119247000,105379000,57665000,37443000,,48001000,23773000,50057,BRT
2017-09-30,,,37188000,70709000,13600000,9396000,54108000,14221000,14221000,,-28171000,,,,1560000,105387000,91166000,51279000,22967000,,35628000,13600000,50057,BRT
2019-12-31,15730000,,-17172000,,-17527000,62363000,61992000,-16101000,-16101000,,-1029000,,,,355000,89133000,105234000,27141000,-1071000,,-17527000,-32348000,50059,ONTF
2018-12-31,14343000,,-17393000,,-17591000,60279000,57687000,-16935000,-16935000,,-1052000,,,,198000,82608000,99543000,24921000,-458000,,-17591000,-20616000,50059,ONTF
2019-12-31,,,-2234,,-2234,,0,0,,,,,,,0,0,0,0,-2234,,-2234,-2234,50060,BHSE
2018-12-31,,,-84876,,-84876,,0,0,,,,,,,0,0,0,0,-84876,,-84876,-84876,50060,BHSE
2019-12-31,,,1558000,5778000,659000,4060000,14261000,2860000,2860000,,-1318000,,,,128000,20605000,17745000,6344000,-1302000,,1430000,659000,50061,AMS
2018-12-31,,,2081000,5946000,1023000,3994000,14231000,3492000,3492000,,-1631000,,,,451000,19714000,16222000,5483000,-1411000,,1630000,1023000,50061,AMS
2017-12-31,,,1837000,6029000,1923000,4323000,15264000,4340000,4340000,,-1927000,,,,-1103000,19556000,15216000,4292000,-2503000,,2940000,1923000,50061,AMS
2016-12-31,,,3193000,5678000,930000,3802000,15057000,4993000,4993000,,-1707000,,,,943000,18700000,13707000,3643000,-1800000,,2250000,930000,50061,AMS
2019-12-31,,,-19390766,,-19390766,12960109,879755,-12080354,-12080354,,,,,,0,1411565,13491919,531810,-7310412,,-19390766,-19680701,50064,POAI
2018-12-31,,,-10086477,,-10086477,8857270,995891,-7861379,-7861379,,,,,,0,1411655,9273034,415764,-2225098,,-10086477,-10086477,50064,POAI
2017-12-31,,,-6003017,,-6003017,6560313,506791,-6053522,-6053522,,,,,,0,654836,6708358,148045,50505,,-6003017,-6003017,50064,POAI
2016-12-31,,,-6526014,,-6526014,5781886,274875,-5507011,-5507011,,-3.0,,,,0,456495,5963506,181620,-1019003,,-6526014,-6526014,50064,POAI
2020-12-31,,,-1838000000,29115000000,-1098000000,816000000,3280000000,2145000000,2145000000,,-2592000000,,,,220000000,5844000000,3699000000,2564000000,-3983000000,,-2058000000,-1098000000,50065,BPYPO
2019-12-31,,,3353000000,31241000000,884000000,953000000,7057000000,5763000000,5763000000,,-2924000000,,,,196000000,10172000000,4409000000,3115000000,-2410000000,,3157000000,949000000,50065,BPYPO
2018-12-31,,,3735000000,34387000000,764000000,746000000,5174000000,4120000000,4120000000,,-2464000000,,,,81000000,8186000000,4066000000,3012000000,-385000000,,3654000000,862000000,50065,BPYPO
2017-12-31,,,2660000000,27729000000,136000000,669000000,4455000000,3511000000,3511000000,,-1967000000,,,,192000000,7096000000,3585000000,2641000000,-851000000,,2468000000,158000000,50065,BPYPO
2020-01-26,107368000,,44694000,246000,31871000,161940000,336684000,50830000,50830000,,-9106000,,,,12828000,547512000,496682000,210828000,-6136000,,31866000,31871000,50066,SMTC
2019-01-27,109047000,,69994000,246000,69639000,152551000,377022000,88775000,88775000,,-9202000,,,,355000,627196000,538421000,250174000,-18781000,,69639000,69639000,50066,SMTC
2018-01-28,105070000,,57502000,246000,34649000,140245000,351971000,78789000,78789000,,-7963000,,,,22853000,587847000,509058000,235876000,-21287000,,34649000,34649000,50066,SMTC
2017-01-29,102500000,,73060000,246000,54661000,136426000,324862000,60635000,60635000,,-9300000,,,,18399000,544272000,483637000,219410000,12425000,,54661000,54661000,50066,SMTC
2020-12-31,46300000,,-127478000,,-126934000,542531000,664845000,76014000,76014000,,-46932000,,,,-544000,1589460000,1513446000,924615000,-203492000,,-126934000,-126934000,50067,ELY
2019-12-31,50579000,,95769000,,79408000,577214000,766787000,138994000,138994000,,-39300000,,,,16540000,1701063000,1562069000,934276000,-43225000,,79229000,79408000,50067,ELY
2018-12-31,40752000,,131272000,9734000.0,104740000,405514000,578369000,132103000,132103000,,-5543000,,,,26018000,1242834000,1110731000,664465000,-831000,,105254000,104740000,50067,ELY
2017-12-31,36568000,,68055000,9744000.0,40806000,365043000,480448000,78837000,78837000,,-4365000,,,,26388000,1048736000,969899000,568288000,-10782000,,41667000,40806000,50067,ELY
2020-12-31,,,92526000,,74854000,294952000,440018000,0,125297000,19769000,,,,,17672000,440018000,314721000,0,-32771000,,74854000,74854000,50070,NWBI
2019-12-31,,,141111000,,110432000,267674000,437214000,0,152985000,16555000,,,,,30679000,437214000,284229000,0,-11874000,,110432000,110432000,50070,NWBI
2018-12-31,,,133913000,,105491000,252131000,410011000,0,144338000,13542000,,,,,28422000,410011000,265673000,0,-10425000,,105491000,105491000,50070,NWBI
2017-12-31,,,135911000,,94467000,256487000,421514000,0,151616000,13411000,,,,,41444000,421514000,269898000,0,-15705000,,94467000,94467000,50070,NWBI
2019-12-31,,,-211859000,,-259720000,72853000,736028000,240274000,240274000,66071000,-33919000,,,,47861000,1171697000,931423000,435669000,-452133000,,-259720000,-259720000,50071,ERF
2018-12-31,,,481490000,,378279000,75783000,843726000,551901000,551901000,-88232000,-36799000,,,,103211000,1205450000,653549000,361724000,-70411000,,378279000,378279000,50071,ERF
2017-12-31,,,318986000,,236998000,74301000,558009000,247244000,247244000,-14310000,-38714000,,,,81988000,866375000,619131000,308366000,71742000,,236998000,236998000,50071,ERF
2016-12-31,,,160218000,,397416000,86319000,330251000,-114429000,-114429000,29397000,-45443000,,,,-237198000,685315000,799744000,355064000,274647000,,397416000,397416000,50071,ERF
2020-12-31,,,303000000,,246400000,25400000,726200000,333900000,333900000,366900000,-30800000,,,,56600000,2922300000,2588400000,2196100000,-30900000,,246400000,246400000,50073,SIGI
2019-12-31,,,336390000,,271623000,41921000,758652000,369683000,369683000,347048000,-33668000,,,,64767000,2846491000,2476808000,2087839000,-33193000,,271623000,271623000,50073,SIGI
2018-12-31,,,211721000,,178939000,25446000,592904000,236140000,236140000,331318000,-24419000,,,,32782000,2586080000,2349940000,1993176000,-24419000,,178939000,178939000,50073,SIGI
2017-12-31,,,261968000,,168826000,36255000,655674000,286322000,286322000,333097000,-24354000,,,,93142000,2469984000,2183662000,1814310000,-24354000,,168826000,168826000,50073,SIGI
2020-12-31,,,-2607000000,9726000000,-568000000,276000000,1783000000,851000000,851000000,,-436000000,,,,-167000000,23290000000,22439000000,21507000000,-3458000000,,-2440000000,-568000000,50074,PAGP
2019-12-31,,,2238000000,12330000000,331000000,302000000,2914000000,2008000000,2008000000,,-425000000,,,,176000000,33669000000,31661000000,30755000000,230000000,,2062000000,331000000,50074,PAGP
2018-12-31,,,2409000000,11473000000,334000000,320000000,2999000000,2158000000,2158000000,,-431000000,,,,302000000,34055000000,31897000000,31056000000,251000000,,2107000000,334000000,50074,PAGP
2017-12-31,,,896000000,10663000000,-731000000,274000000,2055000000,1262000000,1262000000,,-510000000,,,,937000000,26223000000,24961000000,24168000000,-366000000,,-41000000,-731000000,50074,PAGP
2019-12-31,392951000,,353035000,31040000,281297000,2031302000,2825659000,429122000,429122000,-27716000,-61316000,,,,71144000,7278192000,6849070000,4452533000,-76087000,,281891000,281297000,50076,BZUN
2018-12-31,268973000,,334724000,17473000,269712000,1493815000,2095883000,355773000,355773000,-22678000,-13058000,,,,64953000,5393037000,5037264000,3297154000,-21049000,,269771000,269712000,50076,BZUN
2017-12-31,140689000,,263381000,17414000,208866000,1027397000,1413168000,256332000,256332000,-11250000,-4252000,,,,54251000,4148808000,3892476000,2735640000,7049000,,209130000,208866000,50076,BZUN
2016-12-31,95638000,,102255000,17414000,86633000,747093000,927562000,90066000,90066000,-5235000,-4252000,,,,16831000,3390275000,3300209000,2462713000,12189000,,85424000,86633000,50076,BZUN
2019-12-31,,,6368606000,487345000,10697124000,7998514000,20667935000,9197844000,9197844000,1664148000,-3588566000,,,,-1090262000,27725527000,18527683000,7057592000,-2829238000,3284975000,7458868000,10697124000,50077,EBR
2018-12-31,,,15930518000,466042000,13262378000,7542593000,19973474000,17877811000,17877811000,-7148919000,-2989654000,,,,2483718000,25772305000,7894494000,5798831000,-1947293000,18955000,13446800000,13262378000,50077,EBR
2017-12-31,,,4482551000,413155000,-1763805000,8909209000,15058556000,4824965000,4824965000,-199524000,-3449846000,,,,2029028000,24518505000,19693540000,9459949000,-342414000,-4179214000,2453523000,-1763805000,50077,EBR
2016-12-31,,,12182725000,-138543000,3584529000,15460081000,15504516000,-3703529000,-3703529000,1904179000,-6679217000,,,,8510819000,31715450000,35418979000,16210934000,15886254000,-4179214000,3671906000,3584529000,50077,EBR
2019-12-31,,,-54789000,,-54789000,20608000,-36758000,-57366000,-57366000,,,,,,0,15360000,72726000,52118000,2577000,,-54789000,-54789000,50080,SURF
2018-12-31,,,-6597000,,-6597000,16076000,6925000,-9151000,-9151000,,,,,,0,59417000,68568000,52492000,2554000,,-6597000,-6608000,50080,SURF
2017-12-31,,,-45377000,,-45377000,11033000,-34957000,-45990000,-45990000,,,,,,0,12826000,58816000,47783000,613000,,-45377000,-45417000,50080,SURF
2016-12-31,,,-17453000,,-17453000,4144000,-13860000,-18004000,-18004000,,,,,,0,6632000,24636000,20492000,551000,,-17453000,-17494000,50080,SURF
2020-12-31,30855000,,-53540000,,-54476000,17281000,23450000,-24686000,-24686000,,-14474000,,,,936000,50916000,75602000,27466000,-28854000,,-54476000,-54476000,50081,SQNS
2019-12-31,23799000,,-37480000,,-36697000,16538000,12379000,-27958000,-27958000,,-9643000,,,,-783000,30864000,58822000,18485000,-9522000,,-36697000,-36697000,50081,SQNS
2018-12-31,27909000,,-37192000,,-36224000,19496000,15888000,-31517000,-31517000,,-5447000,,,,-968000,40250000,71767000,24362000,-5675000,,-36224000,-36224000,50081,SQNS
2017-12-31,25202000,,-25860000,,-26160000,15464000,21141000,-19525000,-19525000,,-4672000,,,,300000,48263000,67788000,27122000,-6335000,,-26160000,-26160000,50081,SQNS
2019-12-31,,,15642000,227000,6765000,252150000,268275000,16125000,16125000,,-43000,,,,8713000,362215000,346090000,93940000,-483000,,6929000,6765000,50082,NATR
2018-12-31,,,3200000,63000,-854000,261368000,269119000,7751000,7751000,,-387000,,,,4402000,364810000,357059000,95691000,-4551000,,-1202000,-854000,50082,NATR
2017-12-31,,,3222000,411000,-12942000,249605000,250992000,1387000,1387000,,-289000,,,,17039000,342029000,340642000,91037000,1835000,,-13817000,-12942000,50082,NATR
2016-12-31,,,9266000,1286000,2139000,240183000,250222000,10039000,10039000,,-16000,,,,8591000,341159000,331120000,90937000,-773000,,675000,2139000,50082,NATR
2019-12-31,,,68303000,,52017000,121383000,171539000,50156000,50156000,,-6141000,,,,16286000,772702000,722546000,601163000,18147000,,52017000,52017000,50086,ATRO
2018-12-31,,,52282000,,46803000,116033000,180696000,64663000,64663000,,-9710000,,,,5479000,803256000,738593000,622560000,-12381000,,46803000,46803000,50086,ATRO
2017-12-31,,,24991000,,19679000,88775000,137113000,48338000,48338000,,-5369000,,,,5312000,624464000,576126000,487351000,-23347000,,19679000,19679000,50086,ATRO
2016-12-31,,,68785000,,48424000,86285000,159467000,73182000,73182000,,-4354000,,,,20361000,633123000,559941000,473656000,-4397000,,48424000,48424000,50086,ATRO
2019-12-31,,,-97140000,21432000,-92837000,41008000,61609000,-43411000,-43411000,,-30056000,,,,-7912000,201492000,244903000,139883000,-53729000,-9467000,-89228000,-92837000,50087,SMHI
2018-12-31,,,-96776000,29404000,-77608000,46454000,58054000,-57241000,-57241000,,-26106000,,,,-13354000,203567000,260808000,145513000,-39535000,1370000,-83422000,-77608000,50087,SMHI
2017-12-31,,,-113939000,14975000,-32901000,46465000,4151000,-102621000,-102621000,,-15998000,,,,-74410000,123421000,226042000,119270000,-11318000,989000,-39529000,-32901000,50087,SMHI
2016-12-31,,,-196619000,5544000,-132047000,49308000,48711000,-58666000,-58666000,,-10026000,,,,-63469000,215636000,274302000,166925000,-137953000,989000,-133150000,-132047000,50087,SMHI
2019-12-31,44362000,,-51128000,,-51128000,6722000,0,-51084000,-51084000,,-540000,,,,0,0,51084000,0,-44000,,-51128000,-51128000,50090,FHTX
2018-12-31,21225000,,-26337000,,-26337000,4824000,0,-26049000,-26049000,,-371000,,,,0,0,26049000,0,-288000,,-26337000,-26337000,50090,FHTX
2020-06-30,20410000,,-29152000,,-29152000,9089000,23000,-29476000,-29476000,,-196000,,,,0,23000,29499000,0,324000,,-29152000,-29152000,50091,PSTI
2019-06-30,26427000,,-35307000,,-35307000,9157000,52000,-35532000,-35532000,,-2000,,,,0,54000,35586000,2000,225000,,-35307000,-35307000,50091,PSTI
2018-06-30,22629000,,-26126000,,-26126000,11193000,48000,-33731000,-33731000,-43000.0,-25000,,,,0,50000,33781000,2000,7605000,,-26126000,-26126000,50091,PSTI
2017-06-30,20078000,,-27814000,,-27814000,7941000,0,-28019000,-28019000,-43000.0,-25000,,,,0,0,28019000,0,205000,,-27814000,-27814000,50091,PSTI
2020-12-31,,,3809000000,1022000000,2485000000,,14962000000,0,3809000000,11153000000,,,,,1246000000,14962000000,11153000000,0,0,,2563000000,2485000000,50092,ING
2019-12-31,,,5654000000,893000000,3903000000,6146000000.0,15927000000,0,5683000000,4098000000,,,,,1652000000,15927000000,10244000000,0,-29000000,,4002000000,3903000000,50092,ING
2018-12-31,,,6985000000,803000000,4761000000,5821398000.0,17668000000,0,7783602000,4063000000,,,,,2116000000,17668000000,9884398000,0,-798602000,,4869000000,4761000000,50092,ING
2017-12-31,,,8085000000,715000000,5464000000,5657000000.0,17793000000,0,7977000000,4159000000,,,,,2539000000,17793000000,9816000000,0,108000000,,5546000000,5464000000,50092,ING
2020-12-31,101117000,,-27645000,,-24374000,354259000,453494000,-1882000,-1882000,,-38119000,,,,-3271000,495308000,497190000,41814000,-25763000,,-24374000,-24374000,50093,AYX
2019-12-31,69100000,,6064000,,27143000,271571000,378759000,38088000,38088000,,-21844000,,,,-21079000,417910000,379822000,39151000,-32024000,,27143000,27143000,50093,AYX
2018-12-31,43449000,,25434000,,28020000,156927000,230770000,30394000,30394000,,-7378000,,,,-2586000,253570000,223176000,22800000,-4960000,,28020000,28020000,50093,AYX
2017-12-31,29342000,,-18404000,,-17499000,98461000,109804000,-17999000,-17999000,,-7378000,,,,-905000,131607000,149606000,21803000,-405000,,-17499000,-19482000,50093,AYX
2019-12-31,,,-4557000,,-4426000,4984000,0,-8239000,-8239000,577000,-67000,,,,-131000,0,8239000,0,3682000,,-4426000,-4426000,50094,MAG
2018-12-31,,,-5006000,,-5802000,4853000,0,-8098000,-8098000,1121000,-67000,,,,796000,0,8098000,0,3092000,,-5802000,-5802000,50094,MAG
2017-12-31,,,-5769000,,-6497000,4315000,0,-7694000,-7694000,1091000,-67000,,,,728000,0,7694000,0,1925000,,-6497000,-6497000,50094,MAG
2016-12-31,,,-60422000,,-55846000,4237000,0,-60673000,-60673000,257000,-67000,,,,-4576000,0,60673000,0,251000,,-55846000,-55846000,50094,MAG
2019-12-31,,,-362800000,3800000,-346800000,768500000,1180800000,267100000,267100000,,-118100000,,,,-16800000,3308900000,3041800000,2128100000,-629900000,,-346000000,-346800000,50095,SRCL
2018-12-31,,,-275400000,9700000,-244700000,804900000,1394800000,459600000,459600000,,-103300000,,,,-29800000,3485900000,3026300000,2091100000,-735000000,,-245600000,-253300000,50095,SRCL
2017-12-31,,,-107900000,12000000,42400000,840200000,1463600000,505000000,505000000,,-93700000,,,,-150900000,3580700000,3075700000,2117100000,-612900000,,43000000,23400000,50095,SRCL
2016-12-31,,,328100000,10600000,206300000,777100000,1495900000,589500000,589500000,,-97800000,,,,120200000,3562300000,2972800000,2066400000,-261400000,,207900000,178200000,50095,SRCL
2020-12-31,,,12495000,,10018000,,36400000,0,12391000,24009000,,,,,2477000,36400000,24009000,0,104000,,10018000,10018000,50096,RMBI
2019-12-31,,,-19376899,,-14084486,40937573.0,31863256,0,-12653916,3579599,,,,,-5292413,31863256,44517172,0,-6722983,,-14084486,-15806381,50096,RMBI
2018-12-31,,,6956189,,5677951,18943144.0,30060991,0,7556189,3561658,,,,,1278238,30060991,22504802,0,-600000,,5677951,5677951,50096,RMBI
2017-12-31,,,5687531,,2715341,17352737.0,26999491,0,6597735,3049019,,,,,2972190,26999491,20401756,0,-910204,,2715341,2715341,50096,RMBI
2019-12-31,,,-428908000,11363000,-329082000,141748000,337084000,15892000,15892000,,-95472000,,,,-99151000,1474477000,1458585000,1137393000,-444800000,,-329757000,-329082000,50097,SLCA
2018-12-31,,,-229953000,7484000,-200808000,133071000,410853000,128950000,128950000,,-70564000,,,,-29132000,1577298000,1448348000,1166445000,-358903000,,-200821000,-200808000,50097,SLCA
2017-12-31,,,136526000,7484000,145206000,105856000,374031000,170942000,170942000,,-31342000,,,,-8680000,1240851000,1069909000,866820000,-34416000,,145206000,145206000,50097,SLCA
2016-12-31,,,-77745000,7484000,-41056000,61572000,84515000,-45191000,-45191000,,-27972000,,,,-36689000,559625000,604816000,475110000,-32554000,,-41056000,-41056000,50097,SLCA
2019-12-28,10884000,,68922000,1384000,52068000,192097000,290211000,87230000,87230000,,-12755000,,,,16358000,704644000,617414000,414433000,-18308000,,52564000,52068000,50101,KAI
2018-12-29,10552000,,79528000,1603000,60413000,177085000,281830000,94193000,94193000,,-7032000,,,,18482000,633786000,539593000,351956000,-14665000,,61046000,60413000,50101,KAI
2017-12-30,9563000,,57653000,1513000,31092000,155253000,236284000,71468000,71468000,,-3547000,,,,26070000,515033000,443565000,278749000,-13815000,,31583000,31092000,50101,KAI
2016-12-31,7380000,,44549000,1650000,32077000,134071000,188539000,47088000,47088000,,-1293000,,,,12083000,414126000,367038000,225587000,-2539000,3000.0,32466000,32077000,50101,KAI
2019-12-31,,,10509000,,9710000,75225000,833294000,368209000,368209000,,-376346000,,,,799000,982901000,614692000,149607000,-357700000,,9710000,9710000,50102,MPLN
2018-12-31,,,44331000,,36223000,77558000,891420000,427541000,427541000,,-383261000,,,,8108000,1040883000,613342000,149463000,-383210000,,36223000,36223000,50102,MPLN
2017-12-31,,,61620000,,648132000,122920000,873611000,363636000,363636000,,-281972000,,,,-586512000,1067266000,703630000,193655000,-302016000,,648132000,648132000,50102,MPLN
2020-06-30,39149000,,-27005000,,-27236000,169969000,187786000,-22566000,-22566000,,-1973000,,,,231000,236545000,259111000,48759000,-4439000,,-27236000,-27236000,50103,CSII
2019-06-30,33166000,,-65000,,-255000,167700000,200337000,-825000,-825000,,-1684000,,,,190000,248017000,248842000,47680000,760000,,-255000,-255000,50103,CSII
2018-06-30,26552000,,1844000,,1712000,148569000,177559000,2234000,2234000,,-1717000,,,,132000,217043000,214809000,39484000,-390000,,1712000,1693000,50103,CSII
2017-06-30,22911000,,-1706000,,-1792000,144096000,165465000,-1542000,-1542000,,-500000,,,,86000,204906000,206448000,39441000,-164000,,-1792000,-1792000,50103,CSII
2019-12-31,,,-8676629,,-9274805,10994554,7998639,-2995915,-2995915,,-5127365,,,,598176,35583131,38579046,27584492,-5680714,,-9274805,-9274805,50104,ELYS
2018-12-31,,,-2526056,,-3628757,10588162,10432987,-155175,-155175,,-2615598,,,,1102701,34575097,34730272,24142110,-2370881,,-3628757,-3628757,50104,ELYS
2017-12-31,,,2424008,,1451084,5512683,8193047,2680364,2680364,,-506732,,,,972924,22865146,20184782,14672099,-256356,,1451084,1451084,50104,ELYS
2016-12-31,,,-1770634,,-1968659,4512812,3051944,-1460868,-1460868,,-736135,,,,198025,8897963,10358831,5846019,-309766,,-1968659,-1968659,50104,ELYS
2020-06-30,4694349,,-11416358,,-11416358,7120835,0,-11923768,-11923768,,-104280,,,,0,0,11923768,0,507410,,-11416358,-11416358,50107,ENOB
2019-06-30,2498107,,-18016480,,-18016480,8420216,0,-10990032,-10990032,,-43,,,,0,0,10990032,0,-7026448,,-18016480,-18016480,50107,ENOB
2018-06-30,616961,,-6423551,,-6311835,4693884,0,-5329329,-5329329,,-143262,,,,-111716,0,5329329,0,-1094222,,-6311835,-6311835,50107,ENOB
2017-06-30,62763,,-2207707,,-2142830,1696649,0,-2400427,-2400427,,-26259,,,,-64877,0,2400427,0,192720,,-2142830,-2142830,50107,ENOB
2019-12-31,,,898371000,5008000,893754000,3670174000,5254815000,1170140000,1170140000,339549000,-271769000,,,,5984000,5254815000,4084675000,0,-271769000,,892387000,893754000,50109,RKT
2018-12-31,,,615260000,6170000,612889000,3172596000,4308874000,844607000,844607000,214754000,-229347000,,,,2643000,4308874000,3464267000,0,-229347000,,612617000,612889000,50109,RKT
2017-12-31,,,771937000,6170000,770701000,3015295000,4252854000,952876000,952876000,215870000,-180939000,,,,1228000,4252854000,3299978000,0,-180939000,,770709000,770701000,50109,RKT
2019-12-31,1007631000,,3022253000,,2508574000,554317000,3926139000,2436351000,2436351000,-72160000,-171075000,,,,513679000,20337881000,17901530000,16411742000,585902000,,2508574000,2508574000,50112,IMOS
2018-12-31,939269000,,1782442000,,1325824000,538519000,3429995000,2085300000,2085300000,-133093000,-152416000,,,,456618000,18480027000,16394727000,15050032000,-302858000,,1325824000,1325824000,50112,IMOS
2017-12-31,985873000,,1532416000,,2796882000,704206000,3237126000,1621202000,1621202000,-74155000,-190425000,,,,550487000,17940855000,16319653000,14703729000,-88786000,1814953000.0,981929000,2796882000,50112,IMOS
2016-12-31,838866000,,1700435000,,1401210000,894986000,3642121000,1997165000,1997165000,-88896000,-144545000,,,,177120000,18387593000,16390428000,14745472000,-296730000,-122105000.0,1523315000,1707222000,50112,IMOS
2020-12-31,,,583227000,-62109000,436183000,213474000,6554200000,2206362000,2206362000,2050999000,-1431141000,,,,139748000,9894642000,7688280000,3340442000,-1623135000,,443479000,436183000,50113,ATUS
2019-12-31,,,187129000,9298000,138936000,233326000,6460331000,1896789000,1896789000,2067072000,-1590461000,,,,47190000,9760859000,7864070000,3300528000,-1709660000,,139939000,138936000,50113,ATUS
2018-12-31,,,-18061000,9295000,18833000,240273000,6393532000,1720927000,1720927000,2049993000,-1617979000,,,,-38655000,9566608000,7845681000,3173076000,-1738988000,,20594000,18833000,50113,ATUS
2017-12-31,,,-1367588000,1539000,1493177000,235983000,6271295000,981546000,981546000,2123195000,-1597650000,,,,-2862352000,9306950000,8325404000,3035655000,-2349134000,,1494764000,1493177000,50113,ATUS
2019-12-31,,,-4100297,,-4092297,9939632,5949044,-3990588,-3990588,,-109709,,,,-8000,109621943,113612531,103672899,-109709,,-4092297,-4092297,50114,FTHM
2018-12-31,,,-1636050,,-1663205,5386010,3868902,-1517108,-1517108,,-102123,,,,27155,77305562,78822670,73436660,-118942,,-1663205,-1663205,50114,FTHM
2017-12-31,,,-420562,,-420562,3818792,3475201,-343591,-343591,,-76971,,,,0,55378037,55721628,51902836,-76971,,-420562,-420562,50114,FTHM
2020-12-31,,,29423000,,20857000,44833000,83459000,0,32018000,6608000,,,,,8566000,83459000,51441000,0,-2595000,,20857000,19557000,50116,BCBP
2019-12-31,,,30343000,,21034000,46051000,85926000,0,31328000,8547000,,,,,9309000,85926000,54598000,0,-985000,,21034000,19688000,50116,BCBP
2018-12-31,,,24245000,,16763000,43655000,78511000,0,26360000,8496000,,,,,7482000,78511000,52151000,0,-2115000,,16763000,15810000,50116,BCBP
2017-12-31,,,20213000,,9982000,37685000,66923000,0,22954000,6284000,,,,,10231000,66923000,43969000,0,-2741000,,9982000,9368000,50116,BCBP
2019-12-31,69765000,,-80805000,,-80805000,153584000,144103000,-79246000,-79246000,,-8928000,,,,0,779796000,859042000,635693000,-1559000,,-80805000,-80805000,50118,RDFN
2018-12-31,53797000,,-41978000,,-41978000,109561000,119424000,-43934000,-43934000,,-3681000,,,,0,486920000,530854000,367496000,1956000,,-41978000,-41978000,50118,RDFN
2017-12-31,42532000,,-15002000,,-15002000,85260000,111820000,-15972000,-15972000,,-3681000,,,,0,370036000,386008000,258216000,970000,,-15002000,-190917000,50118,RDFN
2016-12-31,34588000,,-22526000,,-22526000,69140000,82744000,-20984000,-20984000,,-3681000,,,,0,267196000,288180000,184452000,-1542000,,-22526000,-78028000,50118,RDFN
2019-12-31,,,1694000000,,1254000000,3683000000,6348000000,2682000000,2682000000,-17000000,-654000000,,,,440000000,11120000000,8438000000,4772000000,-988000000,,1254000000,1254000000,50119,KDP
2018-12-31,,,791000000,,586000000,2635000000,4016000000,1365000000,1365000000,16000000,-452000000,,,,202000000,7442000000,6077000000,3426000000,-574000000,,589000000,586000000,50119,KDP
2017-12-31,,,728000000,265000000.0,2448000000,1168000000,2108000000,940000000,940000000,16000000,-140000000,,,,-1748000000,4680000000,3740000000,2572000000,-212000000,,2476000000,2448000000,50119,KDP
2017-09-30,,,567000000,218792000.0,378000000,1102000000,2044000000,942000000,942000000,16000000,-201000000,,,,184000000,4269000000,3327000000,2225000000,-375000000,,383000000,378000000,50119,KDP
2019-12-31,,,36553000,31616000,44436000,114898000,168118000,49414000,49414000,,-16721000,,,,-3748000,866933000,817519000,698815000,-12861000,,40301000,44436000,50123,AMRC
2018-12-31,,,42390000,14719000,37984000,111319000,173612000,59099000,59099000,,-14804000,,,,4813000,787138000,728039000,613526000,-16709000,,37577000,37984000,50123,AMRC
2017-12-31,,,28717000,10338000,37491000,103756000,144158000,36588000,36588000,,-9295000,,,,-4791000,717152000,680564000,572994000,-7871000,,33508000,37491000,50123,AMRC
2016-12-31,,,16367000,6847000,12032000,102548000,134344000,28776000,28776000,,-7454000,,,,4370000,651227000,622451000,516883000,-12409000,,11997000,12032000,50123,AMRC
2019-12-31,344673000,,-528386000,,-528805000,134449000,0,-479122000,-479122000,,-39291000,,,,419000,0,479122000,0,-49264000,,-528805000,-528805000,50126,BHVN
2018-12-31,189951000,,-240455000,,-240922000,34603000,0,-224554000,-224554000,,-11726000,,,,467000,0,224554000,0,-15901000,,-240922000,-240922000,50126,BHVN
2017-12-31,89441000,,-138190000,,-139196000,18141000,0,-107582000,-107582000,,-11726000,,,,1006000,0,107582000,0,-30608000,,-139196000,-139196000,50126,BHVN
2016-12-31,55529000,,-63444000,,-63677000,5109000,0,-60638000,-60638000,,-385000,,,,90000,0,60638000,0,-2806000,,-63534000,-63677000,50126,BHVN
2020-12-31,,,400782000,770650000,356402000,358181000,2238457000,512823000,512823000,1074000,-333021000,,,,38047000,3845980000,3333157000,1607523000,-112041000,,362735000,263346000,50128,DLR
2019-12-31,,,611216000,770253000,579761000,286397000,2024547000,635558000,635558000,14118000,-353057000,,,,11995000,3217308000,2581750000,1192761000,-24342000,,599221000,493011000,50128,DLR
2018-12-31,,,343199000,1015398000,331246000,236567000,1981474000,628093000,628093000,2818000,-321529000,,,,2084000,3079457000,2451364000,1097983000,-284894000,,341115000,249930000,50128,DLR
2017-12-31,,,264168000,754271000,248259000,211541000,1588833000,581851000,581851000,3077000,-258642000,,,,7901000,2483444000,1901593000,894611000,-317683000,,256267000,173148000,50128,DLR
2020-12-31,,,50025000,,36988000,70260000,128538000,0,53110000,5168000,,,,,13037000,128538000,75428000,0,-3085000,,36988000,36988000,50131,NFBK
2019-12-31,,,53022000,,40235000,65998000,126571000,0,54585000,5988000,,,,,12787000,126571000,71986000,0,-1563000,,40235000,40235000,50131,NFBK
2018-12-31,,,49711000,,40079000,59121000,116754000,0,50776000,6857000,,,,,9632000,116754000,65978000,0,-1065000,,40079000,40079000,50131,NFBK
2017-12-31,,,51746000,,24768000,59868000,117624000,0,51310000,6446000,,,,,26978000,117624000,66314000,0,436000,,24768000,24768000,50131,NFBK
2020-11-30,,,267895000,,164811000,1352764000,1661525000,308761000,308761000,,-48313000,,,,103084000,4719534000,4410773000,3058009000,-40866000,,164811000,164811000,50132,CNXC
2019-11-30,,,204416000,,117164000,1217037000,1748448000,364805000,364805000,,-92196000,,,,87252000,4707912000,4343107000,2959464000,-160389000,,117164000,117164000,50132,CNXC
2018-11-30,,,110908000,,48271000,680977000,937552000,182251000,182251000,,-38239000,,,,62637000,2463151000,2280900000,1525599000,-71343000,,48271000,48271000,50132,CNXC
2017-11-30,,,88277000,,72250000,569222000,749154000,115680000,115680000,,-24020000,,,,16027000,1990180000,1874500000,1241026000,-27403000,,72250000,72250000,50132,CNXC
2019-12-31,123660,,2314621,2550149,1912392,5651511,8620538,2613671,2613671,,-428371,,,,17436,27440110,24826439,18819572,-299050,,2297185,1912392,50133,FSI
2018-12-31,135930,,3054847,2462231,2490268,4412976,5636834,1087928,1087928,,-93653,,,,633130,17829518,16741590,12192684,1966919,,2421717,2490268,50133,FSI
2017-12-31,98928,,3420555,2462231,1754741,4112582,5934152,1721451,1721451,,-44125,,,,1665814,15494325,13772874,9560173,1699104,,1754741,1754741,50133,FSI
2016-12-31,95098,,3079260,2462231,1793334,3646942,6989488,3247448,3247448,,-41699,,,,1285926,16246014,12998566,9256526,-168188,,1793334,1793334,50133,FSI
2020-06-30,,,-595000000,4000000,-878000000,626000000,6885000000,463000000,463000000,2083000000,-379000000,,,,255000000,29245000000,28782000000,22360000000,-1058000000,,-850000000,-878000000,50134,HMY
2019-06-30,,,-2746000000,4000000,-2607000000,740000000,6237000000,-2450000000,-2450000000,-135000000,-271000000,,,,-139000000,26912000000,29362000000,20675000000,-296000000,,-2607000000,-2607000000,50134,HMY
2018-06-30,,,-4707000000,4000000,-4473000000,768000000,4970000000,1353000000,1353000000,144000000,-45000000,,,,-234000000,20452000000,19099000000,15482000000,-6060000000,,-4473000000,-4473000000,50134,HMY
2017-06-30,,,-148000000,4000000,362000000,533000000,3936000000,-288000000,-288000000,-787000000,-45000000,,,,-510000000,19494000000,19782000000,15558000000,140000000,,362000000,362000000,50134,HMY
2019-12-31,2116018,,-4300969,,-4300969,12078762,5614124,-8580656,-8580656,,-972165,,,,0,19090071,27670727,13475947,4279687,,-4300969,-4300969,50135,TBLT
2018-12-31,1816389,,-27651412,,-27651412,6937704,3495194,-5258899,-5258899,,-3321439,,,,0,15289400,20548299,11794206,-22392513,,-27651412,-32299407,50135,TBLT
2017-12-31,1675093,,-5941457,,-5941457,6070868,3966998,-3778963,-3778963,,-2162494,,,,0,14201836,17980799,10234838,-2162494,,-5941457,-5941457,50135,TBLT
2016-12-31,1247449,,-4732331,,-4732331,4397797,1715429,-3929817,-3929817,,-802514,,,,0,9216863,13146680,7501434,-802514,,-4732331,-4732331,50135,TBLT
2019-12-31,,,-109443000,5285000,-107862000,122096000,29753000,-100191000,-100191000,,-5651000,,,,0,556604000,656795000,526851000,-9252000,,-109443000,-137232000,50136,OSH
2018-12-31,,,-79715000,4220000,-79544000,76269000,4414000,-76037000,-76037000,,-3688000,,,,0,317938000,393975000,313524000,-3678000,,-79715000,-118662000,50136,OSH
2017-12-31,,,-42462000,4220000,-42462000,32930000,-6514000,-41950000,-41950000,,-1184000,,,,0,184980000,226930000,191494000,-512000,,-42462000,-54945000,50136,OSH
2019-12-31,9314000,,-56515000,,-56515000,12481000,-24091000,-45886000,-45886000,,,,,,0,1448000,47334000,25539000,-10629000,,-56515000,-84558000,50137,IDRA
2018-12-31,15806000,,-59881000,,-59881000,15420000,-25373000,-56599000,-56599000,,-11000.0,,,,0,662000,57261000,26035000,-3282000,,-59881000,-59881000,50137,IDRA
2017-12-31,25662000,,-65984000,,-65984000,15588000,-18512000,-59762000,-59762000,,-50000.0,,,,0,902000,60664000,19414000,-6222000,,-65984000,-65984000,50137,IDRA
2016-12-31,24095000,,-38389000,,-38389000,15132000,470000,-38757000,-38757000,,-80000.0,,,,0,16199000,54956000,15729000,368000,,-38389000,-38389000,50137,IDRA
2020-06-30,,,-24511766,,-24656475,10479600,34460604,23981004,23981004,,-9671013,,,,144709,34460604,10479600,0,-48492770,,-24656475,-24656475,50140,ICMB
2019-06-30,,,-14384201,,-14542229,11092651,34397822,23305171,23305171,,-9648304,,,,158028,34397822,11092651,0,-37689372,,-14542229,-14542229,50140,ICMB
2018-06-30,,,18204817,,15625480,12230470,40791752,28561282,28561282,,-7006312,,,,2579337,40791752,12230470,0,-10356465,,15625480,15625480,50140,ICMB
2017-06-30,,,23579465,,23579465,9632747,31012197,21379450,21379450,,-5680866,,,,0,31012197,9632747,0,2200015,,23579465,23579465,50140,ICMB
2019-12-31,,,-50018000,,-46741000,103223000,205812000,10477000,10477000,266000,-57155000,,,,-3277000,847451000,836974000,641639000,-60495000,,-46741000,-47383000,50141,NNBR
2018-12-31,,,-276400000,,-262987000,93583000,181476000,15876000,15876000,889000,-61243000,,,,-13413000,770657000,754781000,589181000,-292276000,,-262987000,-262987000,50141,NNBR
2017-12-31,,,-54996000,,162237000,74112000,159379000,32510000,32510000,351000,-52085000,,,,-79545000,619793000,587283000,460414000,-87506000,137688000.0,24549000,162237000,50141,NNBR
2016-12-31,,,-24928000,32000.0,6663000,64144000,156111000,40437000,40437000,809000,-65927000,,,,-15438000,584954000,544517000,428843000,-65365000,16153000.0,-9490000,6663000,50141,NNBR
2020-05-31,,,6531438,,6531438,2710278,15501523,12791245,12791245,,-3117053,,,,0,15501523,2710278,0,-6259807,,6531438,6531438,50142,NPV
2019-05-31,,,18145761,,18145761,2678741,15803477,13124736,13124736,,-3560161,,,,0,15803477,2678741,0,5021025,,18145761,18145761,50142,NPV
2018-05-31,,,4407967,,4407967,2712697,15392932,12680235,12680235,,-2616320,,,,0,15392932,2712697,0,-8272268,,4407967,4407967,50142,NPV
2017-05-31,,,1496823,,1496823,3525090,15438236,11913146,11913146,,-1584247,,,,0,15438236,3525090,0,-10416323,,1496823,1496823,50142,NPV
2019-12-31,,,22120030,,22120030,2411600,17975668,15564068,15564068,,-10131,,,,0,17975668,2411600,0,6555962,,22120030,22120030,50145,TSI
2018-12-31,,,5333665,,5333665,2324115,16666843,14342728,14342728,,10217,,,,0,16666843,2324115,0,-9009063,,5333665,5333665,50145,TSI
2017-12-31,,,19899458,,19899458,2326433,15004323,12677890,12677890,,10217,,,,0,15004323,2326433,0,7221568,,19899458,19899458,50145,TSI
2016-12-31,,,12442385,,12442385,2379951,14622908,12242957,12242957,,10217,,,,0,14622908,2379951,0,199428,,12442385,12442385,50145,TSI
2019-12-31,,,659061000,,555713000,77072000,780444000,669212000,669212000,17572000,-10151000,,,,103348000,867567000,198355000,87123000,-10151000,,555713000,555713000,50146,ESNT
2018-12-31,,,546699000,,467363000,75011000,662338000,556878000,556878000,15376000,-10179000,,,,79336000,719353000,162475000,57015000,-10179000,,467363000,467363000,50146,ESNT
2017-12-31,,,398568000,,379747000,75011000,422434000,403746000,403746000,15376000,-5178000,,,,18821000,576511000,172765000,154077000,-5178000,,379747000,379747000,50146,ESNT
2016-12-31,,,311882000,,222606000,67163000,396352000,312308000,312308000,15376000,-426000,,,,89276000,458258000,145950000,61906000,-426000,,222606000,222606000,50146,ESNT
2020-03-31,190760000,,-288228000,,-288989000,72127000,0,-262887000,-262887000,,-12663000,,,,761000,0,262887000,0,-25341000,,-288989000,-288989000,50147,MYOV
2019-03-31,222607000,,-273075000,,-273551000,42219000,0,-264826000,-264826000,,-8821000,,,,476000,0,264826000,0,-8249000,,-273551000,-273551000,50147,MYOV
2018-03-31,116832000,,-143042000,,-143255000,24231000,0,-141063000,-141063000,,-2046000,,,,213000,0,141063000,0,-1979000,,-143255000,-143255000,50147,MYOV
2017-03-31,43500000,,-83514000,,-83440000,12357000,0,-55857000,-55857000,,-2046000,,,,-74000,0,55857000,0,-27657000,,-83440000,-83440000,50147,MYOV
2019-12-31,,,705891000,4850000,566841000,530839000,2185222000,914413000,914413000,-3948000,-147368000,,,,139210000,5388679000,4474266000,3203457000,-208522000,,566681000,566841000,50149,WCN
2018-12-31,,,707140000,5580000,546871000,503816000,2057237000,872934000,872934000,-492000,-132104000,,,,159986000,4922941000,4050007000,2865704000,-165794000,,547154000,546871000,50149,WCN
2017-12-31,,,508510000,5400000,576817000,476969000,1925713000,748148000,748148000,68112000,-125297000,,,,-68910000,4630488000,3882340000,2704775000,-239638000,,577420000,576817000,50149,WCN
2016-12-31,,,361365000,7362000,246540000,382262000,1418151000,571008000,571008000,969000,-94109000,,,,114044000,3375863000,2804855000,1957712000,-209643000,,247321000,246540000,50149,WCN
2019-12-31,5344000,,1757000,,1798000,17404000,24343000,1595000,1595000,,,,,,-41000,40752000,39157000,16409000,162000,,1798000,1798000,50150,SSTI
2018-12-31,4987000,,-2738000,,-2725000,16602000,19907000,-1682000,-1682000,,,,,,-13000,34753000,36435000,14846000,-1056000,,-2725000,-2725000,50150,SSTI
2017-12-31,4159000,,-9820000,,-9980000,11774000,12393000,-3540000,-3540000,,-1114000.0,,,,160000,23763000,27303000,11370000,-6280000,,-9980000,-9980000,50150,SSTI
2016-12-31,4093000,,-6860000,,-6860000,6837000,5958000,-4972000,-4972000,,-1317000.0,,,,0,15507000,20479000,9549000,-1888000,,-6860000,-6860000,50150,SSTI
2020-12-31,,,20742000000,2211000000,15403000000,41704000000,67000000000,22405000000,22405000000,,-1663000000,,,,4973000000,257141000000,234736000000,190141000000,-1663000000,,15769000000,15403000000,50151,UNH
2019-12-31,,,17981000000,4546000000,13839000000,35193000000,57598000000,19685000000,19685000000,,-1704000000,,,,3742000000,242155000000,222470000000,184557000000,-1704000000,,14239000000,13839000000,50151,UNH
2018-12-31,,,15944000000,4531000000,11986000000,34074000000,53846000000,17344000000,17344000000,,-1400000000,,,,3562000000,226247000000,208903000000,172401000000,-1400000000,,12382000000,11986000000,50151,UNH
2017-12-31,,,14023000000,4246000000,10558000000,29557000000,47011000000,15209000000,15209000000,,-1186000000,,,,3200000000,201159000000,185950000000,154148000000,-1186000000,,10823000000,10558000000,50151,UNH
2020-03-31,,,-66929648,,-71198379,47913772,11435060,-36826178,-36826178,,-2511720,,,,4268731,11435060,48261238,0,-30103470,,-71198379,-71198379,50152,HX
2019-03-31,,,7405253,,5532581,49647350,61330504,5097768,5097768,,-2511720,,,,1872672,61330504,56232736,0,2307485,,5532581,5532581,50152,HX
2018-03-31,,,76536315,,65481973,29553535,107257841,75875438,75875438,,-2511720,,,,11025690,107257841,31382403,0,660877,,65510625,65481973,50152,HX
2017-03-31,,,10093075,,8570864,13006997,22920543,9913546,9913546,,-2511720,,,,1522211,22920543,13006997,0,179529,,8570864,8570864,50152,HX
2019-12-31,18271000,,61990000,,50660000,150603000,259144000,79497000,79497000,10773000,-1579000,,,,11330000,1185424000,1105927000,926280000,-17507000,,50660000,50660000,50153,MTRN
2018-12-31,15187000,,16342000,,20846000,196165000,251105000,26424000,26424000,13329000,-2471000,,,,-4504000,1207815000,1181391000,956710000,-10082000,,20846000,20846000,50153,MTRN
2017-12-31,13981000,,36396000,,11451000,145732000,212829000,38735000,38735000,14381000,-2183000,,,,24945000,1139447000,1100712000,926618000,-2339000,,11451000,11451000,50153,MTRN
2016-12-31,12802000,,25315000,,25740000,130748000,184528000,30567000,30567000,10411000,-1789000,,,,-425000,969236000,938669000,784708000,-5252000,,25740000,25740000,50153,MTRN
2020-06-30,73019000,,-7401000,,-9229000,157725000,253135000,2021000,2021000,,-3856000,,,,1828000,442221000,440200000,189086000,-9422000,,-9229000,-9229000,50154,EPAY
2019-06-30,67364000,,6894000,,9432000,147066000,239243000,3477000,3477000,,-3783000,,,,-2538000,421962000,418485000,182719000,3417000,,9432000,9432000,50154,EPAY
2018-06-30,57500000,,1125000,,9328000,135247000,220654000,5831000,5831000,,-11170000,,,,-8203000,394096000,388265000,173442000,-4706000,,9328000,9328000,50154,EPAY
2017-06-30,53055000,,-38274000,,-33137000,123856000,187498000,-13659000,-13659000,,-17059000,,,,-5137000,349412000,363071000,161914000,-24615000,,-33137000,-33137000,50154,EPAY
2020-06-30,120000,,-5168642,,-11626597,1598984,0,-5163601,-5163601,,-5041,,,,0,0,5163601,0,-5041,-6457955,-5168642,-11626597,50155,CSCW
2019-06-30,120000,,-6659422,,-14388530,2065829,0,-6658029,-6658029,,-1477,,,,0,0,6658029,0,-1393,-7729108,-6659422,-14388530,50155,CSCW
2018-06-30,120000,,-2307119,,-7399965,918605,0,-2307106,-2307106,,-26,,,,0,0,2307106,0,-13,-5092846,-2307119,-7399965,50155,CSCW
2017-06-30,846438,,-11038120,,-11038120,5380702,1094936,-8773267,-8773267,,-830978,,,,0,45048413,53821680,43953477,-2264853,-5092846,-11038120,-11038120,50155,CSCW
2020-03-31,,,-747826000,-269000,-697186000,159151000,250167000,-6450000,-6450000,-1636000,-151622000,,,,-50696000,1190644000,1197094000,940477000,-741376000,,-697130000,-722974000,50156,VTOL
2019-03-31,,,-336299000,7148000,-336847000,183870000,226009000,-80487000,-80487000,-2273000,-113500000,,,,-161000,1307907000,1388394000,1081898000,-255812000,,-336138000,-336847000,50156,VTOL
2018-03-31,,,-228000000,7253000,-194684000,174175000,256076000,-40949000,-40949000,-1192000,-77737000,,,,-30891000,1373437000,1414386000,1117361000,-187051000,,-197109000,-194684000,50156,VTOL
2017-03-31,,,-143328000,11911000,-169562000,182968000,234046000,-54931000,-54931000,-2339000,-50862000,,,,32588000,1335430000,1390361000,1101384000,-88397000,,-175916000,-169562000,50156,VTOL
2020-07-31,,,2947797,,2947797,716082,4158553,3442471,3442471,,-739958,,,,0,4158553,716082,0,-494674,,2947797,2947797,50157,MZA
2019-07-31,,,5962695,,5962695,708304,4302420,3594116,3594116,,-1007431,,,,0,4302420,708304,0,2368579,,5962695,5962695,50157,MZA
2018-07-31,,,864754,,864754,697123,4568662,3871539,3871539,,-814269,,,,0,4568662,697123,0,-3006785,,864754,864754,50157,MZA
2017-07-31,,,-525116,,-525116,696822,4686365,3989543,3989543,,-652438,,,,0,4686365,696822,0,-4514659,,-525116,-525116,50157,MZA
2020-12-31,,,-2408000000,,-1857000000,170000000,-2205000000,-2388000000,-2388000000,,,,,,-551000000,22388000000,24776000000,24593000000,-20000000,,-1857000000,-1857000000,50159,IMO
2019-12-31,,,2046000000,,2200000000,1043000000,4728000000,2040000000,2040000000,,-93000000.0,,,,-154000000,34002000000,31962000000,29274000000,6000000,,2200000000,2200000000,50159,IMO
2018-12-31,,,3073000000,,2314000000,1015000000,5635000000,3092000000,3092000000,,-108000000.0,,,,759000000,34964000000,31872000000,29329000000,-19000000,,2314000000,2314000000,50159,IMO
2017-12-31,,,582000000,,490000000,1005000000,3721000000,361000000,361000000,,-78000000.0,,,,92000000,29125000000,28764000000,25404000000,221000000,,490000000,490000000,50159,IMO
2020-12-31,,,492200000,,24000000,21100000,754500000,576500000,576500000,,-94700000,,,,7300000,1091900000,515400000,337400000,-84300000,,484900000,24000000,50167,HESM
2019-12-31,,,372600000,1200600000.0,66700000,26200000,571500000,402800000,402800000,,-62400000,,,,-100000,848300000,445500000,276800000,-30200000,,372700000,66700000,50167,HESM
2018-12-31,,,372300000,2209000000.0,69100000,14100000,519200000,378200000,378200000,,-53300000,,,,0,712700000,334500000,193500000,-5900000,,372300000,69100000,50167,HESM
2017-12-31,,,216600000,2049300000.0,40400000,13900000,393500000,263100000,263100000,,-25800000,,,,0,579500000,316400000,186000000,-46500000,,216600000,40400000,50167,HESM
2020-03-31,,,2624000,7085000,7656000,39617000,52570000,7272000,7272000,,-4695000,,,,-544000,236785000,229513000,184215000,-4648000,8065000,3168000,7656000,50168,AIRTP
2019-03-31,,,5968000,4475000,1340000,33607000,50192000,9346000,9346000,,-3485000,,,,1761000,215502000,206156000,165310000,-3378000,-1006000,4207000,1340000,50168,AIRTP
2018-03-31,195653.0,,2651607,1118172,2277109,29138534,36288800,4525881,4525881,,-1852632,,,,195000,194519345,189993464,158230545,-1874274,-1006000,2456607,2277109,50168,AIRTP
2017-03-31,1042496.0,,-4219186,640763,-3213539,22205947,23329515,-1715773,-1715773,,-571651,,,,725000,148471659,150187432,125142144,-2503413,-1006000,-4944186,-3213539,50168,AIRTP
2019-12-31,750000,,2889000,-1619000,2315000,11862000,15914000,3302000,3302000,,-640000,,,,157000,73459000,70157000,57545000,-413000,-541000,2732000,2315000,50170,PESI
2018-12-31,1370000,,-2010000,-1495000,-1421000,10741000,11784000,-327000,-327000,,-289000,,,,-936000,49539000,49866000,37755000,-1683000,-667000,-1074000,-1421000,50170,PESI
2017-12-31,1595000,,-4823000,110000,-3680000,11101000,10020000,-2676000,-2676000,,-350000,,,,-1285000,49769000,52445000,39749000,-2147000,-592000,-3538000,-3680000,50170,PESI
2016-12-31,2046000,,-16257000,560000,-13405000,10724000,7671000,-5099000,-5099000,,-597000,,,,-2994000,51219000,56318000,43548000,-11158000,-730000,-13263000,-13405000,50170,PESI
2019-12-31,27992000,,8965000,20161000,9959000,31894000,62015000,5548000,5548000,-3419000,-3034000,,,,586000,431427000,425879000,369412000,3417000,,8379000,9959000,50172,CAAS
2018-12-31,33551000,,-1386000,18950000,2377000,36482000,64198000,-3353000,-3353000,-2482000,-2928000,,,,-1465000,496158000,499511000,431960000,1967000,,79000,2377000,50172,CAAS
2017-12-31,33544000,,22994000,6681000,-19346000,36925000,83703000,17086000,17086000,-3852000,-1753000,,,,41633000,499063000,481977000,415360000,5908000,,-18639000,-19346000,50172,CAAS
2016-12-31,27706000,,25461000,5412000,22511000,30957000,79607000,22993000,22993000,-2049000,-656000,,,,2484000,462050000,439057000,382443000,2468000,,22977000,22511000,50172,CAAS
2019-12-31,,,6085000,175635000,2784000,105234000,265549000,39646000,39646000,,-2688000,,,,1949000,1291589000,1251943000,1026040000,-33561000,,4136000,2784000,50173,WTTR
2018-12-31,,,56003000,277839000,36512000,94127000,329019000,101179000,101179000,,-5311000,,,,1704000,1528930000,1427751000,1199911000,-45176000,,54299000,36512000,50173,WTTR
2017-12-31,,,-35978000,406722000,-16816000,55526000,159425000,450000,450000,,-6629000,,,,-851000,692491000,692041000,533066000,-36428000,,-35127000,-16816000,50173,WTTR
2016-12-31,,,-314472000,221992000,-307524000,34643000,50892000,-80858000,-80858000,,-16128000,,,,-524000,302399000,383257000,251507000,-233614000,,-313948000,-1043000,50173,WTTR
2020-12-31,139837000,,-39631000,,-43609000,85619000,199351000,-44518000,-44518000,,-10340000,,,,3978000,242747000,287265000,43396000,4887000,,-43609000,-43609000,50176,RMBS
2019-12-31,156815000,,-87016000,,-90419000,98916000,172652000,-83079000,-83079000,,-9852000,,,,3403000,224027000,307106000,51375000,-3937000,,-90419000,-90419000,50176,RMBS
2018-12-31,158339000,,-70628000,,-157957000,103911000,177500000,-84750000,-84750000,,-16282000,,,,87329000,231201000,315951000,53701000,14122000,,-157957000,-157957000,50176,RMBS
2017-12-31,149135000,,40989000,,-22862000,110940000,313949000,53874000,53874000,,-13720000,,,,63851000,393096000,339222000,79147000,-12885000,,-22862000,-22862000,50176,RMBS
2019-12-31,117363000,,-165662000,,-163422000,57218000,1708000,-172873000,-172873000,,-1538000,,,,-2240000,2513000,175386000,805000,7211000,,-163422000,-163422000,50177,ORTX
2018-12-31,205319000,,-229525000,,-230495000,31366000,1654000,-235031000,-235031000,,-1538000,,,,970000,2076000,237107000,422000,5506000,,-230495000,-230495000,50177,ORTX
2017-12-31,32527000,,-39691000,,-39744000,5985000,0,-38512000,-38512000,,-1538000,,,,53000,0,38512000,0,-1179000,,-39744000,-39744000,50177,ORTX
2016-12-31,16206000,,-19065000,,-19085000,2997000,0,-19203000,-19203000,,-1538000,,,,20000,0,19203000,0,138000,,-19085000,-19085000,50177,ORTX
2019-12-31,,,15869000,,15324000,48404000,78083000,-66093000,-66093000,,-62464000,,,,545000,131718000,197811000,53635000,81962000,,15324000,15324000,50178,GSAT
2018-12-31,,,-6391000,,-6516000,55579000,78024000,-67993000,-67993000,,-43612000,,,,125000,130113000,198106000,52089000,61602000,,-6516000,-6516000,50178,GSAT
2017-12-31,,,-88884000,,-89074000,39099000,64851000,-51746000,-51746000,,-34771000,,,,190000,112660000,164406000,47809000,-37138000,,-89074000,-89074000,50178,GSAT
2016-12-31,,,-139189000,,-132646000,40982000,55046000,-63326000,-63326000,,-35952000,,,,-6543000,96861000,160187000,41815000,-75863000,,-132646000,-132646000,50178,GSAT
2019-12-29,,,17551968,,13246990,56099521,80681265,19761488,19761488,,-1568815,,,,4304978,294313548,274552060,213632283,-2209520,,13246990,13246990,50179,BGSF
2018-12-30,,,21409280,,17549541,51066327,76595192,20484378,20484378,,-2850405,,,,3859739,286862926,266378548,210267734,924902,,17549541,17549541,50179,BGSF
2017-12-31,,,14507634,,5848434,44575015,68401998,17535025,17535025,,-3253134,,,,8659200,272600050,255065025,204198052,-3027391,,5848434,5848434,50179,BGSF
2016-12-25,,,11170081,,6882407,37971601,60073366,15368424,15368424,,-3961617,,,,4287674,253852214,238483790,193778848,-4198343,,6882407,6882407,50179,BGSF
2019-12-31,,,9588000,30083000,9234000,14249000,64460000,27331000,27331000,,-17472000,,,,0,70726000,43395000,6266000,-17743000,,9588000,3412000,50180,GMRE
2018-12-31,,,14561000,30455000,13490000,10422000,48770000,22244000,22244000,,-14975000,,,,0,53192000,30948000,4422000,-7683000,,14561000,7668000,50180,GMRE
2017-12-31,,,-87000,12678000,-38000,7879000,27221000,9871000,9871000,,-7435000,,,,0,30344000,20473000,3123000,-9958000,,-87000,-1752000,50180,GMRE
2016-12-31,,,-6353000,12678000,-6353000,4292000,6777000,108000,108000,,-4139000,,,,0,8211000,8103000,1434000,-6461000,,-6353000,-6353000,50180,GMRE
2020-08-31,,,-806427000,41336000,-729829000,1631819000,1269142000,-362677000,-362677000,,-103600000,,,,-37785000,3438881000,3801558000,2169739000,-443750000,,-768642000,-729829000,50181,ONE
2019-08-31,,,287744000,65123000,245368000,1693267000,1921806000,228539000,228539000,,-60637000,,,,121541000,3993873000,3765334000,2072067000,59205000,,166203000,245368000,50181,ONE
2018-08-31,,,322935000,70568000,245936000,1220185000,1449602000,229417000,229417000,,-18660000,,,,108479000,2862692000,2633275000,1413090000,93518000,,214456000,-721235000,50181,ONE
2017-08-31,,,335321000,28458000,258827000,750553000,1055291000,304738000,304738000,,-192000,,,,92016000,2057557000,1752819000,1002266000,30583000,,243305000,147056000,50181,ONE
2020-04-24,2331000000,,4275000000,135000000,4959000000,11673000000,19644000000,5269000000,5269000000,371000000,-679000000,,,,-701000000,28913000000,23644000000,9269000000,-994000000,,4976000000,4959000000,50182,MDT
2019-04-26,2330000000,,5300000000,121000000,4724000000,11955000000,21493000000,6771000000,6771000000,437000000,-959000000,,,,557000000,30557000000,23786000000,9064000000,-1471000000,,4743000000,4724000000,50182,MDT
2018-04-27,2256000000,,5675000000,102000000,3104000000,10077000000,20914000000,6545000000,6545000000,213000000,-1146000000,,,,2580000000,29953000000,23408000000,9039000000,-870000000,,3095000000,3104000000,50182,MDT
2017-04-28,2193000000,,4602000000,122000000,4028000000,9715000000,20464000000,6110000000,6110000000,466000000,-1094000000,,,,578000000,29710000000,23600000000,9246000000,-1508000000,,4024000000,4028000000,50182,MDT
2020-03-31,3649000,,-21886000,,-21898000,22211000,9595000,-16265000,-16265000,,-5198000,,,,12000,68926000,85191000,59331000,-5621000,,-21898000,-21985000,50185,CPST
2019-03-31,3600000,,-16651000,,-16659000,20958000,10230000,-14328000,-14328000,,-1502000,,,,8000,83412000,97740000,73182000,-2323000,,-16659000,-16659000,50185,CPST
2018-03-31,4040000,,-10008000,,-10026000,18709000,16401000,-6348000,-6348000,,-606000,,,,18000,82837000,89185000,66436000,-3660000,,-10026000,-10026000,50185,CPST
2017-03-31,5388000,,-25225000,,-25244000,20651000,8267000,-17772000,-17772000,,-536000,,,,19000,77169000,94941000,68902000,-7453000,,-25244000,-25244000,50185,CPST
2019-12-31,,,-21000000,,96000000,101000000,328000000,116000000,116000000,4000000,-2000000,,,,-117000000,2444000000,2328000000,2116000000,-137000000,,96000000,96000000,50186,VRS
2018-12-31,,,171000000,,171000000,89000000,361000000,157000000,157000000,4000000,-33000000,,,,0,2682000000,2525000000,2321000000,14000000,,171000000,171000000,50186,VRS
2017-12-31,,,-38000000,,-30000000,91000000,211000000,10000000,10000000,1000000,-38000000,,,,-8000000,2461000000,2451000000,2250000000,-48000000,,-30000000,-30000000,50186,VRS
2016-12-31,,,1126000000,,1146000000,106000000,265000000,3000000,3000000,6000000,-56000000,,,,-20000000,2641000000,2638000000,2376000000,1123000000,,1146000000,1146000000,50186,VRS
2019-12-31,,,172081000,105530000,150248000,22521000,448290000,289004000,289004000,,-177493000,,,,7477000,601256000,312252000,152966000,-116923000,,164604000,124546000,50187,TGP
2018-12-31,,,30088000,98614000,28316000,28512000,357197000,204307000,204307000,,-111896000,,,,3213000,510762000,306455000,153565000,-174219000,,26875000,2615000,50187,TGP
2017-12-31,,,49735000,102537000,33565000,18141000,322935000,199249000,199249000,,-87369000,,,,824000,432676000,233427000,109741000,-149514000,,48911000,19586000,50187,TGP
2016-12-31,,,158938000,89559000,137696000,19199000,306898000,192157000,192157000,,-69157000,,,,973000,396444000,204287000,89546000,-33219000,,157965000,134977000,50187,TGP
2020-03-31,691886,,-5813891,,-5813891,4628881,3758854,-1561913,-1561913,,-409703,,,,0,14803024,16364937,11044170,-4251978,,-5813891,-5813891,50189,UUU
2019-03-31,502845,,-1347986,,-1347986,4864522,5554231,186864,186864,,-484953,,,,0,17588040,17401176,12033809,-1534850,,-1347986,-1347986,50189,UUU
2018-03-31,653899,,-2262310,,-2262310,4616391,4544055,-726235,-726235,,-213125,,,,0,14873189,15599424,10329134,-1536075,,-2262310,-2262310,50189,UUU
2017-03-31,682508,,-2058902,,-2058902,4444230,4148598,-978140,-978140,,-63252,,,,0,14083428,15061568,9934830,-1080762,,-2058902,-2058902,50189,UUU
2020-12-31,7827000,,22504000,,17068000,74438000,111032000,22821000,22821000,,-317000,,,,5436000,148376000,125555000,37344000,-317000,,17068000,17068000,50190,TTGT
2019-12-31,8107000,,22048000,,16875000,66550000,102099000,22739000,22739000,,-742000,,,,5173000,133957000,111218000,31858000,-691000,,16875000,16875000,50190,TTGT
2018-12-31,8869000,,14843000,,12955000,62336000,92374000,17321000,17321000,,-1300000,,,,1888000,121333000,104012000,28959000,-2478000,,12955000,12955000,50190,TTGT
2017-12-31,8215000,,9717000,,6803000,56959000,80220000,10410000,10410000,,-1272000,,,,2914000,108556000,98146000,28336000,-693000,,6803000,6803000,50190,TTGT
2020-12-31,,,34468000,,28145000,44807000,85874000,0,35006000,6061000,,,,,6323000,85874000,50868000,0,-538000,,28145000,28145000,50192,RRBI
2019-12-31,,,30464000,,24824000,40624000,77799000,0,30901000,6274000,,,,,5640000,77799000,46898000,0,-437000,,24824000,24824000,50192,RRBI
2018-12-31,,,28356000,,23056000,37361000,71778000,0,28998000,5419000,,,,,5300000,71778000,42780000,0,-642000,,23056000,23056000,50192,RRBI
2017-12-31,,,22531000,,13985000,34446000,63004000,0,22531000,6027000,,,,,8546000,63004000,40473000,0,0,,13985000,13985000,50192,RRBI
2020-12-31,30997000,,-14474000,,-17092000,52220000,75446000,-7572000,-7572000,-199000,-5923000,,,,2618000,262881000,270453000,187435000,-6902000,,-17092000,-17092000,50194,CRNT
2019-12-31,26793000,,132000,,-2344000,61855000,96842000,8194000,8194000,-199000,-5923000,,,,2476000,285583000,277389000,188741000,-8062000,,-2344000,-2344000,50194,CRNT
2018-12-31,28180000,,19795000,,23046000,61989000,116169000,26000000,26000000,-199000,-5923000,,,,-3251000,343874000,317874000,227705000,-5735000,,23046000,23046000,50194,CRNT
2017-12-31,25703000,,17257000,,15560000,58485000,107335000,23147000,23147000,-199000,-5923000,,,,1697000,332033000,308886000,224698000,-4144000,,15560000,15560000,50194,CRNT
2020-10-31,,,26951925,,26951925,1759193,3980090,2220897,2220897,,-253,,,,0,3980090,1759193,0,24731028,,26951925,25339425,50197,BCV
2019-10-31,,,23720345,,23720345,1690275,3945784,2255509,2255509,,-876,,,,0,3945784,1690275,0,21464836,,23720345,22107845,50197,BCV
2018-10-31,,,7293844,,7293844,1609095,3158597,1549502,1549502,,-143,,,,0,3158597,1609095,0,5744342,,7293844,5681344,50197,BCV
2017-10-31,,,20106888,,20106888,1567482,4124623,2557141,2557141,,-143,,,,0,4124623,1567482,0,17549747,,20106888,18494388,50197,BCV
2020-12-31,,,688300000,,558600000,3942400000,4674500000,732100000,732100000,,-43700000,,,,129700000,7165900000,6433800000,2491400000,-43800000,,558600000,558600000,50198,ORI
2019-12-31,,,1322200000,,1056400000,3278500000,4641100000,1362600000,1362600000,,-40000000,,,,265800000,7213700000,5851100000,2572600000,-40400000,,1056400000,1056400000,50198,ORI
2018-12-31,,,438100000,,370500000,3080600000,3561100000,480500000,480500000,,-42200000,,,,67600000,6021800000,5541300000,2460700000,-42400000,,370500000,370500000,50198,ORI
2017-12-31,,,725300000,,560500000,2995700000,3784400000,788700000,788700000,,-63000000,,,,164800000,6263100000,5474400000,2478700000,179000000,,560500000,560500000,50198,ORI
2019-12-31,,,81301000,2231000,80081000,15566000,163967000,102698000,102698000,,-33094000,,,,538000,187478000,84780000,23511000,-21397000,,80763000,80081000,50202,ADC
2018-12-31,,,59314000,2411000,58172000,11756000,120111000,75325000,75325000,,-24872000,,,,516000,137122000,61797000,17011000,-16011000,,58798000,58172000,50202,ADC
2017-12-31,,,59017000,2529000,58112000,9428000,99050000,62961000,62961000,,-18137000,,,,227000,111517000,48556000,12467000,-3944000,,58790000,58112000,50202,ADC
2016-12-31,,,45950000,2532000,45118000,7986000,82931000,51662000,51662000,,-15343000,,,,153000,91527000,39865000,8596000,-5712000,,45797000,45118000,50202,ADC
2019-12-31,,,107306599,,107306599,8283215,11341571,3058191,3058191,165,-194327,,,,0,11341571,8283380,0,104248408,,107306599,102974611,50203,GGN
2018-12-31,,,-89535845,,-89535845,8829943,18120467,9290524,9290524,165,-121913,,,,0,18120467,8829943,0,-98826369,,-89535845,-93930738,50203,GGN
2017-12-31,,,55418661,,55418661,9716063,18350382,8634319,8634319,165,-115214,,,,0,18350382,9716063,0,46784342,,55418661,51017116,50203,GGN
2016-12-31,,,129095557,,129095557,9548145,12791318,3243173,3243173,165,-28385,,,,0,12791318,9548145,0,125852384,,129095557,124635158,50203,GGN
2020-12-31,,,516000000,,363000000,358000000,973000000,586000000,586000000,29000000,-69000000,,,,153000000,3263000000,2677000000,2290000000,-70000000,,363000000,363000000,50205,REYN
2019-12-31,,,301000000,,225000000,305000000,880000000,510000000,510000000,65000000,-242000000,,,,76000000,3032000000,2522000000,2152000000,-209000000,,225000000,225000000,50205,REYN
2018-12-31,,,233000000,,176000000,288000000,832000000,513000000,513000000,31000000,-331000000,,,,57000000,3142000000,2629000000,2310000000,-280000000,,176000000,176000000,50205,REYN
2017-12-31,,,218000000,,302000000,294000000,862000000,540000000,540000000,28000000,-344000000,,,,-84000000,2957000000,2417000000,2095000000,-322000000,,302000000,302000000,50205,REYN
2019-12-31,,,3463024,,2510901,11567058,15294582,3727524,3727524,,-440999,,,,952123,24749263,21021739,9454681,-264500,,2510901,1484838,50207,WVVIP
2018-12-31,,,3939586,,2858580,10598784,14781499,4182715,4182715,,-457689,,,,1081006,23079739,18897024,8298240,-243129,,2858580,1839665,50207,WVVIP
2017-12-31,,,3446505,,2993779,9245807,12881851,3636044,3636044,,-473608,,,,452726,20853527,17217483,7971676,-189539,,2993779,2289730,50207,WVVIP
2016-12-31,,,4107285,,2628975,8163127,12220528,4057401,4057401,,-291370,,,,1478310,19425412,15368011,7204884,49884,,2628975,2166446,50207,WVVIP
2019-12-31,29738000,,-45634000,,-45634000,6951000,0,-36689000,-36689000,,,,,,0,0,36689000,0,-8945000,,-45634000,-45634000,50208,PASG
2018-12-31,9167000,,-12770000,,-12770000,928000,0,-10095000,-10095000,,,,,,0,0,10095000,0,-2675000,,-12770000,-12770000,50208,PASG
2019-12-31,,,55141000,,45380000,91800000,135180000,13802000,13802000,,-20258000,,,,9761000,668838000,655036000,533658000,41339000,,45380000,45380000,50209,BH
2018-12-31,,,16755000,,19392000,127232000,148455000,1905000,1905000,,-19884000,,,,-2637000,809894000,807989000,661439000,14850000,,19392000,19392000,50209,BH
2017-12-31,,,-12890000,,50071000,129019000,152523000,2056000,2056000,,-20122000,,,,-62961000,839804000,837748000,687281000,-14946000,,50071000,50071000,50209,BH
2016-12-31,,,146263000,,99451000,127259000,181792000,31608000,31608000,,-20925000,,,,46812000,850076000,818468000,668284000,114655000,,99451000,99451000,50209,BH
2020-06-30,,,-36644000,,-33074000,84376000,102176000,17000000,17000000,800000,-1597000,,,,-3570000,1100938000,1083938000,998762000,-53644000,,-33074000,-33074000,50210,MTRX
2019-06-30,,,38412000,,27982000,94021000,131951000,37930000,37930000,800000,-1296000,,,,10430000,1416680000,1378750000,1284729000,482000,,27982000,27982000,50210,MTRX
2018-06-30,,,-12148000,,-11480000,84417000,91936000,7519000,7519000,800000,-2600000,,,,-668000,1091553000,1084034000,999617000,-19667000,,-11480000,-11480000,50210,MTRX
2017-06-30,,,2446000,,-183000,75544000,81003000,5459000,5459000,800000,-2211000,,,,2308000,1197509000,1192050000,1116506000,-3013000,,138000,-183000,50210,MTRX
2019-12-31,17329000,,10429000,,1720000,96782000,119799000,5688000,5688000,4396000,-314000,,,,8709000,414806000,409118000,295007000,4741000,,1720000,1720000,50211,DRQ
2018-12-31,20297000,,-114989000,,-95695000,101090000,91053000,-30336000,-30336000,2000,-291000,,,,-19294000,384626000,414962000,293573000,-84653000,,-95695000,-95695000,50211,DRQ
2017-12-31,19974000,,-65644000,,-100639000,113588000,125226000,-8304000,-8304000,-32000,-72000,,,,34995000,455469000,463773000,330243000,-57340000,,-100639000,-100639000,50211,DRQ
2016-12-31,44325000,,115868000,,93221000,48746000,210327000,117256000,117256000,-32000,-28000,,,,22647000,538731000,421475000,328404000,-1388000,,93221000,93221000,50211,DRQ
2020-12-31,,,275700000,,227600000,,657500000,433000000,433000000,,-143500000,,,,32900000,1696900000,1263900000,1039400000,-157300000,,242800000,227600000,50212,BKH
2019-12-31,,,242902000,101946000.0,199310000,1669000.0,669533000,405829000,405829000,52915000.0,-145847000,,,,29580000,1734900000,1329071000,1065367000,-162927000,,213322000,199310000,50212,BKH
2018-12-31,,,255882000,105835000.0,258442000,3179000.0,646952000,393858000,393858000,53587000.0,-143720000,,,,-23667000,1754268000,1360410000,1107316000,-137976000,-6887000.0,279549000,258442000,50212,BKH
2017-12-31,,,281742000,111232000.0,177034000,3179000.0,662373000,416736000,416736000,57391000.0,-140533000,,,,73367000,1680266000,1263530000,1017893000,-134994000,-17099000.0,208375000,177034000,50212,BKH
2019-12-31,35446000,,56869000,,56823000,33733000,121996000,52817000,52817000,,,,,,46000,147872000,95055000,25876000,4052000,,56823000,56823000,50214,JNCE
2018-12-31,33157000,,-27333000,,-27379000,32169000,34032000,-31294000,-31294000,,,,,,46000,65201000,96495000,31169000,3961000,,-27379000,-27379000,50214,JNCE
2017-12-31,31688000,,-16407000,,-16443000,29188000,41661000,-19215000,-19215000,,,,,,36000,71644000,90859000,29983000,2808000,,-16443000,-17237000,50214,JNCE
2016-12-31,19264000,,-13703000,,-13703000,16759000,21557000,-14466000,-14466000,,,,,,0,37197000,51663000,15640000,763000,,-13703000,-23138000,50214,JNCE
2020-07-31,,,-38402043,,-38402043,5652007,36301526,30649519,30649519,,-6128845,,,,0,36301526,5652007,0,-69051562,,-38402043,-38402043,50217,JRO
2019-07-31,,,8322693,,8322693,6135063,43443726,37308663,37308663,,-6176948,,,,0,43443726,6135063,0,-28985970,,8322693,8322693,50217,JRO
2018-07-31,,,23208536,,23208536,6486270,40615962,34129692,34129692,,-9571585,,,,0,40615962,6486270,0,-10921156,,23208536,23208536,50217,JRO
2017-07-31,,,46778130,,46778130,6366394,41689598,35323204,35323204,,-4650897,,,,0,41689598,6366394,0,11454926,,46778130,46778130,50217,JRO
2019-12-31,,,211000000,762000000,121000000,1717000000,2839000000,190000000,190000000,,-165000000,,,,64000000,5176000000,4986000000,2337000000,21000000,,147000000,121000000,50218,TDS
2018-12-31,,,221000000,744000000,135000000,1694000000,2773000000,196000000,196000000,,-172000000,,,,46000000,5109000000,4913000000,2336000000,25000000,,175000000,135000000,50218,TDS
2017-12-31,,,-122000000,624000000,153000000,1689000000,2685000000,152000000,152000000,,-170000000,,,,-279000000,5044000000,4892000000,2359000000,-274000000,,157000000,153000000,50218,TDS
2016-12-31,,,92000000,606000000,43000000,1762000000,2726000000,114000000,114000000,,-170000000,,,,40000000,5155000000,5041000000,2429000000,-22000000,,52000000,43000000,50218,TDS
2019-12-31,,,-11644000,,-11698000,6978000,30034000,12040000,12040000,,-19492000,,,,54000,86499000,74459000,56465000,-24848000,,-11698000,-11698000,50224,SHIP
2018-12-31,,,-21042000,,-21058000,7542000,29960000,11542000,11542000,,-24873000,,,,16000,91520000,79978000,61560000,-32584000,,-21058000,-21058000,50224,SHIP
2017-12-31,,,-3235000,,-3235000,6097000,19417000,2802000,2802000,,-17338000,,,,0,74834000,72032000,55417000,-6037000,,-3235000,-3235000,50224,SHIP
2016-12-31,,,-24589000,,-24623000,5029000,-1153000,-14713000,-14713000,,-9824000,,,,34000,34662000,49375000,35815000,-9876000,,-24623000,-24623000,50224,SHIP
2020-12-31,,,445200000,,356300000,555900000,1041100000,489000000,489000000,-3800000,-28300000,,,,88100000,3634100000,3145100000,2593000000,-43800000,-800000,357100000,356300000,50225,LII
2019-12-31,,,507900000,,408700000,585900000,1079800000,488200000,488200000,5700000,-48600000,,,,99100000,3807200000,3319000000,2727400000,19700000,-100000,408800000,408700000,50225,LII
2018-12-31,,,467900000,,359000000,608200000,1111200000,497900000,497900000,5100000,-39100000,,,,107600000,3883900000,3386000000,2772700000,-30000000,-1300000,360300000,359000000,50225,LII
2017-12-31,,,464000000,,305700000,637700000,1125200000,486000000,486000000,1500000,-32100000,,,,156900000,3839600000,3353600000,2714400000,-22000000,-1400000,307100000,305700000,50225,LII
2019-12-31,,,-425834000,-9617000,-387690000,264716000,408572000,143856000,143856000,,-67494000,,,,-65609000,4450832000,4306976000,4042260000,-569690000,,-360225000,-387690000,50227,TPC
2018-12-31,,,132613000,-21288000,83436000,262577000,454453000,191876000,191876000,,-63519000,,,,34832000,4454662000,4262786000,4000209000,-59263000,,97781000,83436000,50227,TPC
2017-12-31,,,153975000,-8495000,148382000,274928000,454405000,179477000,179477000,,-69384000,,,,-569000,4757208000,4577731000,4302803000,-25502000,,154544000,148382000,50227,TPC
2016-12-31,,,149115000,-8495000,95822000,255270000,457190000,201920000,201920000,,-59782000,,,,53293000,4973076000,4771156000,4515886000,-52805000,,95822000,95822000,50227,TPC
2019-12-31,,,-11554000,,-19712000,85882000,123506000,26970000,26970000,-5994000,-13683000,,,,8158000,273575000,246605000,150069000,-38524000,,-19712000,-19712000,50228,EVC
2018-12-31,,,20038000,,12161000,78400000,127477000,33991000,33991000,-1187000,-15743000,,,,7877000,297815000,263824000,170338000,-13953000,,12161000,12161000,50228,EVC
2017-12-31,,,258310000,,175698000,77053000,383753000,290551000,290551000,-262000,-16709000,,,,82612000,536034000,245483000,152281000,-32241000,,175698000,175698000,50228,EVC
2016-12-31,,,33526000,,20405000,71341000,135539000,48856000,48856000,-262000,-15469000,,,,13121000,258514000,209658000,122975000,-15330000,,20405000,20405000,50228,EVC
2020-12-31,1415000000,,4009000000,47000000,2998000000,3896000000,10127000000,4585000000,4585000000,231000000,-514000000,,,,1006000000,41748000000,37163000000,31621000000,-576000000,,3003000000,2998000000,50231,CAT
2019-12-31,1693000000,,7840000000,41000000,6093000000,4796000000,14462000000,8113000000,8113000000,-140000000,-421000000,,,,1746000000,53800000000,45687000000,39338000000,-273000000,,6094000000,6093000000,50231,CAT
2018-12-31,1850000000,,7846000000,41000000,6147000000,4806000000,14903000000,8336000000,8336000000,-89000000,-404000000,,,,1698000000,54722000000,46386000000,39819000000,-490000000,,6148000000,6147000000,50231,CAT
2017-12-31,1842000000,,4098000000,69000000,754000000,4425000000,11824000000,5576000000,5576000000,-19000000,-531000000,,,,3339000000,45462000000,39886000000,33638000000,-1478000000,,759000000,754000000,50231,CAT
2020-12-31,,,889300000,,721000000,305900000,1256500000,936800000,936800000,13800000,-118100000,,,,168200000,4432100000,3495300000,3175600000,-47500000,,721100000,721000000,50232,MLM
2019-12-31,,,748300000,2500000.0,611900000,307700000,1183200000,880400000,880400000,-4900000,-129300000,,,,136300000,4422300000,3541900000,3239100000,-132100000,,612000000,611000000,50232,MLM
2018-12-31,,,576100000,3000000.0,470000000,281800000,989300000,707500000,707500000,-4900000,-137100000,,,,105700000,3980400000,3272900000,2991100000,-131400000,,470400000,469200000,50232,MLM
2017-12-31,,,618900000,2877000.0,713300000,271400000,974000000,693000000,693000000,9600000,-91500000,,,,-94500000,3723500000,3030500000,2749500000,-74100000,,713400000,711300000,50232,MLM
2020-12-31,,,287545000,,228051000,491892000,941471000,0,299616000,149963000,,,,,59494000,941471000,641855000,0,-12071000,,228051000,218563000,50233,BXS
2019-12-31,,,299518000,,234261000,467250000,929125000,0,322532000,139343000,,,,,65257000,929125000,606593000,0,-23014000,,234261000,234261000,50233,BXS
2018-12-31,,,265125000,,221317000,430443000,849759000,0,285470000,133846000,,,,,43808000,849759000,564289000,0,-20345000,,221317000,221317000,50233,BXS
2017-12-31,,,231623000,,153033000,378832000,739069000,0,242214000,118023000,,,,,78590000,739069000,496855000,0,-10591000,,153033000,153033000,50233,BXS
2019-12-31,,,19043860,,19043860,4672451,28972038,24299587,24299587,,-4351609,,,,0,28972038,4672451,0,-5255727,,19043860,19043860,50234,BSL
2018-12-31,,,4983567,,4983567,4768631,29244058,24475427,24475427,,-4266054,,,,0,29244058,4768631,0,-19491860,,4983567,4983567,50234,BSL
2017-12-31,,,17036813,,17036813,5510005,27308701,21798696,21798696,,-2606540,,,,0,27308701,5510005,0,-4761883,,17036813,17036813,50234,BSL
2016-12-31,,,42758954,,42758954,4960252,25456450,20496198,20496198,,-1591676,,,,0,25456450,4960252,0,22262756,,42758954,42758954,50234,BSL
2020-12-31,35511000,,-6870000,,-6790000,29715000,58190000,-8101000,-8101000,,,,,,-80000,114480000,122581000,56290000,1231000,,-6790000,-6790000,50235,DSPG
2019-12-31,35552000,,-2750000,,-1190000,27982000,59547000,-4404000,-4404000,,-15000.0,,,,-1560000,117613000,122017000,58066000,1654000,,-1190000,-1190000,50235,DSPG
2018-12-31,36109000,,-3825000,,-1957000,25278000,57447000,-5640000,-5640000,,-15000.0,,,,-1868000,117438000,123078000,59991000,1815000,,-1957000,-1957000,50235,DSPG
2017-12-31,36655000,,-3095000,,-3003000,24104000,57695000,-4764000,-4764000,,-14000.0,,,,-92000,124753000,129517000,67058000,1669000,,-3003000,-3003000,50235,DSPG
2017-12-31,,,16131000,-150318000,18769000,5286000,50944000,32121000,32121000,,-16724000,,,,-3145000,52625000,20504000,1681000,-15990000,,19276000,12096000,50237,LMRKO
2016-12-31,,,9921000,-135630000,9811000,3755000,37962000,23016000,23016000,,-11617000,,,,0,41171000,18155000,3209000,-13095000,,9921000,7103000,50237,LMRKO
2015-12-31,,,1205000,-47633000,1205000,2923000,29065000,17491000,17491000,,-11404000,,,,0,33597000,16106000,4532000,-16286000,,1205000,736000,50237,LMRKO
2014-12-31,,,2530000,12349,2530000,821000,22571000,15492000,15492000,,-9585000,,,,0,25141000,9649000,2570000,-12962000,,2530000,-2698000,50237,LMRKO
2019-12-31,188049000,,-220242000,114778000,-361917000,289598000,496921000,19274000,19274000,,-168205000,,,,383331000,1626373000,1607099000,1129452000,-239516000,,-603573000,-361917000,50238,AMRX
2018-12-31,194190000,,-202722000,391613000,-169726000,227846000,707957000,285921000,285921000,,-143571000,,,,-1419000,1662991000,1377070000,955034000,-488643000,,-201303000,-20920000,50238,AMRX
2017-12-31,171420000,,171323000,10157000,167648000,109046000,505660000,225194000,225194000,,-71061000,,,,1998000,1033654000,808460000,527994000,-53871000,,169325000,167648000,50238,AMRX
2016-12-31,179019000,,214821000,9345000,207378000,118757000,571727000,273951000,273951000,,-55283000,,,,5395000,1018225000,744274000,446498000,-59130000,,209426000,207378000,50238,AMRX
2020-09-30,,,72716,,72716,873750,946466,72716,72716,,,,,,0,946466,873750,0,0,,72716,72716,50239,MOXC
2019-09-30,,,300455,,300455,900105,370411,-529694,-529694,,,,,,0,370411,900105,0,830149,,300455,300455,50239,MOXC
2018-09-30,2247170.0,,-8595414,,-8595414,5942307,331619,-8539454,-8539454,,-60657.0,,,,0,339947,8879401,8328,-55960,,-8595414,-8595414,50239,MOXC
2017-09-30,2146508.0,,-13597243,,-13693750,7433846,76088,-10601312,-10601312,,-102.0,,,,96507,92205,10693517,16117,-2995931,,-13693750,-13693750,50239,MOXC
2020-07-31,,,-61158000,,-32475000,756483000,817861000,61378000,61378000,,-22327000,,,,-28683000,2522792000,2461414000,1704931000,-122536000,,-32475000,-32475000,50240,CBRL
2019-08-02,,,266356000,,223401000,779279000,1062123000,282844000,282844000,,-16488000,,,,42955000,3071951000,2789107000,2009828000,-16488000,,223401000,223401000,50240,CBRL
2018-08-03,,,278423000,,247620000,745645000,1039237000,293592000,293592000,,-15169000,,,,30803000,3030445000,2736853000,1991208000,-15169000,,247620000,247620000,50240,CBRL
2017-07-28,,,298887000,,201899000,704714000,1017872000,313158000,313158000,,-14271000,,,,96988000,2926289000,2613131000,1908417000,-14271000,,201899000,201899000,50240,CBRL
2020-12-31,,,84710000,,64024000,185961000,306784000,0,94560000,26263000,,,,,20686000,306784000,212224000,0,-9850000,,64024000,62323000,50242,TBK
2019-12-31,,,75446000,,58544000,165448000,279530000,0,84875000,29207000,,,,,16902000,279530000,194655000,0,-9429000,,58544000,58544000,50242,TBK
2018-12-31,,,66500000,,51708000,130824000,232782000,0,79132000,22826000,,,,,14792000,232782000,153650000,0,-12632000,,51708000,51130000,50242,TBK
2017-12-31,,,61098000,,36220000,101790000,163852000,0,46640000,15422000,,,,,24878000,163852000,117212000,0,14458000,,36220000,35446000,50242,TBK
2019-12-31,,,713000,,1011000,34017000,46806000,12789000,12789000,,-10776000,,,,-298000,414961000,402172000,368155000,-12076000,,1011000,1011000,50245,FNHC
2018-12-31,,,20208000,,14928000,36462000,60847000,24385000,24385000,,-4177000,,,,5498000,396093000,371708000,335246000,-4177000,,14710000,14928000,50245,FNHC
2017-12-31,,,8927000,15822000.0,7989000,34484000,43759000,9275000,9275000,,-348000,,,,3585000,391662000,382387000,347903000,-348000,,5342000,7989000,50245,FNHC
2016-12-31,,,1803000,18727000.0,1015000,30934000,33085000,2151000,2151000,,-348000,,,,542000,307525000,305374000,274440000,-348000,,1261000,1015000,50245,FNHC
2020-12-31,,,502141000,87661000,402461000,1787096000,2329524000,0,501702000,38931000,,,,,99449000,2566138000,2064436000,236614000,439000,,402692000,402461000,50247,LAZ
2019-12-31,,,392698000,71583000,286500000,1816794000,2325542000,0,469062000,37446000,,,,,94982000,2583330000,2114268000,257788000,-76364000,,297716000,283110000,50247,LAZ
2018-12-31,,,680766000,53242000,527125000,1805835000,2556575000,0,664742000,82963000,,,,,148317000,2829232000,2164490000,272657000,16024000,,532449000,527125000,50247,LAZ
2017-12-31,,,825446000,59102000,253583000,1774852000,2449435000,0,627582000,44069000,,,,,565599000,2642411000,2014829000,192976000,197864000,,259847000,253583000,50247,LAZ
2019-12-31,,,-55178000,,-55178000,13418000,-43859000,-57277000,-57277000,,,,,,0,0,57277000,43859000,2099000,,-55178000,-55178000,50248,CBIO
2018-12-31,,,-30055000,,-30055000,12354000,-21468000,-33822000,-33822000,,,,,,0,6000,33828000,21474000,3767000,,-30055000,-30055000,50248,CBIO
2017-12-31,,,-21561000,,-21561000,9993000,-11829000,-21822000,-21822000,,,,,,0,1018000,22840000,12847000,261000,,-21561000,-25512000,50248,CBIO
2016-12-31,,,-16945000,,-16945000,9262000,-10156000,-19418000,-19418000,,,,,,0,399000,19817000,10555000,2473000,,-16945000,-16945000,50248,CBIO
2019-12-31,7600000,,-10092000,,-133935000,239521000,307989000,60868000,60868000,,-48609000,,,,14676000,964313000,903445000,656324000,-70960000,-109167000,-24768000,-133935000,50249,CIR
2018-12-31,8500000,,-23896000,,-39384000,270376000,332149000,53273000,53273000,,-52975000,,,,9451000,1013470000,960197000,681321000,-77169000,-6037000,-33347000,-39384000,50249,CIR
2017-12-31,5200000,,3640000,,11789000,141197000,176974000,30577000,30577000,,-10841000,,,,-7211000,505492000,474915000,328518000,-26937000,938000,10851000,11789000,50249,CIR
2016-12-31,5900000,,9680000,,10101000,153891000,187327000,27536000,27536000,,-3310000,,,,-421000,590259000,562723000,402932000,-17856000,938000,10101000,10101000,50249,CIR
2020-12-31,1010000000,,-3151000000,1494000000,-2612000000,3143000000,3519000000,-1527000000,-1527000000,,-360000000,,,,-423000000,5199000000,6726000000,1680000000,-1624000000,,-2728000000,-2687000000,50250,EXPE
2019-12-31,1763000000,,775000000,1584000000,565000000,6982000000,9904000000,961000000,961000000,,-173000000,,,,203000000,12067000000,11106000000,2163000000,-186000000,,572000000,565000000,50250,EXPE
2018-12-31,1617000000,,485000000,1577000000,406000000,6575000000,9258000000,783000000,783000000,-59000000.0,-190000000,,,,87000000,11223000000,10440000000,1965000000,-298000000,,398000000,406000000,50250,EXPE
2017-12-31,1387000000,,417000000,1628000000,378000000,6015000000,8303000000,626000000,626000000,-59000000.0,-182000000,,,,45000000,10060000000,9434000000,1757000000,-209000000,,372000000,378000000,50250,EXPE
2020-11-28,36969000,,165709000,541000,123719000,474094000,757662000,246599000,246599000,,-71158000,,,,41921000,2790269000,2543670000,2032607000,-80890000,,123788000,123719000,50251,FUL
2019-11-30,36624000,,180252000,442000,130817000,518190000,809004000,254190000,254190000,,-57033000,,,,49408000,2897000000,2642810000,2087996000,-73938000,,130844000,130817000,50251,FUL
2018-12-01,35534000,,164876000,401000,171208000,537863000,828158000,254761000,254761000,,-136813000,,,,-6356000,3041002000,2786241000,2212844000,-89885000,,171232000,171208000,50251,FUL
2017-12-02,30072000,,69276000,393000,59418000,431982000,598992000,136938000,136938000,,-46761000,,,,9810000,2306043000,2169105000,1707051000,-67662000,,59466000,59418000,50251,FUL
2019-12-31,,,-22672,,-22672,,0,0,,,,,,,0,0,0,0,-22672,,-22672,-22672,50252,GRCY
2018-12-31,,,-6000,,-6000,,0,0,,,,,,,0,0,0,0,-6000,,-6000,-6000,50252,GRCY
2019-12-31,,,1190071000,155570000,909053000,-31300000,4123197000,1861435000,1861435000,1212404000,-533197000,,,,273499000,8526470000,6665035000,4403273000,-671364000,,916572000,909053000,50253,ES
2018-12-31,,,1329491000,155570000,1033000000,-60800000,3974019000,1760730000,1760730000,1202133000,-498805000,,,,288972000,8448201000,6687471000,4474182000,-431239000,,1040519000,1033000000,50253,ES
2017-12-31,,,1574407000,155570000,987996000,-29900000,3909629000,1918149000,1918149000,1157592000,-421755000,,,,578892000,7751952000,5833803000,3842323000,-343742000,,995515000,987996000,50253,ES
2016-12-31,,,1504818000,155568000,942302000,-18600000,3768667000,1832374000,1832374000,1167731000,-400961000,,,,554997000,7639129000,5806755000,3870462000,-327556000,,949821000,942302000,50253,ES
2020-11-30,,,-34345000,,-33564000,18728000,0,-18735000,-18735000,,-6014000,,,,-781000,0,18735000,0,-15610000,,-33564000,-33564000,50255,NG
2019-11-30,,,-26483000,,-27761000,16306000,0,-16321000,-16321000,,-7286000,,,,1278000,0,16321000,0,-10162000,,-27761000,-27761000,50255,NG
2018-11-30,,,-30940000,,-112765000,18471000,0,-18493000,-18493000,,-6461000,,,,526000,0,18493000,0,-12447000,-81299000.0,-31466000,-112765000,50255,NG
2017-11-30,,,-36608000,,-39016000,20768000,0,-20802000,-20802000,,-5228000,,,,307000,0,20802000,0,-15806000,-2101000.0,-36915000,-39016000,50255,NG
2020-06-30,,,13510000000,4310000000,7956000000,10972001000,34118001000,15149000000,15149000000,1368000000,-881000000,,,,4774000000,42931000000,27782000000,8812999000,-1639000000,,8736000000,7956000000,50256,BBL
2019-06-30,,,15049000000,4584000000,8306000000,11421725000,35455725000,16079000000,16079000000,1603000000,-1095000000,,,,5529000000,44288000000,28209000000,8832275000,-1030000000,-335000000.0,9520000000,8306000000,50256,BBL
2018-06-30,,,14751000000,5078000000,3705000000,11367687000,35216687000,15777000000,15777000000,1143000000,-1088000000,,,,7007000000,43129000000,27352000000,7912313000,-1026000000,-2921000000.0,7744000000,3705000000,50256,BBL
2017-06-30,,,11137000000,5468000000,5890000000,9803000000,29709000000,12428000000,12428000000,896000000,-1050000000,,,,4443000000,35947000000,23519000000,6238000000,-1291000000,-472000000.0,6694000000,5890000000,50256,BBL
2019-12-31,193718000,,234273000,,185904000,566606000,1042144000,239437000,239437000,,-20919000,,,,48369000,1573912000,1334475000,531768000,-5164000,,185904000,185904000,50257,NICE
2018-12-31,183830000,,186715000,,159338000,522733000,947704000,198865000,198865000,,-19872000,,,,27377000,1444519000,1245654000,496815000,-12150000,,159338000,159338000,50257,NICE
2017-12-31,181107000,,129660000,,143291000,489429000,863479000,151041000,151041000,,-22801000,,,,-13631000,1332152000,1181111000,468673000,-21381000,,143291000,143291000,50257,NICE
2016-12-31,141528000,,144481000,,116920000,375570000,677809000,143524000,143524000,,-2199000,,,,21412000,1015542000,872018000,337733000,957000,-6149000.0,123069000,116920000,50257,NICE
2020-03-31,177593000,,324326000,,449723000,626632000,1137166000,302083000,302083000,,,,,,-125397000,2975851000,2673768000,1838685000,22243000,,449723000,449723000,50258,LOGI
2019-03-31,161230000,,271133000,,257573000,586039000,1050353000,278948000,278948000,,,,,,13560000,2788322000,2509374000,1737969000,-7815000,,257573000,257573000,50258,LOGI
2018-03-31,143760000,,232265000,,208542000,531367000,918119000,226596000,226596000,,,,,,23723000,2566863000,2340267000,1648744000,5669000,,208542000,208542000,50258,LOGI
2017-03-31,130525000,,214989000,,205876000,479906000,826216000,205258000,205258000,,,,,,9113000,2221427000,2016169000,1395211000,9731000,,205876000,205876000,50258,LOGI
2020-12-31,,,648500000,,470300000,1425300000,2225600000,708000000,708000000,,-107500000,,,,178200000,13124300000,12416300000,10898700000,-59500000,,470300000,470300000,50259,LAD
2019-12-31,,,375400000,,271500000,1371300000,1953800000,500100000,500100000,,-133400000,,,,103900000,12672700000,12172600000,10718900000,-124700000,,271500000,271500000,50259,LAD
2018-12-31,,,337500000,,265700000,1249000000,1777000000,452600000,452600000,,-118300000,,,,71800000,11821400000,11368800000,10044400000,-115100000,,265700000,265700000,50259,LAD
2017-12-31,,,347100000,,245200000,1043400000,1516100000,415000000,415000000,,-74100000,,,,101900000,10086500000,9671500000,8570400000,-67900000,,245200000,245200000,50259,LAD
2019-12-31,,,1736000000,191000000,1343000000,81000000,6766000000,2595000000,2595000000,2406000000,-1004000000,,,,296000000,12574000000,9979000000,5808000000,-859000000,,1440000000,1343000000,50260,ED
2018-12-31,,,1783000000,113000000,1382000000,170000000,6237000000,2363000000,2363000000,2266000000,-829000000,,,,401000000,12337000000,9974000000,6100000000,-580000000,,1382000000,1382000000,50260,ED
2017-12-31,,,1997000000,7000000,1525000000,163000000,6269000000,2610000000,2610000000,2155000000,-737000000,,,,472000000,12033000000,9423000000,5764000000,-613000000,,1525000000,1525000000,50260,ED
2016-12-31,,,1943000000,8000000,1245000000,205000000,5923000000,2471000000,2471000000,2031000000,-702000000,,,,698000000,12075000000,9604000000,6152000000,-528000000,,1245000000,1245000000,50260,ED
2019-12-31,37299000,,-54503000,,-54568000,179523000,162067000,-54755000,-54755000,,-1643000,,,,65000,214552000,269307000,52485000,252000,,-54568000,-54568000,50262,IRTC
2018-12-31,20860000,,-50334000,,-50378000,133313000,108482000,-45691000,-45691000,,-3115000,,,,44000,147277000,192968000,38795000,-3117000,,-50378000,-50378000,50262,IRTC
2017-12-31,13265000,,-29740000,,-29740000,85252000,70926000,-27591000,-27591000,,-3386000,,,,0,99129000,126720000,28203000,-912000,,-29740000,-29740000,50262,IRTC
2016-12-31,7150000,,-20903000,,-20903000,51621000,43189000,-15582000,-15582000,,-3248000,,,,0,64072000,79654000,20883000,-5321000,,-20903000,-20903000,50262,IRTC
2019-12-31,,,-8330000,,-8330000,4061000,9635000,228000,228000,,-5775000,,,,0,27753000,27525000,18118000,-8558000,,-8330000,-8330000,50263,PXSAP
2018-12-31,,,-8214000,,-8214000,4054000,3838000,-5729000,-5729000,,-4434000,,,,0,28457000,34186000,24619000,-2485000,,-8214000,-8214000,50263,PXSAP
2017-12-31,,,-5243000,,-5243000,4830000,8282000,-2346000,-2346000,,-2897000,,,,0,29579000,31925000,21297000,-3197000,,-5243000,-5243000,50263,PXSAP
2016-12-31,,,-5813000,,-5813000,4229000,10386000,389000,389000,,-2810000,,,,0,30387000,29998000,20001000,-6202000,,-5813000,-5813000,50263,PXSAP
2019-12-31,,,372000000,,1564000000,97000000,1694000000,880000000,880000000,,-161000000,,,,-1198000000,5906000000,5026000000,4212000000,-508000000,-6000000,1570000000,1561000000,50264,TRI
2018-12-31,,,300000000,,3933000000,146000000,1624000000,859000000,859000000,,-330000000,,,,136000000,5501000000,4642000000,3877000000,-559000000,3859000000,164000000,3930000000,50264,TRI
2017-12-31,,,503000000,498000000.0,1395000000,29000000,1644000000,1010000000,1010000000,,-242000000,,,,-134000000,5297000000,4287000000,3653000000,-507000000,822000000,637000000,1393000000,50264,TRI
2016-12-31,,,1041000000,483000000.0,3098000000,52000000,3146000000,1542000000,1542000000,,-313000000,,,,-15000000,11166000000,9624000000,8020000000,-501000000,2093000000,1056000000,3096000000,50264,TRI
2020-12-31,,,19952000,,14475000,,43684000,0,20162000,23522000,,,,,5477000,43684000,23522000,0,-210000,,14475000,14475000,50266,PLBC
2019-12-31,,,21380000,,15512000,17205000.0,44190000,0,21380000,5605000,,,,,5868000,44190000,22810000,0,0,,15512000,15512000,50266,PLBC
2018-12-31,,,19126000,,13992000,15972000.0,40967000,0,19126000,5869000,,,,,5134000,40967000,21841000,0,0,,13992000,13992000,50266,PLBC
2017-12-31,,,15505000,,8189000,15106000.0,35616000,0,15505000,5005000,,,,,7316000,35616000,20111000,0,0,,8189000,8189000,50266,PLBC
2019-12-31,,,-178859000,115175000,-192110000,36194000,203766000,69978000,69978000,14872000,-133242000,,,,1475000,482449000,412471000,278683000,-248837000,-4118000,-180334000,-153608000,50267,NM
2018-12-31,,,-267371000,269747000,-268718000,26640000,203638000,64606000,64606000,12038000,-137807000,,,,-1108000,505686000,441080000,302048000,-331977000,752000,-266263000,-278959000,50267,NM
2017-12-31,,,-167979000,101066000,-165910000,27521000,132407000,-10256000,-10256000,10761000,-121490000,,,,-3192000,463049000,473305000,330642000,-157723000,752000,-164787000,-175298000,50267,NM
2016-12-31,,,-298884000,125266000,-303823000,25295000,117314000,-34430000,-34430000,11320000,-113440000,,,,1265000,419782000,454212000,302468000,-264454000,752000,-300149000,-273105000,50267,NM
2020-03-31,59777000,,298035000,5895000,244241000,93413000,399725000,246535000,246535000,,-725000,,,,53485000,644769000,398234000,245044000,51500000,,244550000,244241000,50269,TARO
2019-03-31,63238000,,356854000,5586000,281777000,89971000,445724000,292515000,292515000,,-256000,,,,74732000,669893000,377378000,224169000,64339000,,282122000,281777000,50269,TARO
2018-03-31,70418000,,292368000,5241000,211150000,88196000,463508000,304894000,304894000,,-304000,,,,81954000,661913000,357019000,198405000,-12526000,-335000.0,210414000,211150000,50269,TARO
2017-03-31,70644000,,560798000,6312000,456356000,85656000,671527000,515227000,515227000,,-131000,,,,103780000,879387000,364160000,207860000,45571000,-352000.0,457018000,456356000,50269,TARO
2020-12-31,,,1483000000,,1224000000,,7110000000,1708000000,1708000000,5402000000,,,,,275000000,7110000000,5402000000,0,-225000000,,1208000000,1224000000,50271,RELX
2019-12-31,,,1847000000,24000000.0,1505000000,3072000000.0,5119000000,2047000000,2047000000,5402000000,-202000000.0,,,,338000000,7874000000,5827000000,2755000000,-200000000,,1509000000,1505000000,50271,RELX
2018-12-31,,,1720000000,30000000.0,1422000000,2925000000.0,4848000000,1923000000,1923000000,5402000000,-197000000.0,,,,292000000,7492000000,5569000000,2644000000,-203000000,,1428000000,1422000000,50271,RELX
2017-12-31,,,1721000000,21000000.0,1648000000,2860000000.0,4713000000,1853000000,1853000000,5402000000,-181000000.0,,,,65000000,7341000000,5488000000,2628000000,-132000000,,1656000000,1648000000,50271,RELX
2019-12-31,,,2723049000000,3981962000000,1872207000000,3599881000000,6840408000000,0,2800809000000,439718000000,,,,,685453000000,6869467000000,4068658000000,29059000000,-77760000000,,2037596000000,1867845000000,50273,WF
2018-12-31,,,2804872000000,213113000000,2033182000000,3480931000000,6826975000000,0,2835999000000,510045000000,,,,,753223000000,6854623000000,4018624000000,27648000000,-31127000000,,2051649000000,1881988000000,50273,WF
2017-12-31,,,1949506000000,199008000000,1512148000000,3393570000000,5689126000000,0,2152995000000,142561000000,,,,,419418000000,5715109000000,3562114000000,25983000000,-203489000000,,1530088000000,1345076000000,50273,WF
2016-12-31,,,1553389000000,159793000000,1261266000000,3349488000000,5394568000000,0,1574770000000,470310000000,,,,,275856000000,5421025000000,3846255000000,26457000000,-21381000000,,1277533000000,1054751000000,50273,WF
2020-12-27,,,161825000,11586000,94757000,408454860,838196000,429741140,429741140,,-126118000,,,,66755000,12091901000,11662159860,11253705000,-267916140,,95070000,94757000,50274,PPC
2019-12-29,,,617545000,10397000,455924000,379921000,1070394000,690473000,690473000,,-132630000,,,,161009000,11409219000,10718746000,10338825000,-72928000,,456536000,455924000,50274,PPC
2018-12-30,,,332227000,9785000,247945000,343025000,843476000,500451000,500451000,,-162812000,,,,85423000,10937784000,10437333000,10094308000,-168224000,,246804000,247945000,50274,PPC
2017-12-31,,,958580000,9505000,694579000,389517000,1471614000,1082097000,1082097000,,-107183000,,,,263899000,10767863000,9685766000,9296249000,-123517000,,694681000,694579000,50274,PPC
2020-12-31,,,1338000000,112000000,996000000,,3845000000,1352000000,1352000000,1758000000,-244000000,,,,318000000,9352000000,8000000000,5507000000,-14000000,,1020000000,996000000,50278,WLTW
2019-12-31,,,1322000000,120000000,1044000000,244000000.0,4024000000,1576000000,1576000000,1475000000,-234000000,,,,249000000,9039000000,7463000000,5015000000,-254000000,,1073000000,1044000000,50278,WLTW
2018-12-31,,,851000000,145000000,695000000,243000000.0,3670000000,1291000000,1291000000,1394000000,-208000000,,,,136000000,8513000000,7222000000,4843000000,-440000000,,715000000,695000000,50278,WLTW
2017-12-31,,,492000000,151000000,568000000,261000000.0,3457000000,1139000000,1139000000,1273000000,-188000000,,,,-100000000,8202000000,7063000000,4745000000,-647000000,,592000000,568000000,50278,WLTW
2019-12-31,,,16038000,17200000,16038000,20639000,116085000,44051000,44051000,1085000,-28781000,,,,0,197761000,153710000,81676000,-28013000,,16038000,4341000,50281,SB
2018-12-31,,,27684000,16998000,27684000,19242000,124143000,55887000,55887000,947000,-27489000,,,,0,193191000,137304000,69048000,-28203000,,27684000,16300000,50281,SB
2017-12-31,,,-84679000,16998000,-84679000,16118000,92247000,22111000,22111000,2594000,-25609000,,,,0,148032000,125921000,55785000,-106790000,,-84679000,-99141000,50281,SB
2016-12-31,,,-55966000,16998000,-55966000,15381000,53921000,-11498000,-11498000,553000,-23259000,,,,0,109772000,121270000,55851000,-44468000,,-55966000,-69991000,50281,SB
2019-12-31,,,29779000,,31653000,92782000,234634000,58471000,58471000,3591000,-25102000,,,,-1874000,743290000,684819000,508656000,-28692000,,31653000,31653000,50283,CWST
2018-12-31,,,6036000,,6420000,84791000,207058000,51759000,51759000,1872000,-26294000,,,,-384000,660660000,608901000,453602000,-45723000,,6420000,6420000,50283,CWST
2017-12-31,,,-37052000,,-21799000,79243000,194121000,52776000,52776000,1872000,-25160000,,,,-15253000,599309000,546533000,405188000,-89828000,,-21799000,-21799000,50283,CWST
2016-12-31,,,-6364000,-24000.0,-6849000,75356000,183057000,45845000,45845000,1872000,-38942000,,,,494000,565030000,519185000,381973000,-52209000,,-6858000,-6849000,50283,CWST
2019-12-31,,,2401000000,121000000,1769000000,1947000000,4022000000,2108000000,2108000000,-75000000,-315000000,,,,640000000,11212000000,9104000000,7190000000,293000000,,1761000000,1769000000,50285,HTHT
2018-12-31,,,1296000000,145000000,716000000,1420000000,3587000000,2217000000,2217000000,-84000000,-244000000,,,,569000000,10063000000,7846000000,6476000000,-921000000,,727000000,716000000,50285,HTHT
2017-12-31,,,1585000000,36000000,1228000000,1168000000,2554000000,1426000000,1426000000,-54000000,-87000000,,,,357000000,8229000000,6803000000,5675000000,159000000,,1228000000,1228000000,50285,HTHT
2016-12-31,,,1053000000,16557000,782000000,768000000,1639000000,907000000,907000000,-41000000,-11000000,,,,279000000,6573000000,5666000000,4934000000,146000000,,774000000,782000000,50285,HTHT
2020-10-31,14552000,,-26419000,,-26469000,9365000,253000,-23664000,-23664000,,,,,,50000,253000,23917000,0,-2755000,,-26469000,-26469000,50286,ADXS
2019-10-31,25734000,,-16562000,,-16612000,11075000,20884000,-15925000,-15925000,,,,,,50000,20884000,36809000,0,-637000,,-16612000,-16612000,50286,ADXS
2018-10-31,56970000,,-66465000,,-66515000,18425000,6063000,-69332000,-69332000,,,,,,50000,6063000,75395000,0,2867000,,-66515000,-66515000,50286,ADXS
2017-10-31,70508000,,-97838000,,-93435000,38054000,12031000,-96531000,-96531000,,,,,,-4403000,12031000,108562000,0,-1307000,,-93435000,-93435000,50286,ADXS
2020-12-31,49663000,,-69784000,,-69784000,21646000,0,-71309000,-71309000,,,,,,0,0,71309000,0,1525000,,-69784000,-69784000,50287,ALVR
2019-12-31,16248000,,-23839000,,-23839000,10618000,165000,-26701000,-26701000,,,,,,0,165000,26866000,0,2862000,,-23839000,-23839000,50287,ALVR
2018-12-31,1700000,,-8156000,,-8156000,3031000,1135000,-3596000,-3596000,,,,,,0,1135000,4731000,0,-4560000,,-8156000,-7637000,50287,ALVR
2020-12-31,29900000,,90200000,,60600000,237700000,410600000,119900000,119900000,-2500000,-37700000,,,,29600000,5748100000,5628200000,5337500000,-29700000,,60600000,60600000,50288,CLS
2019-12-31,28400000,,99800000,,70300000,227300000,384700000,95300000,95300000,4100000,-49500000,,,,29500000,5888300000,5793000000,5503600000,4500000,,70300000,70300000,50288,CLS
2018-12-31,28800000,,81900000,,98900000,219000000,432100000,168700000,168700000,200000,-24400000,,,,-17000000,6633200000,6464500000,6201100000,-86800000,,98900000,98900000,50288,CLS
2017-12-31,26200000,,133100000,,105500000,203200000,418500000,177100000,177100000,3100000,-10100000,,,,27600000,6142700000,5965600000,5724200000,-44000000,,105500000,105500000,50288,CLS
2019-12-31,,,13145000,871000,14084000,115891000,59033000,16417000,16417000,-67817000,-6082000,,,,-1109000,308620000,292203000,249587000,-3272000,,14254000,14084000,50292,HIL
2018-12-31,,,-26273000,605000,-31461000,129950000,45439000,2453000,2453000,-91435000,-5642000,,,,4239000,337244000,334791000,291805000,-28726000,-863000.0,-30512000,-31461000,50292,HIL
2017-12-31,,,-3587000,1595000,27366000,135757000,146853000,686000,686000,-91435000,-3614000,,,,3103000,483736000,483050000,336883000,-4273000,34234000.0,-6690000,27366000,50292,HIL
2016-12-31,,,-16005000,1994000,-33812000,152771000,157069000,-13613000,-13613000,-91435000,-2355000,,,,5955000,516012000,529625000,358943000,-2392000,-11776000.0,-21960000,-33812000,50292,HIL
2019-12-31,,,-1853,,-1853,,0,0,,,,,,,0,0,0,0,-1853,,-1853,-1853,50295,APSG
2018-12-31,,,-1854,,-1854,,0,0,,,,,,,0,0,0,0,-1854,,-1854,-1854,50295,APSG
2019-12-31,,,-43925000,,-43925000,10170000,-33953000,-44123000,-44123000,,-650000,,,,0,14155000,58278000,48108000,198000,,-43925000,-43925000,50296,SGTX
2018-12-31,,,-22765000,,-22765000,6673000,-16402000,-23075000,-23075000,,-289000,,,,0,4637000,27712000,21039000,310000,,-22765000,-25755000,50296,SGTX
2020-12-31,551000000,,1746000000,43000000,1410000000,3075000000,5450000000,1824000000,1824000000,,-149000000,,,,331000000,17858000000,16034000000,12408000000,-78000000,,1415000000,1410000000,50297,ETN
2019-12-31,606000000,,2591000000,51000000,2211000000,3595000000,7052000000,2851000000,2851000000,,-236000000,,,,378000000,21390000000,18539000000,14338000000,-260000000,,2213000000,2211000000,50297,ETN
2018-12-31,584000000,,2424000000,35000000,2145000000,3542000000,7098000000,2972000000,2972000000,,-271000000,,,,278000000,21609000000,18637000000,14511000000,-548000000,,2146000000,2145000000,50297,ETN
2017-12-31,584000000,,3368000000,37000000,2985000000,3560000000,6648000000,2504000000,2504000000,,-246000000,,,,382000000,20404000000,17900000000,13756000000,864000000,,2986000000,2985000000,50297,ETN
2020-06-30,,,28807000,,22783000,79237000,125936000,0,32603000,14096000,,,,,6024000,125936000,93333000,0,-3796000,,22783000,22589000,50299,HTBI
2019-06-30,,,33937000,,27146000,74302000,124071000,0,38705000,11064000,,,,,6791000,124071000,85366000,0,-4768000,,27146000,26957000,50299,HTBI
2018-06-30,,,34971000,,8235000,68735000,120302000,0,40427000,11140000,,,,,26736000,120302000,79875000,0,-5456000,,8235000,8175000,50299,HTBI
2017-06-30,,,17039000,,11847000,66619000,107298000,0,30459000,10220000,,,,,5192000,107298000,76839000,0,-13420000,,11847000,11722000,50299,HTBI
2020-10-31,,,1749066,,1749066,741024,4464230,3723206,3723206,,,,,,0,4464230,741024,0,-1974140,,1749066,1749066,50300,NMI
2019-10-31,,,7936586,,7936586,771741,4508659,3736918,3736918,,,,,,0,4508659,771741,0,4199668,,7936586,7936586,50300,NMI
2018-10-31,,,-35651,,-35651,866891,4618895,3752004,3752004,,,,,,0,4618895,866891,0,-3787655,,-35651,-35651,50300,NMI
2017-10-31,,,2070804,,2070804,749822,4765950,4016128,4016128,,,,,,0,4765950,749822,0,-1945324,,2070804,2070804,50300,NMI
2020-12-31,,,103231000,58107000,97374000,29742000,332003000,165001000,165001000,,-121133000,,,,353000,611190000,446189000,279187000,-61770000,,102878000,97374000,50301,OFC
2019-12-31,,,199787000,69716000,191692000,39641000,334754000,158044000,158044000,,-71052000,,,,-217000,642859000,484815000,308105000,41743000,,200004000,191036000,50301,OFC
2018-12-31,,,78280000,67897000,72301000,34740000,321448000,149592000,149592000,,-75385000,,,,-363000,580809000,431217000,259361000,-68873000,,78643000,71839000,50301,OFC
2017-12-31,,,76039000,89290000,68745000,37050000,323728000,152450000,152450000,,-76983000,,,,1098000,614310000,461860000,290582000,-76411000,,74941000,55230000,50301,OFC
2019-12-31,19738000,,-36507000,,-36507000,2445000,0,-22183000,-22183000,,,,,,0,0,22183000,0,-14324000,,-36507000,-42067000,50304,GLTO
2018-12-31,10093000,,-15869000,,-15869000,2814000,0,-12907000,-12907000,,-2970000.0,,,,0,0,12907000,0,-2962000,,-15869000,-19005000,50304,GLTO
2019-12-31,,,579982,,579982,,-414768,-414768,-414768,,,,,,0,0,414768,414768,579982,,579982,-414768,50305,GLEO
2019-12-28,,,28932000,,23756000,187083000,245382000,32483000,32483000,,-2275000,,,,5176000,508938000,476455000,263556000,-3551000,,23756000,23756000,50308,NVEE
2018-12-29,,,33719000,,26856000,146644000,201404000,37376000,37376000,,-1966000,,,,6863000,418081000,380705000,216677000,-3657000,,26856000,26856000,50308,NVEE
2017-12-30,,,24633000,,24006000,124992000,165254000,27134000,27134000,,-1935000,,,,627000,333034000,305900000,167780000,-2501000,,24006000,24006000,50308,NVEE
2016-12-31,,,18146000,,11607000,81577000,107580000,19775000,19775000,,-257000,,,,6539000,223910000,204135000,116330000,-1629000,,11607000,11607000,50308,NVEE
2019-12-31,3480730,,505714,,286586,6013543,10100643,606370,606370,,-100656,,,,219128,19253105,18646735,9152462,-100656,,286586,286586,50309,SCKT
2018-12-31,3227463,,-714600,,-571141,5814933,8456408,-585988,-585988,,-128612,,,,-143459,16454426,17040414,7998018,-128612,,-571141,-571141,50309,SCKT
2017-12-31,3037924,,2338272,,-1430731,5934370,11390009,2417715,2417715,,-79443,,,,3769003,21285800,18868085,9895791,-79443,,-1430731,-1430731,50309,SCKT
2016-12-31,2453500,,2431666,,12147088,5417702,10434218,2563016,2563016,,-131349,,,,-9715422,20787588,18224572,10353370,-131350,,12147088,12147088,50309,SCKT
2019-12-31,,,59186000,3254000,52164000,258461000,380696000,120235000,120235000,2000000,-39301000,,,,6226000,1131251000,1011016000,750555000,-61049000,,52960000,52164000,50312,CHX
2018-12-31,,,121353000,2458000,92737000,265128000,421697000,156569000,156569000,2000000,-27648000,,,,28162000,1218156000,1061587000,796459000,-35216000,,93191000,92737000,50312,CHX
2017-12-31,,,88355000,4749000,109589000,221776000,326400000,104624000,104624000,2000000,-863000,,,,-22164000,1010466000,905842000,684066000,-16269000,,110519000,109589000,50312,CHX
2016-12-31,,,-18943000,5031000,-12751000,199712000,204736000,5024000,5024000,2000000,-477000,,,,-8043000,751337000,746313000,546601000,-23967000,,-10900000,-12751000,50312,CHX
2020-12-31,,,8227000000,,6629000000,24039000000,32391000000,0,8351000000,1000000,,,,,1583000000,32391000000,24040000000,0,-124000000,,6644000000,6629000000,50314,UBS
2019-12-31,,,5577000000,174000000.0,4304000000,22815000000,28927000000,0,6110000000,2000000,,,,,1267000000,28927000000,22817000000,0,-533000000,,4310000000,4304000000,50314,UBS
2018-12-31,,,5991000000,176000000.0,4516000000,23521000000,30288000000,0,6768000000,-1000000,,,,,1468000000,30288000000,23520000000,0,-777000000,,4523000000,4516000000,50314,UBS
2017-12-31,,,5351000000,59000000.0,969000000,23009000000,29591000000,0,6582000000,-1000000,,,,,4305000000,29591000000,23009000000,0,-1231000000,,1046000000,969000000,50314,UBS
2020-09-26,,,21466000,,18305000,214483000,238427000,23657000,23657000,287000,-84000,,,,3161000,1022038000,998381000,783611000,-2191000,,18305000,18305000,50316,JJSF
2019-09-28,,,126577000,,94819000,232037000,350401000,116956000,116956000,1408000,-120000,,,,31758000,1186487000,1069531000,836086000,9621000,,94819000,94819000,50316,JJSF
2018-09-29,,,118152000,,103596000,225443000,336286000,110775000,110775000,68000,-279000,,,,14556000,1138265000,1027490000,801979000,7377000,,103596000,103596000,50316,JJSF
2017-09-30,,,122200000,,79174000,213061000,329223000,116307000,116307000,-145000,-126000,,,,43026000,1084224000,967917000,755001000,5893000,,79174000,79174000,50316,JJSF
2020-03-31,2009323,,-4774558,,-4160196,2769161,0,-4778484,-4778484,,,,,,-614362,0,4778484,0,3926,,-4160196,-4160196,50317,NMRD
2019-03-31,2296668,,-4452797,,-4452797,2180056,0,-4476724,-4476724,,,,,,0,0,4476724,0,23927,,-4452797,-4452797,50317,NMRD
2018-03-31,993833,,-1820449,,-1820449,915132,0,-1908965,-1908965,,,,,,0,0,1908965,0,88516,,-1820449,-1820449,50317,NMRD
2017-03-31,1034605,,-1551266,,-1551266,516661,0,-1551266,-1551266,,,,,,0,0,1551266,0,0,,-1551266,-1551266,50317,NMRD
2019-12-31,10670000000,,8740000000,3403000000,7011000000,12584000000,28294000000,5040000000,5040000000,,-1677000000,,,,1742000000,35666000000,30626000000,7372000000,3700000000,,6998000000,7011000000,50319,TCOM
2018-12-31,9620000000,,1889000000,2018000000,1112000000,12416000000,24641000000,2605000000,2605000000,,-1508000000,,,,793000000,30965000000,28360000000,6324000000,-716000000,,1096000000,1112000000,50319,TCOM
2017-12-31,8259000000,,3459000000,1779000000,2155000000,10916000000,22118000000,2943000000,2943000000,,-1286000000,,,,1285000000,26796000000,23853000000,4678000000,516000000,,2174000000,2155000000,50319,TCOM
2016-12-31,7687000000,,-1142000000,3983917792,-1418000000,8380000000,14515000000,-1552000000,-1552000000,,-732000000,,,,482000000,19245000000,20797000000,4730000000,410000000,,-1624000000,-1418000000,50319,TCOM
2019-12-31,2206120,,-7625397,,-7625397,4911613,-2174877,-7086490,-7086490,,-933,,,,0,31243,7117733,2206120,-538907,,-7625397,-7625397,50322,HJLI
2018-12-31,1238749,,-13042709,,-13042709,6482953,-1052197,-7535150,-7535150,,-6886116,,,,0,186552,7721702,1238749,-5507559,,-13042709,-16352710,50322,HJLI
2017-12-31,649736,,-7791469,,-7791469,5455963,2452,-6103247,-6103247,,-1919636,,,,0,422111,6525358,419659,-1688222,,-7791469,-8251386,50322,HJLI
2016-12-31,649736,,-5588258,,-3387490,4634801,-24382,-4659183,-4659183,,-57890,,,,0,785912,5445095,810294,-929075,2200768.0,-5588258,-3730349,50322,HJLI
2019-12-31,,,193000000,1101000000,82000000,,786000000,205000000,205000000,-9000000,-179000000,,,,17000000,2347000000,2142000000,1561000000,-12000000,,176000000,52000000,50323,TAC
2018-12-31,,,-96000000,1137000000,-198000000,,634000000,69000000,69000000,-9000000,-185000000,,,,-6000000,2249000000,2180000000,1615000000,-165000000,,-90000000,-248000000,50323,TAC
2017-12-31,,,-54000000,1059000000,-160000000,,774000000,149000000,149000000,-10000000,-212000000,,,,64000000,2307000000,2158000000,1533000000,-203000000,,-118000000,-190000000,50323,TAC
2016-12-31,,,314000000,1152000000,169000000,,945000000,313000000,313000000,31000000,-205000000,,,,38000000,2397000000,2084000000,1452000000,1000000,,276000000,117000000,50323,TAC
2020-06-30,2600000,,260400000,,220700000,570900000,983300000,409800000,409800000,,-126100000,,,,39700000,3094300000,2684500000,2111000000,-149400000,,220700000,173000000,50324,CTLT
2019-06-30,3300000,,160300000,,137400000,507200000,805100000,294600000,294600000,,-110900000,,,,22900000,2518000000,2223400000,1712900000,-134300000,,137400000,132000000,50324,CTLT
2018-06-30,6300000,,152000000,,83600000,458500000,752600000,287800000,287800000,,-111400000,,,,68400000,2463400000,2175600000,1710800000,-135800000,,83600000,83600000,50324,CTLT
2017-06-30,7000000,,135600000,,109800000,395600000,654600000,252000000,252000000,,-90100000,,,,25800000,2075400000,1823400000,1420800000,-116400000,,109800000,109800000,50324,CTLT
2019-12-31,1173800000,,-165000000,,-104500000,335000000,1331200000,-177600000,-177600000,,-44200000,,,,-60500000,1448800000,1626400000,117600000,12600000,,-104500000,-104500000,50325,UTHR
2018-12-31,357900000,,758900000,,589200000,268700000,1429100000,802500000,802500000,,-13900000,,,,169700000,1627800000,825300000,198700000,-43600000,,589200000,589200000,50325,UTHR
2017-12-31,264600000,,769500000,,417900000,332600000,1619600000,1022400000,1022400000,,-9000000,,,,351600000,1725300000,702900000,105700000,-252900000,,417900000,417900000,50325,UTHR
2016-12-31,147600000,,1060200000,,713700000,319300000,1526100000,1059200000,1059200000,,-3900000,,,,346500000,1598800000,539600000,72700000,1000000,,713700000,713700000,50325,UTHR
2019-12-31,,,-29369000,,-29369000,12293000,-17663000,-29956000,-29956000,,,,,,0,0,29956000,17663000,587000,,-29369000,-29369000,50330,ALRN
2018-12-31,,,-31547000,,-31547000,12354000,-18448000,-30802000,-30802000,,,,,,0,0,30802000,18448000,-745000,,-31547000,-31547000,50330,ALRN
2017-12-31,,,-22604000,,-22604000,8769000,-14239000,-23008000,-23008000,,,,,,0,0,23008000,14239000,404000,,-22604000,-22645000,50330,ALRN
2016-12-31,,,-18123000,,-18123000,7893000,-10276000,-18169000,-18169000,,,,,,0,0,18169000,10276000,46000,,-18123000,-18198000,50330,ALRN
2019-12-31,,,9000000,1270000000,47000000,1119000000,1921000000,440000000,440000000,-62000000,-422000000,,,,-96000000,4240000000,3800000000,2319000000,-431000000,,105000000,47000000,50336,SBGI
2018-12-31,,,310000000,-39000000,341000000,720000000,1641000000,658000000,658000000,-17000000,-292000000,,,,-36000000,3055000000,2397000000,1414000000,-348000000,,346000000,341000000,50336,SBGI
2017-12-31,10000000.0,,519000000,-34372000,576000000,626000000,1381000000,480000000,480000000,-1000000,-212000000,,,,-75000000,2636000000,2156000000,1255000000,39000000,,594000000,576000000,50336,SBGI
2016-12-31,4085000.0,,372890000,-30047000,245301000,573745000,1454293000,598224000,598224000,-1000000,-211143000,,,,122128000,2622510000,2024286000,1168217000,-225334000,,250762000,245301000,50336,SBGI
2019-12-31,,,92728000,22903000,87855000,75441000,354475000,155720000,155720000,,-61672000,,,,0,486187000,330467000,131712000,-62992000,,92728000,86519000,50337,SKT
2018-12-31,,,45563000,25356000,43655000,71233000,367514000,164559000,164559000,,-64821000,,,,0,500905000,336346000,133391000,-118996000,,45563000,42444000,50337,SKT
2017-12-31,,,71876000,30724000,68002000,73050000,363982000,163188000,163188000,,-64825000,,,,0,490171000,326983000,126189000,-91312000,,71876000,66793000,50337,SKT
2016-12-31,,,204329000,35225000,193744000,74604000,356210000,166249000,166249000,,-60669000,,,,0,479606000,313357000,123396000,38080000,,204329000,191818000,50337,SKT
2019-12-31,508714000,,564251000,,468173000,791220000,1504616000,261378000,261378000,-56696000,,,,,96078000,8374501000,8113123000,6869885000,302873000,,468173000,468173000,50339,HUYA
2018-12-31,265152000,,-1988632000,,-1937689000,476917000,744540000,26662000,26662000,-24191000,,,,,-50943000,4663440000,4636778000,3918900000,-2015294000,,-1937689000,-2506312000,50339,HUYA
2017-12-31,170160000,,-80968000,,-80968000,189287000,263235000,-94866000,-94866000,-1346000,,,,,0,2184816000,2279682000,1921581000,13898000,,-80968000,-100810000,50339,HUYA
2016-12-31,188334000,,-625627000,,-625627000,140071000,-297740000,-626145000,-626145000,-1346000,,,,,0,796904000,1423049000,1094644000,518000,,-625627000,-625627000,50339,HUYA
2019-12-31,596000,,6543164,,5513608,42975510,52000858,8429348,8429348,,-1828408,,,,1029556,142457342,134027994,90456484,-1886184,,5513608,5513608,50340,ACU
2018-12-31,734000,,5531224,,4598350,42458076,50648982,7456906,7456906,,-1891042,,,,932874,137321395,129864489,86672413,-1925682,,4598350,4598350,50340,ACU
2017-12-31,734000,,6493297,,4052479,40103220,47899273,7796053,7796053,,-1356536,,,,2440818,130550349,122754296,82651076,-1302756,,4052479,4052479,50340,ACU
2016-12-31,734000,,7496703,,5850998,37113000,45555056,8442056,8442056,,-868626,,,,1645705,124574371,116132315,79019315,-945353,,5850998,5850998,50340,ACU
2020-03-27,102052000,,53278000,950000,36971000,106396000,261276000,52828000,52828000,,-110000,,,,16173000,650089000,597261000,388813000,450000,,37105000,36971000,50343,ALGM
2019-03-29,107585000,,99441000,814000,84724000,111161000,319820000,101074000,101074000,,-1211000,,,,14600000,724311000,623237000,404491000,-1633000,,84841000,84723000,50343,ALGM
2007-03-30,38906000,,27249000,288000,21075000,44944000,112913000,29063000,29063000,,-1942000,,,,6149000,320741000,291678000,207828000,-1814000,,21100000,21075000,50343,ALGM
2006-03-31,35493000,,13967000,265000,11558000,40926000,91005000,14586000,14586000,,-2638000,,,,2385000,285055000,270469000,194050000,-619000,,11582000,11558000,50343,ALGM
2020-12-31,,,25206000,,20095000,39669000,69582000,0,26877000,3036000,,,,,5111000,69582000,42705000,0,-1671000,,20095000,20095000,50344,FMAO
2019-12-31,,,22634000,,18402000,36898300,64229000,0,24666100,2664600,,,,,4232000,64229000,39562900,0,-2032100,,18402000,18264000,50344,FMAO
2018-12-31,,,18176000,,14949000,28462900,50397000,0,19640100,2294000,,,,,3227000,50397000,30756900,0,-1464100,,14949000,14799000,50344,FMAO
2017-12-31,,,17903000,,12720000,25946000,46634000,0,18613000,2075000,,,,,5183000,46634000,28021000,0,-710000,,12720000,12598000,50344,FMAO
2019-12-31,,,-97488000,,-97336000,16094000,-91338000,-107432000,-107432000,,-1041000,,,,-152000,8000000,115432000,99338000,9944000,,-97336000,-97336000,50346,ANAB
2018-12-31,,,-61848000,,-61656000,15526000,-51196000,-66722000,-66722000,,-1652000,,,,-192000,5000000,71722000,56196000,4874000,,-61656000,-61656000,50346,ANAB
2017-12-31,,,-30070000,,-30070000,9338000,-19443000,-28781000,-28781000,,-1775000,,,,0,10000000,38781000,29443000,-1289000,,-30070000,-30070000,50346,ANAB
2016-12-31,,,-4259000,,-4259000,4290000,1265000,-3025000,-3025000,,-458000,,,,0,16684000,19709000,15419000,-1234000,,-4259000,-4259000,50346,ANAB
2020-12-31,,,17909505000,1591513000,12354114000,22581182000,46014427000,20398057000,20398057000,,-2865654000,,,,5633265000,52045724000,31647667000,6031297000,-2488552000,,12276240000,12354114000,50348,LU
2019-12-31,,,19433841000,103799000,13332431000,19736405000,43279562000,22911908000,22911908000,-162867000.0,-3000192000,,,,6116697000,48687790000,25775882000,5408228000,-3478067000,,13317144000,13332431000,50348,LU
2018-12-31,,,18649260000,18725000,13619928000,15221797000,40823198000,24949309000,24949309000,-71682000.0,-5442703000,,,,5073326000,44776871000,19827562000,3953673000,-6300049000,,13575934000,13619928000,50348,LU
2017-12-31,,,8363712000,568612000,5965460000,11575934000,29326903000,17430227000,17430227000,-50497000.0,-8700189000,,,,2336723000,35026980000,17596753000,5700077000,-9066515000,,6026989000,5965460000,50348,LU
2019-12-31,164480000,,-30891000,,-30745000,621118000,1005194000,219596000,219596000,,-246587000,,,,-201000,1005194000,785598000,0,-250487000,,-30690000,-30745000,50350,LC
2018-12-31,151455000,,-128110000,1780000.0,-128308000,596534000,1080417000,332428000,332428000,,-385605000,,,,43000,1080417000,747989000,0,-460538000,,-128153000,-128308000,50350,LC
2017-12-31,139864000,,-153413000,5262000.0,-153835000,508439000,1145964000,497661000,497661000,,-571424000,,,,632000,1145964000,648303000,0,-651074000,,-154045000,-153835000,50350,LC
2016-12-31,115223000,,-150197000,5262000.0,-145969000,496006000,1189180000,577951000,577951000,,-688368000,,,,-4228000,1189180000,611229000,0,-728148000,,-145969000,-145969000,50350,LC
2019-12-31,,,83848000,69612000,82610000,40197000,260371000,76509000,76509000,44220000,-41030000,,,,1500000,549348000,472839000,288977000,7339000,,82348000,67463000,50351,INN
2018-12-31,,,90204000,2295000,90921000,40030000,269182000,84800000,84800000,43339000,-41944000,,,,-922000,567270000,482470000,298088000,5404000,,91126000,70702000,50351,INN
2017-12-31,,,101195000,2874000,99214000,37807000,245048000,83895000,83895000,37419000,-29687000,,,,1674000,515377000,431482000,270329000,17300000,,99521000,78927000,50351,INN
2016-12-31,,,106811000,3428000,107805000,38104000,223824000,83064000,83064000,30250000,-28091000,,,,-1450000,473935000,390871000,250111000,23747000,,108261000,87106000,50351,INN
2020-12-31,,,37182000,,30045000,39822000,91747000,0,39518000,12407000,,,,,7137000,91747000,52229000,0,-2336000,,30045000,30045000,50356,AMNB
2019-12-31,,,25767000,,20906000,39294000,91841000,0,39097000,13450000,,,,,4861000,91841000,52744000,0,-13330000,,20906000,20906000,50356,AMNB
2018-12-31,,,28225000,,22579000,32227000,72471000,0,30021000,10223000,,,,,5646000,72471000,42450000,0,-1796000,,22579000,22579000,50356,AMNB
2017-12-31,,,26075000,,15249000,31748000,68958000,0,27444000,9766000,,,,,10826000,68958000,41514000,0,-1369000,,15249000,15249000,50356,AMNB
2019-12-31,10340000,,-22722000,,-22722000,116449000,103041000,-23748000,-23748000,,-909000,,,,0,296701000,320449000,193660000,1026000,,-22722000,-22722000,50360,COLL
2018-12-31,8661000,,-39128000,,-39128000,126760000,114736000,-20685000,-20685000,,-20130000,,,,0,280413000,301098000,165677000,-18443000,,-39128000,-39128000,50360,COLL
2017-12-31,8572000,,-74865000,,-74865000,90911000,25881000,-73602000,-73602000,,-20130000,,,,0,28476000,102078000,2595000,-1263000,,-74865000,-74865000,50360,COLL
2016-12-31,14948000,,-94176000,,-94176000,80632000,1498000,-94082000,-94082000,,-94000,,,,0,1711000,95793000,213000,-94000,,-94176000,-94176000,50360,COLL
2019-12-31,,,33170000,,25237000,129369000,178895000,38952000,38952000,,-3105000,,,,7359000,648448000,609496000,469553000,-5782000,-574000,25811000,25237000,50361,ADUS
2018-12-31,,,20403000,,16433000,100525000,136532000,27365000,27365000,,-5016000,,,,4096000,516375000,489010000,379843000,-6962000,126000,16307000,16433000,50361,ADUS
2017-12-31,,,21064000,,11953000,75702000,106351000,23986000,23986000,,-4472000,,,,9258000,416470000,392484000,310119000,-2922000,147000,11806000,11953000,50361,ADUS
2016-12-31,,,16162000,,12160000,68822000,98963000,23494000,23494000,,-2332000,,,,4099000,393556000,370062000,294593000,-7332000,97000,12063000,12160000,50361,ADUS
2019-12-31,597456,,-4913750,,-6327658,7183834,2796575,-4984715,-4984715,,-482844,,,,1413908,19646652,24631367,16850077,70965,,-6327658,-6327658,50366,CVV
2018-12-31,606618,,-5557583,,-5201021,9826031,5178130,-5254519,-5254519,,-463017,,,,-356562,24334331,29588850,19156201,-303064,,-5201021,-5201021,50366,CVV
2017-12-31,437157,,7195355,,5261411,9944182,17600212,7218873,7218873,,-106280,,,,1933944,41128639,33909766,23528427,-23518,,5261411,5261411,50366,CVV
2016-12-31,433844,,-653185,,-149124,8024148,7104523,-1353469,-1353469,,-79861,,,,-504061,20955347,22308816,13850824,700284,,-149124,-149124,50366,CVV
2020-09-30,,,4226000,,4041000,9539000,10173000,110000,110000,,-553000,,,,185000,49942000,49832000,39769000,4116000,,4041000,4041000,50368,DJCO
2019-09-30,,,-31476000,,-25216000,14224000,11398000,-3415000,-3415000,,-955000,,,,-6260000,48655000,52070000,37257000,-28061000,,-25216000,-25216000,50368,DJCO
2018-09-30,,,-11339000,,8201000,13988000,4633000,-13033000,-13033000,,-746000,,,,-19540000,40703000,53736000,36070000,1694000,,8201000,8201000,50368,DJCO
2017-09-30,,,-8068000,,-918000,14323000,7687000,-12222000,-12222000,,-522000,,,,-7150000,41384000,53606000,33697000,4154000,,-918000,-918000,50368,DJCO
2020-06-30,,,-12283000,,-12547000,7307000,9620000,0,1343000,970000,,,,,264000,9620000,8277000,0,-13626000,,-12547000,-12547000,50369,KFFB
2019-06-30,,,953000,,812000,7574000,9680000,0,1055000,1051000,,,,,141000,9680000,8625000,0,-102000,,812000,812000,50369,KFFB
2018-06-30,,,1286000,,1323000,7748000,10231000,0,1393000,1090000,,,,,-37000,10231000,8838000,0,-107000,,1323000,1323000,50369,KFFB
2017-06-30,,,1448000,,935000,7357000,9979000,0,1559000,1063000,,,,,513000,9979000,8420000,0,-111000,,935000,935000,50369,KFFB
2019-12-31,30992000,,-103223000,,-103319000,108231000,56095000,-83128000,-83128000,,-7134000,,,,96000,77595000,160723000,21500000,-20095000,,-103319000,-103319000,50370,PRCHW
2018-12-31,24173000,,-50475000,,-49917000,63884000,38800000,-49257000,-49257000,,-3706000,,,,-558000,54137000,103394000,15337000,-1218000,,-49917000,-49917000,50370,PRCHW
2019-12-31,34637000,,-27049000,,-28462000,306083000,359348000,13556000,13556000,,-122000,,,,1413000,459955000,446399000,100607000,-40605000,,-28462000,-28462000,50371,OFIX
2018-12-31,33218000,,22885000,,13811000,285478000,356414000,36463000,36463000,,-828000,,,,9074000,453042000,416579000,96628000,-13578000,,13811000,13811000,50371,OFIX
2017-12-31,29700000,,36391000,,6223000,275575000,340786000,35511000,35511000,,-416000,,,,29100000,433823000,398312000,93037000,880000,-1068000.0,7291000,6223000,50371,OFIX
2016-12-31,28803000,,19024000,,3056000,260696000,322335000,32836000,32836000,,-416000,,,,15527000,409788000,376952000,87453000,-13812000,-441000.0,3497000,3056000,50371,OFIX
2019-12-31,,,-3014634,,-2889147,8283266,6806736,-2880366,-2880366,,-159220,,,,-125487,19409230,22289596,12602494,-134268,,-2889147,-2889147,50377,DSS
2018-12-31,,,1481562,,1464969,7088610,6661583,-1708661,-1708661,,-191070,,,,16593,18515082,20223743,11853499,3190223,,1464969,1464969,50377,DSS
2017-12-31,,,-599118,,-578156,6465016,7652990,-225864,-225864,,-377463,,,,-20962,18661872,18887736,11008882,-373254,,-578156,-578156,50377,DSS
2016-12-31,,,-939273,,-950003,7326063,8057819,-660059,-660059,,-279214,,,,10730,19177599,19837658,11119780,-279214,,-950003,-950003,50377,DSS
2019-12-31,,,12776000000,8831000000,9171000000,16516000000,31967000000,16154000000,16154000000,-703000000,-4273000000,,,,2786000000,52329000000,36175000000,20362000000,-3378000000,424000000,9990000000,9171000000,50378,BUD
2018-12-31,,,7742000000,7404000000,4370000000,16901000000,33108000000,16932000000,16932000000,-725000000,-4229000000,,,,2585000000,53041000000,36109000000,19933000000,-9190000000,531000000,5157000000,4370000000,50378,BUD
2017-12-31,,,11075000000,7635000000,7996000000,18200000000,35058000000,17564000000,17564000000,-706000000,-4906000000,,,,1920000000,56444000000,38880000000,21386000000,-6489000000,28000000,9155000000,7996000000,50378,BUD
2016-12-31,,,4334000000,10086000000,1241000000,15284000000,27714000000,13125000000,13125000000,-695000000,-4728000000,,,,1613000000,45517000000,32392000000,17803000000,-8791000000,48000000,2721000000,1241000000,50378,BUD
2020-12-31,,,1333965000,,1064151000,2123413000,3759694000,0,1378078000,258203000,,,,,269814000,3759694000,2381616000,0,-44113000,,1064151000,1005426000,50380,FRC
2019-12-31,,,1133236000,,930329000,1845601000,3279697000,0,1171995000,262101000,,,,,202907000,3279697000,2107702000,0,-38759000,,930329000,881259000,50380,FRC
2018-12-31,,,1051742000,,853828000,1623759000,2968461000,0,1109864000,234838000,,,,,197914000,2968461000,1858597000,0,-58122000,,853828000,796103000,50380,FRC
2017-12-31,,,912202000,,757660000,1381627000,2551743000,0,967994000,202122000,,,,,154542000,2551743000,1583749000,0,-55792000,,757660000,699620000,50380,FRC
2020-12-31,109387000,,-6246000,,2378000,112172000,218051000,-3508000,-3508000,,-5000,,,,-8624000,506510000,510018000,288459000,-2738000,,2378000,2378000,50381,ADTN
2019-12-31,120914000,,-24777000,,-52982000,130382000,219952000,-31344000,-31344000,,-511000,,,,28205000,530061000,561405000,310109000,6567000,,-52982000,-52982000,50381,ADTN
2018-12-31,122716000,,-33371000,,-19342000,121211000,206340000,-37587000,-37587000,,-533000,,,,-14029000,529277000,566864000,322937000,4216000,,-19342000,-19342000,50381,ADTN
2017-12-31,130544000,,44687000,,23840000,135080000,303635000,38011000,38011000,,-556000,,,,20847000,666900000,628889000,363265000,6676000,,23840000,23840000,50381,ADTN
2019-12-31,,,491000000,275000000,380000000,122000000,988000000,579000000,579000000,,-102000000,,,,129000000,6364000000,5785000000,5376000000,-88000000,,362000000,380000000,50383,CVI
2018-12-31,,,445000000,657000000,259000000,112000000,924000000,538000000,538000000,,-102000000,,,,79000000,7124000000,6586000000,6200000000,-93000000,,366000000,259000000,50383,CVI
2017-12-31,,,38000000,785000000,263000000,113000000,519000000,148000000,148000000,69800000.0,-109000000,,,,-220000000,5988000000,5840000000,5469000000,-110000000,,258000000,263000000,50383,CVI
2016-12-31,,,-11000000,851500000,25000000,110000000,374000000,71000000,71000000,19400000.0,-83000000,,,,-20000000,4782000000,4711000000,4408000000,-82000000,,9000000,25000000,50383,CVI
2020-01-31,263566000,,-327882000,,-336582000,637877000,561689000,-339754000,-339754000,,,,,,8700000,794191000,1133945000,232502000,11872000,,-336582000,-336582000,50385,CLDR
2019-01-31,173814000,,-187231000,,-192649000,340977000,343827000,-170964000,-170964000,,,,,,5418000,479941000,650905000,136114000,-16267000,,-192649000,-192649000,50385,CLDR
2018-01-31,215695000,,-367593000,,-369672000,372735000,214258000,-374172000,-374172000,,,,,,2079000,372293000,746465000,158035000,6579000,,-369672000,-369672000,50385,CLDR
2017-01-31,102309000,,-156198000,,-158385000,219754000,185555000,-136508000,-136508000,,,,,,2187000,272543000,409051000,86988000,-19690000,,-158385000,-158385000,50385,CLDR
2020-09-30,1096000000,,985000000,,874000000,4318000000,7919000000,2520000000,2520000000,-15000000,-528000000,,,,111000000,17117000000,14597000000,9198000000,-1535000000,,874000000,767000000,50388,BDXB
2019-09-30,1032000000,,1176000000,,1233000000,4334000000,8288000000,2921000000,2921000000,1000000,-639000000,,,,-57000000,17290000000,14369000000,9002000000,-1745000000,,1233000000,1081000000,50388,BDXB
2018-09-30,1004000000,,1173000000,,311000000,4029000000,7805000000,2772000000,2772000000,1000000,-706000000,,,,862000000,15983000000,13211000000,8178000000,-1599000000,,311000000,159000000,50388,BDXB
2017-09-30,770000000,,976000000,,1100000000,2953000000,5965000000,2243000000,2243000000,-1000000,-521000000,,,,-124000000,12093000000,9850000000,6128000000,-1267000000,,1100000000,1030000000,50388,BDXB
2019-12-31,30656000,,-40106000,,-40128000,10385000,0,-41041000,-41041000,,-546000,,,,22000,0,41041000,0,935000,,-40128000,-40128000,50390,LOGC
2018-12-31,11079000,,-17535000,,-17621000,6864000,0,-17943000,-17943000,,-2000,,,,86000,0,17943000,0,408000,,-17621000,-17621000,50390,LOGC
2017-12-31,3558000,,-5733000,,-5795000,2296000,0,-5854000,-5854000,,-2000,,,,62000,0,5854000,0,121000,,-5795000,-7735000,50390,LOGC
2016-12-31,2030000,,-3410000,,-3428000,1373000,0,-3403000,-3403000,,-1000,,,,18000,0,3403000,0,-7000,,-3428000,-3765000,50390,LOGC
2020-12-31,,,1577549000,881555000,1405521000,68492000,2830834000,1818135000,1818135000,875176000,-143456000,,,,111838000,8525275000,6707140000,5694441000,-240586000,,1465711000,1363909000,50391,ACGLO
2019-12-31,,,1849110000,818181000,1636319000,65667000,2953803000,2005035000,2005035000,800997000,-120872000,,,,155810000,6928200000,4923165000,3974397000,-155925000,,1693300000,1594707000,50391,ACGLO
2018-12-31,,,841772000,997852000,757971000,58608000,1755327000,913240000,913240000,677809000,-120484000,,,,113951000,5450568000,4537328000,3695241000,-71468000,,727821000,713616000,50391,ACGLO
2017-12-31,,,757277000,1049333000,619278000,61602000,1884471000,1012640000,1012640000,684451000,-117431000,,,,127568000,5627375000,4614735000,3742904000,-255363000,,629709000,566502000,50391,ACGLO
2019-12-31,12841000,,-44486000,,-44486000,48195000,17000000,-44036000,-44036000,,-711000,,,,0,32790000,76826000,15790000,-450000,,-44486000,-44486000,50392,EAR
2018-12-31,9520000,,-33793000,,-33793000,33791000,11740000,-31571000,-31571000,,-424000,,,,0,23163000,54734000,11423000,-2222000,,-33793000,-33793000,50392,EAR
2017-12-31,5449000,,-24616000,,-24616000,15043000,2153000,-18339000,-18339000,,-1783000,,,,0,6620000,24959000,4467000,-6277000,,-24616000,-24616000,50392,EAR
2019-12-31,52193000,,-62660000,,-62659000,17164000,5283000,-64074000,-64074000,,-491000,,,,-1000,5283000,69357000,0,1414000,,-62659000,-62659000,50395,ERYP
2018-12-31,33468000,,-38222000,,-38224000,14600000,4447000,-43621000,-43621000,,-9000,,,,2000,4447000,48068000,0,5399000,,-38224000,-38224000,50395,ERYP
2017-12-31,25463000,,-33533000,,-33530000,8791000,3364000,-30890000,-30890000,,-15000,,,,-3000,3364000,34254000,0,-2643000,,-33530000,-33530000,50395,ERYP
2016-12-31,19720000,,-21903000,,-21913000,6808000,4138000,-22390000,-22390000,,-4000,,,,10000,4138000,26528000,0,487000,,-21913000,-21913000,50395,ERYP
2019-12-31,,,6394535000,,5001014000,15126381000,23706290000,7431244000,7431244000,1148665000,-975465000,,,,1393521000,44268171000,36836927000,20561881000,-1036709000,,5001014000,5001014000,50397,VIV
2018-12-31,,,11277490000,,8928258000,15364886000,24031809000,7213864000,7213864000,1453059000,-696636000,,,,2349232000,43462740000,36248876000,19430931000,4063626000,,8928258000,8928258000,50397,VIV
2017-12-31,,,5730773000,,4608790000,15579579000,22934302000,6632237000,6632237000,722486000,-2659002000,,,,1121983000,43206832000,36574595000,20272530000,-901464000,,4608790000,4608790000,50397,VIV
2016-12-31,,,5134722000,,4085242000,15150425000,23546682000,6889593000,6889593000,1506664000,-1339273000,,,,1049480000,42508459000,35618866000,18961777000,-1754871000,,4085242000,4085242000,50397,VIV
2020-12-31,,,441178000,2925000,354057000,710949000,1209556000,0,441178000,57429000,,,,,87293000,1209556000,768378000,0,0,,353885000,342091000,50398,CBSH
2019-12-31,,,531786000,3788000,421231000,667393000,1299184000,0,538462000,93329000,,,,,109074000,1299184000,760722000,0,-6676000,,422712000,408212000,50398,CBSH
2018-12-31,,,544163000,5851000,433542000,633814000,1281984000,0,555709000,92461000,,,,,105949000,1281984000,726275000,0,-11546000,,438214000,419984000,50398,CBSH
2017-12-31,,,430406000,1624000,319383000,608212000,1174749000,0,444392000,122145000,,,,,110506000,1174749000,730357000,0,-13986000,,319900000,306535000,50398,CBSH
2019-12-31,47416000,,-65886000,,-65789000,19565000,43000,-66938000,-66938000,,-19000,,,,-97000,43000,66981000,0,1052000,,-65789000,-65789000,50400,NK
2018-12-31,55318000,,-96729000,,-96226000,43118000,47000,-98389000,-98389000,,-433000,,,,-503000,47000,98436000,0,1660000,,-96226000,-96226000,50400,NK
2017-12-31,41644000,,-96916000,,-96423000,57521000,45000,-99120000,-99120000,,-618000,,,,-493000,45000,99165000,0,2204000,,-96423000,-96423000,50400,NK
2016-12-31,28853000,,-121381000,,-120809000,95691000,44000,-124500000,-124500000,,-66000,,,,-572000,44000,124544000,0,3119000,,-120809000,-120809000,50400,NK
2020-03-28,,,326400000,,384300000,3081400000,3812800000,602100000,602100000,29600000,-17600000,,,,-57900000,6159800000,5557700000,2347000000,-275700000,,384300000,384300000,50401,RL
2019-03-30,,,582500000,,430900000,3144400000,3893200000,706700000,706700000,18200000,-20700000,,,,151600000,6313000000,5606300000,2419800000,-124200000,,430900000,430900000,50401,RL
2018-03-31,,,489200000,,162800000,3061300000,3759300000,663800000,663800000,18200000,-18200000,,,,326400000,6182300000,5518500000,2423000000,-174600000,,162800000,162800000,50401,RL
2017-04-01,,,-104900000,,-99300000,2857300000,3849000000,678000000,678000000,18200000,-12400000,,,,-5600000,6652800000,5974800000,2803800000,-782900000,,-99300000,-99300000,50401,RL
2019-12-31,,,9211000,,8675000,23425000,110156000,29932000,29932000,,-25633000,,,,536000,355547000,325615000,245391000,-20721000,,8675000,8675000,50402,OSG
2018-12-31,,,-4225000,,13489000,26348000,100401000,23541000,23541000,,-30890000,,,,-17714000,366163000,342622000,265762000,-27766000,,13489000,13489000,50402,OSG
2017-12-31,,,-1649000,,55978000,27336000,133301000,47292000,47292000,,-37401000,,,,-57627000,390426000,343134000,257125000,-48941000,,55978000,55957000,50402,OSG
2016-12-31,,,-66157000,,-293614000,41350000,213259000,82346000,82346000,,-43151000,,,,-65098000,462420000,380074000,249161000,-148503000,-292555000.0,-1059000,-296003000,50402,OSG
2020-12-31,,,1318262000,1513214000,773642000,1212584000,3561991000,1718972000,1718972000,,-304111000,,,,313932000,11550604000,9831632000,7988613000,-400710000,-9653000,1004330000,773642000,50403,DVA
2019-12-31,,,1195439000,1366209000,810981000,1103312000,3473994000,1755530000,1755530000,,-435233000,,,,279628000,11388479000,9632949000,7914485000,-560091000,105483000,915811000,810981000,50403,DVA
2018-12-31,,,1048478000,1329597000,159394000,1135454000,3216638000,1490149000,1490149000,,-478969000,,,,258400000,11412151000,9922002000,8195513000,-441671000,-457038000,790078000,159394000,50403,DVA
2017-12-31,,,1399786000,1207397000,663618000,1052076000,3243662000,1631675000,1631675000,,-422356000,,,,323859000,10883667000,9251992000,7640005000,-231889000,-245372000,1075927000,663618000,50403,DVA
2020-12-31,,,-33713000,328119000,-119625000,152372000,325556000,76398000,76398000,96786000,-141618000,,,,57957000,3314029000,3237631000,2988473000,-110111000,,-91670000,-119625000,50404,AENZ
2019-12-31,,,-474726000,398275000,-884721000,211458000,445670000,-43495000,-43495000,277707000,-143374000,,,,319957000,4085004000,4128499000,3639334000,-431231000,-43959000.0,-794683000,-884721000,50404,AENZ
2018-12-31,,,133948000,401571000,-83188000,276507000,679957000,411138000,411138000,-7688000,-175442000,,,,113318000,3899462000,3488324000,3219505000,-277190000,36785000.0,20630000,-83188000,50404,AENZ
2017-12-31,,,45112000,465748000,148738000,315026000,514380000,193971000,193971000,5383000,-117177000,,,,46305000,4014013000,3820042000,3499633000,-148859000,210431000.0,-1193000,148738000,50404,AENZ
2020-03-31,,,-730000000,,-676000000,365000000,1044000000,305000000,305000000,,-137000000,,,,-54000000,4504000000,4199000000,3460000000,-1035000000,,-676000000,-676000000,50408,PRSP
2019-03-31,,,112000000,,72000000,326000000,987000000,331000000,331000000,,-121000000,,,,40000000,4030000000,3699000000,3043000000,-219000000,,72000000,72000000,50408,PRSP
2018-03-31,,,199000000,,208000000,182000000,664000000,315000000,315000000,,-12000000,,,,-9000000,2819000000,2504000000,2155000000,-116000000,,208000000,208000000,50408,PRSP
2017-03-31,,,141600000,,86400000,184800000,607200000,247200000,247200000,,-24000000,,,,55200000,2575200000,2328000000,1968000000,-105600000,,86400000,86400000,50408,PRSP
2019-12-31,,,-5375001,124477,-5733658,2701314,3324268,-4529465,-4529465,5152419,-845536,,,,234180,3399788,7929253,75520,-845536,,-5609181,-5733658,50410,MDWT
2018-12-31,,,-5037250,124477,-5065534,2160853,761351,-5037250,-5037250,3637748,-845536,,,,0,875812,5913062,114461,0,-28284.0,-5037250,-5065534,50410,MDWT
2017-12-31,,,-2898713,124477,-2749071,2143449,1096152,-3385074,-3385074,2337777,-845536,,,,0,1946019,5331093,849867,486361,149642.0,-2898713,-2749071,50410,MDWT
2016-12-31,,,-3847922,124477,-3847922,2175519,1415638,-3375465,-3375465,2615584,-845536,,,,0,4114248,7489713,2698610,-472457,149642.0,-3847922,-3847922,50410,MDWT
2019-12-31,463111,,-2689949,,-2689949,2226837,0,-2689948,-2689948,,,,,,0,0,2689948,0,-1,,-2689949,-2689949,50411,SCPS
2018-12-31,277539,,-685964,,-685964,408425,0,-685964,-685964,,,,,,0,0,685964,0,0,,-685964,-685964,50411,SCPS
2017-12-31,197759,,-395301,,-395301,197543,0,-395301,-395301,,,,,,0,0,395301,0,0,,-395301,-395301,50411,SCPS
2019-12-27,,,4656000,,4841000,109583000,134973000,10363000,10363000,,-4900000,,,,-185000,443099000,432736000,308126000,-5707000,,4841000,4841000,50412,WLDN
2018-12-28,,,12161000,,10030000,72613000,92971000,14298000,14298000,,-700000,,,,2131000,272252000,257954000,179281000,-2137000,,10030000,10030000,50412,WLDN
2017-12-29,,,13691000,,12129000,58859000,76690000,13882000,13882000,,-111000,,,,1562000,273352000,259470000,196662000,-191000,,12129000,12129000,50412,WLDN
2016-12-30,,,11367000,,8299000,50862000,65681000,11615000,11615000,,-179000,,,,3068000,208941000,197326000,143260000,-248000,,8299000,8299000,50412,WLDN
2019-12-31,35400000,,150400000,400000,112200000,273700000,470600000,161500000,161500000,,-4800000,,,,38200000,1513300000,1351800000,1042700000,-11100000,,112200000,112200000,50413,IOSP
2018-12-31,33400000,,131600000,500000,85000000,255300000,441800000,153100000,153100000,,-6900000,,,,46600000,1476900000,1323800000,1035100000,-21500000,,85000000,85000000,50413,IOSP
2017-12-31,31400000,,128100000,400000,61800000,239500000,409200000,138300000,138300000,,-8200000,,,,66300000,1306800000,1168500000,897600000,-10200000,,61800000,61800000,50413,IOSP
2016-12-31,25400000,,103100000,300000,81300000,209500000,337000000,102100000,102100000,,-3200000,,,,21800000,883400000,781300000,546400000,1000000,,81300000,81300000,50413,IOSP
2020-01-31,52462000,,-91236000,,-92137000,141497000,110558000,-83401000,-83401000,,-123000,,,,901000,155056000,238457000,44498000,-7835000,,-92137000,-92137000,50417,SUMO
2019-01-31,36240000,,-47182000,,-47789000,86565000,74632000,-48173000,-48173000,,-105000,,,,607000,103642000,151815000,29010000,991000,,-47789000,-47789000,50417,SUMO
2018-01-31,25261000,,-32010000,,-32435000,52688000,45390000,-32559000,-32559000,,-19000,,,,425000,67828000,100387000,22438000,549000,,-32435000,-32435000,50417,SUMO
2019-12-31,,,933710000,197414000,742686000,1245698000,2287298000,841791000,841791000,199809000,-43381000,,,,202452000,7294055000,6452264000,5006757000,91919000,,731258000,742686000,50418,TS
2018-12-31,,,1103107000,92610000,876063000,1329866000,2512596000,980813000,980813000,201917000,-36942000,,,,229207000,7658588000,6677775000,5145992000,122294000,,873900000,876063000,50418,TS
2017-12-31,,,427711000,98785000,544737000,1270016000,1603447000,334588000,334588000,-1157000,-27072000,,,,-17136000,5288504000,4953916000,3685057000,93123000,91542000.0,444847000,544737000,50418,TS
2016-12-31,,,34430000,125655000,55298000,1129205000,1144601000,-59057000,-59057000,74453000,-22329000,,,,17102000,4293592000,4352649000,3148991000,93487000,41411000.0,17328000,55298000,50418,TS
2019-12-31,,,47941000,,37125000,134187000,211314000,56529000,56529000,,-7418000,,,,10816000,565527000,508998000,354213000,-8588000,,37125000,37125000,50419,PRFT
2018-12-31,,,32372000,,24559000,118484000,178544000,39632000,39632000,,-3560000,,,,7813000,498375000,458743000,319831000,-7260000,,24559000,24559000,50419,PRFT
2017-12-31,,,27143000,,18581000,108192000,161513000,33574000,33574000,,-1838000,,,,8562000,485261000,451687000,323748000,-6431000,,18581000,18581000,50419,PRFT
2016-12-31,,,30509000,,20459000,101264000,151280000,31778000,31778000,,-1636000,,,,10050000,486982000,455204000,335702000,-1269000,,20459000,20459000,50419,PRFT
2019-12-31,,,2875829,,2780713,12494510,16255842,3241034,3241034,,-414961,,,,95116,82024497,78783463,65768655,-365205,,2780713,2780713,50420,ELA
2018-12-31,,,718357,,657685,8701499,9679723,691477,691477,,-149540,,,,60672,54056343,53364866,44376620,26880,,657685,657685,50420,ELA
2017-12-31,,,1840009,,1838786,8983152,11288824,1984928,1984928,,-199243,,,,1223,61994918,60009990,50706094,-144919,,1838786,1838786,50420,ELA
2016-12-31,,,-3957898,,-4005814,10345557,8307847,-2441426,-2441426,,-364532,,,,47916,48326609,50768035,40018762,-1516472,,-4005814,-4005814,50420,ELA
2019-12-31,,,-56600000,,-58100000,131000000,179000000,7800000,7800000,,-51500000,,,,1500000,731400000,723600000,552400000,-64400000,,-58100000,-63100000,50423,FOUR
2018-12-31,,,-53700000,,-49900000,97200000,150400000,12800000,12800000,,-47000000,,,,-3800000,560600000,547800000,410200000,-66500000,,-49900000,-54600000,50423,FOUR
2019-12-31,,,-5000000,89000000,-14000000,36000000,117000000,50000000,50000000,,-30000000,,,,17000000,373000000,323000000,256000000,-51000000,24000000,-22000000,-14000000,50424,KEN
2018-12-31,,,461968000,66695000,434213000,33424000,104497000,40751000,40751000,,-30382000,,,,11499000,364012000,323261000,259515000,421217000,-5631000,450469000,434213000,50424,KEN
2017-12-31,,,-135636000,68229000,236590000,55600000,118568000,32174000,32174000,,-59514000,,,,72809000,365704000,333530000,247136000,-167810000,476565000,-208445000,236590000,50424,KEN
2016-12-31,,,-426900000,212963000,-411937000,46454000,72587000,-1205000,-1205000,,-45317000,,,,2252000,324253000,325458000,251666000,-425695000,35150000,-429152000,-411937000,50424,KEN
2019-12-31,2268000000,,47242000000,3596000000,40137000000,26114000000,122105000000,77887000000,77887000000,13590000000,-19783000000,,,,16400000000,302245000000,224358000000,180140000000,-30645000000,10128000000,30842000000,40137000000,50425,PBR
2018-12-31,2345000000,,38967000000,6318000000,25779000000,22084000000,118687000000,70668000000,70668000000,16192000000,-14980000000,,,,15462000000,310255000000,239587000000,191568000000,-31701000000,3193000000,23505000000,25779000000,50425,PBR
2017-12-31,1831000000,,6174000000,5624000000,-446000000,23824000000,91595000000,48004000000,48004000000,13411000000,-16602000000,,,,5797000000,258454000000,210450000000,166859000000,-41830000000,3193000000,377000000,-446000000,50425,PBR
2016-12-31,1826000000,,-10703000000,2513000000,-14824000000,25307000000,89978000000,47096000000,47096000000,3908000000,-20959000000,,,,2342000000,282589000000,235493000000,192611000000,-57799000000,3193000000,-13045000000,-14824000000,50425,PBR
2020-12-31,,,1076000000,,1056000000,678000000,3871000000,1947000000,1947000000,-362000000,-689000000,,,,20000000,5840000000,3893000000,1969000000,-871000000,,1056000000,999000000,50428,CCI
2019-12-31,,,881000000,,860000000,614000000,3777000000,1591000000,1591000000,-362000000,-683000000,,,,21000000,5763000000,4172000000,1986000000,-710000000,,860000000,747000000,50428,CCI
2018-12-31,,,641000000,,622000000,563000000,3526000000,1436000000,1436000000,-362000000,-642000000,,,,19000000,5370000000,3934000000,1844000000,-795000000,,622000000,509000000,50428,CCI
2017-12-31,,,392000000,,366000000,426000000,2712000000,1045000000,1045000000,-362000000,-591000000,,,,26000000,4255000000,3210000000,1543000000,-653000000,,366000000,308000000,50428,CCI
2020-10-31,1874000000,,-442000000,47000000,-322000000,4483000000,8496000000,1659000000,1659000000,101000000,-332000000,,,,-120000000,26982000000,25323000000,18486000000,-2101000000,,-322000000,-322000000,50432,HPE
2019-10-31,1842000000,,1553000000,51000000,1049000000,4837000000,9493000000,2924000000,2924000000,-377000000,-311000000,,,,504000000,29135000000,26211000000,19642000000,-1371000000,,1049000000,1049000000,50432,HPE
2018-10-31,1667000000,,268000000,35000000,1908000000,4783000000,9231000000,1133000000,1133000000,1354000000,-353000000,,,,-1744000000,30852000000,29719000000,21621000000,-865000000,-104000000.0,2012000000,1908000000,50432,HPE
2017-10-31,1490000000,,272000000,39000000,344000000,4951000000,8669000000,1904000000,1904000000,3000000,-334000000,,,,-164000000,28871000000,26967000000,20202000000,-1632000000,-92000000.0,436000000,344000000,50432,HPE
2020-12-31,,,1741881000,213791000,1208368000,1817279000,3776922000,0,1769468000,190175000,,,,,447587000,3776922000,2007454000,0,-27587000,,1294294000,1191217000,50434,SIVBP
2019-12-31,,,1610402000,150773000,1136856000,1429255000,3220624000,0,1639186000,152183000,,,,,425685000,3220624000,1581438000,0,-28784000,,1184717000,1136856000,50434,SIVBP
2018-12-31,,,1362909000,148634000,973840000,1057866000,2551102000,0,1405985000,87251000,,,,,351561000,2551102000,1145117000,0,-43076000,,1011348000,973840000,50434,SIVBP
2017-12-31,,,874641000,139620000,490506000,890465000,1882565000,0,906979000,85121000,,,,,355463000,1882565000,975586000,0,-32338000,,519178000,490506000,50434,SIVBP
2019-12-31,,,948989,,703109,412670,0,-412670,-412670,,,,,,245880,0,412670,0,1361659,,703109,-658550,50439,FSRV
2020-10-31,715000000,,761000000,,627000000,1053000000,2533000000,777000000,777000000,-12000000,-78000000,,,,134000000,4221000000,3444000000,1688000000,-16000000,,627000000,627000000,50442,KEYS
2019-10-31,688000000,,715000000,,621000000,1092000000,2534000000,773000000,773000000,-19000000,-80000000,,,,94000000,4303000000,3530000000,1769000000,-58000000,,621000000,621000000,50442,KEYS
2018-10-31,624000000,,-411000000,,165000000,1065000000,2111000000,435000000,435000000,-13000000,-83000000,,,,-576000000,3878000000,3443000000,1767000000,-846000000,,165000000,165000000,50442,KEYS
2017-10-31,507000000,,179000000,,102000000,932000000,1697000000,198000000,198000000,60000000,-80000000,,,,77000000,3189000000,2991000000,1492000000,-19000000,,102000000,102000000,50442,KEYS
2019-12-31,17419000,,-42304000,,-42304000,29814000,4032000,-43201000,-43201000,,-390000,,,,0,6291000,49492000,2259000,897000,,-42304000,-42304000,50446,RDHL
2018-12-31,24862000,,-38820000,,-38820000,19992000,5523000,-39331000,-39331000,,-390000,,,,0,8360000,47691000,2837000,511000,,-38820000,-38820000,50446,RDHL
2017-12-31,32969000,,-45544000,,-45544000,20039000,1881000,-51127000,-51127000,845000.0,-390000,,,,0,4007000,55134000,2126000,5583000,,-45544000,-45544000,50446,RDHL
2016-12-31,25241000,,-29370000,,-29370000,5403000,101000,-30543000,-30543000,845000.0,-7000,,,,0,101000,30644000,0,1173000,,-29370000,-29370000,50446,RDHL
2020-12-31,,,69446000,,52452000,85091000,165150000,0,71758000,8301000,,,,,16994000,165150000,93392000,0,-2312000,,52452000,52452000,50448,TRST
2019-12-31,,,76509000,,57840000,86659000,174239000,0,78130000,9450000,,,,,18669000,174239000,96109000,0,-1621000,,57840000,57840000,50448,TRST
2018-12-31,,,79654000,,61445000,83463000,177367000,0,83626000,10278000,,,,,18209000,177367000,93741000,0,-3972000,,61445000,61445000,50448,TRST
2017-12-31,,,76747000,,43145000,79209000,170741000,0,82097000,9435000,,,,,33602000,170741000,88644000,0,-5350000,,43145000,43145000,50448,TRST
2020-12-31,,,310616000,45840000,383259000,1766613000,2395937000,0,485277000,144047000,,,,,-72933000,2395937000,1910660000,0,-174661000,,383549000,383259000,50449,IFS
2019-12-31,,,1943441000,46578000,1441258000,1809223000,3849492000,0,1873411000,166858000,,,,,493326000,3849492000,1976081000,0,70030000,,1450115000,1441258000,50449,IFS
2018-12-31,,,1506909000,40402000,1084280000,1660873000,3331616000,0,1494135000,176608000,,,,,415515000,3331616000,1837481000,0,12774000,,1091394000,1084280000,50449,IFS
2017-12-31,,,1359980000,36364000,1027379000,1559365000,3056594000,0,1345960000,151269000,,,,,326526000,3056594000,1710634000,0,14020000,,1033454000,1027379000,50449,IFS
2020-10-31,,,1079574,,1079574,821380,2690240,1868860,1868860,,,,,,0,2690240,821380,0,-789286,,1079574,1079574,50450,FMY
2019-10-31,,,2818339,,2818339,838957,2283773,1444816,1444816,,,,,,0,2283773,838957,0,1373523,,2818339,2818339,50450,FMY
2018-10-31,,,1010342,,1010342,1016986,2904140,1887154,1887154,,,,,,0,2904140,1016986,0,-876812,,1010342,1010342,50450,FMY
2017-10-31,,,3045529,,3045529,817786,1546835,729049,729049,,,,,,0,1546835,817786,0,2316480,,3045529,3045529,50450,FMY
2019-12-31,,,260077000,26307000,258699000,46622000,383783000,231131000,231131000,,-76430000,,,,0,579305000,348174000,195522000,28946000,,260077000,258699000,50453,LSI
2018-12-31,,,207558000,23716000,206590000,48322000,371953000,224201000,224201000,,-70672000,,,,0,554972000,330771000,183019000,-16643000,,207558000,206590000,50453,LSI
2017-12-31,,,96809000,19373000,96365000,50031000,352183000,178867000,178867000,,-74362000,,,,0,533064000,354197000,180881000,-82058000,,96809000,96365000,50453,LSI
2016-12-31,,,84956000,18091000,85225000,43103000,315009000,163025000,163025000,,-54504000,,,,0,466273000,303248000,151264000,-78069000,,84956000,85225000,50453,LSI
2019-12-31,,,-67300000,,-58500000,144700000,85300000,-59400000,-59400000,,-4400000,,,,1600000,626300000,685700000,541000000,-7900000,10400000,-68900000,-58500000,50456,AFI
2018-12-31,,,-25100000,,-163000000,158200000,143200000,-15000000,-15000000,,-4800000,,,,-6000000,728200000,743200000,585000000,-10100000,-143900000,-19100000,-163000000,50456,AFI
2017-12-31,,,-19100000,,-41800000,162700000,151100000,-11600000,-11600000,,-2700000,,,,-2000000,704100000,715700000,553000000,-7500000,-24700000,-17100000,-41800000,50456,AFI
2016-12-31,,,-20900000,,9200000,170900000,155600000,-15300000,-15300000,,-1500000,,,,-4700000,710100000,725400000,554500000,-5600000,25400000,-16200000,9200000,50456,AFI
2019-12-31,,,-43597000,,-43597000,36335000,-15344000,-51679000,-51679000,,,,,,0,104391000,156070000,119735000,8082000,,-43597000,-43597000,50463,VYGR
2018-12-31,,,-88468000,,-88288000,33809000,-57286000,-91095000,-91095000,,,,,,-180000,7619000,98714000,64905000,2627000,,-88288000,-88288000,50463,VYGR
2017-12-31,,,-70698000,,-70698000,19738000,-52125000,-71863000,-71863000,,,,,,0,10135000,81998000,62260000,1165000,,-70698000,-70698000,50463,VYGR
2016-12-31,,,-40141000,,-40193000,13270000,-28029000,-41299000,-41299000,,,,,,52000,14220000,55519000,42249000,1158000,,-40193000,-40193000,50463,VYGR
2020-12-31,,,168470000,194731000,159327000,39619000,843699000,455334000,455334000,,-224346000,,,,4925000,892381000,437047000,48682000,-286864000,,163545000,159327000,50465,OHI
2019-12-31,,,354791000,201166000,341123000,57869000,905980000,546428000,546428000,,-208715000,,,,2844000,928830000,382402000,22850000,-191637000,,351947000,341123000,50465,OHI
2018-12-31,,,296894000,320043000,281578000,63508000,854131000,502655000,502655000,,-201422000,,,,3010000,881682000,379027000,27551000,-205761000,,293884000,281578000,50465,OHI
2017-12-31,,,108158000,333167000,100419000,47683000,710186000,360332000,360332000,,-198278000,,,,3248000,908385000,548053000,198199000,-252174000,,104910000,100419000,50465,OHI
2020-12-31,64152000,,29403000,,29403000,72799000,32566000,-104385000,-104385000,,-267000,,,,0,78893000,183278000,46327000,133788000,,29403000,29403000,50466,PACB
2019-12-31,59630000,,-84134000,,-84134000,61391000,34576000,-86445000,-86445000,,-2611000,,,,0,90891000,177336000,56315000,2311000,,-84134000,-84134000,50466,PACB
2018-12-31,62594000,,-102562000,,-102562000,58789000,25096000,-96287000,-96287000,,-2423000,,,,0,78626000,174913000,53530000,-6275000,,-102562000,-102562000,50466,PACB
2017-12-31,65324000,,-92189000,,-92189000,59119000,34659000,-89784000,-89784000,,-2921000,,,,0,93468000,183252000,58809000,-2405000,,-92189000,-92189000,50466,PACB
2019-12-31,,,6547252,-376827,6547252,2495272,43919849,18950321,18950321,7790008,-12201966,,,,0,62155868,43205547,18236019,-12403069,,6547252,6547252,50468,NEN
2018-12-31,,,4169090,-354833,4169090,2204923,41818071,16558426,16558426,7485749,-12389680,,,,0,59654118,43095692,17836047,-12389336,,4169090,4169090,50468,NEN
2017-12-31,,,6937931,-351745,6937931,2008107,40335384,18050793,18050793,6814089,-11114146,,,,0,56733215,38682422,16397831,-11112862,,6937931,6937931,50468,NEN
2016-12-31,,,4950852,-340840,4950852,2102812,35593759,15045777,15045777,6263774,-10200393,,,,0,51340917,36295140,15747158,-10094925,,4950852,4950852,50468,NEN
2019-12-31,16836000,,-194405000,,-211642000,157675000,174711000,200000,200000,,-12571000,,,,17237000,308384000,308184000,133673000,-194605000,,-211642000,-211642000,50469,SRGA
2018-12-31,14410000,,-7391000,,-3123000,119724000,141260000,7126000,7126000,,-2771000,,,,-4268000,280362000,273236000,139102000,-14517000,,-3123000,-5243000,50469,SRGA
2017-12-31,13315000,,26255000,,6906000,115009000,143072000,14748000,14748000,,-3180000,,,,19349000,280349000,265601000,137277000,11507000,,6906000,3183000,50469,SRGA
2016-12-31,16090000,,-17460000,,-14399000,116125000,132349000,134000,134000,,-1655000,,,,-3061000,272865000,272731000,140516000,-17594000,,-14399000,-17907000,50469,SRGA
2019-12-31,,,4720000000,70000000,3419000000,15519000000,22160000000,0,5365000000,1276000000,,,,,1295000000,22160000000,16795000000,0,-645000000,,3425000000,3419000000,50470,CS
2018-12-31,,,3372000000,97000000,2024000000,15139000000,20675000000,0,4277000000,1259000000,,,,,1361000000,20675000000,16398000000,0,-905000000,,2011000000,2024000000,50470,CS
2017-12-31,,,1793000000,287000000,-983000000,16488000000,20690000000,0,2772000000,1430000000,,,,,2741000000,20690000000,17918000000,0,-979000000,,-948000000,-983000000,50470,CS
2016-12-31,,,-2266000000,414000000,-2710000000,17521000000,20071000000,0,1095000000,1455000000,,,,,441000000,20071000000,18976000000,0,-3361000000,,-2707000000,-2710000000,50470,CS
2019-12-27,,,90700000,79800000,66500000,191900000,305000000,104600000,104600000,,-25400000,,,,21400000,4489000000,4384400000,4184000000,-13900000,,69300000,66500000,50471,FDP
2018-12-28,,,200000,77600000,-21900000,191000000,279800000,82500000,82500000,-700000.0,-23600000,,,,16100000,4493900000,4411400000,4214100000,-82300000,,-15900000,-21900000,50471,FDP
2017-12-29,,,144100000,23800000,120800000,176700000,331600000,153600000,153600000,500000.0,-6400000,,,,24900000,4085900000,3932300000,3754300000,-9500000,,119200000,120800000,50471,FDP
2016-12-30,3300000.0,,237400000,24600000,225100000,184100000,461400000,273400000,273400000,600000.0,-4100000,,,,11800000,4011500000,3738100000,3550100000,-36000000,,225600000,225100000,50471,FDP
2019-12-31,,,-119516275,11257057,-164686075,472304901,304201145,-136673954,-136673954,-31429802,,,,,52944639,785947212,922621166,481746067,17157679,,-172460914,-164686075,50472,JP
2018-12-31,,,-264941932,28137492,-387744018,577953239,637185004,107974662,107974662,-48742897,,,,,129855367,1321743663,1213769001,684558659,-372916594,,-394797299,-387744018,50472,JP
2017-12-31,,,545504751,34516245,409492179,486224327,968653718,523567834,523567834,-41138443,,,,,122998509,1706161622,1182593788,737507904,21936917,,422506242,409492179,50472,JP
2016-12-31,,,312657561,47664877,207583868,393256358,650675532,294805008,294805008,-37385834,,,,,82612132,1127710444,832905436,477034912,17852553,,230045429,207583868,50472,JP
2019-12-31,,,932656000,452959000,938089000,473086000,1394494000,921408000,921408000,,-52541000,,,,4437000,2573111000,1651703000,1178617000,11248000,,928219000,902175000,50480,ESGRO
2018-12-31,,,-218396000,470599000,-150221000,407375000,191316000,-216059000,-216059000,,-26217000,,,,-6124000,839134000,1055193000,647818000,-2337000,,-212272000,-162354000,50480,ESGRO
2017-12-31,,,314411000,488870000,311458000,435985000,806480000,370495000,370495000,,-28102000,,,,-6395000,1100952000,730457000,294472000,-56084000,10993000.0,320806000,311458000,50480,ESGRO
2016-12-31,,,327324000,463042000,264807000,423734000,777765000,354031000,354031000,,-20642000,,,,34874000,1136395000,782364000,358630000,-26707000,11963000.0,292450000,264807000,50480,ESGRO
2020-09-30,,,77885000,244983000,28792000,155728000,171677000,72237000,72237000,-57256000,,,,,11552000,171677000,99440000,0,5648000,,66333000,28583000,50481,RMR
2019-09-30,,,196364000,240381000,74580000,152275000,301338000,205536000,205536000,-57490000,,,,,27320000,301338000,95802000,0,-9172000,,169044000,74098000,50481,RMR
2018-09-30,,,276288000,201899000,96041000,146335000,351827000,257396000,257396000,-53152000,,,,,58862000,351827000,94431000,0,18892000,,217426000,95477000,50481,RMR
2017-09-30,,,136920000,140132000,42293000,124942000,231396000,144748000,144748000,-40332000,,,,,28251000,231396000,86648000,0,-8024000,,108669000,42135000,50481,RMR
2020-12-31,,,819899000,,816965000,173478000,1312728000,880675000,880675000,-101000,-222863000,,,,2934000,2427802000,1547127000,1115074000,-60776000,,816965000,816965000,50485,MMP
2019-12-31,,,1022286000,,1020849000,208164000,1474552000,1010002000,1010002000,10252000,-201839000,,,,1437000,2727912000,1717910000,1253360000,12284000,,1020849000,1020849000,50485,MMP
2018-12-31,,,1333996000,,1333925000,209651000,1472824000,1047196000,1047196000,10252000,-203524000,,,,71000,2826573000,1779377000,1353749000,286800000,,1333925000,1333925000,50485,MMP
2017-12-31,,,873361000,,869531000,174441000,1294066000,922995000,922995000,10252000,-195133000,,,,3830000,2507661000,1584666000,1213595000,-49634000,,869531000,869531000,50485,MMP
2019-12-31,,,53177148,,53177148,5439633,42606729,37167096,37167096,,-4692162,,,,0,42606729,5439633,0,16010052,,53177148,53177148,50487,BLW
2019-08-31,,,44426544,,44426544,5059636,44983490,39923854,39923854,,-5810660,,,,0,44983490,5059636,0,4502690,,44426544,44426544,50487,BLW
2018-08-31,,,23061080,,23061080,5530992,45747017,40216025,40216025,,-4230939,,,,0,45747017,5530992,0,-17154945,,23061080,23061080,50487,BLW
2017-08-31,,,53615358,,53615358,5568079,46494776,40926697,40926697,,-3472321,,,,0,46494776,5568079,0,12688661,,53615358,53615358,50487,BLW
2020-01-31,,,2201730000,,1712555000,6152157000,8489061000,2336904000,2336904000,,-100574000,,,,489175000,27753973000,25417069000,19264912000,-135174000,,1712555000,1712555000,50489,DG
2019-02-01,,,2015416000,,1589472000,5683464000,7803870000,2120406000,2120406000,,-99871000,,,,425944000,25625043000,23504637000,17821173000,-104990000,,1589472000,1589472000,50489,DG
2018-02-02,,,1907280000,,1538960000,5205741000,7221359000,2015618000,2015618000,,-97036000,,,,368320000,23470967000,21455349000,16249608000,-108338000,,1538960000,1538960000,50489,DG
2017-02-03,,,1965628000,,1251133000,4712889000,6782638000,2069749000,2069749000,,-97821000,,,,714495000,21986598000,19916849000,15203960000,-104121000,,1251133000,1251133000,50489,DG
2020-12-31,,,626073000,,472640000,484105000,1494051000,731838000,731838000,101018000,-105765000,,,,153433000,5871640000,5139802000,4377589000,-105765000,,472640000,472640000,50491,LPLA
2019-12-31,,,741835000,,559880000,465446000,1616097000,874992000,874992000,114546000,-130001000,,,,181955000,5624856000,4749864000,4008759000,-133157000,,559880000,559880000,50491,LPLA
2018-12-31,,,592637000,,439459000,456174000,1441020000,717660000,717660000,119278000,-125023000,,,,153178000,5188400000,4470740000,3747380000,-125023000,,439459000,439459000,50491,LPLA
2017-12-31,,,364570000,,238863000,385341000,1097917000,494002000,494002000,96210000,-107025000,,,,125707000,4281481000,3787479000,3183564000,-129432000,,238863000,238863000,50491,LPLA
2019-12-31,,,106658000,,86874000,-3317000,202330000,114227000,114227000,19858000,-23063000,,,,19784000,554955000,440728000,352625000,-7569000,,86874000,86874000,50495,MGEE
2018-12-31,,,111653000,,84219000,-10946000,190029000,125153000,125153000,19410000,-19609000,,,,27434000,545368000,420215000,355339000,-13500000,,84219000,84219000,50495,MGEE
2017-12-31,,,119700000,,97606000,-6230000,196996000,130855000,130855000,19294000,-19324000,,,,22094000,548999000,418144000,352003000,-9608000,,97606000,97606000,50495,MGEE
2016-12-31,,,118073000,,75560000,-6587000,188590000,130469000,130469000,20062000,-19866000,,,,42513000,530245000,399776000,341655000,-12396000,,75560000,75560000,50495,MGEE
2019-12-31,,,6527000000,4545000000,4739000000,-267000000,9627000000,5602000000,5602000000,1254000000,-1751000000,,,,1798000000,21419000000,15817000000,11792000000,925000000,,4729000000,4739000000,50504,SO
2018-12-31,,,2733000000,4607000000,2226000000,-235000000,9664000000,4356000000,4356000000,2412000000,-1858000000,,,,449000000,23495000000,19139000000,13831000000,-1623000000,,2284000000,2226000000,50504,SO
2017-12-31,,,1030000000,1685000000,842000000,-235000000,9915000000,2528000000,2528000000,4612000000,-1732000000,,,,142000000,23031000000,20503000000,13116000000,-1498000000,,888000000,842000000,50504,SO
2016-12-31,,,3435000000,2136000000,2448000000,-235000000,8530000000,4487000000,4487000000,1541000000,-1362000000,,,,951000000,19896000000,15409000000,11366000000,-1052000000,,2484000000,2448000000,50504,SO
2020-12-31,152000000,,1511000000,631000000,906000000,1769000000,3779000000,1865000000,1865000000,-7000000,-129000000,,,,455000000,12756000000,10891000000,8977000000,-354000000,,1056000000,906000000,50505,OTIS
2019-12-31,163000000,,1861000000,626000000,1116000000,1699000000,3826000000,1953000000,1953000000,11000000,-129000000,,,,594000000,13118000000,11165000000,9292000000,-92000000,,1267000000,1116000000,50505,OTIS
2018-12-31,181000000,,1893000000,646000000,1049000000,1645000000,3726000000,1925000000,1925000000,-25000000,-129000000,,,,683000000,12915000000,10990000000,9189000000,-32000000,,1210000000,1049000000,50505,OTIS
2017-12-31,175000000,,1957000000,698000000,636000000,1597000000,3702000000,1967000000,1967000000,-37000000,-40000000,,,,1148000000,12323000000,10356000000,8621000000,-10000000,,809000000,636000000,50505,OTIS
2020-12-31,,,24160000,,20075000,34505000,69945000,0,25462000,9978000,,,,,4085000,69945000,44483000,0,-1302000,,20075000,20075000,50510,LCNB
2019-12-31,,,23025000,,18912000,34475000,66548000,0,24460000,7613000,,,,,4113000,66548000,42088000,0,-1435000,,18912000,18881000,50510,LCNB
2018-12-31,,,17794000,,14845000,29583000,57721000,0,21278000,6860000,,,,,2949000,57721000,36443000,0,-3484000,,14845000,14827000,50510,LCNB
2017-12-31,,,17244000,,12972000,25233000,50112000,0,18546000,6333000,,,,,4272000,50994000,32448000,882000,-1302000,,12972000,12965000,50510,LCNB
2019-12-31,,,-8030000,87899000,-8044000,4141000,19153000,4395000,4395000,,-10885000,,,,0,20318000,15923000,1165000,-12425000,,-8030000,-8044000,50511,NTST
2018-12-31,,,-20297000,87899000,-20297000,3792000,22097000,5425000,5425000,,-11004000,,,,0,23828000,18403000,1731000,-25722000,,-20297000,-20297000,50511,NTST
2020-12-31,248384000,,-212417000,,-218178000,654717000,779897000,-133174000,-133174000,9970000,-43319000,,,,5761000,1029564000,1162738000,249667000,-79243000,,-218178000,-218178000,50513,ZEN
2019-12-31,207548000,,-168303000,,-169653000,528590000,582134000,-154004000,-154004000,9567000,-26708000,,,,1350000,816416000,970420000,234282000,-14299000,,-169653000,-169653000,50513,ZEN
2018-12-31,158260000,,-143191000,,-131084000,395159000,417491000,-135928000,-135928000,9567000,-19882000,,,,-12107000,598746000,734674000,181255000,-7263000,,-131084000,-131084000,50513,ZEN
2017-12-31,115291000,,-103659000,,-102141000,293598000,302743000,-106146000,-106146000,9567000,-19882000,,,,-1518000,430165000,536311000,127422000,2487000,,-102141000,-102141000,50513,ZEN
2020-09-30,,,-447000000,18000000,-475000000,2034000000,2130000000,-94000000,-94000000,,-127000000,,,,23000000,4463000000,4557000000,2333000000,-353000000,,-470000000,-476000000,50514,WMG
2019-09-30,,,267000000,20000000,256000000,1483000000,2074000000,383000000,383000000,,-142000000,,,,9000000,4475000000,4092000000,2401000000,-116000000,,258000000,256000000,50514,WMG
2018-09-30,,,442000000,14000000,307000000,1411000000,1834000000,217000000,217000000,,-138000000,,,,130000000,4005000000,3788000000,2171000000,225000000,,312000000,307000000,50514,WMG
2017-09-30,,,-2000000,15000000,143000000,1222000000,1645000000,222000000,222000000,,-149000000,,,,-151000000,3576000000,3354000000,1931000000,-224000000,,149000000,143000000,50514,WMG
2019-12-31,141060000,,-122893000,,-130075000,171832000,317084000,4192000,4192000,,-4477000,,,,7182000,563111000,558919000,246027000,-127085000,,-130075000,-130075000,50517,RBBN
2018-12-31,145462000,,-73410000,,-76810000,194312000,308332000,-31442000,-31442000,,-4530000,,,,3400000,577905000,609347000,269573000,-41968000,,-76810000,-76810000,50517,RBBN
2017-12-31,101481000,,-53692000,,-35252000,131045000,206967000,-25559000,-25559000,,-14000,,,,-18440000,329942000,355501000,122975000,-28133000,,-35252000,-35252000,50517,RBBN
2016-12-31,72841000,,-11416000,,-13932000,104487000,167611000,-9717000,-9717000,,-131000,,,,2516000,252591000,262308000,84980000,-1699000,,-13932000,-13932000,50517,RBBN
2020-07-31,,,-86930000,,-86930000,6364000,98135000,91771000,91771000,,-23372000,,,,0,98135000,6364000,0,-178701000,,-86930000,-88002000,50519,PHK
2019-07-31,,,92041000,,92041000,7400000,94093000,86693000,86693000,,4278000,,,,0,94093000,7400000,0,5348000,,92041000,88357000,50519,PHK
2018-07-31,,,78768000,,78768000,7707000,93126000,85419000,85419000,,-12262000,,,,0,93126000,7707000,0,-6651000,,78768000,76407000,50519,PHK
2017-07-31,,,174017000,,174017000,7662000,96262000,88600000,88600000,,-8353000,,,,0,96262000,7662000,0,85417000,,174017000,172908000,50519,PHK
2020-12-31,,,963353000,576786000,913636000,48305000,1655320000,786183000,786183000,,-374012000,,,,852000,2571705000,1785522000,916385000,177170000,,962501000,910546000,50522,EQR
2019-12-31,,,1007427000,692420000,970377000,52757000,1792747000,908907000,908907000,,-401746000,,,,-2281000,2701075000,1792168000,908328000,98520000,,1009708000,967287000,50522,EQR
2018-12-31,,,686070000,605551000,657535000,53813000,1698800000,859262000,859262000,,-424670000,,,,878000,2578434000,1719172000,879634000,-173192000,,685192000,654445000,50522,EQR
2017-12-31,,,628859000,598354000,603454000,52224000,1645137000,849164000,849164000,,-392416000,,,,478000,2471406000,1622242000,826269000,-220305000,,628381000,600363000,50522,EQR
2020-12-31,,,21047000,,15730000,32627000,59446000,0,22121000,4698000,,,,,5317000,59446000,37325000,0,-1074000,,15730000,15730000,50528,SHBI
2019-12-31,,,21894000,,16198000,31478000,59451000,0,23268000,4705000,,,,,5610000,59451000,36183000,0,-1374000,-86000.0,16284000,16198000,50528,SHBI
2018-12-31,,,21143000,,24997000,30485000,57974000,0,23133000,4356000,,,,,5380000,57974000,34841000,0,-1990000,9234000.0,15763000,24997000,50528,SHBI
2017-12-31,,,17959000,,11262000,28576000,51599000,0,19061000,3962000,,,,,8734000,51599000,32538000,0,-1102000,2037000.0,9225000,11262000,50528,SHBI
2019-12-31,,,-12667000,,-12678000,18555000,8706000,-10353000,-10353000,,-651000,,,,11000,102486000,112839000,93780000,-2314000,,-12678000,-14257000,50529,LOTZ
2018-12-31,,,-6557000,,-6560000,11911000,5643000,-6606000,-6606000,,-466000,,,,3000,58351000,64957000,52708000,49000,,-6560000,-7574000,50529,LOTZ
2017-12-31,,,-2465000,,-2469000,7327000,5553000,-1992000,-1992000,,-414000,,,,4000,44072000,46064000,38519000,-473000,,-2469000,-2743000,50529,LOTZ
2019-12-31,,,38524000000,73762000000,20699000000,142183000000,191481000000,47695000000,47695000000,1603000000,-13751000000,,,,10476000000,506711000000,459016000000,315230000000,-9171000000,,28048000000,20699000000,50531,FMX
2018-12-31,,,39882000000,78489000000,23990000000,132259000000,175170000000,41052000000,41052000000,1859000000,-9452000000,,,,10169000000,469744000000,428692000000,294574000000,-1170000000,1430000000.0,29713000000,23990000000,50531,FMX
2017-12-31,,,43694000000,86621000000,42409000000,121419000000,162090000000,38005000000,38005000000,2666000000,-10775000000,,,,10213000000,439932000000,401927000000,277842000000,5689000000,1545000000.0,33481000000,42409000000,50531,FMX
2016-12-31,,,35063000000,74266000000,21140000000,110478000000,148204000000,36015000000,36015000000,1711000000,-9364000000,,,,7888000000,399507000000,363492000000,251303000000,-952000000,1545000000.0,27175000000,21140000000,50531,FMX
2019-12-31,,,44897784,30471371,29393449,58533709,102951827,44418118,44418118,,-221449,,,,9797817,744292323,699874205,641340496,479666,,35099967,24775382,50533,DFH
2018-12-31,,,23261369,28929857,12991765,43545254,67855653,24310399,24310399,,-682152,,,,4330589,522258473,497948074,454402820,-1049030,,18930780,12390950,50533,DFH
2019-12-31,,,-1108000,,74086000,55107000,322141000,58649000,58649000,79347000,-61469000,,,,-75194000,532372000,473723000,210231000,-59757000,,74086000,72715000,50534,WTI
2018-12-31,,,249362000,,248827000,60147000,403230000,247027000,247027000,-35367000,-48645000,,,,535000,578874000,331847000,175644000,2335000,,248827000,239100000,50534,WTI
2017-12-31,,,67113000,,79682000,59744000,321177000,109950000,109950000,12973000,-45521000,,,,-12569000,485356000,375406000,164179000,-42837000,,79682000,76438000,50534,WTI
2016-12-31,,,-292396000,,-249020000,59740000,221570000,-52705000,-52705000,20497000,-85782000,,,,-43376000,398097000,450802000,176527000,-239691000,,-249020000,-249020000,50534,WTI
2020-12-31,,,42646000,,34767000,105836000,176341000,0,48092000,22413000,,,,,7879000,176341000,128249000,0,-5446000,,34767000,34767000,50536,PEBO
2019-12-31,,,65358000,,53695000,104012000,198566000,0,74311000,20243000,,,,,11663000,201582000,127271000,3016000,-8953000,,53695000,53299000,50536,PEBO
2018-12-31,,,54941000,,46255000,91944000,178507000,0,67589000,18974000,,,,,8686000,181332000,113743000,2825000,-12648000,,46255000,45994000,50536,PEBO
2017-12-31,,,57203000,,38471000,82541000,162605000,0,63422000,16642000,,,,,18732000,165178000,101756000,2573000,-6219000,,38471000,38274000,50536,PEBO
2020-02-02,,,457021000,,356062000,1669943000,2139092000,469149000,469149000,,-8853000,,,,100959000,5898008000,5428859000,3758916000,-12128000,,356062000,356062000,50539,WSM
2019-02-03,,,429247000,,333684000,1659445000,2101013000,441568000,441568000,,-6706000,,,,95563000,5671593000,5230025000,3570580000,-12321000,,333684000,333684000,50539,WSM
2018-01-28,,,452439000,,259545000,1474702000,1931711000,457009000,457009000,,-1372000,,,,192894000,5292359000,4835350000,3360648000,-13170000,,259545000,259545000,50539,WSM
2017-01-29,,,471911000,,305387000,1405373000,1883310000,477937000,477937000,,-688000,,,,166524000,5083812000,4605875000,3200502000,-6026000,,305387000,305387000,50539,WSM
2019-12-31,,,30097000,,24934000,18179000,67743000,29532000,29532000,511000,-1193000,,,,5163000,230213000,200681000,162470000,565000,,24934000,24934000,50541,METC
2018-12-31,,,25187000,,25074000,14006000,51019000,24096000,24096000,494000,-1427000,,,,113000,227574000,203478000,176555000,1091000,,25074000,25074000,50541,METC
2017-12-31,,,-15417000,,-15417000,12591000,515000,-15893000,-15893000,663000,-1427000,,,,0,61036000,76929000,60521000,476000,,-15417000,-15417000,50541,METC
2016-12-31,,,-7515000,,-7515000,7452000,819000,-7530000,-7530000,645000,-124000,,,,0,5216000,12746000,4397000,15000,,-7515000,-7515000,50541,METC
2019-12-26,,,150380000,,150631000,673228000,863014000,165192000,165192000,,-8801000,,,,-251000,2045456000,1880264000,1182442000,-14812000,,150631000,150631000,50542,FND
2018-12-27,,,122384000,,116187000,544822000,702268000,131301000,131301000,,-8917000,,,,6197000,1709848000,1578547000,1007580000,-8917000,,116187000,116187000,50542,FND
2017-12-28,,,98552000,,102788000,438308000,572564000,117771000,117771000,,-13777000,,,,-4236000,1384767000,1266996000,812203000,-19219000,,102788000,102788000,50542,FND
2016-12-29,,,54513000,,43039000,335901000,429262000,79629000,79629000,,-12803000,,,,11474000,1050759000,971130000,621497000,-25116000,,43039000,43039000,50542,FND
2020-12-31,,,16610000,,11985000,29277000,52418000,0,18485000,4656000,,,,,4625000,52418000,33933000,0,-1875000,,11985000,11985000,50545,PVBC
2019-12-31,,,14619000,,10808000,23729000,42175000,0,15353000,3093000,,,,,3811000,42175000,26822000,0,-734000,,10808000,10808000,50545,PVBC
2018-12-31,,,12562000,,9325000,21903000,37976000,0,13207000,2866000,,,,,3237000,37976000,24769000,0,-645000,,9325000,9325000,50545,PVBC
2017-12-31,,,15333000,,7915000,20375000,39082000,0,15642000,3065000,,,,,7418000,39082000,23440000,0,-309000,,7915000,7915000,50545,PVBC
2019-12-31,,,37426000,,37189000,14123000,208624000,100656000,100656000,,-70498000,,,,237000,704629000,603973000,496005000,-63230000,,37189000,37189000,50549,GOGL
2018-12-31,,,84767000,,84535000,14705000,252686000,145833000,145833000,,-69545000,,,,232000,659061000,513228000,406375000,-61066000,,84535000,84535000,50549,GOGL
2017-12-31,,,-2292000,,-2348000,12558000,142104000,51453000,51453000,,-60320000,,,,56000,463904000,412451000,321800000,-53745000,,-2348000,-2348000,50549,GOGL
2016-12-31,,,-127866000,,-127711000,12728000,8388000,-69573000,-69573000,,-47356000,,,,-155000,257808000,327381000,249420000,-58293000,,-127711000,-127711000,50549,GOGL
2020-12-28,19770000,,-46277000,,177535000,186359000,364858000,119891000,119891000,,-73156000,,,,-29891000,2105322000,1985431000,1740464000,-166168000,193921000,-16386000,177535000,50550,TTMI
2019-12-30,19770000,,46184000,,41301000,219205000,401683000,134004000,134004000,,-83234000,,,,4883000,2689308000,2555304000,2287625000,-87820000,193921000,41301000,41301000,50550,TTMI
2018-12-31,19770000,,89768000,,173584000,219471000,461934000,182782000,182782000,,-78958000,,,,-83816000,2847261000,2664479000,2385327000,-93014000,193921000,173584000,173584000,50550,TTMI
2018-01-01,19770000,,139958000,,124214000,191997000,429581000,213950000,213950000,,-53898000,,,,15231000,2658592000,2444642000,2229011000,-73992000,193921000,124727000,124214000,50550,TTMI
2020-07-31,,,7281724,,7281724,2210877,12443365,10232488,10232488,,-2335303,,,,0,12443365,2210877,0,-2950764,,7281724,7281724,50552,BNY
2019-07-31,,,14356114,,14356114,2155274,12646752,10491478,10491478,,-2992750,,,,0,12646752,2155274,0,3864636,,14356114,14356114,50552,BNY
2018-07-31,,,1546125,,1546125,2153257,12473711,10320454,10320454,,-2533808,,,,0,12473711,2153257,0,-8774329,,1546125,1546125,50552,BNY
2017-07-31,,,-2294731,,-2294731,2185793,12852333,10666540,10666540,,-1993631,,,,0,12852333,2185793,0,-12961271,,-2294731,-2294731,50552,BNY
2019-12-31,70200000,,330000000,55400000,249000000,822100000,1588600000,583200000,583200000,,-177300000,,,,77400000,4482200000,3899000000,2893600000,-253200000,,252600000,249000000,50556,AXTA
2018-12-31,73100000,,267500000,105400000,207100000,876400000,1600000000,535100000,535100000,,-169000000,,,,54200000,4696000000,4160900000,3096000000,-267600000,,213300000,207100000,50556,AXTA
2017-12-31,65300000,,189600000,131700000,36700000,934700000,1596500000,495900000,495900000,-600000.0,-147000000,,,,141900000,4377000000,3881100000,2780500000,-306300000,,47700000,36700000,50556,AXTA
2016-12-31,57700000,,82700000,121500000,38800000,882200000,1563900000,540600000,540600000,-600000.0,-178200000,,,,38100000,4092700000,3552100000,2528800000,-457900000,,44600000,38800000,50556,AXTA
2019-12-31,1219000,,795000,,686000,8637000,11215000,474000,474000,,,,,,109000,16295000,15821000,5080000,321000,,686000,686000,50557,ISDR
2018-12-31,1276000,,1210000,,837000,7087000,10129000,1163000,1163000,,,,,,373000,14232000,13069000,4103000,47000,,837000,837000,50557,ISDR
2017-12-31,763000,,2002000,,1871000,5988000,9233000,2028000,2028000,,-2000.0,,,,131000,12628000,10600000,3395000,-26000,,1871000,1871000,50557,ISDR
2016-12-31,404000,,2019000,,1555000,5786000,9034000,1935000,1935000,,-2000.0,,,,464000,12059000,10124000,3025000,84000,,1555000,1555000,50557,ISDR
2020-12-26,,,198970000,24315000,139493000,177318000,431882000,209721000,209721000,,-19247000,,,,55321000,2398043000,2188322000,1966161000,-10751000,,143649000,139493000,50558,MLI
2019-12-28,,,141489000,18668000,100972000,158268000,395006000,194045000,194045000,,-25683000,,,,35257000,2430616000,2236571000,2035610000,-52556000,,106232000,100972000,50558,MLI
2018-12-29,,,137772000,14904000,104459000,145974000,359678000,174149000,174149000,,-25199000,,,,30952000,2507878000,2333729000,2148200000,-36377000,,106820000,104459000,50558,MLI
2017-12-30,,,124895000,13917000,85598000,139580000,325456000,151932000,151932000,,-19502000,,,,37884000,2266073000,2114141000,1940617000,-27037000,,87011000,85598000,50558,MLI
2019-12-31,4520000,,-5231000,,-5268000,24648000,24274000,-4894000,-4894000,,-643000,,,,37000,31258000,36152000,6984000,-337000,,-5268000,-5268000,50559,ITMR
2018-12-31,3638000,,-1605000,,-1729000,17946000,18463000,-3121000,-3121000,,-794000,,,,124000,24189000,27310000,5726000,1609000,,-1729000,-1729000,50559,ITMR
2017-12-31,4129000,,-5216000,,-5301000,17418000,15699000,-5848000,-5848000,,-4427000,,,,85000,20701000,26549000,5002000,2021000,,-5301000,-5301000,50559,ITMR
2016-12-31,3225000,,-14272000,,-14403000,20248000,13461000,-10012000,-10012000,,-4610000,,,,131000,18440000,28452000,4979000,-3713000,,-14403000,-14403000,50559,ITMR
2019-12-31,8863000,,-76936000,,-32279000,27975000,-29872000,-75175000,-75175000,,-2019000,,,,-201000,119353000,194528000,149225000,-1761000,44456000,-76735000,-32279000,50560,FTK
2018-12-31,10356000,,-80657000,,-70340000,31467000,17965000,-33074000,-33074000,,-2866000,,,,-7216000,177773000,210847000,159808000,-47583000,2743000,-73441000,-70340000,50560,FTK
2017-12-31,13130000,,-11392000,358000.0,-27395000,41492000,54362000,-10028000,-10028000,,-2168000,,,,6112000,243106000,253134000,188744000,-1364000,-9891000,-17504000,-27395000,50560,FTK
2016-12-31,9319000,,-6651000,358000.0,-49130000,43745000,44250000,-16986000,-16986000,,-1979000,,,,-2204000,188233000,205219000,143983000,10335000,-44683000,-4447000,-49130000,50560,FTK
2019-12-31,44038000,,-52179000,,-52264000,10096000,0,-54134000,-54134000,,-6000,,,,85000,0,54134000,0,1955000,,-52264000,-52264000,50567,ALGS
2018-12-31,11406545,,-15199635,,-15199635,3837818,0,-15244362,-15244362,,-661091,,,,0,0,15244362,0,44727,,-15199635,-15199635,50567,ALGS
2020-02-01,,,31356000,,22622000,211507000,240244000,28737000,28737000,,,,,,8734000,619300000,590563000,379056000,2619000,,22622000,22622000,50570,TLYS
2019-02-02,,,33793000,,24943000,193337000,224103000,30766000,30766000,,,,,,8850000,598478000,567712000,374375000,3027000,,24943000,24943000,50570,TLYS
2018-02-03,,,25209000,,14700000,187013000,211847000,24834000,24834000,,,,,,10509000,576899000,552065000,365052000,375000,,14700000,14700000,50570,TLYS
2017-01-28,,,19748000,,11410000,146777000,168459000,21682000,21682000,,,,,,8338000,568952000,547270000,400493000,-1934000,,11410000,11410000,50570,TLYS
2019-12-31,,,-59006000,,-59006000,27304000,-24754000,-52058000,-52058000,,-7348000,,,,0,8335000,60393000,33089000,-6948000,,-59006000,-59006000,50571,TTOO
2018-12-31,,,-51153000,,-51153000,25697000,-18710000,-44407000,-44407000,,-6682000,,,,0,10500000,54907000,29210000,-6746000,,-51153000,-51153000,50571,TTOO
2017-12-31,,,-62428000,,-62428000,22757000,-28524000,-51281000,-51281000,,-6669000,,,,0,4666000,55947000,33190000,-11147000,,-62428000,-62428000,50571,TTOO
2016-12-31,,,-54804000,,-54804000,24077000,-26801000,-50878000,-50878000,,-4098000,,,,0,4080000,54958000,30881000,-3926000,,-54804000,-54804000,50571,TTOO
2020-12-31,,,38553000,1558928000,50421000,39601000,586540000,161691000,161691000,,-142872000,,,,0,891953000,730262000,305413000,-123138000,,38553000,50421000,50572,DEI
2019-12-31,,,418698000,1658862000,363713000,38068000,645442000,277631000,277631000,,-143308000,,,,0,943605000,665974000,298163000,141067000,,418698000,362119000,50572,DEI
2018-12-31,,,128612000,1446098000,116086000,38641000,606849000,258344000,258344000,,-133402000,,,,0,887716000,629372000,280867000,-129732000,,128612000,115540000,50572,DEI
2017-12-31,,,104427000,1464525000,94443000,36234000,559923000,246928000,246928000,,-145176000,,,,0,817957000,571029000,258034000,-142501000,,104427000,93817000,50572,DEI
2019-12-31,68308000,,-50036000,,15424000,152120000,202396000,-18032000,-18032000,,-2565000,,,,-65460000,236984000,255016000,34588000,-32004000,,15424000,15424000,50573,GKOS
2018-12-31,49676000,,-12368000,,-12951000,119529000,156203000,-13002000,-13002000,,-2565000,,,,583000,181278000,194280000,25075000,634000,,-12951000,-12951000,50573,GKOS
2017-12-31,38905000,,1000,,-92000,96260000,138204000,3039000,3039000,,-44000,,,,93000,159254000,156215000,21050000,-3038000,,-92000,-92000,50573,GKOS
2016-12-31,29223000,,4565000,,4522000,64756000,98220000,4241000,4241000,,-208000,,,,43000,114397000,110156000,16177000,324000,,4522000,4522000,50573,GKOS
2020-12-31,2582000000,,-2353000000,1721000000,-3519000000,4592000000,8531000000,2242000000,2242000000,-885000000,-1366000000,,,,575000000,56587000000,54345000000,48056000000,-4595000000,-410000000,-2928000000,-3519000000,50578,RTX
2019-12-31,3015000000,,8243000000,2552000000,5537000000,7399000000,20212000000,10273000000,10273000000,-475000000,-1773000000,,,,2295000000,77046000000,66773000000,56834000000,-2030000000,-410000000,5948000000,5537000000,50578,RTX
2018-12-31,2462000000,,8280000000,2273000000,5269000000,6189000000,16516000000,8516000000,8516000000,-651000000,-1225000000,,,,2626000000,66501000000,57985000000,49985000000,-236000000,-410000000,5654000000,5269000000,50578,RTX
2017-12-31,2427000000,,7763000000,1942000000,4552000000,5856000000,15636000000,8145000000,8145000000,-792000000,-1017000000,,,,2843000000,59837000000,51692000000,44201000000,-382000000,-410000000,4920000000,4552000000,50578,RTX
2020-12-31,170905000,,-861000,,-6221000,211263000,438921000,56753000,56753000,,-66297000,,,,5360000,644338000,587585000,205417000,-57614000,,-6221000,-6221000,50579,CHGG
2019-12-31,139772000,,-6971000,,-9605000,160058000,318744000,18914000,18914000,,-44851000,,,,2634000,410926000,392012000,92182000,-25885000,,-9605000,-9605000,50579,CHGG
2018-12-31,114291000,,-13458000,,-14888000,131428000,241088000,-4631000,-4631000,,-11225000,,,,1430000,321084000,325715000,79996000,-8827000,,-14888000,-14888000,50579,CHGG
2017-12-31,81926000,,-18481000,,-20283000,114951000,174891000,-21986000,-21986000,,-74000,,,,1802000,255066000,277052000,80175000,3505000,,-20283000,-20283000,50579,CHGG
2019-12-31,1154871000,,-2417874000,,-2438536000,685582000,-95000,-1840548000,-1840548000,,-83667000,,,,0,284367000,2124915000,284462000,-577326000,-20662000,-2417874000,-3281607000,50580,LI
2018-12-31,781956000,,-1165296000,,-1532318000,348961000,0,-1130917000,-1130917000,,-63467000,,,,0,0,1130917000,0,-34379000,-367022000,-1165296000,-1849638000,50580,LI
2019-12-31,,,-3517065,,-3517065,1693113,-2098222,-3791335,-3791335,,-51915,,,,0,1185227,4976562,3283449,274270,,-3517065,-3517065,50581,MARA
2018-12-31,,,-12745190,,-12814324,3269014,-3734634,-7003648,-7003648,,-2371510,,,,69134,1562372,8566020,5297006,-5741542,,-12814324,-12814324,50581,MARA
2017-12-31,,,-31437521,,-31333569,6234063,-5245877,-11479940,-11479940,,-4870932,,,,-103952,519622,11999562,5765499,-19957581,,-31333569,-31333569,50581,MARA
2016-12-31,,,-17312065,-163848.0,-28665024,5463588,6175163,711575,711575,,-3140375,,,,11516807,36629276,35917701,30454113,-18023640,,-28828872,-28665024,50581,MARA
2019-12-31,132851000,,-75595000,,-75595000,140509000,235445000,-37915000,-37915000,,-15019000,,,,0,272260000,310175000,36815000,-37680000,,-75595000,-75595000,50582,PBYI
2018-12-31,164854000,,-113575000,,-113575000,146188000,216370000,-94672000,-94672000,,-10985000,,,,0,250991000,345663000,34621000,-18903000,,-113575000,-113575000,50582,PBYI
2017-12-31,207810000,,-291955000,,-291955000,106693000,22113000,-292390000,-292390000,,-720000,,,,0,27685000,320075000,5572000,435000,,-291955000,-291955000,50582,PBYI
2016-12-31,222798000,,-276011000,,-276011000,53798000,0,-276596000,-276596000,,-720000,,,,0,0,276596000,0,585000,,-276011000,-276011000,50582,PBYI
2020-12-31,40033000,,-64662000,,-65381000,155542000,168055000,-27520000,-27520000,,-14521000,,,,719000,445887000,473407000,277832000,-37142000,,-65381000,-65381000,50583,QUOT
2019-12-31,39076000,,-36397000,,-37057000,152593000,172554000,-19115000,-19115000,,-13955000,,,,660000,436160000,455275000,263606000,-17282000,,-37057000,-37057000,50583,QUOT
2018-12-31,46873000,,-27836000,,-28318000,137091000,180728000,-3236000,-3236000,,-13411000,,,,482000,386958000,390194000,206230000,-24600000,,-28318000,-28318000,50583,QUOT
2017-12-31,50009000,,-15779000,,-15077000,139057000,181363000,-7703000,-7703000,,-1589000,,,,-702000,322115000,329818000,140752000,-8076000,,-15077000,-15077000,50583,QUOT
2019-12-31,7042000,,17820000,,17820000,33213000,65096000,24841000,24841000,,-7021000,,,,0,408005000,383164000,342909000,-7021000,,17820000,17820000,50585,MAX
2018-12-31,10339000,,18125000,,18125000,19582000,49240000,19319000,19319000,,-1194000,,,,0,296910000,277591000,247670000,-1194000,,18125000,18125000,50585,MAX
2020-03-31,,,412561000000,82558000000,302700000000,476679000000,875435000000,385351000000,385351000000,13405000000,-98979000000,,,,105837000000,2280329000000,1894978000000,1404894000000,27210000000,,306724000000,302700000000,50587,IX
2019-03-31,,,395730000000,65907000000,323745000000,457678000000,876949000000,420964000000,420964000000,-1693000000,-83900000000,,,,68691000000,2426259000000,2005295000000,1549310000000,-25234000000,,327039000000,323745000000,50587,IX
2018-03-31,,,435501000000,123870000000,313135000000,457677000000,877362000000,415266000000,415266000000,4419000000,-74870000000,,,,113912000000,2862246000000,2446980000000,1984884000000,20235000000,,321589000000,313135000000,50587,IX
2017-03-31,,,424965000000,146475000000,273239000000,444055000000,857472000000,422225000000,422225000000,-8808000000,-72213000000,,,,144039000000,2678596000000,2256371000000,1821124000000,2740000000,,280926000000,273239000000,50587,IX
2019-12-31,,,86053000,,86053000,26260000,124935000,0,86755000,11920000,,,,,0,126705000,39950000,1770000,-202000,,86053000,86053000,50589,BLX
2018-12-31,,,11138000,,11138000,30401000,67138000,0,22332000,14405000,,,,,0,70050000,47718000,2912000,-11194000,,11138000,11138000,50589,BLX
2017-12-31,,,81999000,,81999000,29679000,124996000,0,82837000,12480000,,,,,0,126669000,43832000,1673000,-838000,,81999000,81999000,50589,BLX
2016-12-31,,,87045000,,87045000,27875000,130853000,0,87674000,15304000,,,,,0,132719000,45045000,1866000,-629000,,87045000,87045000,50589,BLX
2019-12-31,1168133,,-15990437,,-16072547,11607364,-4879126,-18993619,-18993619,,,,,,280316,6750351,25743970,11629477,3003182,198206,-16270753,-16072547,50593,CERC
2018-12-31,1818635,,-35323565,,-40052810,11056425,-200290,-14903902,-14903902,,,,,,-49466,7028378,21932280,7228668,-20419663,-4778711,-35274099,-41710193,50593,CERC
2017-12-31,1926578,,13836342,,11869823,8511409,24731489,13889982,13889982,,-24016.0,,,,1966519,27813137,13923155,3081648,-53640,-4778711,11869823,7772084,50593,CERC
2016-12-31,1910879,,-16471603,,-16471603,7083155,-7086013,-16080047,-16080047,,-433000.0,,,,0,1152987,17233034,8239000,-391556,-4778711,-16471603,-16471603,50593,CERC
2020-12-31,,,118767000,,84369000,105805000,244545000,0,118767000,19973000,,,,,34398000,244545000,125778000,0,0,,84369000,84369000,50595,FFWM
2019-12-31,,,79499000,,56239000,98255000,209093000,0,79009000,31829000,,,,,23260000,209093000,130084000,0,490000,,56239000,56239000,50595,FFWM
2018-12-31,,,60086000,,42958000,95870000,187161000,0,63880000,27411000,,,,,17128000,187161000,123281000,0,-3794000,,42958000,42958000,50595,FFWM
2017-12-31,,,50599000,,27582000,79641000,149575000,0,53239000,16695000,,,,,23017000,149575000,96336000,0,-2640000,,27582000,27582000,50595,FFWM
2020-12-31,,,628331000,,506421000,496122000,1169390000,673268000,673268000,,-49100000,,,,121910000,16207106000,15533838000,15037716000,-44937000,,506421000,506421000,50598,CHRW
2019-12-31,,,742257000,,576968000,497806000,1287782000,789976000,789976000,,-43519000,,,,165289000,15309508000,14519532000,14021726000,-47719000,,576968000,576968000,50598,CHRW
2018-12-31,,,880273000,,664505000,449610000,1361693000,912083000,912083000,,-48710000,,,,215768000,16631172000,15719089000,15269479000,-31810000,,664505000,664505000,50598,CHRW
2017-12-31,,,728463000,,504893000,413404000,1188523000,775119000,775119000,,-37256000,,,,223570000,14869380000,14094261000,13680857000,-46656000,,504893000,504893000,50598,CHRW
2019-12-31,174556000,,-266766000,,-266766000,117088000,2060000,-289584000,-289584000,,,,,,0,2108000,291692000,48000,22818000,,-266766000,-266766000,50600,GBT
2018-12-31,131307000,,-174193000,,-174193000,51435000,0,-182742000,-182742000,,,,,,0,0,182742000,0,8549000,,-174193000,-174193000,50600,GBT
2017-12-31,87807000,,-117024000,,-117024000,31438000,0,-119245000,-119245000,,,,,,0,0,119245000,0,2221000,,-117024000,-117024000,50600,GBT
2016-12-31,61263000,,-82468000,,-82468000,20364000,0,-81627000,-81627000,,,,,,0,0,81627000,0,-841000,,-82468000,-82468000,50600,GBT
2019-12-31,,,2173000,,2173000,3694000,351000,-3380000,-3380000,37000,-11000,,,,0,351000,3731000,0,5553000,,2173000,2173000,50601,EQS
2018-12-31,,,51000,,51000,4010000,480000,-3551000,-3551000,21000,-4000,,,,0,480000,4031000,0,3602000,,51000,51000,50601,EQS
2017-12-31,,,-829000,,-829000,7043000,560000,-6503000,-6503000,20000,-11000,,,,0,560000,7063000,0,5674000,,-829000,-829000,50601,EQS
2016-12-31,,,5432000,,5432000,3169000,748000,-2443000,-2443000,22000,-8000,,,,0,748000,3191000,0,7875000,,5432000,5432000,50601,EQS
2019-12-31,,,192772276,,192772276,8744684,7480604,-1264080,-1264080,,,,,,0,7480604,8744684,0,194036356,,192772276,192772276,50605,EOS
2018-12-31,,,4450354,,4450354,8630598,7321494,-1309104,-1309104,,,,,,0,7321494,8630598,0,5759458,,4450354,4450354,50605,EOS
2017-12-31,,,150448388,,150448388,7850041,6776304,-1073737,-1073737,,,,,,0,6776304,7850041,0,151522125,,150448388,150448388,50605,EOS
2016-12-31,,,14491088,,14491088,7246791,8415734,1168943,1168943,,,,,,0,8415734,7246791,0,13322145,,14491088,14491088,50605,EOS
2019-12-31,6961981,,-10878750,,-10878750,3625833,0,-10587814,-10587814,,-177997,,,,0,0,10587814,0,-290936,,-10878750,-10878750,50606,FSR
2018-12-31,1938871,,-3430945,,-3430945,1475613,0,-3414484,-3414484,,-1590,,,,0,0,3414484,0,-16461,,-3430945,-4653313,50606,FSR
2019-12-31,,,-41852000,,-41852000,9467000,-34107000,-43574000,-43574000,,-338000,,,,0,1740000,45314000,35847000,1722000,,-41852000,-41852000,50607,ALPN
2018-12-31,,,-36853000,,-36487000,8362000,-28265000,-36627000,-36627000,,-319000,,,,-366000,705000,37332000,28970000,-226000,,-36487000,-36487000,50607,ALPN
2017-12-31,,,-7983000,,-7783000,4579000,-8895000,-13474000,-13474000,,-152000,,,,-200000,1731000,15205000,10626000,5491000,,-7783000,-7783000,50607,ALPN
2016-12-31,,,-1166000,,-1232000,1149000,-39000,-1188000,-1188000,,-152000,,,,66000,2950000,4138000,2989000,22000,,-1232000,-1232000,50607,ALPN
2020-03-31,,,248261000000,77797000000,216998000000,579901000000,1009389000000,0,250651000000,178837000000,,,,,28894000000,1285829000000,1035178000000,276440000000,-2390000000,,219367000000,216998000000,50608,NMR
2019-03-31,,,-37701000000,49732000000,-100442000000,588572000000,860268000000,0,47019000000,224677000000,,,,,57010000000,1109770000000,1062751000000,249502000000,-84720000000,,-94711000000,-100442000000,50608,NMR
2018-03-31,,,328158000000,50504000000,219343000000,635298000000,1223320000000,0,339158000000,248864000000,,,,,103866000000,1507969000000,1168811000000,284649000000,-11000000000,,224292000000,219343000000,50608,NMR
2017-03-31,,,322795000000,53875000000,239617000000,601332000000,1127422000000,0,316795000000,209295000000,,,,,80229000000,1397197000000,1080402000000,269775000000,6000000000,,242566000000,239617000000,50608,NMR
2020-04-25,,,-590407000,2327000,-588446000,1011266000,1197410000,186144000,186144000,,-60499000,,,,-1040000,5490011000,5303867000,4292601000,-776551000,,-589367000,-588446000,50610,PDCO
2019-04-27,,,106228000,3248000,83628000,1017174000,1190775000,173601000,173601000,,-42569000,,,,23352000,5574523000,5400922000,4383748000,-67373000,,82876000,83628000,50610,PDCO
2018-04-28,,,179263000,3248000,200974000,979477000,1199366000,219889000,219889000,,-46743000,,,,-21711000,5465683000,5245794000,4266317000,-40626000,,200974000,200974000,50610,PDCO
2017-04-29,,,250881000,3248000,170893000,977157000,1301397000,324240000,324240000,,-43060000,,,,77093000,5593127000,5268887000,4291730000,-73359000,-2895000.0,173788000,170893000,50610,PDCO
2019-12-31,,,107000000,,87400000,,123200000,111900000,111900000,11300000,-4900000,,,,19600000,1410000000,1298100000,1286800000,-4900000,,87400000,87400000,50611,STFC
2018-12-31,,,12900000,,12800000,,29600000,18600000,18600000,11000000,-5700000,,,,100000,1275800000,1257200000,1246200000,-5700000,,12800000,12800000,50611,STFC
2017-12-31,,,35000000,,-17800000,,48800000,40900000,40900000,7900000,-5900000,,,,52800000,1422300000,1381400000,1373500000,-5900000,,-17800000,-17800000,50611,STFC
2016-12-31,,,18800000,,19200000,,32200000,24300000,24300000,7900000,-5500000,,,,-400000,1404600000,1380300000,1372400000,-5500000,,19200000,19200000,50611,STFC
2019-12-31,26925000,,-7302000,,-8743000,76793000,110697000,6979000,6979000,,-5448000,,,,1441000,492412000,485433000,381715000,-14281000,,-8743000,-8743000,50612,BELFB
2018-12-31,29487000,,23616000,,20709000,83707000,139257000,26063000,26063000,,-5317000,,,,2907000,548184000,522121000,408927000,-2447000,,20709000,20709000,50612,BELFB
2017-12-31,29487000,,9643000,,-11897000,82903000,102349000,19446000,19446000,,-6802000,,,,21540000,491611000,472165000,389262000,-9803000,,-11897000,-11897000,50612,BELFB
2016-12-31,29487000,,-82552000,,-64834000,79305000,99908000,25803000,25803000,-5200000.0,-6662000,,,,-17718000,500153000,474350000,400245000,-108355000,,-64834000,-64834000,50612,BELFB
2019-12-31,60393000,,-86527000,,-86527000,18457000,0,-78850000,-78850000,,-3553000,,,,0,0,78850000,0,-7677000,,-86527000,-86527000,50614,PSTX
2018-12-31,30883000,,-44606000,,-44404000,9674000,0,-40557000,-40557000,,-1796000,,,,-202000,0,40557000,0,-4049000,,-44404000,-44404000,50614,PSTX
2017-12-31,19099000,,-20189000,,-19662000,5479000,2985000,-21593000,-21593000,,-558000,,,,-527000,2985000,24578000,0,1404000,,-19662000,-19662000,50614,PSTX
2016-12-31,9264000,,-4740000,,-4575000,5353000,9768000,-4849000,-4849000,,-558000,,,,-165000,9768000,14617000,0,109000,,-4575000,-4575000,50614,PSTX
2020-12-31,42740000000,,24194000000,,21331000000,87193000000,152757000000,22899000000,22899000000,-75000000,-1647000000,,,,2863000000,386064000000,363165000000,233307000000,1295000000,,21331000000,21331000000,50617,AMZN
2019-12-31,35931000000,,13962000000,,11588000000,64313000000,114986000000,14404000000,14404000000,338000000,-1600000000,,,,2374000000,280522000000,266118000000,165536000000,-442000000,,11588000000,11588000000,50617,AMZN
2018-12-31,28837000000,,11270000000,,10073000000,52177000000,93731000000,12421000000,12421000000,296000000,-1417000000,,,,1197000000,232887000000,220466000000,139156000000,-1151000000,,10073000000,10073000000,50617,AMZN
2017-12-31,22620000000,,3802000000,,3033000000,38992000000,65932000000,4106000000,4106000000,214000000,-848000000,,,,769000000,177866000000,173760000000,111934000000,-304000000,,3033000000,3033000000,50617,AMZN
2019-12-31,,,-37027000,8124000,-41028000,9324000,43194000,19941000,19941000,,-19838000,,,,-11000,562233000,542292000,519039000,-56968000,,-37016000,-15569000,50618,OSW
2018-12-31,,,14831000,3586000,9886000,9937000,61979000,48521000,48521000,,-34099000,,,,1088000,540778000,492257000,478799000,-33690000,,13743000,9886000,50618,OSW
2017-12-31,,,38489000,4596000,31117000,9222000,51041000,38298000,38298000,,-34099000,,,,5263000,506685000,468387000,455644000,191000,,33226000,31117000,50618,OSW
2016-12-31,,,23779000,4596000,14903000,10432000,37570000,23617000,23617000,,-34099000,,,,5615000,476284000,452667000,438714000,162000,,18164000,14903000,50618,OSW
2019-12-31,14856000,,-30641000,,-30641000,10412000,-5020000,-30288000,-30288000,,-2000,,,,0,4896000,35184000,9916000,-353000,,-30641000,-30641000,50619,NOVN
2018-12-31,15050000,,-12673000,,-12673000,11507000,-2004000,-28561000,-28561000,,-1047000,,,,0,5991000,34552000,7995000,15888000,,-12673000,-12673000,50619,NOVN
2017-12-31,13914000,,-36621000,,-36621000,13113000,-8278000,-35305000,-35305000,,-1048000,,,,0,2646000,37951000,10924000,-1316000,,-36621000,-36621000,50619,NOVN
2016-12-31,8532000,,-59699000,,-59699000,13337000,-37957000,-59826000,-59826000,,-1048000,,,,0,0,59826000,37957000,127000,,-59699000,-59699000,50619,NOVN
2020-10-31,,,187600000,68500000,108800000,517100000,914700000,397600000,397600000,,-115800000,,,,63300000,4515000000,4117400000,3600300000,-210000000,,124300000,108800000,50621,GEF
2019-10-31,,,264900000,79300000,171000000,506600000,959900000,453300000,453300000,,-112500000,,,,70700000,4595000000,4141700000,3635100000,-188400000,,194200000,171000000,50621,GEF
2018-10-31,,,302800000,81900000,209400000,404200000,788900000,384700000,384700000,,-51000000,,,,73300000,3873800000,3489100000,3084900000,-81900000,,229500000,209400000,50621,GEF
2017-10-31,,,202300000,68100000,118600000,381000000,714700000,333700000,333700000,,-60100000,,,,67200000,3638200000,3304500000,2923500000,-131400000,,135100000,118600000,50621,GEF
2019-12-31,,,-55027000,,-54937000,20864000,37219000,-19828000,-19828000,,-5227000,,,,-90000,168238000,188066000,131019000,-35199000,,-54937000,-54937000,50622,NES
2018-12-31,,,-59056000,,-59263000,21910000,38578000,-29766000,-29766000,,-5973000,,,,207000,197474000,227240000,158896000,-29290000,,-59263000,-59263000,50622,NES
2017-12-31,,,120047000,,120716000,24367000,27984000,-63915000,-63915000,,-24979000,,,,-669000,176071000,239986000,148087000,183962000,,120716000,120716000,50622,NES
2016-12-31,,,-166814000,,-168856000,37013000,22552000,-75224000,-75224000,,-54530000,,,,807000,152176000,227400000,129624000,-91590000,-1235000.0,-167621000,-168856000,50622,NES
2019-12-31,,,-10610000,,-7331000,170470000,296382000,81651000,81651000,-3139000,-94970000,,,,-3279000,1529752000,1448101000,1233370000,-92261000,,-7331000,-7331000,50624,FRTA
2018-12-31,,,-21280000,,-24365000,156577000,245569000,41749000,41749000,-5257000,-78337000,,,,3085000,1479712000,1437963000,1234143000,-63029000,,-24365000,-24365000,50624,FRTA
2017-12-31,,,-42732000,,-2060000,199234000,253108000,5778000,5778000,-7304000,-59408000,,,,-40672000,1580413000,1574635000,1327305000,-48510000,,-2060000,-2060000,50624,FRTA
2016-12-31,,,-62782000,,-7606000,163999000,280454000,83558000,83558000,-6503000,-125048000,,,,-51692000,1363962000,1280404000,1083508000,-146340000,3484000.0,-11090000,-7606000,50624,FRTA
2020-06-30,,,-6160350,,-6162083,14304541,13852804,-451737,-451737,,-884,,,,1733,29189020,29640757,15336216,-5708613,,-6162083,-6162083,50627,CTHR
2019-06-30,2069.0,,2274024,,2275467,12624316,15284942,2658557,2658557,,-2198,,,,-1443,32244109,29585552,16959167,-384533,,2275467,2275467,50627,CTHR
2018-06-30,570.0,,-1075922,,-766876,12458457,11751635,-707392,-707392,,-742,,,,-309046,27908838,28616230,16157203,-368530,,-766876,-766876,50627,CTHR
2017-12-31,3714.0,,-425868,,-453477,12167177,12160347,-10544,-10544,,-541,,,,27609,27032964,27043508,14872617,-415324,,-453477,-453477,50627,CTHR
2019-12-31,69607000,,-94637000,,-94940000,26337000,4681000,-91263000,-91263000,,-5726000,,,,303000,5281000,96544000,600000,-3374000,,-94940000,-94940000,50630,ARDX
2018-12-31,69373000,,-91294000,,-91298000,23715000,2141000,-90947000,-90947000,,-3534000,,,,4000,2607000,93554000,466000,-347000,,-91298000,-91298000,50630,ARDX
2017-12-31,75484000,,-63160000,,-64339000,23231000,33600000,-65115000,-65115000,,-3534000,,,,1179000,42000000,107115000,8400000,1955000,,-64339000,-64339000,50630,ARDX
2016-12-31,94161000,,-112387000,,-112387000,18734000,0,-112895000,-112895000,,-3534000,,,,0,0,112895000,0,508000,,-112387000,-112387000,50630,ARDX
2020-12-31,31652000,,-9371000,,-9372000,34893000,57932000,-8613000,-8613000,,-726000,,,,1000,116156000,124769000,58224000,-758000,,-9372000,-9372000,50631,SITM
2019-12-31,23795000,,-6615000,,-6607000,20636000,39558000,-4873000,-4873000,,-1714000,,,,-8000,84074000,88947000,44516000,-1742000,,-6607000,-6607000,50631,SITM
2018-12-31,22775000,,-9368000,,-9342000,21220000,36205000,-7790000,-7790000,,-1512000,,,,-26000,85214000,93004000,49009000,-1578000,,-9342000,-9342000,50631,SITM
2017-12-31,20988000,,4691000,,4723000,21340000,47918000,5590000,5590000,,-870000,,,,-32000,101065000,95475000,53147000,-899000,,4723000,4723000,50631,SITM
2019-12-29,,,5046000,21450000,4866000,182138000,466129000,61118000,61118000,175592000,-20593000,,,,-611000,1619248000,1558130000,1153119000,-56072000,,5657000,-7633000,50635,PZZA
2018-12-30,,,6697000,20689000,2474000,158218000,442335000,67158000,67158000,170556000,-25673000,,,,2624000,1662871000,1595713000,1220536000,-60461000,,4073000,2474000,50635,PZZA
2017-12-31,,,140342000,22495000,102292000,150866000,416560000,152691000,152691000,69335000,-11283000,,,,33817000,1783359000,1630668000,1366799000,-12349000,,106525000,103288000,50635,PZZA
2016-12-25,,,158809000,22173000,102820000,158135000,419676000,154301000,154301000,66253000,-7397000,,,,49717000,1713620000,1559319000,1293944000,4508000,,109092000,102967000,50635,PZZA
2019-12-31,4004000,,-48169000,,-48169000,4863000,2560000,-2303000,-2303000,,-19000,,,,0,6564000,8867000,4004000,-45866000,,-48169000,-48169000,50636,COCP
2018-12-31,4004000,,-62630000,,-49048000,4352000,-4667000,-9019000,-9019000,,-58000,,,,-13582000,0,9019000,4667000,-53611000,,-49048000,-49048000,50636,COCP
2017-12-31,4004000,,-7493000,,-613000,3336000,-5822000,-9158000,-9158000,,-7000,,,,-6880000,0,9158000,5822000,1665000,,-613000,-613000,50636,COCP
2016-12-31,4004000,,-104268000,,-74874000,4140000,-101679000,-105819000,-105819000,,-7000,,,,-29394000,0,105819000,101679000,1551000,,-74874000,-74874000,50636,COCP
2014-12-31,,,-1212,,-1212,1212,0,-1212,-1212,,,,,,0,0,1212,0,0,,-1212,-1212,50637,SV
2019-12-31,,,3932144,,3932144,350881,0,-350881,-350881,,,,,,0,0,350881,0,4283025,,3932144,-137158,50638,FREE
2020-10-31,,,-3676942,,-3676942,4329932,11070549,6740617,6740617,,-1632085,,,,0,11070549,4329932,0,-10417559,,-3676942,-3676942,50639,OCCIP
2019-10-31,,,-7858509,,-7858509,3546936,8857672,5310736,5310736,,-982195,,,,0,8857672,3546936,0,-13169245,,-7858509,-7858509,50639,OCCIP
2018-10-31,,,3438084,,3438084,1605540,4209984,2604444,2604444,,-982195,,,,0,4209984,1605540,0,833640,,3438084,3438084,50639,OCCIP
2019-12-28,,,-1383000,,-1466000,9284000,7916000,-1401000,-1401000,,-31000,,,,83000,56446000,57847000,48530000,18000,,-1466000,-1466000,50643,ENG
2018-12-29,,,-5561000,,-5671000,10030000,6933000,-3097000,-3097000,,-22000,,,,110000,53996000,57093000,47063000,-2464000,,-5671000,-5671000,50643,ENG
2017-12-30,,,-6171000,,-16258000,12581000,6438000,-6143000,-6143000,,-104000,,,,10087000,55765000,61908000,49327000,-28000,,-16258000,-16258000,50643,ENG
2016-12-31,,,-3369000,,-2342000,13350000,10112000,-3238000,-3238000,,-173000,,,,-1027000,59224000,62462000,49112000,-131000,,-2342000,-2342000,50643,ENG
2019-12-31,8680669,,-15177686,,-15177686,6063078,0,-14743747,-14743747,,-433939,,,,0,0,14743747,0,-433939,,-15177686,-15177686,50644,AZRX
2018-12-31,5771405,,-13533617,,-13533617,7450366,0,-13221771,-13221771,,-101846,,,,0,0,13221771,0,-311846,,-13533617,-13533617,50644,AZRX
2017-12-31,2395478,,-11096383,,-11096383,7685706,0,-10081184,-10081184,,-875199,,,,0,0,10081184,0,-1015199,,-11096383,-11096383,50644,AZRX
2016-12-31,2496105,,-14591662,,-14591662,4129053,0,-6625158,-6625158,,-5937486,,,,0,0,6625158,0,-7966504,,-14591662,-14591662,50644,AZRX
2019-12-31,,,1006000000,5628000000,494000000,1495000000,3940000000,1628000000,1628000000,231000000,-435000000,,,,271000000,7794000000,6166000000,3854000000,-622000000,,735000000,494000000,50646,LSXMB
2018-12-31,,,1245000000,5108000000,676000000,878000000,2993000000,1623000000,1623000000,106000000,-388000000,,,,241000000,5771000000,4148000000,2778000000,-378000000,,1004000000,676000000,50646,LSXMB
2017-12-31,,,1193000000,5615000000,1124000000,812000000,2824000000,1547000000,1547000000,97000000,-356000000,,,,-466000000,5425000000,3878000000,2601000000,-354000000,,1659000000,1124000000,50646,LSXMB
2016-12-31,,,998000000,5945000000,413000000,761000000,2507000000,1352000000,1352000000,69000000,-342000000,,,,341000000,5014000000,3662000000,2507000000,-354000000,,657000000,413000000,50646,LSXMB
2020-12-31,,,-1893000000,,-1362000000,110000000,-590000000,-1997000000,-1997000000,762000000,-166000000,,,,-531000000,2957000000,4954000000,3547000000,104000000,,-1362000000,-1362000000,50647,JBLU
2019-12-31,,,768000000,,569000000,290000000,2735000000,814000000,814000000,1106000000,-65000000,,,,199000000,8094000000,7280000000,5359000000,-46000000,,569000000,569000000,50647,JBLU
2018-12-31,,,219000000,,189000000,294000000,2524000000,701000000,701000000,1060000000,-60000000,,,,30000000,7658000000,6957000000,5134000000,-482000000,,189000000,189000000,50647,JBLU
2017-12-31,,,918000000,,1140000000,271000000,2600000000,973000000,973000000,932000000,-61000000,,,,-222000000,7012000000,6039000000,4412000000,-55000000,,1140000000,1140000000,50647,JBLU
2019-12-31,,,-26303000,,-26303000,8573000,-18044000,-26617000,-26617000,,-786000,,,,0,1296000,27913000,19340000,314000,,-26303000,-26303000,50650,XCUR
2018-12-31,,,-22413000,,-22413000,7818000,-14001000,-21819000,-21819000,,-672000,,,,0,118000,21937000,14119000,-594000,,-22413000,-22413000,50650,XCUR
2017-12-31,,,-11011000,,-11011000,7046000,-3361000,-10407000,-10407000,,-795000,,,,0,9719000,20126000,13080000,-604000,,-11011000,-11011000,50650,XCUR
2016-12-31,,,-16941000,,-16941000,3539000,-12623000,-16162000,-16162000,,-724000,,,,0,1036000,17198000,13659000,-779000,,-16941000,-16941000,50650,XCUR
2020-03-31,,,795000000,1215000000,-920000000,9624000000,14292000000,4330000000,4330000000,338000000,-2223000000,,,,1250000000,44974000000,40644000000,30682000000,-3535000000,,-455000000,-920000000,50652,VOD
2019-03-31,,,-2613000000,1227000000,-8020000000,9301000000,13506000000,4058000000,4058000000,147000000,-1506000000,,,,1496000000,43666000000,39608000000,30160000000,-6671000000,-3535000000.0,-4109000000,-8020000000,50652,VOD
2018-03-31,,,3878000000,967000000,2439000000,9127000000,13800000000,4741000000,4741000000,-68000000,-1148000000,,,,-879000000,46571000000,41830000000,32771000000,-863000000,-1969000000.0,4757000000,2439000000,50652,VOD
2017-03-31,,,2792000000,1519000000,-6297000000,9840000000,13055000000,3119000000,3119000000,96000000,-1644000000,,,,4764000000,47631000000,44512000000,34576000000,-327000000,-4107000000.0,-1972000000,-6297000000,50652,VOD
2020-12-31,,,18995000000,,17894000000,48483000000,74208000000,0,18995000000,6730000000,,,,,1101000000,74208000000,55213000000,0,0,,17894000000,16473000000,50654,BAC
2019-12-31,,,32754000000,,27430000000,46742000000,85582000000,0,33435000000,5405000000,,,,,5324000000,85582000000,52147000000,0,-681000000,,27430000000,25998000000,50654,BAC
2018-12-31,,,34584000000,,28147000000,46188000000,88467000000,0,35782000000,6497000000,,,,,6437000000,88467000000,52685000000,0,-1198000000,,28147000000,26696000000,50654,BAC
2017-12-31,,,29213000000,,18232000000,46359000000,83730000000,0,29213000000,8158000000,,,,,10981000000,83730000000,54517000000,0,0,,18232000000,16618000000,50654,BAC
2020-03-31,973146,,-5145966,,-5145966,5682109,4052825,-3227432,-3227432,,-2133824,,,,0,13500403,16727835,9447578,-1918534,,-5145966,-5145966,50659,GP
2019-03-31,437208,,-4544151,,-4544151,4022168,1858142,-3117442,-3117442,,-1400923,,,,0,6082561,9200003,4224419,-1426709,,-4544151,-4544151,50659,GP
2018-03-31,251826,,-3384140,,-2774140,3281645,1248391,-2839125,-2839125,,-563411,,,,-610000,3516156,6355281,2267765,-545015,,-2774140,-2774140,50659,GP
2017-03-31,312278,,-2813217,,-2813217,1829493,0,-2711038,-2711038,,-95629,,,,0,0,2711038,0,-102179,,-2813217,-2813217,50659,GP
2019-12-31,,,-15499726,-24003114,-10439961,5491849,-4854844,-10346693,-10346693,,-5360192,,,,0,3072987,13419680,7927831,-5153033,,-15499726,-10439961,50661,OMEX
2018-12-31,,,-9104285,-19309066,-5172436,5654409,-412807,-6067216,-6067216,,-3142280,,,,0,3275753,9342969,3688560,-3037069,,-9104285,-5172436,50661,OMEX
2017-12-31,,,-11021142,-15377217,-7759472,6167181,-2189912,-8357093,-8357093,,-2727235,,,,0,1248477,9605570,3438389,-2664049,,-11021142,-7759472,50661,OMEX
2016-12-31,,,-9078075,-12115547,-6316021,7959122,-3584366,-11543488,-11543488,,-2396994,,,,0,4683035,16226523,8267401,2465413,,-9078075,-6316021,50661,OMEX
2020-02-29,,,14231637,,14231637,875310,6243010,5367700,5367700,,-35126,,,,0,6243010,875310,0,8863937,,14231637,14231637,50666,NNY
2019-02-28,,,6447127,,6447127,837363,6289877,5452514,5452514,,-36789,,,,0,6289877,837363,0,957824,,6447127,6447127,50666,NNY
2018-02-28,,,4526831,,4526831,867543,6503201,5635658,5635658,,-43284,,,,0,6503201,867543,0,-1108827,,4526831,4526831,50666,NNY
2017-02-28,,,-10045246,,-10045246,909002,6607310,5698308,5698308,,-40042,,,,0,6607310,909002,0,-15743554,,-10045246,-10045246,50666,NNY
2020-06-30,,,-134407208,,-136752136,178315259,44750578,-133564681,-133564681,,-304071,,,,2344928,249243496,382808177,204492918,-842527,,-136752136,-136752136,50667,CGA
2019-06-30,,,18087735,,11590395,45837932,64642680,18804748,18804748,,-595125,,,,6497340,294320803,275516055,229678123,-717013,,11590395,11590395,50667,CGA
2018-06-30,,,28880508,,-6931225,44307146,74108933,29801787,29801787,,-592153,,,,35852127,287053530,257251743,212944597,-921279,40394.0,-6971619,-6931225,50667,CGA
2017-06-30,,,31212426,,25152154,51194568,82715180,31520612,31520612,,-544404,,,,6511880,277848486,246327874,195133306,-308186,451608.0,24700546,25152154,50667,CGA
2019-12-31,,,56702000,,34041000,65320000,145553000,78689000,78689000,,-1554000,,,,22661000,397550000,318861000,251997000,-21987000,,34041000,33374000,50669,BOOM
2018-12-31,,,34607000,,30473000,61213000,110695000,46538000,46538000,,-1615000,,,,4134000,326429000,279891000,215734000,-11931000,,30473000,29780000,50669,BOOM
2017-12-31,,,-15284000,,-18853000,45724000,59391000,9607000,9607000,,-1648000,,,,3569000,192803000,183196000,133412000,-24891000,,-18853000,-18853000,50669,BOOM
2016-12-31,,,-5708000,,-6505000,38741000,38680000,-4072000,-4072000,,-1070000,,,,797000,158575000,162647000,119895000,-1636000,,-6505000,-6505000,50669,BOOM
2020-12-31,,,10498000,,8556000,31957000,43011000,0,11054000,,,,,,1942000,43011000,31957000,0,-556000,,8556000,8556000,50670,FFNW
2019-12-31,,,12931000,,10369000,30202000,43349000,0,13176000,-29000.0,,,,,2562000,43349000,30173000,0,-245000,,10369000,10353000,50670,FFNW
2018-12-31,,,18592000,,14899000,28952000,48053000,0,19101000,-29000.0,,,,,3693000,48053000,28952000,0,-509000,,14899000,14871000,50670,FFNW
2017-12-31,,,13421000,,8479000,26385000,40230000,0,13845000,-29000.0,,,,,4942000,40230000,26385000,0,-424000,,8479000,8475000,50670,FFNW
2019-12-31,1129007,,3433120,,3334043,4452089,9520477,3544818,3544818,,,,,,99077,20550682,17005864,11030205,-111698,,3334043,3334043,50671,KIQ
2018-12-31,1352817,,-56711,,194453,3095273,5261185,393994,393994,,,,,,-251164,12716596,12322602,7455411,-450705,,194453,194453,50671,KIQ
2017-12-31,1572714,,-5166207,,-5015911,3852049,820956,-5172124,-5172124,,,,,,-150296,6062778,11234902,5241822,5917,,-5015911,-5015911,50671,KIQ
2016-12-31,704868,,-3454778,,-2465592,4512210,1978241,-3527606,-3527606,,,,,,-989186,8077143,11604749,6098902,72828,,-2465592,-2465592,50671,KIQ
2020-11-30,,,4702100,,4702100,1447397,8929349,7481952,7481952,,-1626613,,,,0,8929349,1447397,0,-2779852,,4702100,4702100,50672,KSM
2019-11-30,,,17238639,,17238639,1544463,9903894,8359431,8359431,,-2455219,,,,0,9903894,1544463,0,8879208,,17238639,17238639,50672,KSM
2018-11-30,,,-298522,,-298522,1532713,10594600,9061887,9061887,,-2199163,,,,0,10594600,1532713,0,-9360409,,-298522,-298522,50672,KSM
2017-11-30,,,10475697,,10475697,1540279,11121870,9581591,9581591,,-1755612,,,,0,11121870,1540279,0,894106,,10475697,10475697,50672,KSM
2020-07-31,,,-53628691,,-53628691,7903423,51446219,43542796,43542796,,-8565503,,,,0,51446219,7903423,0,-97171487,,-53628691,-53628691,50673,JFR
2019-07-31,,,12412867,,12412867,8604168,61349162,52744994,52744994,,-10033477,,,,0,61349162,8604168,0,-40332127,,12412867,12412867,50673,JFR
2018-07-31,,,31860254,,31860254,9055650,56896371,47840721,47840721,,-12857903,,,,0,56896371,9055650,0,-15980467,,31860254,31860254,50673,JFR
2017-07-31,,,65977244,,65977244,8951756,57548821,48597065,48597065,,-6825050,,,,0,57548821,8951756,0,17380179,,65977244,65977244,50673,JFR
2020-12-31,,,106341000,43825000,81437000,173760000,295198000,0,113536000,7902000,,,,,24880000,295198000,181662000,0,-7195000,,81461000,81437000,50674,SRCE
2019-12-31,,,120154000,20359000,91960000,177278000,310414000,0,125351000,7785000,,,,,28139000,310414000,185063000,0,-5197000,,92015000,91442000,50674,SRCE
2018-12-31,,,105027000,1508000,82414000,173691000,291622000,0,111425000,6506000,,,,,22613000,291622000,180197000,0,-6398000,,82414000,81869000,50674,SRCE
2017-12-31,,,101360000,1508000,68051000,163162000,275657000,0,107031000,5464000,,,,,33309000,275657000,168626000,0,-5671000,,68051000,67531000,50674,SRCE
2019-12-31,42200000,,140900000,-1600000,92200000,500300000,788300000,245800000,245800000,,-90700000,,,,61300000,1835900000,1590100000,1047600000,-104900000,13300000,79600000,92200000,50675,ESI
2018-12-31,44300000,,-53200000,71900000,-324400000,538600000,837700000,254800000,254800000,,-311000000,,,,23800000,1961000000,1706200000,1123300000,-308000000,-242900000,-77000000,-324400000,50675,ESI
2017-12-31,46400000,,-260400000,116900000,-296200000,545300000,815400000,223700000,223700000,,-336900000,,,,-68600000,1878600000,1654900000,1063200000,-484100000,-103800000,-191800000,-296200000,50675,ESI
2016-12-31,45000000,,-231800000,153700000,-73700000,542400000,790300000,202900000,202900000,,-372300000,,,,-41300000,1770100000,1567200000,979800000,-434700000,113800000,-190500000,-40800000,50675,ESI
2019-12-31,,,-21697115,,-21697115,35041996,80165466,4577566,4577566,1125000,-30577489,,,,0,292377638,287800072,212212172,-26274681,,-21697115,-21697115,50676,EGLE
2018-12-31,,,12574684,,12574684,36156660,111145768,37271646,37271646,1125000,-25743531,,,,0,310094258,272822612,198948490,-24696962,,12574684,12574684,50676,EGLE
2017-12-31,,,-43796685,,-43796685,33126310,64542173,-2274823,-2274823,1125000,-29376994,,,,0,236784625,239059448,172242452,-41521862,,-43796685,-43796685,50676,EGLE
2016-12-31,,,-223522435,,-223522435,22905802,-4463101,-66253225,-66253225,1125000,-21799146,,,,0,124492844,190746069,128955945,-157269210,,-223522435,-223522435,50676,EGLE
2019-12-31,,,126892000,,126313000,39835000,166727000,0,126892000,,,,,,579000,166727000,39835000,0,0,,126313000,126298000,50678,TRTX
2018-12-31,,,107281000,,106941000,33595000,140876000,0,107281000,,,,,,340000,140876000,33595000,0,0,,106941000,106938000,50678,TRTX
2017-12-31,,,94498000,,94352000,27834000,122332000,0,94498000,,,,,,146000,122332000,27834000,0,0,,94352000,94336000,50678,TRTX
2016-12-31,,,69962000,,69967000,22436000,92398000,0,69962000,,,,,,-5000,92398000,22436000,0,0,,69967000,69951000,50678,TRTX
2019-12-31,10925000,,-9587000,,-9587000,3110000,2032000,-12003000,-12003000,,-435000,,,,0,2032000,14035000,0,2416000,,-9587000,-9587000,50679,CANF
2018-12-31,6024000,,-6567000,,-6571000,3210000,3820000,-5414000,-5414000,,-427000,,,,4000,3820000,9234000,0,-1153000,,-6571000,-6571000,50679,CANF
2017-12-31,5055000,,-6404000,,-6339000,2919000,789000,-7185000,-7185000,,-427000,,,,29000,789000,7974000,0,781000,,-6433000,-6339000,50679,CANF
2016-12-31,6067000,,-8364000,42000.0,-8257000,2793000,165000,-8695000,-8695000,,-427000,,,,29000,165000,8860000,0,331000,,-8393000,-8257000,50679,CANF
2019-12-31,,,125628000,24149000,129181000,45252000,490151000,233315000,233315000,,-91295000,,,,-3751000,1567859000,1334544000,1077708000,-107687000,,129379000,101385000,50680,RLJ
2018-12-31,,,199655000,67165000,190126000,49195000,550547000,259711000,259711000,,-101643000,,,,8793000,1763329000,1503618000,1212782000,-60056000,,190862000,162347000,50680,RLJ
2017-12-31,,,117857000,67311000,75331000,40453000,453296000,225850000,225850000,,-78322000,,,,42118000,1356884000,1131034000,903588000,-107993000,,75739000,65434000,50680,RLJ
2016-12-31,,,209504000,13353000,200352000,35716000,418613000,220397000,220397000,,-58820000,,,,8190000,1159995000,939598000,741382000,-10893000,,201314000,199059000,50680,RLJ
2020-12-31,,,2240609000,,1646884000,948560000,4704624000,0,2240329000,1515735000,,,,,593725000,5181304000,2940975000,476680000,280000,,1646884000,1646884000,50682,PFSI
2019-12-31,,,529444000,,392965000,633179000,1778294000,0,529065000,616050000,,,,,136479000,2060329000,1531264000,282035000,379000,,392965000,392965000,50682,PFSI
2018-12-31,,,267697000,,87694000,518140000,1064301000,0,266571000,279590000,,,,,23254000,1228803000,962232000,164502000,1126000,,244443000,87694000,50682,PFSI
2017-12-31,,,335909000,1250263000.0,100757000,451194000,1057542000,0,302969000,303379000,,,,,24387000,1195667000,892698000,138125000,26087000,,311522000,100757000,50682,PFSI
2020-12-31,,,52884000,,31576000,118939000,202846000,0,52988000,30919000,,,,,10230000,202846000,149858000,0,-104000,,42654000,31576000,50683,CCBG
2019-12-31,,,40760000,,30807000,86844000,154369000,0,41306000,26219000,,,,,9953000,154369000,113063000,0,-546000,,30807000,30807000,50683,CCBG
2018-12-31,,,29645000,,26224000,84035000,143148000,0,29203000,29910000,,,,,3421000,143148000,113945000,0,442000,,26224000,26224000,50683,CCBG
2017-12-31,,,23066000,,10863000,81880000,132513000,0,24201000,26432000,,,,,12203000,132513000,108312000,0,-1135000,,10863000,10863000,50683,CCBG
2019-12-31,4741130,,-20502395,,-20502395,10026627,565464,-14202293,-14202293,,-994979,,,,0,565464,14767757,0,-6300102,,-20502395,-34253201,50689,PLXP
2018-12-31,3922665,,896480,,896480,7791600,753108,-10961157,-10961157,,-1145761,,,,0,753108,11714265,0,11857637,,896480,896480,50689,PLXP
2017-12-31,4157454,,-16266731,,-15346731,10174997,778657,-13553794,-13553794,,-1164897,,,,-920000,778657,14332451,0,-2712937,,-15346731,-15346731,50689,PLXP
2016-12-31,78656,,-4905278,,-4905278,4752068,20000,-4810724,-4810724,,-95125,,,,0,20000,4830724,0,-94554,,-4905278,-4905278,50689,PLXP
2019-12-31,30163000,,-52807000,,-52807000,16640000,0,-46803000,-46803000,,-2147000,,,,0,0,46803000,0,-6004000,,-52807000,-53399000,50690,XFOR
2018-12-31,20346000,,-33285000,,-33285000,8739000,0,-29085000,-29085000,,-720000,,,,0,0,29085000,0,-4200000,,-33285000,-36307000,50690,XFOR
2017-12-31,17066000,,-21994000,,-21994000,5181000,0,-22247000,-22247000,,-490000,,,,0,0,22247000,0,253000,,-21994000,-24994000,50690,XFOR
2016-12-31,12761000,,-17865000,,-17865000,5126000,0,-17887000,-17887000,,-53000,,,,0,0,17887000,0,22000,,-17865000,-20873000,50690,XFOR
2020-12-31,,,14156000,,11215000,41644000,65796000,0,16206000,7946000,,,,,2941000,65796000,49590000,0,-2050000,,11215000,11215000,50694,WNEB
2019-12-31,,,17201000,,13349000,40052000,65009000,0,17631000,7326000,,,,,3852000,65009000,47378000,0,-430000,,13349000,13349000,50694,WNEB
2018-12-31,,,21108000,,16408000,38360000,66630000,0,20996000,7274000,,,,,4700000,66630000,45634000,0,112000,,16408000,16408000,50694,WNEB
2017-12-31,,,21748000,,12320000,36965000,66535000,0,22894000,6676000,,,,,9428000,66535000,43641000,0,-1146000,,12320000,12320000,50694,WNEB
2019-12-31,,,367889000,,372111000,403038000,1163566000,510500000,510500000,,-150616000,,,,-4222000,1753644000,1243144000,590078000,-142611000,,372111000,371746000,50696,LAMR
2018-12-31,,,315929000,,305232000,372324000,1065374000,467789000,467789000,,-129732000,,,,10697000,1627222000,1159433000,561848000,-151860000,,305232000,304867000,50696,LAMR
2017-12-31,,,326906000,,317676000,338573000,1000380000,450703000,450703000,,-128396000,,,,9230000,1541260000,1090557000,540880000,-123797000,,317676000,317311000,50696,LAMR
2016-12-31,,,312165000,,298809000,345789000,974697000,423950000,423950000,,-123688000,,,,13356000,1500294000,1076344000,525597000,-111785000,,298809000,298444000,50696,LAMR
2019-12-31,,,9085000,5477000,9197000,64254000,188535000,45989000,45989000,,-43170000,,,,21000,288837000,242848000,100302000,-36904000,,9064000,8887000,50698,CXP
2018-12-31,,,9528000,5477000,9491000,68641000,208276000,57840000,57840000,,-56499000,,,,37000,297943000,240103000,89667000,-48312000,,9491000,9195000,50698,CXP
2017-12-31,,,175828000,5477000,176041000,68823000,198188000,48971000,48971000,,-60516000,,,,-213000,289000000,240029000,90812000,126857000,,176041000,175704000,50698,CXP
2016-12-31,,,84726000,5477000,84281000,90651000,287074000,99280000,99280000,-11400000.0,-67609000,,,,445000,462143000,362863000,175069000,-14554000,,84281000,83967000,50698,CXP
2020-05-31,11099000,,-51307000,,-38191000,71486000,71988000,-10597000,-10597000,,-9603000,,,,-13116000,590366000,600963000,518378000,-40710000,,-38191000,-38191000,50702,LNDC
2019-05-26,11466000,,3640000,,411000,62262000,81003000,7275000,7275000,,-5230000,,,,1518000,557559000,550284000,476556000,-3635000,-1711000.0,2122000,411000,50702,LNDC
2018-05-27,12800000,,16398000,,24829000,51951000,78338000,13587000,13587000,,-1950000,,,,-9363000,524227000,510640000,445889000,2811000,-838000.0,25761000,24829000,50702,LNDC
2017-05-28,9473000,,14175000,1543000.0,10590000,50191000,79212000,19548000,19548000,,-1826000,,,,4040000,469776000,450228000,390564000,-5373000,542000.0,10135000,10590000,50702,LNDC
2019-12-31,,,9587000,,-9639000,74537000,284031000,83693000,83693000,,-75750000,,,,19226000,1624411000,1540718000,1340380000,-74106000,,-9639000,-9639000,50703,MERC
2018-12-31,,,177270000,,128589000,59946000,425617000,269383000,269383000,,-51464000,,,,48681000,1457718000,1188335000,1032101000,-92113000,,128589000,128589000,50703,MERC
2017-12-31,,,103935000,,70483000,49679000,303126000,168554000,168554000,,-54796000,,,,33452000,1169145000,1000591000,866019000,-64619000,,70483000,70483000,50703,MERC
2016-12-31,,,59464000,,34943000,44529000,231129000,115124000,115124000,,-51575000,,,,24521000,931623000,816499000,700494000,-55660000,,34943000,34943000,50703,MERC
2020-02-01,,,133891000,,111081000,1725059000,2107233000,159825000,159825000,,-43287000,,,,22810000,6343211000,6183386000,4235978000,-25934000,,111081000,111081000,50704,DDS
2019-02-02,,,207993000,,170263000,1727486000,2211829000,260528000,260528000,,-49044000,,,,37730000,6503349000,6242821000,4291520000,-52535000,,170263000,170263000,50704,DDS
2018-02-03,,,213524000,,221324000,1720157000,2222958000,271206000,271206000,,-61326000,,,,-7800000,6422676000,6151470000,4199718000,-57682000,,221324000,221324000,50704,DDS
2017-01-28,,,257720000,,169220000,1681611000,2251597000,326329000,326329000,,-61373000,,,,88500000,6418008000,6091679000,4166411000,-68609000,,169220000,169220000,50704,DDS
2019-12-31,,,13597221,,13528610,1345363,5086086,3740723,3740723,,-190418,,,,68611,5086086,1345363,0,9856498,,13528610,13528610,50705,FEO
2018-12-31,,,-10809683,,-10863364,1410246,5086377,3676131,3676131,,-173529,,,,53681,5086377,1410246,0,-14485814,,-10863364,-10863364,50705,FEO
2017-12-31,,,16203856,,16174847,1523203,5559273,4036070,4036070,,-121492,,,,29009,5559273,1523203,0,12167786,,16174847,16174847,50705,FEO
2016-12-31,,,11404003,,11358733,1395268,4941658,3546390,3546390,,-83493,,,,45270,4941658,1395268,0,7857613,,11358733,11358733,50705,FEO
2020-02-29,,,33700758,,33700758,2803705,17907956,15104251,15104251,,-4071003,,,,0,17907956,2803705,0,18596507,,33700758,33700758,50707,VTN
2019-02-28,,,8503571,,8503571,2803408,18882682,16079274,16079274,,-4050303,,,,0,18882682,2803408,0,-7575703,,8503571,8503571,50707,VTN
2018-02-28,,,8465357,,8465357,2955372,20076867,17072413,17072413,49082.0,-3624418,,,,0,20076867,3004454,0,-8607056,,8465357,8465357,50707,VTN
2017-02-28,,,-2360970,,-2360970,2621774,19802792,16926838,16926838,254180.0,-2931793,,,,0,19802792,2875954,0,-19287808,,-2360970,-2360970,50707,VTN
2019-12-31,,,781553000,376920000,373526000,4336637000,6110866000,1848174000,1848174000,-103948000,-1028240000,,,,378609000,89297975000,87449801000,83187109000,-1066621000,,402944000,373526000,50708,UGP
2018-12-31,,,1771039000,351924000,1150421000,4227456000,6160615000,2004515000,2004515000,-140606000,-884705000,,,,638719000,90697983000,88693468000,84537368000,-233476000,,1132320000,1150421000,50708,UGP
2017-12-31,,,2339119000,377824000,1526505000,4062917000,6798541000,2784912000,2784912000,-49288000,-1062102000,,,,813254000,79230014000,76445102000,72431473000,-445793000,,1525865000,1526505000,50708,UGP
2016-12-31,,,2270610000,30935000,1561585000,4097360000,7010232000,3035401000,3035401000,-122529000,-1159388000,,,,699992000,77352955000,74317554000,70342723000,-764791000,,1570618000,1561585000,50708,UGP
2019-12-28,,,41467400,,32149300,25745300,68876400,43131100,43131100,,-1731100,,,,9318100,73298900,30167800,4422500,-1663700,,32149300,32149300,50710,WINA
2018-12-29,,,39283100,,30125500,26038300,67802100,41763800,41763800,,-2447500,,,,9157600,72511100,30747300,4709000,-2480700,,30125500,30125500,50710,WINA
2017-12-30,,,36451500,,24580500,25241600,64046600,38805000,38805000,,-2366400,,,,11871000,69757300,30952300,5710700,-2352100,,24580500,24580500,50710,WINA
2016-12-31,,,35854300,,22148400,23866900,62076200,38209300,38209300,,-2342800,,,,13705900,66519900,28310600,4443700,-2367600,,22148400,22148400,50710,WINA
2019-12-28,19870000,,-33507000,,-33547000,23596000,13863000,-29603000,-29603000,,-4353000,,,,40000,23604000,53207000,9741000,-3904000,,-33547000,-33547000,50712,TMDX
2018-12-29,13656000,,-23715000,,-23756000,12315000,5734000,-20237000,-20237000,,-2720000,,,,41000,13017000,33254000,7283000,-3478000,,-23756000,-23756000,50712,TMDX
2017-12-30,14957000,,-20791000,,-20823000,7606000,2137000,-20426000,-20426000,,-1072000,,,,32000,7685000,28111000,5548000,-365000,,-20823000,-20823000,50712,TMDX
2016-12-31,15637000,,-24065000,,-24065000,8115000,766000,-22986000,-22986000,,-979000,,,,0,6209000,29195000,5443000,-1079000,,-24065000,-24065000,50712,TMDX
2020-12-31,103561000,,-19953000,,-7524000,229046000,389680000,57073000,57073000,,,,,,-12429000,480735000,423662000,91055000,-77026000,,-7524000,-7524000,50713,MSTR
2019-12-31,109423000,,38263000,,34355000,277932000,386353000,-1002000,-1002000,,,,,,3908000,486327000,487329000,99974000,39265000,,34355000,34355000,50713,MSTR
2018-12-31,102499000,,20482000,,22501000,291659000,398139000,3981000,3981000,,,,,,-2019000,497638000,493657000,99499000,16501000,,22501000,22501000,50713,MSTR
2017-12-31,78766000,,71474000,,18195000,255206000,407194000,73222000,73222000,,,,,,53279000,503843000,430621000,96649000,-1748000,,18195000,18195000,50713,MSTR
2019-12-28,,,11992000,634000,8363000,50224000,94824000,26561000,26561000,-210000,-1669000,,,,3243000,444427000,417866000,349603000,-14569000,,8749000,8363000,50714,HCCI
2018-12-29,,,20489000,648000,14728000,47714000,87018000,22541000,22541000,606000,-1552000,,,,5451000,410183000,387642000,323165000,-2052000,,15038000,14728000,50714,HCCI
2017-12-30,,,34333000,698000,28123000,47401000,89855000,23627000,23627000,860000,-1494000,,,,5923000,365957000,342330000,276102000,10706000,,28410000,28123000,50714,HCCI
2016-12-31,,,8825000,720000,5842000,49823000,81775000,12545000,12545000,1416000,-2069000,,,,2811000,347627000,335082000,265852000,-3720000,,6014000,5842000,50714,HCCI
2020-12-31,,,1272687000,618766000,1112564000,333140000,3690898000,1971809000,1971809000,67941000,-784400000,,,,-4637000,4578052000,2606243000,887154000,-699122000,,1277324000,1109227000,50715,SPG
2019-12-31,,,2453242000,603913000,2101584000,375313000,4638845000,2821343000,2821343000,101686000,-789353000,,,,30054000,5660489000,2839146000,1021644000,-368101000,,2423188000,2098247000,50715,SPG
2018-12-31,,,2859241000,730438000,2440058000,334461000,4619424000,2923611000,2923611000,78898000,-815923000,,,,36898000,5627388000,2703777000,1007964000,-64370000,,2822343000,2436721000,50715,SPG
2017-12-31,,,2268246000,743076000,1947962000,337987000,4547256000,2802340000,2802340000,131477000,-809393000,,,,23343000,5527336000,2724996000,980080000,-534094000,,2244903000,1944625000,50715,SPG
2020-05-30,,,35228000,,28285000,221691000,275483000,43028000,43028000,,-2161000,,,,6943000,703353000,660325000,427870000,-7800000,,28285000,28285000,50717,RGP
2019-05-25,,,47969000,,31470000,224392000,282439000,49569000,49569000,,-2490000,,,,16499000,728999000,679430000,446560000,-1600000,,31470000,31470000,50717,RGP
2018-05-26,,,28889000,,18826000,209042000,246055000,30624000,30624000,,-1735000,,,,10063000,654129000,623505000,408074000,-15735000,,18826000,18826000,50717,RGP
2017-05-27,,,33773000,,18651000,183471000,221325000,34402000,34402000,,-629000,,,,15122000,583411000,549009000,362086000,-5829000,,18651000,18651000,50717,RGP
2020-12-31,,,47317000,73235000,44889000,75001000,737267000,303724000,303724000,12642000,-159550000,,,,0,1050344000,746620000,313077000,-256407000,,47317000,44889000,50719,REG
2019-12-31,,,243258000,76613000,239430000,74984000,858527000,401446000,401446000,7814000,-152333000,,,,0,1164672000,763226000,306145000,-158188000,,243258000,239430000,50719,REG
2018-12-31,,,252325000,52198000,249127000,65491000,854451000,419535000,419535000,9737000,-149686000,,,,0,1160341000,740806000,305890000,-163819000,,252325000,249127000,50719,REG
2017-12-31,,,169243000,41002000,176077000,67624000,767363000,357013000,357013000,8525000,-132629000,,,,-9737000,1021076000,664063000,253713000,-184249000,,178980000,159949000,50719,REG
2019-12-31,,,29417619,,29278523,8292577,53476763,45184186,45184186,,-13108624,,,,139096,53476763,8292577,0,-15766567,,29278523,29278523,50720,CCAP
2018-12-31,,,8236018,,8114574,6995327,33295124,26299797,26299797,,-8263150,,,,121444,33295124,6995327,0,-18063779,,8114574,8114574,50720,CCAP
2017-12-31,,,9080660,,9055186,7055728,22291677,15235949,15235949,,-5075579,,,,25474,22291677,7055728,0,-6155289,,9055186,9055186,50720,CCAP
2016-12-31,,,11770293,,11768693,4771190,13887777,9116587,9116587,,-2524588,,,,1600,13887777,4771190,0,2653706,,11768693,11768693,50720,CCAP
2020-09-30,,,-2973000,,-3774000,106606000,109924000,-2940000,-2940000,-32000,,,,,801000,205940000,208880000,96016000,-33000,,-3774000,-3774000,50721,LQDT
2019-09-30,,,-18060000,,-19260000,122199000,113280000,-13981000,-13981000,-29000,,,,,1200000,226525000,240506000,113245000,-4079000,,-19260000,-19260000,50721,LQDT
2018-09-30,,,-20943000,,-11615000,124647000,109712000,-18984000,-18984000,-550000,,,,,-9328000,224514000,243498000,114802000,-1959000,,-11615000,-11615000,50721,LQDT
2017-09-30,,,-39638000,,-39187000,154034000,124490000,-35368000,-35368000,28000,,,,,-451000,270015000,305383000,145525000,-4270000,,-39187000,-39187000,50721,LQDT
2019-12-31,,,-13531000,1110000,-22377000,1146261000,1186129000,39868000,39868000,,-23593000,,,,761000,2218915000,2179047000,1032786000,-53399000,2597000,-14292000,-22377000,50722,GRPN
2018-12-31,,,1031000,1363000,-11079000,1231443000,1320601000,89058000,89058000,,-21909000,,,,-957000,2636746000,2547688000,1316145000,-88027000,2597000,1988000,-11079000,50722,GRPN
2017-12-31,,,36145000,872000,14040000,1302699000,1333861000,30917000,30917000,,-20680000,,,,7544000,2843877000,2812960000,1510016000,5228000,-1974000,28601000,14040000,50722,GRPN
2016-12-31,,,-171527000,642000,-194587000,1346202000,1280653000,-66400000,-66400000,,-15912000,,,,-5318000,3013615000,3080015000,1732962000,-105127000,-17114000,-166209000,-194587000,50722,GRPN
2019-12-31,,,47236997,,47236997,8927480,53987691,44711834,44711834,,-3426380,,,,0,152120636,107408802,98132945,2525163,,47236997,47236997,50724,LXEH
2018-12-31,,,82237323,,82237323,82127709,158740851,75877773,75877773,,-15260160,,,,0,427570755,351692982,268829904,6359550,,82237323,82237323,50724,LXEH
2020-08-01,,,-344454000,-2487000,-274140000,3464461000,3874792000,372482000,372482000,,-193729000,,,,-90445000,26514267000,26141785000,22639475000,-716936000,-15202000,-254009000,-274140000,50726,UNFI
2019-08-03,,,-344457000,-2737000,-284730000,2923122000,3208606000,275735000,275735000,,-175886000,,,,-58936000,22307456000,22031721000,19098850000,-620192000,898000,-285521000,-284730000,50726,UNFI
2018-07-28,,,209992000,-2737000,162777000,1262556000,1520014000,245452000,245452000,,-16471000,,,,47215000,10226683000,9981231000,8706669000,-35460000,898000,162777000,162777000,50726,UNFI
2017-07-29,,,214423000,-2737000,130155000,1190304000,1428921000,232889000,232889000,,-16754000,,,,84268000,9274471000,9041582000,7845550000,-18466000,898000,130155000,130155000,50726,UNFI
2019-12-31,,,3223922,,2533106,1100138,0,-1100138,-1100138,,,,,,690816,0,1100138,0,4324060,,2533106,-443675,50727,TDAC
2018-12-31,,,1778728,,1404083,699334,0,-699334,-699334,,,,,,374645,0,699334,0,2478062,,1404083,-476055,50727,TDAC
2017-12-31,,,-387,,-387,387,0,-387,-387,,,,,,0,0,387,0,0,,-387,-387,50727,TDAC
2016-12-31,,,-2628,,-2628,2628,0,-2628,-2628,,,,,,0,0,2628,0,0,,-2628,-2628,50727,TDAC
2019-12-31,9902254,,-45130184,635610,-45147883,35422301,1233322,-44091233,-44091233,,,,,,17699,2390279,46481512,1156957,-1038951,,-45147883,-45147883,50728,ECOR
2018-12-31,12466172,,-55763024,635610,-55820460,42501562,414210,-54553524,-54553524,,,,,,2431,992953,55546477,578743,-1209500,,-55765455,-34702123,50728,ECOR
2017-12-31,7830868,,-36028780,604055,-35792422,18106647,292925,-25644590,-25644590,,-7123171.0,,,,0,811457,26456047,518532,-10384190,,-55765455,-34702123,50728,ECOR
2016-12-31,7971342,,-15781485,400421,-15737339,7169305,130407,-15010240,-15010240,,-771245.0,,,,0,254138,15264378,123731,-771245,,-15781485,-15737339,50728,ECOR
2019-12-31,10384000,,-27157000,,-27432000,42318000,25675000,-29122000,-29122000,,-4052000,,,,275000,50713000,79835000,25038000,1965000,,-27432000,-27432000,50730,APEN
2018-12-31,12176000,,-45596000,,-45787000,46267000,33194000,-32323000,-32323000,,-4063000,,,,191000,60854000,93177000,27660000,-13273000,,-45787000,-45787000,50730,APEN
2017-12-31,8299000,,-26988000,,-27292000,46632000,39732000,-22439000,-22439000,,-4508000,,,,304000,64310000,86749000,24578000,-4549000,,-27292000,-27292000,50730,APEN
2016-12-31,7805000,,-40780000,,-41167000,41558000,39395000,-17161000,-17161000,,-18168000,,,,387000,64650000,81811000,25255000,-23619000,,-41167000,-41167000,50730,APEN
2019-12-31,2683930,,-4068569,,-4068569,1380306,0,-4064236,-4064236,,,,,,0,0,4064236,0,-4333,,-4068569,-4068569,50732,FBRX
2018-12-31,422602,,-861662,,-861662,265680,0,-688282,-688282,,-173380.0,,,,0,0,688282,0,-173380,,-861662,-861662,50732,FBRX
2019-12-31,,,58943000,,21505000,169550000,293024000,123474000,123474000,,-36602000,,,,0,428413000,304939000,135389000,-64531000,-37438000,58943000,21505000,50734,IRWD
2018-12-31,,,-194146000,,-282368000,217476000,212581000,-13006000,-13006000,,-37724000,,,,0,346639000,359645000,134058000,-181140000,-88222000,-194146000,-282368000,50734,IRWD
2017-12-31,,,-54915000,,-116937000,230284000,190725000,-45773000,-45773000,,-36370000,,,,0,298276000,344049000,107551000,-9142000,-62022000,-54915000,-116937000,50734,IRWD
2016-12-31,,,-81708000,,-81708000,173281000,132223000,-42039000,-42039000,,-39153000,,,,0,273957000,315996000,141734000,-39669000,-62022000,-81708000,-81708000,50734,IRWD
2019-12-31,,,9674000,,7221000,186532000,197354000,10822000,10822000,,-603000,,,,2453000,370785000,359963000,173431000,-1148000,,7221000,7221000,50735,LAWS
2018-12-31,,,6863000,,6214000,179481000,189540000,10059000,10059000,,-1009000,,,,649000,349637000,339578000,160097000,-3196000,,6214000,6214000,50735,LAWS
2017-12-31,,,10094000,,29688000,177804000,183018000,5214000,5214000,,-622000,,,,-19594000,305907000,300693000,122889000,4880000,,29688000,29688000,50735,LAWS
2016-12-31,,,-1531000,,-1629000,166543000,168062000,1519000,1519000,,-496000,,,,98000,276573000,275054000,108511000,-3050000,,-1629000,-1629000,50735,LAWS
2020-12-31,,,207293000,247378000,187105000,78764000,637677000,259605000,259605000,,-70772000,,,,0,898397000,638792000,260720000,-52312000,,207293000,187105000,50741,KRC
2019-12-31,,,215229000,277348000,195443000,88139000,583592000,222323000,222323000,,-48537000,,,,0,837454000,615131000,253862000,-7094000,,215229000,193324000,50741,KRC
2018-12-31,,,277926000,271354000,258415000,90471000,536515000,186078000,186078000,,-49721000,,,,0,747298000,561220000,210783000,91848000,,277926000,256411000,50741,KRC
2017-12-31,,,180615000,259523000,164612000,60581000,516244000,206508000,206508000,,-66040000,,,,0,719001000,512493000,202757000,-25893000,,180615000,149274000,50741,KRC
2019-12-31,,,7920743,,6257388,993145,0,-993145,-993145,,,,,,1663356,0,993145,0,8913888,,6257388,-234176,50747,CCX
2019-12-31,,,758745000,63781000,541260000,3581258000,4855794000,983766000,983766000,,-138504000,,,,215330000,12506109000,11522343000,7650315000,-225021000,645000,543415000,541260000,50752,LKQ
2018-12-31,,,678960000,56454000,480118000,3353278000,4574857000,947366000,947366000,,-146377000,,,,191395000,11876674000,10929308000,7301817000,-268406000,-4397000,487565000,480118000,50752,LKQ
2017-12-31,,,772534000,8484000,533744000,2713087000,3799623000,866990000,866990000,,-101640000,,,,235560000,9736909000,8869919000,5937286000,-94456000,-6746000,536974000,533744000,50752,LKQ
2016-12-31,,,676689000,8484000,463975000,2359110000,3351703000,801160000,801160000,,-88263000,,,,220566000,8584031000,7782871000,5232328000,-124471000,7852000,456123000,463975000,50752,LKQ
2019-12-31,,,8838371,,8838371,1011289,10449660,9438371,9438371,,,,,,0,10449660,1011289,0,-600000,,8838371,8838371,50753,PRT
2018-12-31,,,15589855,,15589855,648930,16238785,15589855,15589855,,,,,,0,16238785,648930,0,0,,15589855,15589855,50753,PRT
2019-12-31,,,64451000,7590000,58539000,13128000,86317000,64622000,64622000,291000,-1013000,,,,3513000,123215000,58593000,36898000,-171000,,60938000,58539000,50754,PAX
2018-12-31,,,46456000,6005000,43669000,16627000,70503000,46616000,46616000,65000,-206000,,,,1992000,105670000,59054000,35167000,-160000,,44464000,43669000,50754,PAX
2020-10-25,2234000000,,4166000000,,3619000000,1013000000,7715000000,4468000000,4468000000,,-240000000,,,,547000000,17202000000,12734000000,9487000000,-302000000,,3619000000,3619000000,50757,AMAT
2019-10-27,2054000000,,3269000000,,2706000000,960000000,6386000000,3372000000,3372000000,,-237000000,,,,563000000,14608000000,11236000000,8222000000,-103000000,,2706000000,2706000000,50757,AMAT
2018-10-28,2022000000,,4396000000,,3038000000,999000000,7517000000,4496000000,4496000000,,-234000000,,,,1358000000,16705000000,12209000000,9188000000,32000000,,3038000000,3038000000,50757,AMAT
2017-10-29,1781000000,,3816000000,,3519000000,895000000,6612000000,3936000000,3936000000,,-198000000,,,,297000000,14698000000,10762000000,8086000000,-120000000,,3519000000,3519000000,50757,AMAT
2020-03-31,,,-188704185,,-188704185,21377713,131947232,110569519,110569519,,-27879613,,,,0,131947232,21377713,0,-299273704,,-188704185,-195140591,50759,EVV
2019-03-31,,,64454327,,64454327,21999748,142008585,120008837,120008837,,-21834661,,,,0,142008585,21999748,0,-55554510,,64454327,60837823,50759,EVV
2018-03-31,,,74745035,,74745035,22785451,134180326,111394875,111394875,,-15268912,,,,0,134180326,22785451,0,-36649840,,74745035,69785028,50759,EVV
2017-03-31,,,201753515,,201753515,22985703,140098493,117112790,117112790,,-10404316,,,,0,140098493,22985703,0,84640725,,201753515,199669510,50759,EVV
2019-12-31,,,17397000,,42568000,90196000,121372000,24599000,24599000,,-5034000,,,,-25171000,655057000,630458000,533685000,-7202000,,42568000,42568000,50763,FSTR
2018-12-31,,,-26711000,,-31168000,87679000,117159000,22382000,22382000,,-6188000,,,,4457000,626969000,604587000,509810000,-49093000,,-31168000,-31168000,50763,FSTR
2017-12-31,,,10051000,,5361000,80521000,105261000,17748000,17748000,,-8448000,,,,4690000,536377000,518629000,431116000,-7697000,,5361000,5361000,50763,FSTR
2016-12-31,,,-147169000,,-141660000,85076000,91580000,-3071000,-3071000,,-6551000,,,,-5509000,483514000,486585000,391934000,-144098000,,-141660000,-141660000,50763,FSTR
2019-12-31,,,116835000,1888000,95483000,301651000,428103000,126452000,126452000,,-8245000,,,,20836000,1314578000,1188126000,886475000,-9617000,,95999000,94783000,50764,FELE
2018-12-31,,,120407000,2473000,105877000,297306000,432366000,135060000,135060000,,-9839000,,,,14890000,1298129000,1163069000,865763000,-14653000,,105517000,105077000,50764,FELE
2017-12-31,,,104587000,3466000,78180000,266247000,376982000,110735000,110735000,,-10322000,,,,25994000,1124909000,1014174000,747927000,-6148000,,78593000,77580000,50764,FELE
2016-12-31,,,104113000,9295000,78745000,221134000,331406000,110272000,110272000,,-8732000,,,,24798000,949856000,839584000,618450000,-6159000,,79315000,77045000,50764,FELE
2019-12-31,101151000,,-1364000,,-4054000,314224000,427308000,11933000,11933000,,-21559000,,,,2690000,576523000,564590000,149215000,-13297000,,-4054000,-4054000,50765,CSOD
2018-12-31,76981000,,-31247000,,-33842000,314284000,393542000,2277000,2277000,,-28176000,,,,2595000,537891000,535614000,144349000,-33524000,,-33842000,-33842000,50765,CSOD
2017-12-31,61975000,,-59589000,,-61335000,324860000,339118000,-47717000,-47717000,,-14762000,,,,1746000,481985000,529702000,142867000,-11872000,,-61335000,-61335000,50765,CSOD
2016-12-31,46977000,,-65630000,,-66837000,296737000,287372000,-56342000,-56342000,,-12924000,,,,1207000,423124000,479466000,135752000,-9438000,,-66837000,-66837000,50765,CSOD
2019-12-31,3184082,,-7946020,,-6718698,4586003,0,-7770085,-7770085,,-554998,,,,-1227322,0,7770085,0,-175935,,-6718698,-12161645,50766,HEPA
2018-12-31,7593715,,-9985295,,-9449295,7000444,0,-14594159,-14594159,,-339158,,,,-536000,0,14594159,0,4608864,,-9449295,-17901146,50766,HEPA
2017-12-31,13368165,,-15027518,,-13079758,7277951,0,-20646116,-20646116,,-339158,,,,-1947760,0,20646116,0,5618598,,-13079758,-13079758,50766,HEPA
2017-06-30,13651987,,-16799053,,-14891050,7371885,0,-21023872,-21023872,,-339158,,,,-1908003,0,21023872,0,4134819,,-14891050,-14891050,50766,HEPA
2019-12-31,,,13180138,,13178871,5693065,791297,-4906983,-4906983,5215,,,,,1267,791297,5698280,0,18087121,,13178871,13178871,50773,TURN
2018-12-31,,,997782,,991779,3030779,685836,-2349828,-2349828,4885,,,,,6003,685836,3035664,0,3347610,,991779,991779,50773,TURN
2017-12-31,,,9430596,,9417743,3964998,1229923,-2758466,-2758466,4885,,,,,12853,1229923,3988389,0,12189062,,9417743,9417743,50773,TURN
2016-12-31,,,-16364593,,-16366360,5332797,1792190,-3586116,-3586116,4885,-886874.0,,,,1767,1792190,5378306,0,-12778477,,-16366360,-16366360,50773,TURN
2019-12-31,,,34566000,,31256000,161857000,274407000,78535000,78535000,,-42944000,,,,3310000,3502410000,3423875000,3228003000,-43969000,,31256000,25093000,50774,SRLP
2018-12-31,,,84851000,,79819000,168034000,325748000,124336000,124336000,,-38931000,,,,5032000,3771133000,3646797000,3445385000,-39485000,,79819000,71940000,50774,SRLP
2017-12-31,,,33319000,,29497000,156660000,252208000,67423000,67423000,,-31345000,,,,3822000,2850974000,2783551000,2598766000,-34104000,,29497000,25504000,50774,SRLP
2016-12-31,,,12274000,,10166000,148962000,210909000,40710000,40710000,,-27533000,,,,2108000,2389998000,2349288000,2179089000,-28436000,,10166000,8424000,50774,SRLP
2020-10-31,,,224468115,,224468115,30750066,81728789,50978723,50978723,,-18197275,,,,0,81728789,30750066,0,173489392,,224468115,224468115,50775,CSQ
2019-10-31,,,258591279,,258591279,29911685,86185998,56274313,56274313,,-29012318,,,,0,86185998,29911685,0,202316966,,258591279,258591279,50775,CSQ
2018-10-31,,,73354571,,73354571,30772759,80077445,49304686,49304686,,-24254368,,,,0,80077445,30772759,0,24049885,,73354571,73354571,50775,CSQ
2017-10-31,,,405422582,,405422582,27304192,79312567,52008375,52008375,,-11554164,,,,0,79312567,27304192,0,353414207,,405422582,405422582,50775,CSQ
2019-12-31,,,-60318000,2965000,-42793000,12431000,-47887000,0,-60318000,,,,,,-16822000,-30765000,29553000,17122000,0,,-43496000,-52146000,50776,CHMI
2018-12-31,,,39161000,3258000,37285000,9887000,49048000,0,39161000,,,,,,1388000,59663000,20502000,10615000,0,,37773000,31988000,50776,CHMI
2017-12-31,,,48615000,2475000,47359000,8164000,56779000,0,48615000,,,,,,601000,62562000,13947000,5783000,0,,48014000,45526000,50776,CHMI
2016-12-31,,,25701000,1777000,24832000,6230000,31931000,0,25701000,,,,,,458000,34493000,8792000,2562000,0,,25243000,24832000,50776,CHMI
2020-01-31,95469000,,-95826000,,-95940000,226287000,218051000,-103705000,-103705000,,-250000,,,,114000,270882000,374587000,52831000,7879000,,-95940000,-95940000,50778,SMAR
2019-01-31,58841000,,-53592000,,-53885000,140116000,143873000,-55084000,-55084000,,-400000,,,,293000,177722000,232806000,33849000,1492000,,-53885000,-53885000,50778,SMAR
2018-01-31,37590000,,-49413000,,-49106000,100959000,89571000,-48978000,-48978000,,-300000,,,,-307000,111253000,160231000,21682000,-435000,,-49106000,-53664000,50778,SMAR
2017-01-31,19640000,,-15184000,,-15184000,48346000,52831000,-15155000,-15155000,,-200000,,,,0,66964000,82119000,14133000,-29000,,-15184000,-15184000,50778,SMAR
2019-12-31,,,58993000,,44732000,156984000,247202000,99118000,99118000,-8900000,-40125000,,,,14261000,346813000,247695000,99611000,-40125000,,44732000,44732000,50780,RM
2018-12-31,,,45902000,,35345000,140284000,211050000,79366000,79366000,-8600000,-33464000,,,,10557000,298106000,218740000,87056000,-33464000,,35345000,35345000,50780,RM
2017-12-31,,,40257000,,29963000,130955000,184756000,64165000,64165000,-10364000,-23908000,,,,10294000,262095000,197930000,77339000,-23908000,,29963000,29963000,50780,RM
2016-12-31,,,38948000,,24031000,118632000,167405000,58872000,58872000,-10099000,-19924000,,,,14917000,230419000,171547000,63014000,-19924000,,24031000,24031000,50780,RM
2019-12-31,,,18475000,-632023000,18075000,17919000,54124000,36205000,36205000,,-15975000,,,,63000,371070000,334865000,316946000,-17462000,,18412000,-7040000,50781,BKEPP
2018-12-31,,,-41849000,-631791000,-41535000,15995000,41700000,25705000,25705000,,-16860000,,,,198000,384835000,359130000,343135000,-67554000,,-42047000,-66650000,50781,BKEPP
2017-12-31,,,20211000,-703597000,19101000,17112000,49327000,32215000,32215000,,-14027000,,,,166000,181939000,149724000,132612000,-12004000,,20045000,-5885000,50781,BKEPP
2016-12-31,,,-4580000,-699527000,-5273000,18229000,52173000,33944000,33944000,,-12554000,,,,260000,177394000,143450000,125221000,-38524000,,-4840000,-30398000,50781,BKEPP
2019-12-31,64232000,,-86331000,,-86331000,22428000,0,-86660000,-86660000,,-977000,,,,0,0,86660000,0,329000,,-86331000,-86331000,50782,KLDO
2018-12-31,42062000,,-61744000,,-61744000,18621000,0,-60683000,-60683000,,-1005000,,,,0,0,60683000,0,-1061000,,-61744000,-61744000,50782,KLDO
2017-12-31,20992000,,-27559000,,-27559000,6038000,0,-27030000,-27030000,,-435000,,,,0,0,27030000,0,-529000,,-27559000,-27559000,50782,KLDO
2016-12-31,7863000,,-9685000,,-9685000,1573000,0,-9436000,-9436000,,-141000,,,,0,0,9436000,0,-249000,,-9685000,-9685000,50782,KLDO
2019-12-31,,,60075000,,60075000,5772000,136612000,99489000,99489000,,-38901000,,,,0,226350000,126861000,89738000,-39414000,,60075000,60075000,50784,ALX
2018-12-31,,,56641000,,32844000,5343000,139050000,100618000,100618000,,-41913000,,,,0,232825000,132207000,93775000,-43977000,-23797000.0,56641000,32844000,50784,ALX
2017-12-31,,,80509000,,80509000,5255000,145447000,105267000,105267000,,-31474000,,,,0,230574000,125307000,85127000,-24758000,-23797000.0,80509000,80509000,50784,ALX
2016-12-31,,,86525000,,86477000,5436000,144704000,105461000,105461000,,-22241000,,,,48000,226936000,121475000,82232000,-18936000,-23797000.0,86477000,86477000,50784,ALX
2020-09-30,,,32500000,-25500000,800000,927500000,1787400000,698300000,698300000,1300000,-575700000,,,,3500000,5698700000,5000400000,3911300000,-665800000,,29000000,800000,50785,POST
2019-09-30,,,122100000,11400000,124700000,890700000,1799500000,745400000,745400000,2100000,-657700000,,,,-3900000,5681100000,4935700000,3881600000,-623300000,,126000000,121700000,50785,POST
2018-09-30,,,264400000,10100000,467300000,940100000,1856500000,737200000,737200000,1800000,-278300000,,,,-204000000,6257200000,5520000000,4400700000,-472800000,,468400000,457300000,50785,POST
2017-09-30,,,74400000,9700000,48300000,792300000,1570800000,618400000,618400000,1000000,-212700000,,,,26100000,5225800000,4607400000,3655000000,-544000000,,48300000,34800000,50785,POST
2019-12-31,11377000,,96478000,,79671000,95164000,211367000,104826000,104826000,,-7316000,,,,16807000,643705000,538879000,432338000,-8348000,,79671000,79671000,50786,BCPC
2018-12-31,11592000,,99030000,,78573000,83774000,204252000,108886000,108886000,,-7248000,,,,20457000,643679000,534793000,439427000,-9856000,,78573000,78573000,50786,BCPC
2017-12-31,9305000,,88488000,,90071000,80638000,189009000,99066000,99066000,,-7532000,,,,-1583000,594790000,495724000,405781000,-10578000,,90071000,90071000,50786,BCPC
2016-12-31,7325000,,82934000,,55972000,82698000,180861000,90838000,90838000,,-7265000,,,,26962000,553204000,462366000,372343000,-7904000,,55972000,55972000,50786,BCPC
2020-02-02,,,-15161707,,-15205019,126837813,116690324,-15305551,-15305551,,-200000,,,,43312,233377379,248682930,116687055,143844,,-15205019,-15205019,50789,LOVE
2019-02-03,,,-6687949,,-6704356,92027883,90880821,-4280813,-4280813,,-200000,,,,16407,165881297,170162110,75000476,-2407136,,-6704356,-34537354,50789,LOVE
2018-02-04,,,-5475798,,-5501798,58081486,57217152,-3078833,-3078833,,-437965,,,,26000,101810413,104889246,44593261,-2396965,,-5501798,-6709801,50789,LOVE
2017-01-29,,,-6736448,,-6874448,47779120,41697229,-6081891,-6081891,,-565557,,,,138000,76343441,82425332,34646212,-654557,,-6874448,-6874448,50789,LOVE
2019-12-31,,,-16458000,,-16458000,11925000,-4919000,-16844000,-16844000,,-967000,,,,0,3611000,20455000,8530000,386000,,-16458000,-16458000,50791,TTNP
2018-12-31,,,-9023000,,-9023000,6866000,-1398000,-8264000,-8264000,,-887000,,,,0,6618000,14882000,8016000,-759000,,-9023000,-9308000,50791,TTNP
2017-12-31,,,-14307000,,-14307000,5069000,-9433000,-14502000,-14502000,,-369000,,,,0,215000,14717000,9648000,195000,,-14307000,-14307000,50791,TTNP
2016-12-31,,,5135000,,5135000,4596000,8939000,4343000,4343000,,-369000,,,,0,15065000,10722000,6126000,792000,,5135000,5135000,50791,TTNP
2019-12-31,3471153,,-8394363,,-8394363,5084111,0,-8555264,-8555264,,,,,,0,0,8555264,0,160901,,-8394363,-8394363,50796,TENX
2018-12-31,1239300,,-6813445,,-6813445,5653980,0,-6893280,-6893280,,,,,,0,0,6893280,0,79835,,-6813445,-14144049,50796,TENX
2017-12-31,3527317,,-8839682,,-8839682,5678581,0,-9205898,-9205898,,,,,,0,0,9205898,0,366216,,-8839682,-8839682,50796,TENX
2016-12-31,12983681,,-51886004,,-43923904,6245958,0,-19229639,-19229639,,,,,,-7962100,0,19229639,0,-32656365,,-43923904,-43923904,50796,TENX
2019-12-31,136363000,,-56940000,,-53607000,568427000,671815000,-32975000,-32975000,,-20512000,,,,-3333000,902858000,935833000,231043000,-23965000,,-53607000,-53607000,50797,RNG
2018-12-31,101042000,,-26063000,,-26203000,431889000,516495000,-16436000,-16436000,,-16102000,,,,140000,673624000,690060000,157129000,-9627000,,-26203000,-26203000,50797,RNG
2017-12-31,75148000,,-3946000,,-4204000,312536000,382346000,-5338000,-5338000,,-99000,,,,258000,503617000,508955000,121271000,949000,,-4204000,-4204000,50797,RNG
2016-12-31,65514000,,-15989000,,-16225000,235579000,288225000,-12868000,-12868000,,-746000,,,,236000,380436000,393304000,92211000,-3121000,,-16225000,-16225000,50797,RNG
2020-12-31,,,139000000,14600000,131600000,546600000,809600000,263000000,263000000,,-64500000,,,,5200000,3242100000,2979100000,2432500000,-124000000,-400000,133800000,131600000,50801,AVNT
2019-12-31,,,109400000,800000,588600000,440600000,662900000,222300000,222300000,,-67700000,,,,33700000,2862700000,2640400000,2199800000,-112900000,513100000,75700000,588600000,50801,AVNT
2018-12-31,,,101800000,600000,159800000,450500000,643600000,193100000,193100000,,-61300000,,,,14400000,2881000000,2687900000,2237400000,-91300000,72100000,87400000,159800000,50801,AVNT
2017-12-31,,,111900000,900000,-57700000,418600000,602200000,183600000,183600000,,-59400000,,,,800000,2590300000,2406700000,1988100000,-71700000,-168700000,111100000,-57700000,50801,AVNT
2019-12-31,,,-4019537,,-4092806,4786529,1311437,-3652336,-3652336,177244,-57474,,,,73269,3173014,6825350,1861577,-367201,,-4092806,-4092806,50802,TKAT
2018-12-31,,,-8111864,,-7631963,11827223,5916659,-6305816,-6305816,395252,-573765,,,,-479901,8495423,14801239,2578764,-1806048,,-7631963,-7631963,50802,TKAT
2017-12-31,,,-718719,,-1061575,13205887,11675102,-1831682,-1831682,300897,-600819,,,,342856,12922388,14754070,1247286,1112963,,-1061575,-1061575,50802,TKAT
2016-12-31,,,8140143,,6370694,9408192,18014398,8442516,8442516,163690,-202376,,,,1769449,19143429,10700913,1129031,-302373,,6370694,6370694,50802,TKAT
2019-12-31,,,49799000,,33140000,129089000,209834000,80745000,80745000,,-19239000,,,,16659000,685509000,604764000,475675000,-30946000,,33140000,33140000,50805,ECOL
2018-12-31,,,64858000,,49595000,92340000,170094000,77754000,77754000,,-12130000,,,,15263000,565928000,488174000,395834000,-12896000,,49595000,49595000,50805,ECOL
2017-12-31,,,42970000,,49365000,84466000,153127000,68661000,68661000,,-18157000,,,,-6395000,504042000,435381000,350915000,-25691000,,49365000,49365000,50805,ECOL
2016-12-31,,,55301000,,34252000,77566000,147595000,70029000,70029000,,-17317000,,,,21049000,477665000,407636000,330070000,-14728000,,34252000,34252000,50805,ECOL
2019-12-31,,,173598000,,173598000,60702000,267874000,204946000,204946000,2226000,-61674000,,,,0,267874000,62928000,0,-31348000,,173598000,173236000,50806,HTGC
2018-12-31,,,76496000,,76496000,51358000,207753000,155424000,155424000,971000,-46695000,,,,0,207753000,52329000,0,-78928000,,76496000,75921000,50806,HTGC
2017-12-31,,,78998000,,78998000,47414000,190880000,143029000,143029000,437000,-46585000,,,,0,190880000,47851000,0,-64031000,,78998000,78427000,50806,HTGC
2016-12-31,,,68703000,,68703000,45649000,175051000,129402000,129402000,437000,-37058000,,,,0,175051000,45649000,0,-60699000,,68703000,67435000,50806,HTGC
2019-12-31,,,-2051000,,-2179000,6082000,-2413000,-11472000,-11472000,,,,,,128000,3243000,14715000,5656000,9421000,,-2179000,-2179000,50807,TPHS
2018-12-31,,,-7599000,,-7889000,5728000,762000,-7429000,-7429000,,,,,,290000,2987000,10416000,2225000,-170000,,-7889000,-7889000,50807,TPHS
2017-12-31,,,-5032000,,-2021000,5578000,-512000,-8475000,-8475000,1841000.0,,,,,-3011000,805000,9280000,1317000,3443000,,-2021000,-2021000,50807,TPHS
2016-12-31,,,-7220000,,-7436000,6927000,529000,-6855000,-6855000,1841000.0,-279000.0,,,,216000,1746000,8601000,1217000,-365000,,-7436000,-7436000,50807,TPHS
2019-12-31,,,-40774000,,-40083000,43784000,27086000,-18249000,-18249000,1551000,-13467000,,,,-691000,235111000,253360000,208025000,-22525000,,-40083000,-40083000,50808,HYFM
2018-12-31,,,-35939000,,-32892000,42229000,24070000,-19181000,-19181000,1022000,-11606000,,,,-397000,211813000,230994000,187743000,-16758000,,-35542000,-32892000,50808,HYFM
2019-12-31,69595000,,-151977000,,-151977000,77261000,4418000,-142438000,-142438000,,-6073000,,,,0,5995000,148433000,1577000,-9539000,,-151977000,-151977000,50810,HRMY
2018-12-31,12372000,,-39898000,,-39898000,29067000,0,-41439000,-41439000,,-6073000,,,,0,0,41439000,0,1541000,,-39898000,-70083000,50810,HRMY
2020-12-31,,,6927000000,259000000,5407000000,,19975000000,7940000000,7940000000,12035000000,-913000000,,,,1509000000,67842000000,59902000000,47867000000,-1013000000,,5418000000,5191000000,50811,MET
2019-12-31,,,6795000000,238000000,5899000000,,20484000000,7856000000,7856000000,12628000000,-955000000,,,,886000000,69620000000,61764000000,49136000000,-1061000000,,5909000000,5721000000,50811,MET
2018-12-31,,,6307000000,217000000,5123000000,,20021000000,7490000000,7490000000,12531000000,-1122000000,,,,1179000000,67941000000,60451000000,47920000000,-1183000000,,5128000000,4982000000,50811,MET
2017-12-31,,,3536000000,194000000,4010000000,,17157000000,4838000000,4838000000,12319000000,-1129000000,,,,-1470000000,62308000000,57470000000,45151000000,-1302000000,-986000000.0,5006000000,3907000000,50811,MET
2019-12-31,5427000,,-12030000,,-12038000,5663000,-71000,-12053000,-12053000,,,,,,8000,1666000,13719000,1737000,23000,,-12038000,-12094000,50813,WISA
2018-12-31,4873000,,-67349000,,-67357000,6460000,-238000,-11571000,-11571000,,-33502000.0,,,,8000,1374000,12945000,1612000,-55778000,,-67357000,-67357000,50813,WISA
2017-12-31,3664629,,-25646603,,-25652213,3018084,-158808,-6841521,-6841521,,-14696283.0,,,,5610,1112726,7954247,1271534,-18805082,,-25652213,-25652213,50813,WISA
2016-12-31,5218958,,-9698834,,-9708269,3016955,-260677,-8496590,-8496590,,-1863746.0,,,,9435,1273113,9769703,1533790,-1202244,,-9708269,-9708269,50813,WISA
2020-12-31,,,187500000,,151300000,172000000,824700000,286900000,286900000,35300000,-190300000,,,,37300000,1209200000,922300000,384500000,-99400000,1100000,150200000,151300000,50816,GATX
2019-12-31,,,259600000,,211200000,190300000,867300000,313800000,313800000,31300000,-190400000,,,,48400000,1393800000,1080000000,526500000,-54200000,1100000,211200000,211200000,50816,GATX
2018-12-31,,,245400000,,211300000,194500000,858600000,309100000,309100000,33100000,-174300000,,,,34100000,1360900000,1051800000,502300000,-63700000,1100000,211300000,211300000,50816,GATX
2017-12-31,,,258300000,,502000000,181500000,847300000,324100000,324100000,34400000,-163600000,,,,-243700000,1369100000,1045000000,521800000,-65800000,1100000,502000000,502000000,50816,GATX
2019-12-31,,,2090361,,2090361,484108,-484108,-484108,-484108,,,,,,0,0,484108,484108,2574469,,2090361,-255555,50820,ALAC
2018-12-31,,,410050,,410050,123012,0,-123012,-123012,,,,,,0,0,123012,0,409840,,410050,25277,50820,ALAC
2020-09-30,,,71289000,,52226000,252893000,350543000,82010000,82010000,,-8468000,,,,17973000,2127077000,2045067000,1776534000,-10721000,-1090000,53316000,52226000,50821,BZH
2019-09-30,,,-116638000,,-79520000,241173000,314654000,58722000,58722000,,-3109000,,,,-37217000,2087739000,2029017000,1773085000,-175360000,-99000,-79421000,-79520000,50821,BZH
2018-09-30,,,49438000,,-45375000,249660000,351514000,88047000,88047000,,-5325000,,,,94484000,2107133000,2019086000,1755619000,-38609000,-329000,-45046000,-45375000,50821,BZH
2017-09-30,,,34649000,,31813000,236717000,315309000,64583000,64583000,,-15636000,,,,2696000,1916278000,1851695000,1600969000,-29934000,-140000,31953000,31813000,50821,BZH
2020-12-31,,,767565000,,511607000,116288000,1713961000,933413000,933413000,-80333000,-95134000,,,,255958000,3138113000,2204700000,1424152000,-165848000,,511607000,511607000,50824,AEM
2019-12-31,,,738742000,,473166000,120987000,1260387000,842990000,842990000,-8605000,-93505000,,,,265576000,2494892000,1651902000,1234505000,-104248000,,473166000,473166000,50824,AEM
2018-12-31,,,-259052000,,-326701000,124873000,1046866000,102122000,102122000,27592000,-83649000,,,,67649000,2191221000,2089099000,1144355000,-361174000,,-326701000,-326701000,50824,AEM
2017-12-31,,,339289000,,240795000,137603000,1187262000,433454000,433454000,-11445000,-68086000,,,,98494000,2242604000,1809150000,1055342000,-94165000,,240795000,240795000,50824,AEM
2020-10-31,,,3286363,,3286363,766507,4052870,3286363,3286363,,,,,,0,4052870,766507,0,0,,3286363,3286363,50827,NRT
2019-10-31,,,7578065,,7578065,781098,8359163,7578065,7578065,,,,,,0,8359163,781098,0,0,,7578065,7578065,50827,NRT
2018-10-31,,,6407955,,6407955,795088,7203043,6407955,6407955,,,,,,0,7203043,795088,0,0,,6407955,6407955,50827,NRT
2017-10-31,,,7026448,,7026448,740129,7766577,7026448,7026448,,,,,,0,7766577,740129,0,0,,7026448,7026448,50827,NRT
2019-12-31,3994464,,15565496,603464,13056011,22324307,38904573,12585802,12585802,,-190808,,,,2391371,173409113,160823311,134504540,2979694,,13174125,13056011,50831,CCRC
2018-12-31,4069794,,19268011,707948,16092538,17260114,38865745,17535837,17535837,,-404958,,,,2966880,141433641,123897804,102567896,1732174,,16301131,16092538,50831,CCRC
2017-12-31,3551629,,10370785,922713,8773459,11214895,23409224,8642700,8642700,,-1609,,,,1255654,88971787,80329087,65562563,1728085,,9115131,8773459,50831,CCRC
2016-12-31,3264073,,9726174,922713,8277251,7818033,19633154,8551048,8551048,,-50383,,,,1448923,72731706,64180658,53098552,1175126,,8277251,8277251,50831,CCRC
2020-12-31,2295000000,,4968000000,,4495000000,9621000000,19769000000,5721000000,5721000000,,-500000000,,,,497000000,34608000000,28887000000,14839000000,-753000000,24000000,4471000000,4495000000,50833,ABT
2019-12-31,2408000000,,4077000000,213000000.0,3687000000,9469000000,18708000000,4895000000,4895000000,,-670000000,,,,390000000,31904000000,27009000000,13196000000,-818000000,24000000,3687000000,3666000000,50833,ABT
2018-12-31,2288000000,,2873000000,198000000.0,2368000000,9531000000,17919000000,3922000000,3922000000,,-826000000,,,,539000000,30578000000,26656000000,12659000000,-1049000000,34000000,2334000000,2353000000,50833,ABT
2017-12-31,2183000000,,2231000000,201000000.0,477000000,8804000000,15900000000,2938000000,2938000000,,-904000000,,,,1878000000,27390000000,24452000000,11490000000,-707000000,124000000,353000000,468000000,50833,ABT
2020-08-31,,,386878000,9302000,422439000,697678000,981807000,284129000,284129000,,-116977000,,,,-36731000,28406365000,28122236000,27424558000,102749000,,423609000,253771000,50836,CHSCL
2019-08-31,,,815601000,7390000,829880000,691877000,1384333000,692456000,692456000,,-167065000,,,,-12456000,31900453000,31207997000,30516120000,123145000,,828057000,661212000,50836,CHSCL
2018-08-31,,,671230000,9446000,775907000,635519000,1092120000,456601000,456601000,,-149202000,,,,-104076000,32683347000,32226746000,31591227000,214629000,,775306000,607239000,50836,CHSCL
2017-08-31,,,-110166000,12505000,71592000,609590000,893877000,284287000,284287000,,-171239000,,,,-181124000,32037426000,31753139000,31143549000,-394453000,,70958000,-96051000,50836,CHSCL
2020-12-31,,,-232218000,,-295697000,517872000,276631000,-241241000,-241241000,,-2174000,,,,63479000,2666702000,2907943000,2390071000,9023000,,-295697000,-295697000,50838,INCY
2019-12-31,,,486791000,,446906000,469276000,890399000,421123000,421123000,,-1855000,,,,39885000,2158759000,1737636000,1268360000,65668000,,446906000,446906000,50838,INCY
2018-12-31,,,115347000,,109493000,434934000,589803000,154869000,154869000,,-1543000,,,,5854000,1881883000,1727014000,1292080000,-39522000,,109493000,109493000,50838,INCY
2017-12-31,,,-312290000,,-313142000,366633000,142603000,-224030000,-224030000,,-6900000,,,,852000,1536216000,1760246000,1393613000,-88260000,,-313142000,-313142000,50838,INCY
2020-12-31,1915000000,,1489000000,31000000,1187000000,5274000000,8781000000,1542000000,1542000000,50000000,-204000000,,,,284000000,19535000000,17993000000,10754000000,-53000000,-10000000,1205000000,1187000000,50839,PHG
2019-12-31,1733000000,,1528000000,28000000,1167000000,5143000000,9078000000,2194000000,2194000000,8000000,-173000000,,,,337000000,19482000000,17288000000,10404000000,-666000000,-19000000,1191000000,1167000000,50839,PHG
2018-12-31,1683000000,,1503000000,29000000,1090000000,5003000000,8660000000,1965000000,1965000000,9000000,-165000000,,,,193000000,18121000000,16156000000,9461000000,-462000000,-213000000,1310000000,1090000000,50839,PHG
2017-12-31,1660000000,,1377000000,24000000,1657000000,4831000000,8260000000,1749000000,1749000000,20000000,-185000000,,,,349000000,17780000000,16031000000,9520000000,-372000000,843000000,1028000000,1657000000,50839,PHG
2019-12-31,7199000,,-10795000,,-10795000,4281000,26000,-11454000,-11454000,,-84000,,,,0,236000,11690000,210000,659000,,-10795000,-10795000,50840,ENTX
2018-12-31,8518000,,-10304000,,-10304000,2843000,500000,-10861000,-10861000,,-84000,,,,0,500000,11361000,0,591000,,-10304000,-10304000,50840,ENTX
2017-12-31,2768000,,-11197000,,-11197000,8575000,0,-11343000,-11343000,,-105000,,,,0,0,11343000,0,146000,,-11197000,-11197000,50840,ENTX
2016-12-31,2648000,,-1199000,,-1199000,2719000,0,-5367000,-5367000,,-105000,,,,0,0,5367000,0,4168000,,-1199000,-1199000,50840,ENTX
2020-12-31,,,73289000,,60582000,130676000,224196000,0,83916000,9604000,,,,,12707000,224196000,140280000,0,-10627000,,60582000,60582000,50841,QCRH
2019-12-31,,,72027000,,57408000,125098000,211650000,0,75769000,10783000,,,,,14619000,211650000,135881000,0,-3742000,,57408000,57408000,50841,QCRH
2018-12-31,,,52135000,,43120000,96882000,171278000,0,63791000,10605000,,,,,9015000,171278000,107487000,0,-11656000,,43120000,43120000,50841,QCRH
2017-12-31,,,40653000,,35707000,80042000,138077000,0,49787000,8248000,,,,,4946000,138077000,88290000,0,-9134000,,35707000,35707000,50841,QCRH
2019-12-31,,,21470000,16067000,8450000,134862000,206900000,22651000,22651000,8400000,-8621000,,,,7257000,813725000,791074000,606825000,-1181000,,14213000,359000,50842,SPKEP
2018-12-31,,,-12315000,44488000,-1186000,113146000,170335000,-5369000,-5369000,9900000,-9410000,,,,2077000,1005928000,1011297000,835593000,-6946000,,-14392000,-9295000,50842,SPKEP
2017-12-31,,,113809000,101559000,19245000,109025000,254888000,94522000,94522000,9000000,-11134000,,,,38765000,798055000,703533000,543167000,19287000,,75044000,16207000,50842,SPKEP
2016-12-31,,,76099000,93406000,14444000,85104000,207053000,83861000,83861000,5300000,-8859000,,,,10426000,546697000,462836000,339644000,-7762000,,65673000,14444000,50842,SPKEP
2020-03-31,,,2374750,,2374750,753953,4603122,3849169,3849169,,,,,,0,4603122,753953,0,-1474419,,2374750,2374750,50844,NIM
2019-03-31,,,6754807,,6754807,730454,4823947,4093493,4093493,,,,,,0,4823947,730454,0,2661314,,6754807,6754807,50844,NIM
2018-03-31,,,4576834,,4576834,751259,4919940,4168681,4168681,,,,,,0,4919940,751259,0,408153,,4576834,4576834,50844,NIM
2017-03-31,,,-459657,,-459657,758949,4713492,3954543,3954543,,,,,,0,4713492,758949,0,-4414200,,-459657,-459657,50844,NIM
2019-09-30,,,2653497,4104206,1738123,932073,3179951,2247878,2247878,,-18865,,,,723384,5194259,2946381,2014308,405619,211344,1930113,1738123,50847,EZGO
2018-09-30,,,1123677,2966167,512541,463834,1523736,1059902,1059902,,-18865,,,,286905,3191560,2131658,1667824,63775,-164194,836772,512541,50847,EZGO
2019-12-31,,,5781000,-1510000,1270000,115303000,118771000,3468000,3468000,,-1222000,,,,4562000,383101000,379633000,264330000,2313000,,1219000,1270000,50849,EVK
2018-12-31,,,16382000,-1551000,12008000,131250000,147355000,16105000,16105000,,-1989000,,,,4942000,448508000,432403000,301153000,277000,,11440000,12008000,50849,EVK
2017-12-31,,,17870000,-1062000,12459000,120993000,135742000,14749000,14749000,,-1648000,,,,5805000,415581000,400832000,279839000,3121000,,12065000,12459000,50849,EVK
2016-12-31,,,10261000,-612000,6764000,111440000,121160000,9720000,9720000,,-1997000,,,,4077000,392666000,382946000,271506000,541000,,6184000,6764000,50849,EVK
2019-12-31,56120000,,-13088000,,-8500000,172953000,223040000,-6033000,-6033000,,-5073000,,,,-4588000,288515000,294548000,65475000,-7055000,,-8500000,-8500000,50850,SAIL
2018-12-31,43154000,,4760000,,3670000,140183000,194250000,10913000,10913000,,-2459000,,,,1090000,248920000,238007000,54670000,-6153000,,3670000,3641000,50850,SAIL
2017-12-31,33331000,,-5299000,,-7592000,98192000,141466000,9943000,9943000,,-13081000,,,,2293000,186056000,176113000,44590000,-15242000,,-7592000,-28721000,50850,SAIL
2016-12-31,24358000,,-5158000,,-3173000,68287000,95374000,2729000,2729000,,-7277000,,,,-1985000,132412000,129683000,37038000,-7887000,,-3173000,-26791000,50850,SAIL
2019-12-31,,,451400000,,311000000,1921300000,2470900000,581100000,581100000,-31500000,-153000000,,,,140400000,4877100000,4296000000,2406200000,-129700000,,311000000,311000000,50854,HLF
2018-12-31,,,464200000,,296600000,1955200000,2608500000,683100000,683100000,-29800000,-181000000,,,,167600000,4891800000,4208700000,2283300000,-276200000,,296600000,296600000,50854,HLF
2017-12-31,,,471200000,,213900000,1758600000,2324900000,617100000,617100000,-50800000,-160800000,,,,257300000,4427700000,3810600000,2102800000,-145900000,,213900000,213900000,50854,HLF
2016-12-31,,,364700000,,260000000,1966900000,2361200000,428400000,428400000,-34100000,-99300000,,,,104700000,4488400000,4060000000,2127200000,-63700000,,260000000,260000000,50854,HLF
2019-12-31,,,31113000,,30335000,32728000,570385000,126829000,126829000,120943000,-134880000,,,,778000,678404000,551575000,108019000,-95716000,,30335000,30335000,50855,OPINI
2018-12-31,,,-27489000,,-21884000,24922000,350427000,73407000,73407000,89610000,-89865000,,,,117000,426560000,353153000,76133000,-100896000,5722000.0,-27606000,-22255000,50855,OPINI
2017-12-31,,,-9638000,20496000.0,12090000,18847000,257592000,63808000,63808000,65349000,-65406000,,,,101000,316532000,252724000,58940000,-73446000,21829000.0,-9739000,11815000,50855,OPINI
2016-12-31,,,23066000,20496000.0,57843000,14897000,210208000,67868000,67868000,54290000,-45060000,,,,101000,258180000,190312000,47972000,-44802000,34878000.0,22965000,57843000,50855,OPINI
2019-12-31,,,156260000,683364000,141039000,43206000,619392000,246893000,246893000,,-127114000,,,,0,1143378000,896485000,523986000,-90633000,,156260000,85745000,50856,AMH
2018-12-31,,,112438000,721777000,108273000,36575000,580152000,224892000,224892000,,-122900000,,,,0,1072855000,847963000,492703000,-112454000,,112438000,23387000,50856,AMH
2017-12-31,,,76492000,726195000,80999000,34732000,530990000,198968000,198968000,,-112620000,,,,0,960399000,761431000,429409000,-122476000,,76492000,-22135000,50856,AMH
2016-12-31,,,10446000,744684000,6695000,33068000,485212000,153467000,153467000,,-130847000,,,,0,878889000,725422000,393677000,-143021000,,10446000,-33542000,50856,AMH
2020-06-30,12347000,,106163000,,81147000,212440000,364116000,139329000,139329000,,-25761000,,,,25016000,531515000,392186000,167399000,-33166000,,81147000,-16004000,50859,SLQT
2019-06-30,8326000,,94613000,,72579000,124034000,233048000,100688000,100688000,,-1660000,,,,22034000,337469000,236781000,104421000,-6075000,,72579000,59918000,50859,SLQT
2018-06-30,9913000,,41518000,,34899000,93579000,150348000,46856000,46856000,,-929000,,,,6619000,233688000,186832000,83340000,-5338000,,34899000,22238000,50859,SLQT
2019-12-31,15336000,,-6663000,,-6832000,15592000,23093000,-7835000,-7835000,,,,,,169000,33010000,40845000,9917000,1172000,,-6832000,-6832000,50862,RDCM
2018-12-31,13855000,,-2352000,,-2415000,14817000,25184000,-3488000,-3488000,,,,,,63000,34050000,37538000,8866000,1136000,,-2415000,-2415000,50862,RDCM
2017-12-31,8963000,,2984000,,2901000,15187000,26745000,2595000,2595000,,,,,,83000,37233000,34638000,10488000,389000,,2901000,2901000,50862,RDCM
2016-12-31,5331000,,1939000,,1915000,14074000,20528000,1123000,1123000,,,,,,24000,29510000,28387000,8982000,816000,,1915000,1915000,50862,RDCM
2020-03-31,83295000,,4259000,,7498000,166124000,308278000,19238000,19238000,,-1955000,,,,-3239000,540239000,521001000,231961000,-14979000,,7498000,7498000,50863,NXGN
2019-03-31,80994000,,29288000,,24494000,169579000,310966000,27559000,27559000,,-2814000,,,,4794000,529173000,501614000,218207000,1729000,,24494000,24494000,50863,NXGN
2018-03-31,81259000,,-410000,,2420000,193226000,311574000,7189000,7189000,,-3323000,,,,-2830000,531019000,523830000,219445000,-7599000,,2420000,2420000,50863,NXGN
2017-03-31,78341000,,23609000,,18241000,159376000,304270000,38338000,38338000,,-3156000,,,,5368000,509624000,471286000,205354000,-14729000,,18241000,18241000,50863,NXGN
2019-12-31,,,66321000,74581000,77362000,194611000,832384000,138816000,138816000,231149000,-121544000,,,,-25282000,1457603000,1318787000,625219000,-72495000,,91603000,77362000,50866,PNM
2018-12-31,,,108529000,75741000,85642000,193187000,810976000,231330000,231330000,145271000,-127772000,,,,7775000,1436613000,1205283000,625637000,-122801000,,100754000,85642000,50866,PNM
2017-12-31,,,225231000,77724000,79874000,185968000,828498000,306862000,306862000,103726000,-128153000,,,,130340000,1445003000,1138141000,616505000,-81631000,,94891000,79874000,50866,PNM
2016-12-31,,,194646000,80449000,116849000,191474000,769941000,278025000,278025000,91332000,-129161000,,,,63278000,1362951000,1084926000,593010000,-83379000,,131368000,116849000,50866,PNM
2019-12-31,340582,,-2297733,,-2297733,4826192,3913917,-2083244,-2083244,,-217534,,,,0,6347160,8430404,2433243,-214489,,-2297733,-2080199,50867,TOMZ
2018-12-31,916003,,-3230462,,-3230462,4559802,3117498,-3070220,-3070220,,-259969,,,,0,5584612,8654832,2467114,-160242,,-3230462,-2970493,50867,TOMZ
2017-12-31,454089,,-3639815,,-3639815,5132924,3065895,-3444080,-3444080,-319388.0,-197535,,,,0,4993668,8437748,1927773,-195735,,-3639815,-3442280,50867,TOMZ
2016-12-31,184259,,-3157259,,-3157259,5716743,3732932,-3369150,-3369150,-319388.0,-197535,,,,0,6343432,9712582,2610500,211891,,-3157259,-3157259,50867,TOMZ
2020-09-30,,,159967000,,113245000,1334109000,1715594000,274685000,274685000,,-98793000,,,,46722000,3514330000,3239645000,1798736000,-114718000,,113245000,113245000,50870,SBH
2019-09-30,,,362164000,,271623000,1345051000,1910542000,457791000,457791000,,-96309000,,,,90541000,3876411000,3418620000,1965869000,-95627000,,271623000,271623000,50870,SBH
2018-09-30,,,328427000,,258047000,1375409000,1944413000,460204000,460204000,,-98162000,,,,70380000,3932565000,3472361000,1988152000,-131777000,,258047000,258047000,50870,SBH
2017-09-30,,,345698000,,215076000,1348519000,1964895000,504076000,504076000,,-132899000,,,,130622000,3938317000,3434241000,1973422000,-158378000,,215076000,215076000,50870,SBH
2020-09-30,,,36995000,,27464000,52246000,130875000,-3667000,-3667000,,-44120000,,,,9531000,545070000,548737000,414195000,40662000,,27464000,27464000,50871,MESA
2019-09-30,,,63286000,,47580000,50527000,259198000,130677000,130677000,,-55717000,,,,15706000,723357000,592680000,464159000,-67391000,,47580000,47580000,50871,MESA
2018-09-30,,,15829000,,33255000,53647000,206435000,87757000,87757000,,-56867000,,,,-17426000,681595000,593838000,475160000,-71928000,,33255000,33255000,50871,MESA
2017-09-30,,,53702000,,32828000,38996000,200338000,100294000,100294000,,-46110000,,,,20874000,643576000,543282000,443238000,-46592000,,32828000,32828000,50871,MESA
2019-12-31,,,42339194,,42339194,2701696,5275127,2573431,2573431,,-691899,,,,0,5275127,2701696,0,39765763,,42339194,42339194,50872,LGI
2018-12-31,,,-18091400,,-18091400,2685616,5733177,3047561,3047561,,-640081,,,,0,5733177,2685616,0,-21138961,,-18091400,-18091400,50872,LGI
2017-12-31,,,48777642,,48777642,2500290,4936036,2435746,2435746,,-452321,,,,0,4936036,2500290,0,46341896,,48777642,48777642,50872,LGI
2016-12-31,,,13527748,,13527748,2176522,6404571,4228049,4228049,,-319659,,,,0,6404571,2176522,0,9299699,,13527748,13527748,50872,LGI
2019-12-31,,,9971260,,9971260,32170256,31301813,-868443,-868443,,-1393483,,,,0,75146546,76014989,43844733,10839703,,9971260,9971260,50873,CELH
2018-12-31,,,-11206648,,-11206648,30701122,21060378,-9640744,-9640744,,-188856,,,,0,52603986,62244730,31543608,-1565904,,-11206648,-11419781,50873,CELH
2017-12-31,,,-8240583,,-8240583,23510644,15430677,-8079967,-8079967,,-160616,,,,0,36164064,44244031,20733387,-160616,,-8240583,-8606578,50873,CELH
2016-12-31,,,-3067615,,-3067615,12574794,9729834,-2844960,-2844960,,-228750,,,,0,22760987,25605947,13031153,-222655,,-3067615,-3433769,50873,CELH
2019-12-31,45190000,,-4448000,,-4552000,144280000,193495000,4025000,4025000,,-13794000,,,,104000,328006000,323981000,134511000,-8473000,,-4552000,-4552000,50874,FIVN
2018-12-31,34172000,,79000,,-221000,112449000,153630000,7009000,7009000,,-10245000,,,,300000,257664000,250655000,104034000,-6930000,,-221000,-221000,50874,FIVN
2017-12-31,27120000,,-8701000,,-8969000,94021000,117121000,-4020000,-4020000,,-3471000,,,,268000,200225000,204245000,83104000,-4681000,,-8969000,-8969000,50874,FIVN
2016-12-31,23878000,,-11806000,,-11860000,78220000,95156000,-6542000,-6542000,-400000.0,-4226000,,,,54000,162090000,168632000,66934000,-5264000,,-11860000,-11860000,50874,FIVN
2019-12-31,166089000,,-185694000,,-155176000,506542000,731558000,18552000,18552000,,-15091000,,,,-30153000,1084170000,1065618000,352612000,-204246000,365000,-155541000,-155176000,50875,LIVN
2018-12-31,146724000,,-248091000,,-189399000,462167000,738869000,92784000,92784000,,-9825000,,,,-69629000,1106961000,1014177000,368092000,-340875000,-10937000,-178462000,-189399000,50875,LIVN
2017-12-31,109516000,,104419000,,-25089000,380100000,651831000,129071000,129071000,,-7797000,,,,49954000,1012277000,883206000,360446000,-24652000,-79554000,54465000,-25089000,50875,LIVN
2016-12-31,82078000,,6987000,,-62789000,355164000,584679000,116402000,116402000,,-10616000,,,,5113000,964858000,848456000,380179000,-109415000,-64663000,1874000,-62789000,50875,LIVN
2020-12-31,,,55825000,77849000,8874000,14859000,70132000,55273000,55273000,,,,,,4287000,138619000,83346000,68487000,552000,,51538000,8874000,50876,PZN
2019-12-31,,,51271000,76766000,8462000,16973000,85356000,68383000,68383000,,-48000.0,,,,5795000,150746000,82363000,65390000,-17112000,,45476000,8462000,50876,PZN
2018-12-31,,,76097000,66006000,13794000,13405000,92160000,78755000,78755000,,-77000.0,,,,7778000,153579000,74824000,61419000,-2658000,,68319000,13794000,50876,PZN
2017-12-31,,,94662000,66985000,6908000,13337000,82391000,69054000,69054000,,-29000.0,,,,34512000,141295000,72241000,58904000,25608000,,60150000,6907000,50876,PZN
2019-12-31,,,10282000000,4768000000,-4396000000,14746000000,127586000000,19511000000,19511000000,28273000000,-10935000000,,,,14170000000,237024000000,217513000000,109438000000,-9229000000,,-3888000000,-4396000000,50882,TEO
2018-12-31,,,4150000000,4964000000,8145000000,17356000000,145206000000,37735000000,37735000000,33891000000,-6695000000,,,,-4366000000,258518000000,220783000000,113312000000,-33585000000,,8516000000,8145000000,50882,TEO
2017-12-31,,,23653000000,846000000,14969000000,5678000000,56628000000,22565000000,22565000000,11917000000,-1654000000,,,,8486000000,102531000000,79966000000,45903000000,1088000000,,15167000000,14969000000,50882,TEO
2016-12-31,,,16561000000,426053160,10457000000,3464000000,31870000000,12664000000,12664000000,7118000000,-1813000000,,,,6015000000,60405000000,47741000000,28535000000,3897000000,,10546000000,10457000000,50882,TEO
2020-12-31,,,6771000000,1455000000,5326000000,7510000000,10580000000,7952000000,7952000000,-4882000000,-1181000000,,,,1195000000,77121000000,69169000000,66541000000,-1181000000,,5576000000,5700000000,50883,MFC
2019-12-31,,,6220000000,1211000000,5269000000,7686000000,14345000000,7539000000,7539000000,-880000000,-1319000000,,,,718000000,77822000000,70283000000,63477000000,-1319000000,,5502000000,5430000000,50883,MFC
2018-12-31,,,5519000000,1093000000,4673000000,7957000000,5424000000,6794000000,6794000000,-9327000000,-1275000000,,,,632000000,37264000000,30470000000,31840000000,-1275000000,,4887000000,4632000000,50883,MFC
2017-12-31,,,2501000000,929000000,2068000000,7233000000,13502000000,3640000000,3640000000,2629000000,-1139000000,,,,239000000,56720000000,53080000000,43218000000,-1139000000,,2262000000,1945000000,50883,MFC
2019-12-31,,,89734640,,89734640,6189098,15874695,9685597,9685597,,,,,,0,15874695,6189098,0,80049043,,89734640,89734640,50884,DIAX
2018-12-31,,,-33126067,,-33126067,6184823,15379479,9194656,9194656,,,,,,0,15379479,6184823,0,-42320723,,-33126067,-33126067,50884,DIAX
2017-12-31,,,128649546,,128649546,5890147,15201955,9311808,9311808,,,,,,0,15201955,5890147,0,119337738,,128649546,128649546,50884,DIAX
2016-12-31,,,65249235,,65249235,5320859,15109432,9788573,9788573,,,,,,0,15109432,5320859,0,55460662,,65249235,65249235,50884,DIAX
2019-12-31,,,-240727000,,-231808000,122932000,214765000,-31486000,-31486000,,-17898000,,,,-8919000,1017354000,1048840000,802589000,-209241000,,-231808000,-231808000,50885,OIS
2018-12-31,,,-21732000,,-19105000,136770000,253620000,-6176000,-6176000,-504000.0,-19314000,,,,-2627000,1088133000,1094309000,834513000,-15556000,,-19105000,-19105000,50885,OIS
2017-12-31,,,-77412000,,-84850000,114816000,149872000,-73872000,-73872000,1261000.0,-4674000,,,,7438000,670627000,744499000,520755000,-3540000,,-84850000,-84850000,50885,OIS
2016-12-31,,,-73325000,,-46390000,124033000,167674000,-73983000,-73983000,-1096000.0,-5343000,,,,-26939000,694444000,768427000,526770000,658000,-4000.0,-46386000,-46390000,50885,OIS
2019-12-31,106782600,,-106520477,,-103014058,59336147,59670105,-106448642,-106448642,,-1728000,,,,-3506419,71755303,178203945,12085198,-71835,,-103014058,-103014058,50888,MOR
2018-12-31,87208017,,-60476795,,-56172121,28310241,74645876,-40872382,-40872382,,-179000,,,,-4304674,76442505,117314887,1796629,-19604413,,-56172121,-56172121,50888,MOR
2017-12-31,103450097,,-68790104,,-69826469,20533616,66790840,-57192873,-57192873,,-374000,,,,1036365,66790840,123983713,0,-11597231,,-69826469,-69826469,50888,MOR
2016-12-31,83821788,,-59864151,,-60382776,15876179,49743515,-49954452,-49954452,,-20000,,,,518625,49743515,99697967,0,-9909699,,-60382776,-60382776,50888,MOR
2020-10-31,,,650723,,650723,1609895,13882291,12272396,12272396,,-1222665,,,,0,13882291,1609895,0,-11621673,,650723,650723,50890,JHI
2019-10-31,,,22553708,,22553708,1597247,14538703,12941456,12941456,,-2583122,,,,0,14538703,1597247,0,9612252,,22553708,22553708,50890,JHI
2018-10-31,,,-5022366,,-5022366,1736280,14417542,12681262,12681262,,-2164963,,,,0,14417542,1736280,0,-17703628,,-5022366,-5022366,50890,JHI
2017-10-31,,,17407591,,17407591,1693423,14208180,12514757,12514757,,-1396480,,,,0,14208180,1693423,0,4892834,,17407591,17407591,50890,JHI
2020-12-31,,,63910000,,48132000,79180000,233680000,80359000,80359000,,-14579000,,,,15778000,1391083000,1310724000,1157403000,-16449000,,48132000,48132000,50891,ULH
2019-12-31,,,50186000,,37586000,98319000,263264000,90180000,90180000,,-17085000,,,,12600000,1511998000,1421818000,1248734000,-39994000,,37586000,37586000,50891,ULH
2018-12-31,,,69389000,,52178000,88879000,237598000,94294000,94294000,,-14669000,,,,17211000,1461708000,1367414000,1224110000,-24905000,,52178000,52178000,50891,ULH
2017-12-31,,,17141000,,28153000,91012000,178821000,40814000,40814000,,-9538000,,,,-11012000,1216665000,1175851000,1037844000,-23673000,,28153000,28153000,50891,ULH
2019-12-31,,,47922000,,47922000,1085000,49007000,47922000,47922000,,,,,,0,49007000,1085000,0,0,,47922000,47922000,50892,BPT
2018-12-31,,,113282000,,113282000,1121000,114403000,113282000,113282000,,,,,,0,114403000,1121000,0,0,,113282000,113282000,50892,BPT
2017-12-31,,,77039000,,77039000,1165000,78204000,77039000,77039000,,,,,,0,78204000,1165000,0,0,,77039000,77039000,50892,BPT
2016-12-31,,,43621000,,43621000,1298000,44919000,43621000,43621000,,,,,,0,44919000,1298000,0,0,,43621000,43621000,50892,BPT
2019-12-31,,,64196000,68375000,51723000,20793000,173592000,106466000,106466000,,-42082000,,,,0,231525000,125059000,57933000,-42270000,,64196000,36253000,50893,BFS
2018-12-31,,,63059000,69308000,50554000,18459000,171641000,107321000,107321000,-272000.0,-45043000,,,,0,227219000,119898000,55578000,-44262000,,63059000,35964000,50893,BFS
2017-12-31,,,60668000,58698000,48257000,18176000,171613000,107743000,107743000,-80000.0,-47155000,,,,0,226299000,118556000,54686000,-47005000,,60668000,35882000,50893,BFS
2016-12-31,,,56720000,54744000,45279000,17496000,160258000,101396000,101396000,-3051000.0,-45689000,,,,0,214019000,112623000,53761000,-44676000,,56720000,32904000,50893,BFS
2019-12-31,3300000,,57800000,,50200000,40500000,114900000,70200000,70200000,900000,,,,,7600000,388400000,318200000,273500000,-12400000,,50200000,50200000,50894,LTHM
2018-12-31,3800000,,153700000,,126600000,36600000,206300000,165700000,165700000,200000,-300000.0,,,,27100000,442500000,276800000,236200000,-12000000,,126600000,126600000,50894,LTHM
2017-12-31,3100000,,69100000,,41500000,66900000,147800000,77400000,77400000,400000,-300000.0,,,,27600000,347400000,270000000,199600000,-8300000,,41500000,41500000,50894,LTHM
2016-12-31,3100000,,54500000,,47100000,28800000,88300000,55400000,55400000,1000000,-900000.0,,,,7400000,264100000,208700000,175800000,-1500000,,47100000,47100000,50894,LTHM
2019-12-31,,,782600000,-26600000,669900000,55600000,2432800000,1150000000,1150000000,365500000,-374000000,,,,97000000,5147800000,3997800000,2715000000,-367400000,,685600000,669900000,50895,EVRG
2018-12-31,,,605000000,-37500000,535800000,47800000,1920800000,985100000,985100000,269100000,-279600000,,,,59000000,4275900000,3290800000,2355100000,-380100000,,546000000,535800000,50895,EVRG
2017-12-31,,,487700000,-47700000,323900000,20000000,1218100000,658800000,658800000,167600000,-171000000,,,,151200000,2571000000,1912200000,1352900000,-181900000,,336500000,323900000,50895,EVRG
2016-12-31,,,545700000,27315000,346600000,20600000,1232600000,681800000,681800000,191700000,-161700000,,,,184500000,2562100000,1880300000,1329500000,-146300000,,361200000,346600000,50895,EVRG
2019-12-31,,,172596000,,171917000,150199000,580772000,237333000,237333000,,-61191000,,,,679000,1266597000,1029264000,685825000,-64737000,,171917000,171917000,50896,APLE
2018-12-31,,,206673000,,206086000,130128000,574451000,260841000,260841000,,-51185000,,,,587000,1270555000,1009714000,696104000,-54168000,,206086000,206086000,50896,APLE
2017-12-31,,,183339000,,182492000,127218000,561393000,257676000,257676000,,-47343000,,,,847000,1238622000,980946000,677229000,-74337000,,182492000,182492000,50896,APLE
2016-12-31,,,145083000,,144652000,99695000,473580000,225722000,225722000,,-40026000,,,,431000,1041025000,815303000,567445000,-80639000,,144652000,144652000,50896,APLE
2020-04-30,5077000,,-11768000,,-10026000,11593000,5748000,-10922000,-10922000,,-107000,,,,-1742000,41507000,52429000,35759000,-846000,,-10026000,-10026000,50900,FEIM
2019-04-30,6506000,,-2473000,,-2529000,12100000,15789000,-2817000,-2817000,,-83000,,,,56000,49509000,52326000,33720000,344000,,-2529000,-2529000,50900,FEIM
2018-04-30,6950000,,-11275000,,-23777000,10608000,5163000,-12395000,-12395000,,-79000,,,,11176000,39407000,51802000,34244000,1120000,-1326000.0,-22451000,-23777000,50900,FEIM
2017-04-30,6876000,,-7039000,,-4821000,11898000,11249000,-7525000,-7525000,,-150000,,,,-2115000,50351000,57876000,39102000,486000,103000.0,-4924000,-4821000,50900,FEIM
2019-12-31,9240000,,9924000,,9924000,48797000,70832000,12795000,12795000,,-3948000,,,,0,164892000,152097000,94060000,-2871000,,9924000,8579000,50902,DSP
2018-12-31,9585000,,-25535000,,-25535000,45092000,34011000,-20666000,-20666000,,-4362000,,,,0,108355000,129021000,74344000,-4869000,,-25535000,-25535000,50902,DSP
2020-12-31,,,5257000,50000,4159000,13593000,22349000,0,5257000,3499000,,,,,1093000,22349000,17092000,0,0,,4164000,4159000,50903,ESBK
2019-12-31,,,4180000,50000,3486000,13250000,20457000,0,4180000,3027000,,,,,689000,20457000,16277000,0,0,,3491000,3486000,50903,ESBK
2018-12-31,,,5232000,51000,4239000,12353000,20721000,0,5232000,3136000,,,,,988000,20721000,15489000,0,0,,4244000,4239000,50903,ESBK
2017-12-31,,,5206000,52000,4851000,12564000,21090000,0,5206000,3320000,,,,,350000,21090000,15884000,0,0,,4856000,4006000,50903,ESBK
2019-12-31,17261000,,-32557000,,-32557000,22612000,0,-39873000,-39873000,,,,,,0,0,39873000,0,7316000,,-32557000,-32557000,50904,BXRX
2018-12-31,35583000,,-73667000,,-73667000,29453000,0,-65036000,-65036000,,,,,,0,0,65036000,0,-8631000,,-73667000,-73667000,50904,BXRX
2017-12-31,28635000,,-61084000,,-61084000,19626000,0,-48261000,-48261000,,,,,,0,0,48261000,0,-12823000,,-61084000,-61084000,50904,BXRX
2020-03-31,,,-122629497,,-122629497,11168969,69374803,58205834,58205834,,-243960,,,,0,69374803,11168969,0,-180835331,,-122629497,-122629497,50905,AWF
2019-03-31,,,20138568,,20138568,11209602,76277221,65067619,65067619,,-822673,,,,0,76277221,11209602,0,-44929051,,20138568,20138568,50905,AWF
2018-03-31,,,45570544,,45570544,11854300,84421121,72566821,72566821,,1115498,,,,0,84421121,11854300,0,-26996277,,45570544,45570544,50905,AWF
2017-03-31,,,187565744,,187565744,11345132,82598471,71253339,71253339,,8196225,,,,0,82598471,11345132,0,116312405,,187565744,187565744,50905,AWF
2019-12-31,,,-1278000,5402000,-18149000,151605000,489068000,113976000,113976000,-2539000,-147383000,,,,11766000,3299761000,3185785000,2810693000,-115254000,,-13044000,-18149000,50906,ZIM
2018-12-31,,,-105721000,6282000,-125653000,143920000,248251000,6403000,6403000,-2224000,-100584000,,,,14132000,3247864000,3241461000,2999613000,-112124000,,-119853000,-125653000,50906,ZIM
2017-12-31,,,25596000,6509000,6235000,147560000,378144000,136273000,136273000,-2857000,-102175000,,,,14233000,2978291000,2842018000,2600147000,-110677000,,11363000,6235000,50906,ZIM
2016-12-31,,,-145135000,3125000,-168290000,142542000,145170000,-81005000,-81005000,-2656000,-97824000,,,,18366000,2539296000,2620301000,2394126000,-64130000,,-163501000,-168290000,50906,ZIM
2020-10-31,,,-65967000,,-60990000,109087000,137303000,28216000,28216000,,-34408000,,,,-4977000,304301000,276085000,166998000,-94183000,,-60990000,-62920000,50908,BBCP
2019-10-31,,,-39982000,,-32487000,96850000,125422000,28572000,28572000,,-36524000,,,,-7495000,282961000,254389000,157539000,-68554000,,-32487000,-34236000,50908,BBCP
2018-10-31,,,18598000,,28382000,58262000,106347000,48085000,48085000,,-21425000,,,,-9784000,243223000,195138000,136876000,-29487000,,28382000,20589000,50908,BBCP
2017-10-31,,,4669937,,913279,44402463,89759100,36894190,36894190,,-22747848,,,,3756658,211210599,174316409,121451499,-32224253,,913279,-898558,50908,BBCP
2019-12-31,,,-6960568,6975459,-5230465,5860144,4147931,-1712213,-1712213,,-372902,,,,431388,24257953,25970166,20110022,-5248355,-661472,-7391956,-5230465,50912,AEI
2018-12-31,,,-6292601,9155051,-4989870,6567638,4847239,-1720399,-1720399,,-509208,,,,0,20380940,22101339,15533701,-4572202,-1197967,-6292601,-4989870,50912,AEI
2017-12-31,350462.0,,-7453487,11723524,-4308511,7780596,3229491,-4901567,-4901567,,-509208,,,,-588659,10757093,15658660,7527602,-2551920,-221018,-6864828,-4308511,50912,AEI
2016-12-31,386816.0,,-5753042,8227494,-5751261,4280021,208820,-5250025,-5250025,792008.0,-38289,,,,585708,1233061,6483086,1024241,-503017,587489,-6338750,-5751261,50912,AEI
2019-12-31,,,155158000,,117216000,32811000,5409000,-29277000,-29277000,,-25166000,,,,37942000,14859000,44136000,9450000,184435000,,117216000,117216000,50913,LBRDA
2018-12-31,,,91877000,,69953000,23497000,14262000,-12014000,-12014000,,-23302000,,,,21924000,22256000,34270000,7994000,103891000,,69953000,69953000,50913,LBRDA
2017-12-31,,,2450600000,,2033667000,24065000,2357000,-25478000,-25478000,,-19570000,,,,416933000,13092000,38570000,10735000,2476078000,,2033667000,2033667000,50913,LBRDA
2016-12-31,10240000.0,,1475672000,,917303000,34703000,27788000,-21160000,-21160000,,-14956000,,,,558369000,30586000,51746000,2798000,1496832000,,917303000,917303000,50913,LBRDA
2019-12-31,47085000,,83499000,,66887000,348703000,503463000,105488000,105488000,,,,,,16612000,506201000,400713000,2738000,-21989000,,66887000,66887000,50915,EHTH
2018-12-31,31970000,,3306000,,241000,199314000,250167000,16792000,16792000,,,,,,3065000,251395000,234603000,1228000,-13486000,,241000,241000,50915,EHTH
2017-12-31,32889000,,-8270000,,25426000,165026000,190124000,-8831000,-8831000,,,,,,-33696000,190706000,199537000,582000,561000,,25426000,25426000,50915,EHTH
2016-12-31,32749000,,3972000,,304000,156147000,192462000,2526000,2526000,,,,,,3668000,193324000,190798000,862000,1446000,,304000,304000,50915,EHTH
2019-12-31,9490000,,-8879000,,-8879000,11279000,861000,-19908000,-19908000,,-4746000,,,,0,1580000,21488000,719000,11029000,,-8879000,-8879000,50917,DCTH
2018-12-31,19650000,,-19222000,,-19222000,9819000,2398000,-27071000,-27071000,,-7959000,,,,0,3407000,30478000,1009000,7849000,,-19222000,-19222000,50917,DCTH
2017-12-31,10495000,,-45117000,,-45117000,9684000,2014000,-18165000,-18165000,,-21703000,,,,0,2715000,20880000,701000,-26952000,,-45117000,-45644000,50917,DCTH
2016-12-31,8448000,,-17971000,,-17971000,9434000,1442000,-16440000,-16440000,,-14328000,,,,0,1992000,18432000,550000,-1531000,,-17971000,-17971000,50917,DCTH
2020-02-01,,,78593000,3180000,62819000,1049113000,1193160000,143960000,143960000,87000,-33123000,,,,16511000,2921562000,2777602000,1728402000,-65367000,,62082000,60831000,50918,CAL
2019-02-02,,,-5754000,1382000,-5441000,1025968000,1168744000,142742000,142742000,34000,-18277000,,,,-273000,2834846000,2692104000,1666102000,-148496000,,-5481000,-5441000,50918,CAL
2018-02-03,,,122706000,1473000,87200000,1019928000,1168649000,148721000,148721000,34000,-17325000,,,,35475000,2785584000,2636863000,1616935000,-25858000,,87231000,84816000,50918,CAL
2017-01-28,,,97254000,1369000,65658000,926016000,1064791000,138775000,138775000,34000,-13731000,,,,31168000,2579388000,2440613000,1514597000,-41521000,,66086000,63908000,50918,CAL
2019-12-31,3728000,,2191000,,1512000,15074000,20951000,2149000,2149000,,-165000,,,,679000,44860000,42711000,23909000,42000,,1512000,1512000,50919,EDAP
2018-12-31,4088000,,20000,,-338000,14144000,16898000,-1334000,-1334000,,-111000,,,,358000,39163000,40497000,22265000,1354000,,-338000,-338000,50919,EDAP
2017-12-31,3881000,,-293000,,-681000,12954000,14748000,-2087000,-2087000,,-44000,,,,388000,35686000,37773000,20938000,1794000,,-681000,-681000,50919,EDAP
2016-12-31,3868000,,4444000,,3842000,12152000,16379000,359000,359000,,-57000,,,,602000,35579000,35220000,19200000,4085000,,3842000,3842000,50919,EDAP
2019-12-31,38781000,,-78173000,,-78173000,12862000,0,-50741000,-50741000,-1213000,-70000,,,,0,0,50741000,0,-27432000,,-78173000,-78173000,50921,SVRA
2018-12-31,37173000,,-68573000,,-61516000,10388000,0,-46633000,-46633000,-1454000,-70000,,,,-7057000,0,46633000,0,-21940000,,-61516000,-61516000,50921,SVRA
2017-12-31,18512000,,-33431000,,-29797000,6641000,-18512000,-25516000,-25516000,-1454000,-1161000,,,,-3634000,0,25516000,18512000,-7915000,,-29797000,-30779000,50921,SVRA
2016-12-31,8182000,,-11280000,,-10923000,2820000,400000,-10948000,-10948000,-1454000,-452000,,,,-357000,400000,11348000,8182000,-332000,,-10923000,-11017000,50921,SVRA
2019-12-31,86473000,,-59618000,,-70538000,140920000,219990000,-28010000,-28010000,,-263000,,,,10920000,713513000,741523000,493523000,-31608000,,-70538000,-70538000,50922,SWIR
2018-12-31,93707000,,-23694000,,-24610000,150169000,264576000,-5129000,-5129000,,-156000,,,,916000,793602000,798731000,529026000,-18565000,,-24610000,-24610000,50922,SWIR
2017-12-31,82653000,,7717000,,4518000,118039000,234239000,13039000,13039000,,-159000,,,,3199000,690727000,677688000,456488000,-5322000,,4518000,4518000,50922,SWIR
2016-12-31,72675000,,20017000,,15646000,104826000,204246000,9468000,9468000,,-71000,,,,4371000,615015000,605547000,410769000,10549000,,15646000,15646000,50922,SWIR
2020-07-31,,,633000,,-5284000,103261000,162959000,32443000,32443000,,-33969000,,,,5917000,782813000,750370000,619854000,-31810000,,-5284000,-7413000,50923,STCN
2019-07-31,,,-62057000,,-66727000,144078000,149730000,-24794000,-24794000,,-41951000,,,,4670000,819830000,844624000,670100000,-37263000,,-66727000,-68856000,50923,STCN
2018-07-31,,,-34487000,,36715000,100472000,108470000,-12287000,-12287000,,-29884000,,,,-71202000,645258000,657545000,536788000,-22200000,,36715000,35380000,50923,STCN
2017-07-31,,,-23131000,,-25827000,54159000,36365000,-17794000,-17794000,,-8247000,,,,2696000,436620000,454414000,400255000,-5337000,,-25827000,-25827000,50923,STCN
2019-12-31,,,-3805867,269541,-3805102,3307195,-1530775,-5344453,-5344453,-244164,-879530,,,,0,179632,5524085,1710407,1538586,,-3805867,-3805102,50925,LODE
2018-12-31,,,-9480753,269541,-9480753,3403833,-2780017,-7400432,-7400432,258507,-1410389,,,,0,150289,7550721,2930306,-2080321,,-9480753,-9480753,50925,LODE
2017-12-31,,,-10576178,269541,-10576178,2595331,-4364572,-8877966,-8877966,787496,-1710390,,,,0,104329,8982295,4468901,-1698212,,-10576178,-10576178,50925,LODE
2016-12-31,,,-12964704,269541,-12964704,3518071,-744006,-10213344,-10213344,1389362,-753670,,,,0,5070217,15283561,5814223,-2751360,,-12964704,-12964704,50925,LODE
2019-12-31,7000000,,786000000,20000000,4438000000,827000000,2518000000,1311000000,1311000000,,-413000000,,,,-3334000000,9821000000,8510000000,7303000000,-525000000,321000000,4120000000,4438000000,50926,NRG
2018-12-31,11000000,,467000000,19000000,268000000,799000000,2370000000,1139000000,1139000000,,-483000000,,,,7000000,9478000000,8339000000,7108000000,-672000000,-192000000,460000000,268000000,50926,NRG
2017-12-31,22000000,,-1389000000,2392000000,-2153000000,836000000,2188000000,821000000,821000000,-87000000.0,-557000000,,,,-44000000,9074000000,8253000000,6886000000,-2210000000,-992000000,-1345000000,-2153000000,50926,NRG
2016-12-31,48000000,,-931000000,2451000000,-774000000,1032000000,2239000000,596000000,596000000,-193000000.0,-583000000,,,,25000000,8915000000,8319000000,6676000000,-1527000000,65000000,-956000000,-701000000,50926,NRG
2019-12-31,,,-8471000,281880000,-3351000,416355000,984690000,267697000,267697000,78427000,-176146000,,,,-1734000,1856534000,1588837000,871844000,-276168000,,-6737000,-3351000,50927,RRR
2018-12-31,,,243355000,297375000,157541000,390492000,961202000,315954000,315954000,74501000,-130684000,,,,23875000,1681030000,1365076000,719828000,-72599000,,219480000,157541000,50927,RRR
2017-12-31,,,198319000,252981000,35423000,380930000,951956000,323380000,323380000,69429000,-117330000,,,,134786000,1642139000,1318759000,690183000,-125061000,,63533000,35423000,50927,RRR
2016-12-31,,,164207000,283604000,91952000,327358000,882648000,334996000,334996000,63626000,-140102000,,,,8243000,1475760000,1140764000,593112000,-170789000,,155964000,35419000,50927,RRR
2019-12-31,,,261609000,,219923000,301048000,617429000,271176000,271176000,,-4535000,,,,41686000,1938555000,1667379000,1321126000,-9567000,,219923000,219923000,50929,CHE
2018-12-31,,,239600000,,205544000,271209000,555004000,244932000,244932000,,-4990000,,,,34056000,1782648000,1537716000,1227644000,-5332000,,205544000,205544000,50929,CHE
2017-12-31,,,116917000,,98177000,271458000,516192000,209109000,209109000,-213000.0,-4272000,,,,18740000,1666724000,1457615000,1150532000,-92192000,,98177000,98177000,50929,CHE
2016-12-31,,,177054000,,108743000,238312000,461450000,188500000,188500000,-213000.0,-3715000,,,,68311000,1576881000,1388381000,1115431000,-11446000,,108743000,108743000,50929,CHE
2019-12-31,1049000,,-4221000,,-4221000,4234000,0,-5283000,-5283000,,,,,,0,0,5283000,0,1062000,,-4221000,-4221000,50931,FWP
2018-12-31,2748000,,-8926000,,-8722000,9082000,0,-11830000,-11830000,,,,,,-204000,0,11830000,0,2904000,,-8722000,-8722000,50931,FWP
2017-12-31,12588000,,1184488000,,917093000,18748000,-25000000,-56336000,-56336000,,,,,,267395000,0,56336000,25000000,1240824000,,917093000,917093000,50931,FWP
2016-12-31,41052000,,-54539000,,-33336000,14067000,0,-55119000,-55119000,,,,,,-21203000,0,55119000,0,580000,,-33336000,-33336000,50931,FWP
2020-12-31,,,45700000,,7900000,243300000,315600000,72300000,72300000,,-43600000,,,,37800000,3035500000,2963200000,2719900000,-26600000,,7900000,7900000,50933,TSE
2019-12-31,54600000.0,,104600000,,92000000,231600000,328900000,42700000,42700000,,-48400000,,,,12600000,3775800000,3733100000,3446900000,61900000,,92000000,92000000,50933,TSE
2018-12-31,56000000.0,,364300000,,292500000,200500000,528800000,272300000,272300000,,-52200000,,,,71800000,4622800000,4350500000,4094000000,92000000,,292500000,292500000,50933,TSE
2017-12-31,54300000.0,,411100000,,328300000,161900000,640300000,424100000,424100000,,-70100000,,,,82800000,4448100000,4024000000,3807800000,-13000000,,328300000,328300000,50933,TSE
2019-12-31,26534000,,-68839000,14117000,-68611000,8663000,0,-35197000,-35197000,,,,,,-20000,0,35197000,0,-33642000,,-68819000,-68611000,50937,TERN
2018-12-31,14554000,,-18085000,14325000,-17711000,3901000,0,-18455000,-18455000,,,,,,-67000,0,18455000,0,370000,,-18018000,-17711000,50937,TERN
2019-12-31,,,146769000,221511000,145794000,90245000,572872000,265658000,265658000,,-131620000,,,,18475000,1603456000,1337798000,1030584000,-118889000,,128294000,145794000,50938,RHP
2018-12-31,,,276415000,287433000,264670000,71847000,426635000,229043000,229043000,,-74961000,,,,11745000,1265923000,1036880000,839288000,47372000,,264670000,264670000,50938,RHP
2017-12-31,,,126945000,287433000,176100000,70296000,400605000,216424000,216424000,,-66051000,,,,-49155000,1180317000,963893000,779712000,-89479000,,176100000,176100000,50938,RHP
2016-12-31,,,162766000,287433000,159366000,65298000,386047000,210933000,210933000,,-63906000,,,,3400000,1146413000,935480000,760366000,-48167000,,159366000,159366000,50938,RHP
2020-12-31,,,-4789152,,-4990755,5749166,0,-5949166,-5949166,200000,,,,,201603,0,5949166,0,1160014,,-4990755,-4990755,50939,SBE
2019-12-31,,,1887954,,1169358,1402043,0,-1533935,-1533935,131892,,,,,718596,0,1533935,0,3421889,,1169358,1169358,50939,SBE
2020-12-31,,,8235000000,23000000,6833000000,-241000000,8681000000,8877000000,8877000000,45000000,-591000000,,,,1347000000,65398000000,56521000000,56717000000,-642000000,-55000000,6888000000,6833000000,50940,LMT
2019-12-31,,,7241000000,44000000,6230000000,608000000,8367000000,7698000000,7698000000,61000000,-653000000,,,,1011000000,59812000000,52114000000,51445000000,-457000000,-55000000,6230000000,6230000000,50940,LMT
2018-12-31,,,5838000000,55000000,5046000000,777000000,7370000000,6644000000,6644000000,-51000000,-668000000,,,,792000000,53762000000,47118000000,46392000000,-806000000,-55000000,5046000000,5046000000,50940,LMT
2017-12-31,,,5246000000,74000000,1963000000,746000000,6371000000,5593000000,5593000000,32000000,-651000000,,,,3356000000,49960000000,44367000000,43589000000,-347000000,73000000,1890000000,1963000000,50940,LMT
2020-09-27,,,1164400000,5700000,928300000,1679600000,5141100000,1599900000,1599900000,430300000,-437000000,,,,239700000,23518000000,21918100000,18376900000,-435500000,,924700000,928300000,50941,SBUX
2019-09-29,,,4466200000,1200000,3599200000,1824100000,7488100000,3915700000,3915700000,371000000,-331000000,,,,871600000,26508600000,22592900000,19020500000,550500000,,3594600000,3599200000,50941,SBUX
2018-09-30,,,5780000000,6300000,4518300000,1704600000,7316600000,3810100000,3810100000,554900000,-170300000,,,,1262000000,24719500000,20909400000,17402900000,1969900000,,4518000000,4518300000,50941,SBUX
2017-10-01,,,4317500000,6900000,2884700000,1408400000,6834600000,3896800000,3896800000,518000000,-92500000,,,,1432600000,22386800000,18490000000,15552200000,420700000,,2884900000,2884700000,50941,SBUX
2019-12-31,,,506600000,,383100000,35400000,2338300000,1288700000,1288700000,296800000,-386800000,,,,123500000,5208900000,3920200000,2870600000,-782100000,,383100000,328000000,50942,NI
2018-12-31,,,-230600000,,-50600000,31100000,1049400000,143900000,143900000,274800000,-335500000,,,,-180000000,5114500000,4970600000,4065100000,-374500000,,-50600000,-65600000,50942,NI
2017-12-31,,,443000000,,128500000,60100000,1803700000,916100000,916100000,257200000,-376900000,,,,314500000,4874600000,3958500000,3070900000,-473100000,,128500000,128500000,50942,NI
2016-12-31,,,513600000,,331500000,59900000,1708500000,857200000,857200000,244300000,-369100000,,,,182100000,4492500000,3635300000,2784000000,-343600000,,331500000,331500000,50942,NI
2020-12-31,,,369300000,93800000,212600000,105500000,463800000,358300000,358300000,,-10800000,,,,60800000,899600000,541300000,435800000,11000000,,308500000,212600000,50944,APAM
2019-12-31,,,269266000,48654000,156536000,113453000,399015000,285562000,285562000,,-11054000,,,,27809000,798952000,513390000,399937000,-16296000,,241457000,135382000,50944,APAM
2018-12-31,,,301788000,39792000,158309000,110528000,415469000,304941000,304941000,,-11223000,,,,47598000,828635000,523694000,413166000,-3153000,,254190000,138862000,50944,APAM
2017-12-31,,,571245000,60723000,49599000,106333000,392744000,286411000,286411000,,-11449000,,,,420508000,795624000,509213000,402880000,284834000,,150737000,33573000,50944,APAM
2020-04-30,15348000,,6798000,,6742000,41477000,63158000,6048000,6048000,,,,,,56000,115466000,109418000,52308000,750000,,6742000,6742000,50947,AMSWA
2019-04-30,13078000,,7641000,,6803000,37998000,56740000,5276000,5276000,,,,,,838000,108706000,103430000,51966000,2365000,,6803000,6803000,50947,AMSWA
2018-04-30,11877000,,15715000,,12053000,36715000,62703000,13531000,13531000,,,,,,3662000,112703000,99172000,50000000,2184000,,12053000,12053000,50947,AMSWA
2017-04-30,11889000,,21615000,,14621000,34506000,55202000,7766000,7766000,,,,,,6994000,106286000,98520000,51084000,13849000,,14621000,14621000,50947,AMSWA
2019-12-31,,,162607844,,162607844,6774581,14786735,8012154,8012154,,,,,,0,14786735,6774581,0,154595690,,162607844,162607844,50950,CII
2018-12-31,,,-40484300,,-40484300,6761373,14328372,7566999,7566999,,,,,,0,14328372,6761373,0,-48051299,,-40484300,-40484300,50950,CII
2017-12-31,,,137079845,,137079845,6597323,13241232,6643909,6643909,,,,,,0,13241232,6597323,0,130435936,,137079845,137079845,50950,CII
2016-12-31,,,49336382,,49336382,6055848,11697919,5642071,5642071,,,,,,0,11697919,6055848,0,43694311,,49336382,49336382,50950,CII
2020-09-30,,,1136100000,319000000,1023400000,1515800000,2595200000,1079400000,1079400000,,-103500000,,,,112900000,6329800000,5250400000,3734600000,56700000,,1023200000,1022400000,50952,ROK
2019-09-30,,,901000000,319000000,695800000,1528800000,2900100000,1371300000,1371300000,,-98200000,,,,205200000,6694800000,5323500000,3794700000,-470300000,,695800000,695100000,50952,ROK
2018-09-30,,,1330800000,319000000,535500000,1612900000,2884900000,1272000000,1272000000,-16300000.0,-73000000,,,,795300000,6666000000,5394000000,3781100000,58800000,,535500000,535000000,50952,ROK
2017-09-30,,,1037400000,319000000,825700000,1634700000,2667900000,1033200000,1033200000,-9100000.0,-76200000,,,,211700000,6311300000,5278100000,3643400000,4200000,,825700000,824800000,50952,ROK
2020-11-30,,,7037645,,7037645,2923886,8730134,5806248,5806248,,-395,,,,0,8730134,2923886,0,1231397,,7037645,6817969,50953,MNP
2019-11-30,,,16104891,,16104891,3344776,9380096,6035320,6035320,,-447,,,,0,9380096,3344776,0,10069571,,16104891,15632302,50953,MNP
2018-11-30,,,236911,,236911,3253727,9808786,6555059,6555059,,-71,,,,0,9808786,3253727,0,-6318148,,236911,-172191,50953,MNP
2017-11-30,,,12515641,,12515630,2968264,9805181,6836917,6836917,,-100,,,,11,9805181,2968264,0,5678724,,12515630,12267597,50953,MNP
2020-12-31,486000,,13840000,,10798000,11354000,25548000,13708000,13708000,,,,,,3042000,42178000,28470000,16630000,132000,,10798000,10798000,50955,UTMD
2019-12-31,483000,,17884000,,14727000,11335000,29466000,17648000,17648000,,,,,,3157000,46904000,29256000,17438000,236000,,14727000,14727000,50955,UTMD
2018-12-31,454000,,19459000,,18555000,7163000,26306000,18689000,18689000,7609000.0,,,,,904000,41998000,23309000,15692000,770000,,18555000,18555000,50955,UTMD
2017-12-31,447000,,19082000,,8505000,6908000,26395000,19040000,19040000,7609000.0,,,,,10577000,41414000,22374000,15019000,42000,,8505000,8505000,50955,UTMD
2021-01-02,,,71000000,379300000,79400000,766500000,1037100000,271600000,271600000,-1000000,-154300000,,,,-19300000,2793000000,2521400000,1755900000,-200600000,-300000,90300000,79400000,50956,GTES
2019-12-28,,,198800000,359700000,690100000,771500000,1147700000,367100000,367100000,9100000,-157800000,,,,-495900000,3087100000,2720000000,1939400000,-168300000,-600000,694700000,690100000,50956,GTES
2018-12-29,,,303500000,386300000,245300000,802700000,1333000000,516000000,516000000,14300000,-175900000,,,,31800000,3347600000,2831600000,2014600000,-212500000,-600000,271700000,245300000,50956,GTES
2017-12-30,,,109500000,413800000,151300000,777100000,1221400000,444600000,444600000,-300000,-234600000,,,,-72500000,3041700000,2597100000,1820300000,-335100000,700000,182000000,151300000,50956,GTES
2019-12-31,,,-319785000,-1237174000,-150457000,247097000,423029000,118564000,118564000,5361000,-4660000,,,,157133000,1166014000,1047450000,742985000,-438349000,,-476918000,-150457000,50957,TRQ
2018-12-31,,,253630000,-910135000,411198000,244156000,402774000,153543000,153543000,5075000,-47414000,,,,-140644000,1180022000,1026479000,777248000,100087000,,394274000,411198000,50957,TRQ
2017-12-31,,,-43085000,-893211000,181247000,230294000,175982000,-59164000,-59164000,4852000,-148498000,,,,-154013000,939780000,998944000,763798000,16079000,,110928000,181247000,50957,TRQ
2016-12-31,,,-3669000,-822892000,210605000,318816000,341525000,18629000,18629000,4080000,-111788000,,,,-110291000,1203282000,1184653000,861757000,-22298000,,106622000,210605000,50957,TRQ
2019-12-31,3202000,,-70988000,7101000,-46116000,50664000,-5477000,-59343000,-59343000,,-4057000,,,,-1920000,334697000,394040000,340174000,-11645000,,-69068000,-46116000,50960,KXIN
2018-12-31,4419000,,-88076000,32406000,-89215000,47089000,17433000,-34075000,-34075000,,-4261000,,,,862000,431404000,465479000,413971000,-54001000,-594000.0,-88938000,-89215000,50960,KXIN
2017-12-31,3982000,,-29382000,34653000,-28619000,25669000,3528000,-26123000,-26123000,,-3068000,,,,1158000,116586000,142709000,113058000,-3259000,1845000.0,-30540000,-28619000,50960,KXIN
2016-12-31,2374000,,-14298000,34653000,-24054000,18366000,6775000,-13965000,-13965000,,-58000,,,,1690000,68000,14033000,-6707000,-333000,-8066000.0,-15988000,-24054000,50960,KXIN
2020-10-31,,,111410004,,111410004,19092749,33161018,14068269,14068269,,,,,,0,33161018,19092749,0,97341735,,111410004,111410004,50963,ETY
2019-10-31,,,153364601,,153364601,18804274,33869702,15065428,15065428,,,,,,0,33869702,18804274,0,138299173,,153364601,153364601,50963,ETY
2018-10-31,,,135218966,,135218966,19708635,31940515,12231880,12231880,,,,,,0,31940515,19708635,0,122987086,,135218966,135218966,50963,ETY
2017-10-31,,,273875801,,273875801,18832905,33841613,15008708,15008708,,,,,,0,33841613,18832905,0,258867093,,273875801,273875801,50963,ETY
2019-12-31,,,1544109000,2563000,1080484000,2006905000,3521748000,1645068000,1645068000,-130225000,-84400000,,,,454625000,5127808000,3482740000,1606060000,-101959000,,1089484000,1080484000,50966,XP
2018-12-31,,,640728000,6935000,461440000,1228935000,2017207000,740487000,740487000,47785000,-72310000,,,,175398000,2958453000,2217966000,941246000,-99759000,,465330000,461440000,50966,XP
2017-12-31,,,575507000,7923000,413874000,661027000,1326770000,657163000,657163000,8580000,-61093000,,,,151966000,1906650000,1249487000,579880000,-81656000,,423541000,413874000,50966,XP
2016-12-31,,,373916000,49647000,188675000,488140000,875719000,375659000,375659000,11920000,-61093000,,,,130151000,1251807000,876148000,376088000,-1743000,,243765000,188675000,50966,XP
2020-12-31,,,1082309000,,872439000,515630000,1543514000,1027884000,1027884000,,-86062000,,,,209870000,4540029000,3512145000,2996515000,54425000,,872439000,872439000,50970,AME
2019-12-31,,,1069748000,,861297000,643680000,1787660000,1143980000,1143980000,,-88481000,,,,208451000,5158557000,4014577000,3370897000,-74232000,,861297000,861297000,50970,AME
2018-12-31,,,987745000,,777933000,597433000,1659562000,1062129000,1062129000,,-82180000,,,,209812000,4845872000,3783743000,3186310000,-74384000,,777933000,777933000,50970,AME
2017-12-31,,,796729000,,681470000,553853000,1438800000,884947000,884947000,,-98029000,,,,115259000,4300170000,3415223000,2861370000,-88218000,,681470000,681470000,50970,AME
2020-09-30,,,347000,,257000,19690000,26542000,-531000,-531000,,-31000,,,,90000,88713000,89244000,62171000,878000,,257000,257000,50972,PATI
2019-09-30,,,2393000,,1763000,21580000,29772000,322000,322000,,-32000,,,,630000,108716000,108394000,78944000,2071000,,1763000,1763000,50972,PATI
2018-09-30,,,2197000,,5119000,23588000,33363000,1016000,1016000,,-39000,,,,-2922000,114065000,113049000,80702000,1181000,,5119000,5119000,50972,PATI
2017-09-30,,,2298000,,1829000,22843000,34186000,1801000,1801000,,-80000,,,,469000,112165000,110364000,77979000,497000,,1829000,1829000,50972,PATI
2020-10-02,78900000,,-72600000,14100000,-57900000,132900000,194400000,-17400000,-17400000,,-31400000,,,,-15200000,738300000,755700000,543900000,-55200000,,-57400000,-57900000,50973,VREX
2019-09-27,78100000,,21500000,13800000,15500000,121600000,264300000,64600000,64600000,,-21100000,,,,5700000,780600000,716000000,516300000,-43100000,,15800000,15500000,50973,VREX
2018-09-28,83000000,,25700000,13200000,27500000,123400000,253900000,47500000,47500000,,-21700000,,,,-2600000,773400000,725900000,519500000,-21800000,,28300000,27500000,50973,VREX
2017-09-29,67300000,,74800000,11200000,51600000,102500000,253500000,83700000,83700000,,-12300000,,,,22800000,698100000,614400000,444600000,-13900000,,52000000,51600000,50973,VREX
2020-12-31,,,31246000,,25188000,53802000,89555000,35753000,35753000,,,,,,6058000,348967000,313214000,259412000,-4507000,,25188000,25188000,50975,GRC
2019-12-31,,,45166000,,35815000,59293000,102675000,43382000,43382000,,-1000.0,,,,9351000,398179000,354797000,295504000,1784000,,35815000,35815000,50975,GRC
2018-12-31,,,50316000,,39979000,60802000,109921000,49119000,49119000,,-1000.0,,,,10337000,414334000,365215000,304413000,1197000,,39979000,39979000,50975,GRC
2017-12-31,,,39378000,,26555000,59252000,101208000,41956000,41956000,,-17000.0,,,,12823000,379389000,337433000,278181000,-2578000,,26555000,26555000,50975,GRC
2020-12-31,,,-1511479000,4741724000,-1032724000,2582481000,1709371000,-2083750000,-2083750000,,-676380000,,,,-191572000,4917133000,7000883000,3207762000,572271000,,-1319907000,-1032724000,50976,MGM
2019-12-31,,,2846725000,5040700000,2049146000,2565859000,5296183000,1418500000,1418500000,,-847932000,,,,632345000,12462785000,11044285000,7166602000,1428225000,,2214380000,2046433000,50976,MGM
2018-12-31,,,634006000,4059758000,466772000,2183842000,4844221000,1330943000,1330943000,,-769513000,,,,50112000,11337604000,10006661000,6493383000,-696937000,,583894000,445446000,50976,MGM
2017-12-31,,,960790000,4113841000,1952052000,1988447000,4604357000,1575955000,1575955000,-72000000.0,-668745000,,,,-1127394000,10395437000,8819482000,5791080000,-615165000,,2088184000,1933689000,50976,MGM
2020-06-27,302500000,,157400000,,118800000,127000000,543100000,101900000,101900000,,-22500000,,,,38600000,1333900000,1232000000,790800000,55500000,,118800000,118800000,50979,SYNA
2019-06-29,342700000,,-22600000,,-22900000,131300000,497100000,11400000,11400000,,-21200000,,,,300000,1472200000,1460800000,975100000,-34000000,,-22900000,-22900000,50979,SYNA
2018-06-30,363200000,,-83600000,,-124100000,154000000,480100000,-49900000,-49900000,,-22200000,,,,40500000,1630300000,1680200000,1150200000,-33700000,,-124100000,-124100000,50979,SYNA
2017-06-24,292300000,,61000000,,48800000,137600000,523600000,82000000,82000000,,-6000000,,,,12200000,1718200000,1636200000,1194600000,-21000000,,48800000,48800000,50979,SYNA
2019-12-31,,,299526000,,261057000,457433000,805600000,302850000,302850000,,,,,,38469000,2293798000,1990948000,1488198000,-3324000,,261057000,261057000,50982,EPAM
2018-12-31,,,249773000,,240256000,373587000,655991000,245764000,245764000,,,,,,9517000,1842912000,1597148000,1186921000,4009000,,240256000,240256000,50982,EPAM
2017-12-31,,,174305000,,72760000,327588000,529096000,172946000,172946000,,,,,,101545000,1450448000,1277502000,921352000,1359000,,72760000,72760000,50982,EPAM
2016-12-31,,,126466000,,99266000,264631000,422946000,134928000,134928000,,,,,,27200000,1160132000,1025204000,737186000,-8462000,,99266000,99266000,50982,EPAM
2019-12-31,5036613,,-12358627,,-12387976,20092300,15556970,-9952943,-9952943,,-142275,,,,29349,22699386,32652329,7142416,-2405684,,-12387976,-12387976,50984,SHSP
2018-12-31,4298031,,-9809816,,-9478822,16200778,12853256,-8614114,-8614114,,-298213,,,,-330994,18651525,27265639,5798269,-1195702,,-9478822,-9478822,50984,SHSP
2017-12-31,2883714,,-6773943,,-4669835,12023943,8452007,-6983118,-6983118,,-298213,,,,-2104108,13448752,20431870,4996745,209175,,-4669835,-4669835,50984,SHSP
2016-12-31,2277957,,-7585163,,4951010,9578839,7162806,-6054095,-6054095,,-298213,,,,-1869188,11541702,17595797,4378896,-1531068,10666985.0,-5715975,4951010,50984,SHSP
2019-12-31,2249525,,-13007144,,-13007344,5597070,-5053695,-12900290,-12900290,,,,,,200,164990,13065280,5218685,-106854,,-13007344,-13007344,50985,LPCN
2018-12-31,2403463,,-11659322,,-11660022,5289142,-3633214,-11325819,-11325819,,-793000.0,,,,700,428031,11753850,4061245,-667006,,-11660022,-11660022,50985,LPCN
2017-12-31,11004281,,-20982160,,-20982860,10213695,0,-21217976,-21217976,,-793000.0,,,,700,0,21217976,0,235816,,-20982860,-20982860,50985,LPCN
2016-12-31,8076053,,-18970756,,-18971508,10382146,0,-18458199,-18458199,,-793000.0,,,,752,0,18458199,0,-512557,,-18971508,-18971508,50985,LPCN
2018-12-31,,,845820000,,715842000,,1809011000,1022874000,1022874000,756037000,-147355000,,,,129978000,12875664000,11852790000,11066653000,-177054000,,715842000,715842000,50987,RZA
2017-12-31,,,1142815000,,1822181000,,2028166000,1339976000,1339976000,665890000,-146025000,,,,-679366000,12515769000,11175793000,10487603000,-197161000,,1822181000,1822181000,50987,RZA
2016-12-31,,,1043946000,,701443000,,1852905000,1207396000,1207396000,612409000,-137623000,,,,342503000,11521511000,10314115000,9668606000,-163450000,,701443000,701443000,50987,RZA
2015-12-31,,,744795000,,502166000,,1464346000,910302000,910302000,538044000,-142863000,,,,242629000,10418178000,9507876000,8953832000,-165507000,,502166000,502166000,50987,RZA
2019-12-31,,,-43100000,12000000,-42700000,312900000,416100000,95200000,95200000,8000000,-134600000,,,,500000,3452600000,3357400000,3036500000,-138300000,,-43600000,-42700000,50991,CLMT
2018-12-31,,,-50300000,12800000,-54000000,317600000,467300000,182800000,182800000,-33100000,-155500000,,,,700000,3497500000,3314700000,3030200000,-233100000,-4100000.0,-51000000,-54000000,50991,CLMT
2017-12-31,,,-31400000,13800000,-101700000,341800000,467600000,88800000,88800000,37000000,-183100000,,,,-100000,3763800000,3675000000,3296200000,-120200000,-72500000.0,-31300000,-101700000,50991,CLMT
2016-12-31,,,-296600000,15800000,-322000000,329300000,347900000,-6500000,-6500000,25100000,-161700000,,,,200000,3474300000,3480800000,3126400000,-290100000,-31800000.0,-296800000,-322000000,50991,CLMT
2020-07-31,,,-14616067,,-14610516,9441898,-4582403,-14334523,-14334523,,-3296181,,,,-5551,0,14334523,4582403,-281544,,-14610516,-14610516,50995,UEC
2019-07-31,,,-17167161,,-17152789,10142035,-4487537,-14977013,-14977013,,-3087211,,,,-14372,0,14977013,4487537,-2190148,,-17152789,-17152789,50995,UEC
2018-07-31,,,-18534145,,-17826634,11407206,-4552151,-16313981,-16313981,,-2802361,,,,-707511,0,16313981,4552151,-2220164,,-17826634,-17826634,50995,UEC
2017-07-31,,,-18005411,,-17971056,10241681,-4181082,-15218433,-15218433,,-2778879,,,,-34355,0,15218433,4181082,-2786978,,-17971056,-17971056,50995,UEC
2019-12-31,,,5830000,,5577000,687712000,768280000,69340000,69340000,3895000,-55391000,,,,253000,768280000,698940000,0,-63510000,,5577000,5577000,50996,GHLD
2018-12-31,,,97593000,,73333000,615955000,766921000,139352000,139352000,4434000,-44002000,,,,24260000,766921000,627569000,0,-41759000,,73333000,73333000,50996,GHLD
2020-08-31,,,13279036,,13279036,5143424,33097763,27954339,27954339,,-6486698,,,,0,33097763,5143424,0,-14675303,,13279036,13279036,50997,MFL
2019-08-31,,,56519455,,56519455,5036130,36090841,31054711,31054711,,-8821068,,,,0,36090841,5036130,0,25464744,,56519455,56519455,50997,MFL
2018-08-31,,,-1789527,,-1789527,5138697,40016857,34878160,34878160,,-8034251,,,,0,40016857,5138697,0,-36667687,,-1789527,-1789527,50997,MFL
2017-08-31,,,-3618075,,-3618075,5347366,41022403,35675037,35675037,,-6322642,,,,0,41022403,5347366,0,-39293112,,-3618075,-3618075,50997,MFL
2020-06-30,89405000,,450196000,,380297000,39169000,606772000,478198000,478198000,,-23002000,,,,69899000,1284500000,806302000,677728000,-28002000,,380297000,380297000,50998,UI
2019-06-30,82070000,,381489000,,322694000,41537000,535904000,412297000,412297000,,-12808000,,,,58795000,1161733000,749436000,625829000,-30808000,,322694000,322694000,50998,UI
2018-06-30,74324000,,314142000,,196290000,41521000,441972000,326127000,326127000,,-11985000,,,,117852000,1016861000,690734000,574889000,-11985000,,196290000,196290000,50998,UI
2017-06-30,69094000,,285024000,,257506000,34753000,393608000,289761000,289761000,,-4737000,,,,27518000,865268000,575507000,471660000,-4737000,,257506000,257506000,50998,UI
2019-12-31,,,351000000,-45000000,306000000,114000000,902000000,446000000,446000000,78000000,-140000000,,,,35000000,2830000000,2384000000,1928000000,-95000000,,316000000,305000000,51002,PK
2018-12-31,,,500000000,-46000000,472000000,117000000,868000000,401000000,401000000,73000000,-127000000,,,,23000000,2730000000,2329000000,1862000000,99000000,,477000000,470000000,51002,PK
2017-12-31,,,285000000,-49000000,2625000000,123000000,910000000,436000000,436000000,63000000,-124000000,,,,-2346000000,2831000000,2395000000,1921000000,-151000000,,2631000000,2617000000,51002,PK
2016-12-31,,,221000000,-49000000,133000000,127000000,899000000,453000000,453000000,19000000,-200000000,,,,82000000,2747000000,2294000000,1848000000,-232000000,,139000000,133000000,51002,PK
2020-12-31,36940000,,62945000,,50867000,121051000,217827000,59836000,59836000,,,,,,12078000,434395000,374559000,216568000,3109000,,50867000,50867000,51003,PRLB
2019-12-31,32692000,,81193000,,63655000,122742000,235290000,79856000,79856000,,,,,,17538000,458728000,378872000,223438000,1337000,,63655000,63655000,51003,PRLB
2018-12-31,28735000,,91655000,,76588000,121046000,238679000,88898000,88898000,,,,,,15067000,445596000,356698000,206917000,2757000,,76588000,76588000,51003,PRLB
2017-12-31,23560000,,74435000,,51778000,98056000,193842000,72226000,72226000,,,,,,22657000,344490000,272264000,150648000,2209000,,51778000,51778000,51003,PRLB
2019-12-31,,,402567000,704260000,373173000,714015000,2098886000,751478000,751478000,,-310102000,,,,8339000,5736801000,4985323000,3637915000,-348911000,,394228000,373173000,51004,MLCO
2018-12-31,,,339134000,675015000,340299000,652130000,1855622000,602847000,602847000,,-264880000,,,,238000,5188942000,4586095000,3333320000,-263713000,,338896000,340299000,51004,MLCO
2017-12-31,,,312210000,448065000,344828000,580645000,1731974000,628240000,628240000,,-255764000,,,,-10000,5284823000,4656583000,3552849000,-316030000,,312220000,344828000,51004,MLCO
2016-12-31,,,75096000,479544000,175906000,505858000,1405658000,366461000,366461000,,-271912000,,,,8178000,4519396000,4152935000,3113738000,-291365000,,66918000,175906000,51004,MLCO
2019-12-31,31462000,,-34421000,,-34351000,16783000,0,-48245000,-48245000,,-758000,,,,-70000,0,48245000,0,13824000,,-34351000,-34351000,51006,GMDA
2018-12-31,22045000,,-52861000,,-52931000,11599000,0,-33644000,-33644000,,-758000,,,,70000,0,33644000,0,-19217000,,-52931000,-52931000,51006,GMDA
2017-12-31,15018000,,-19011000,,-19011000,4472000,0,-19490000,-19490000,,-758000,,,,0,0,19490000,0,479000,,-19011000,-19011000,51006,GMDA
2016-12-31,19095000,,-22671000,,-22671000,4614000,0,-23709000,-23709000,,-758000,,,,0,0,23709000,0,1038000,,-22671000,-22671000,51006,GMDA
2019-12-31,23228810,,-38399089,,-38399089,15779233,200143,-38807900,-38807900,,,,,,0,200143,39008043,0,408811,,-38399089,-38399089,51009,WATT
2018-12-31,32871685,,-50840122,,-50840122,18572548,514823,-50929410,-50929410,,,,,,0,514823,51444233,0,89288,,-50840122,-50840122,51009,WATT
2017-12-31,33230668,,-49376875,,-49376875,17311169,1154009,-49387828,-49387828,,,,,,0,1154009,50541837,0,10953,,-49376875,-49376875,51009,WATT
2016-12-31,32832677,,-45817394,,-45817394,14449984,1451941,-45830720,-45830720,,,,,,0,1451941,47282661,0,13326,,-45817394,-45817394,51009,WATT
2020-03-31,,,17078000,,11938000,111202000,166338000,37363000,37363000,,-14279000,,,,5142000,383486000,346123000,217148000,-20285000,,11936000,11938000,51012,THR
2019-03-31,,,33142000,4204000.0,22756000,106660000,175940000,48509000,48509000,,-15714000,,,,9973000,412642000,364133000,236702000,-16124000,,23169000,22756000,51012,THR
2018-03-31,,,18389000,5928000.0,11913000,94615000,143811000,32738000,32738000,,-8984000,,,,5170000,308609000,275871000,164798000,-14349000,,13219000,11913000,51012,THR
2017-03-31,,,19082000,4622000.0,14641000,77715000,111931000,22444000,22444000,,-3518000,,,,4098000,264130000,241686000,152199000,-3362000,,14984000,14641000,51012,THR
2020-12-31,,,206076000,,164676000,314871000,582189000,0,227835000,39483000,,,,,41400000,582189000,354354000,0,-21759000,,164676000,164676000,51013,CBU
2019-12-31,,,209338000,,169063000,323372000,581364000,0,233902000,24090000,,,,,40275000,581364000,347462000,0,-24564000,,169063000,168663000,51013,CBU
2018-12-31,,,212988000,,168641000,306432000,558595000,0,230692000,21471000,,,,,44347000,558595000,327903000,0,-17704000,,168641000,167897000,51013,CBU
2017-12-31,,,159965000,,150717000,281613000,507114000,0,202892000,22609000,,,,,9248000,507114000,304222000,0,-42927000,,150717000,150120000,51013,CBU
2020-12-31,173100000,,423000000,,350100000,353100000,1053700000,472300000,472300000,,-29100000,,,,72900000,2330000000,1857700000,1276300000,-49300000,,350100000,350100000,51014,MKSI
2019-12-31,164061000,,177836000,,140386000,330346000,838055000,276246000,276246000,,-44135000,,,,37450000,1899773000,1623527000,1061718000,-98410000,,140386000,140386000,51014,MKSI
2018-12-31,135720000,,480950000,,392896000,298118000,979476000,502117000,502117000,1000000.0,-16942000,,,,88054000,2075108000,1572991000,1095632000,-21167000,,392896000,392896000,51014,MKSI
2017-12-31,132555000,,447625000,,339132000,290056000,891451000,423097000,423097000,1000000.0,-30990000,,,,108493000,1915977000,1492880000,1024526000,24528000,,339132000,339132000,51014,MKSI
2020-12-31,,,25537000,,20318000,37309000,83570000,0,25537000,20724000,,,,,5219000,83570000,58033000,0,0,,20318000,20318000,51016,FGBI
2019-12-31,,,17897000,,14241000,33371000,65116000,0,17897000,13848000,,,,,3656000,65116000,47219000,0,0,,14241000,14241000,51016,FGBI
2018-12-31,,,17675000,,14213000,30718000,60950000,0,17675000,12557000,,,,,3462000,60950000,43275000,0,0,,14213000,14213000,51016,FGBI
2017-12-31,,,19150000,,11751000,26523000,57671000,0,19150000,11998000,,,,,7399000,57671000,38521000,0,0,,11751000,11751000,51016,FGBI
2019-12-31,19339000,,-26068000,,-26050000,7306000,0,-26645000,-26645000,,,,,,-18000,0,26645000,0,577000,,-26050000,-26754000,51017,TRVI
2018-12-31,14072000,,-20669000,,-20545000,4336000,0,-18408000,-18408000,,-174000.0,,,,-124000,0,18408000,0,-2261000,,-20545000,-25577000,51017,TRVI
2017-12-31,6095000,,-12886000,,-12860000,2142000,0,-8237000,-8237000,,-3342000.0,,,,-26000,0,8237000,0,-4649000,,-12860000,-12540000,51017,TRVI
2016-12-31,6913000,,-11095000,,-11087000,1712000,0,-8625000,-8625000,,-2607000.0,,,,-8000,0,8625000,0,-2470000,,-11087000,-6714000,51017,TRVI
2020-03-31,,,148740000,20738000,131916000,53341000,315881000,150966000,150966000,109659000,-10211000,,,,3955000,446611000,295645000,130730000,-2226000,,144785000,131916000,51019,STEP
2019-03-31,,,61599000,16953000,54196000,49160000,147928000,65565000,65565000,31478000,-10261000,,,,1640000,256268000,190703000,108340000,-3966000,,59959000,54196000,51019,STEP
2018-03-31,,,85805000,15576000,81438000,35851000,177270000,81546000,81546000,59684000,-913000,,,,1986000,264275000,182729000,87005000,4259000,,83819000,81438000,51019,STEP
2017-03-31,,,43310000,15576000,40256000,23045000,101109000,44010000,44010000,33455000,-648000,,,,454000,163059000,119049000,61950000,-700000,,42856000,40256000,51019,STEP
2019-12-31,,,124119000,,130133000,56835000,226918000,170083000,170083000,,-20676000,,,,-6014000,322073000,151990000,95155000,-45964000,,130133000,130133000,51021,LXRX
2018-12-31,,,-120548000,,-120548000,63754000,-39525000,-103279000,-103279000,,-20777000,,,,0,63209000,166488000,102734000,-17269000,,-120548000,-120548000,51021,LXRX
2017-12-31,,,-135654000,,-122993000,66090000,-62433000,-128523000,-128523000,,-6984000,,,,-12661000,91689000,220212000,154122000,-7131000,,-122993000,-122993000,51021,LXRX
2016-12-31,,,-131445000,,-131445000,43157000,-84717000,-127874000,-127874000,,-6567000,,,,0,79256000,207130000,163973000,-3571000,,-131445000,-131445000,51021,LXRX
2019-12-31,864320,,4387643,-46617,4046670,5720472,10226936,3642144,3642144,,,,,,387144,14882763,11240619,4655827,745499,,4000499,4046670,51022,ZCMD
2018-12-31,1447949,,3503620,-27836,3019323,3686921,8409517,3274647,3274647,,,,,,502131,12865870,9591223,4456353,228973,,3001489,3019323,51022,ZCMD
2017-12-31,943253,,1340975,-10002,1529280,3854366,5846244,1048625,1048625,,,,,,-153953,9816312,8767687,3970068,292350,,1494928,1529280,51022,ZCMD
2019-12-31,7219898,,-1191825,,-1191825,37169311,45310161,920952,920952,,-920459,,,,0,51128905,50207953,5818744,-2112777,,-1191825,-1191825,51027,NARI
2018-12-31,3989752,,-10152688,,-10152688,10697914,5548285,-9139381,-9139381,,-887173,,,,0,6828773,15968154,1280488,-1013307,,-10152688,-10152688,51027,NARI
2019-12-31,,,-522192000,,-424150000,1416532000,3735373000,329759000,329759000,,-619573000,,,,-98042000,5125657000,4795898000,1390284000,-851951000,,-424150000,-424150000,51028,ADT
2018-12-31,,,-632618000,,-609155000,1264450000,3540337000,344958000,344958000,,-663204000,,,,-23463000,4581673000,4236715000,1041336000,-977576000,,-609155000,-609155000,51028,ADT
2017-12-31,,,-421686000,,342627000,1209200000,3419766000,347267000,347267000,42828000.0,-732841000,,,,-764313000,4315502000,3968235000,895736000,-768953000,,342627000,342627000,51028,ADT
2016-12-31,,,-802738000,,-536587000,858896000,2256336000,164473000,164473000,6788000.0,-521491000,,,,-266151000,2949766000,2785293000,693430000,-967211000,,-536587000,-536587000,51028,ADT
2019-12-31,,,102484000,3064000,100699000,58384000,376483000,153012000,153012000,,-84721000,,,,659000,516146000,363134000,139663000,-50528000,,101825000,60605000,51030,SITC
2018-12-31,,,116967000,2928000,114434000,56998000,489360000,190260000,190260000,-3775000.0,-141305000,,,,862000,697352000,507092000,207992000,-73293000,,116105000,79766000,51030,SITC
2017-12-31,,,-230714000,6506000,-241685000,59128000,652161000,246829000,246829000,-10505000.0,-188647000,,,,12418000,915904000,669075000,263743000,-477543000,,-243132000,-271433000,51030,SITC
2016-12-31,,,62980000,8497000,60012000,60151000,728021000,278351000,278351000,-10505000.0,-217589000,,,,1781000,1020155000,741804000,292134000,-215371000,,61199000,36851000,51030,SITC
2020-12-31,12965000,,-21496000,1612000,-37225000,39131000,42824000,-9272000,-9272000,,-13805000,,,,15616000,122674000,131946000,79850000,-12224000,,-37112000,-37225000,51031,IO
2019-12-31,19025000,,-39150000,2188000,-48199000,59736000,69094000,-9667000,-9667000,,-13074000,,,,8064000,174679000,184346000,105585000,-29483000,,-47214000,-48199000,51031,IO
2018-12-31,18182000,,-67680000,1592000,-71171000,57052000,59620000,-15614000,-15614000,,-12972000,,,,2718000,180045000,195659000,120425000,-52066000,,-70398000,-71171000,51031,IO
2017-12-31,16431000,,-29353000,1239000,-30242000,61766000,77943000,-254000,-254000,,-16709000,,,,24000,197554000,197808000,119611000,-29099000,,-29377000,-30242000,51031,IO
2020-12-31,,,1003855000,77994000,1000833000,93217000,714924000,332752000,332752000,,-186904000,,,,978000,1057893000,725141000,342969000,671103000,,1002877000,969070000,51032,KIM
2019-12-31,,,410244000,81958000,410605000,94342000,821933000,449712000,449712000,,-177395000,,,,-3317000,1158884000,709172000,336951000,-39468000,,413561000,337389000,51032,KIM
2018-12-31,,,500063000,100931000,497795000,83997000,836203000,435573000,435573000,,-183339000,,,,1600000,1164762000,729189000,328559000,64490000,,498463000,429708000,51032,KIM
2017-12-31,,,438791000,144046000,426075000,86190000,862941000,410310000,410310000,,-191956000,,,,-880000,1200834000,790524000,337893000,28481000,,439671000,370329000,51032,KIM
2019-12-31,,,-48490000,,-48490000,62295000,399235000,129972000,129972000,,-181154000,,,,0,704325000,574353000,305090000,-178462000,,-48490000,-48490000,51033,STNG
2018-12-31,,,-190071000,,-190071000,52272000,239809000,10814000,10814000,,-169637000,,,,0,585047000,574233000,345238000,-200885000,,-190071000,-190071000,51033,STNG
2017-12-31,,,-158240000,,-158240000,47511000,198022000,9093000,9093000,,-112295000,,,,0,512732000,503639000,314710000,-167333000,,-158240000,-158240000,51033,STNG
2016-12-31,,,-24903000,,-24903000,54899000,255187000,78827000,78827000,,-89569000,,,,0,522747000,443920000,267560000,-103730000,,-24903000,-24903000,51033,STNG
2019-12-31,,,-15578000,,-15223000,29069000,21506000,-7563000,-7563000,,-4144000,,,,-355000,284290000,291853000,262784000,-8015000,,-15223000,-15223000,51034,CMT
2018-12-31,,,-5446000,,-4782000,25731000,27141000,1410000,1410000,,-2394000,,,,-664000,269485000,268075000,242344000,-6856000,,-4782000,-4782000,51034,CMT
2017-12-31,,,7745000,,5459000,16075000,24631000,8556000,8556000,,-245000,,,,2286000,161673000,153117000,137042000,-811000,,5459000,5459000,51034,CMT
2016-12-31,,,11247000,,7411000,16450000,27906000,11456000,11456000,,-298000,,,,3836000,174882000,163426000,146976000,-209000,,7411000,7411000,51034,CMT
2019-12-31,,,36093000,,26576000,31624000,92463000,49148000,49148000,11624000,-13055000,,,,9517000,242474000,193326000,150011000,-13055000,,26576000,25128000,51037,HCI
2018-12-31,,,26902000,,17725000,25908000,83021000,44998000,44998000,11538000,-18096000,,,,9177000,231292000,186294000,148271000,-18096000,,17725000,18442000,51037,HCI
2017-12-31,,,-15624000,,-6893000,25127000,39114000,1924000,1924000,12063000,-16767000,,,,-8731000,244406000,242482000,205292000,-17548000,,-6893000,-6412000,51037,HCI
2016-12-31,,,46856000,,29021000,26200000,94913000,56099000,56099000,12614000,-11079000,,,,17835000,262222000,206123000,167309000,-9243000,,29021000,27476000,51037,HCI
2019-09-30,13267000,,-65143000,7209000,-62120000,31267000,-12830000,-55422000,-55422000,-1942000,-4680000,,,,510000,92440000,147862000,105270000,-9721000,,-65653000,-62120000,51040,SEED
2018-09-30,27132000,,-152790000,1363000,-153663000,32558000,5880000,-40818000,-40818000,-12992000,-22787000,,,,0,12927000,53745000,7047000,-111972000,,-152790000,-153663000,51040,SEED
2017-09-30,38682000,,-121841000,490000,-75674000,36094000,-18641000,-88062000,-88062000,-5355000,-9006000,,,,0,870000,88932000,19511000,-33779000,15580000.0,-121841000,-75674000,51040,SEED
2016-09-30,41272000,,-73038000,38329000,-65578000,32974000,481000,-65243000,-65243000,-8522000,-7607000,,,,0,481000,65724000,0,-7795000,-3795000.0,-73038000,-65578000,51040,SEED
2019-12-31,,,28550000,17892000,17200000,61406000,102333000,40927000,40927000,,,,,,6159000,630988000,590061000,528655000,-12377000,,22391000,17200000,51041,LSEA
2018-12-31,,,41319000,12571000,29184000,42579000,72313000,29734000,29734000,,-111000.0,,,,4613000,378617000,348883000,306304000,11585000,,36706000,29184000,51041,LSEA
2017-12-31,,,-145000,12571000,-413000,25261000,21886000,-3375000,-3375000,,-645000.0,,,,158000,197306000,200681000,175420000,3230000,,-303000,-413000,51041,LSEA
2020-10-31,512700000,,-2940400000,,-2969500000,1441200000,2302300000,348400000,348400000,,-279800000,,,,34200000,3001000000,2652600000,698700000,-3288800000,5100000,-2974600000,-2969500000,51042,MFGP
2019-10-31,491700000,,-34100000,1300000.0,1468800000,1558800000,2571100000,513800000,513800000,6800000.0,-264200000,,,,-16000000,3348400000,2834600000,777300000,-547900000,1487200000,-18100000,1468800000,51042,MFGP
2018-10-31,442266888,,22733345,1000000.0,522666928,1298333983,2344734506,608533638,608533638,-4400002.0,-224400112,,,,-448733558,3169601585,2561067947,824867079,-585800293,51266692,471466902,522666928,51042,MFGP
2018-04-30,458362000,,77221000,1001000.0,726234000,1471970000,2507849000,577517000,577517000,-4400002.0,-200296000,,,,-649060000,3208676000,2631159000,700827000,-500296000,51266692,726281000,726234000,51042,MFGP
2019-12-31,133406000,,-163914000,,-161867000,36557000,0,-169963000,-169963000,,,,,,-2047000,0,169963000,0,6049000,,-161867000,-161867000,51043,KNSA
2018-12-31,86597000,,-103441000,,-103227000,21563000,0,-108160000,-108160000,,,,,,-214000,0,108160000,0,4719000,,-103227000,-103227000,51043,KNSA
2017-12-31,55955000,,-64871000,,-64873000,9445000,0,-65400000,-65400000,,,,,,2000,0,65400000,0,529000,,-64873000,-64873000,51043,KNSA
2016-12-31,17153000,,-23937000,,-23973000,6849000,0,-24002000,-24002000,,,,,,36000,0,24002000,0,65000,,-23973000,-23973000,51043,KNSA
2019-12-31,,,405900000,,344100000,28800000,699300000,410200000,410200000,-2900000,-8500000,,,,61800000,841700000,431500000,142400000,-4300000,,344100000,344100000,51048,FNV
2018-12-31,,,189100000,,139000000,22600000,535000000,188800000,188800000,-100000,-2500000,,,,50100000,650900000,462100000,115900000,300000,,139000000,139000000,51048,FNV
2017-12-31,,,236000000,,194700000,24900000,533000000,235400000,235400000,-300000,-900000,,,,41300000,672700000,437300000,139700000,600000,,194700000,194700000,51048,FNV
2016-12-31,,,167900000,,122200000,24100000,504400000,141300000,141300000,-2300000,-1400000,,,,45700000,609700000,468400000,105300000,26600000,,122200000,122200000,51048,FNV
2020-12-31,38384000,,-184932000,,-181544000,961615000,1147852000,147853000,147853000,,-105753000,,,,6727000,3554075000,3406222000,2406223000,-332785000,10115000,-191659000,-181544000,51049,PBI
2019-12-31,51258000,,27142000,,194609000,999764000,1282986000,231964000,231964000,,-110910000,,,,-13007000,3205125000,2973161000,1922139000,-204822000,154460000,40149000,194601000,51049,PBI
2018-12-31,58523000,,188121000,,241811000,1025360000,1421248000,337365000,337365000,,-115381000,,,,6416000,3211522000,2874157000,1790274000,-149244000,60106000,181705000,241779000,51049,PBI
2017-12-31,60857000,,193698000,,243528000,1034907000,1456151000,360387000,360387000,,-117984000,,,,13659000,2784007000,2423620000,1327856000,-166689000,63489000,180039000,243492000,51049,PBI
2019-12-31,324434526,,1202331496,3137708510,898662226,3309362546,5431685621,1797888549,1797888549,,-651186776,,,,277979001,29746287759,27948399210,24314602138,-595557053,,924352495,898662226,51051,JKS
2018-12-31,366576571,,409985056,614086626,406478694,2487693484,3513744922,659474867,659474867,,-369452313,,,,4409523,25042613341,24383138474,21528868419,-249489811,,405575533,406478694,51051,JKS
2017-12-31,294102790,,146819368,-10213,141705689,2372203382,2991568401,325262229,325262229,,-320462072,,,,4628003,26472943454,26147681225,23481375053,-178442861,,142191365,141705689,51051,JKS
2016-12-31,181106128,,1247722561,-495889,1826709975,2212805721,3869338919,1474627171,1474627171,799899.0,-411180103,,,,257487006,21400638092,19926010921,17531299173,-226904610,836041879.0,990235555,1826709975,51051,JKS
2019-12-31,243392000,,-200778000,-5628000,-202416000,2041459000,1959026000,-325825000,-325825000,,-79486000,,,,18290000,35175889000,35501714000,33216863000,125047000,,-219068000,-202416000,51052,BEST
2018-12-31,184581000,,-496504000,2043000,-507988000,1914530000,1441137000,-657974000,-657974000,,-75060000,,,,11887000,27960979000,28618953000,26519842000,161470000,,-508391000,-507988000,51052,BEST
2017-12-31,139009000,,-1218204000,678000,-1227893000,1623040000,485551000,-1276498000,-1276498000,,-47154000,,,,9856000,19989562000,21266060000,19504011000,58294000,,-1228060000,-1227893000,51052,BEST
2016-12-31,80326000,,-1362910000,678000,-1363480000,891254000,-532430000,-1399963000,-1399963000,-104047000.0,-21379000,,,,570000,8844137000,10244100000,9376567000,37053000,,-1363480000,-5610325000,51052,BEST
2019-12-31,,,186937000,48632000,153916000,236571000,441777000,207800000,207800000,-2594000,-56228000,,,,14175000,750630000,542830000,308853000,-20863000,,172762000,153916000,51054,AFYA
2018-12-31,,,98722000,88372000,86353000,70034000,165883000,96448000,96448000,-599000,-1185000,,,,3988000,333935000,237487000,168052000,-1503000,,94734000,86353000,51054,AFYA
2017-12-31,,,50979000,651000,45393000,45355000,91943000,49343000,49343000,-2755000,-1042000,,,,2500000,216008000,166665000,124065000,1636000,,48479000,45393000,51054,AFYA
2020-12-31,,,584374000,,515595000,1794688000,2430690000,636002000,636002000,,-52379000,,,,68647000,9552197000,8916195000,7121507000,-51628000,,515727000,515595000,51055,MHK
2019-12-31,,,749545000,6607000.0,744211000,1835949200,2768245000,932295800,932295800,,-41272000,,,,4974000,9970672000,9038376200,7202427000,-182750800,,744571000,744211000,51055,MHK
2018-12-31,,,1049201000,6245000.0,861704000,1711157000,2900533000,1189376000,1189376000,,-38827000,,,,184346000,9983634000,8794258000,7083101000,-140175000,,864855000,857812000,51055,MHK
2017-12-31,,,1317857000,37310000.0,971638000,1629326000,3045739000,1416413000,1416413000,,-31111000,,,,343165000,9491290000,8074877000,6445551000,-98556000,,974692000,971592000,51055,MHK
2019-12-31,89017000,,116676000,,94181000,100359000,300982000,111606000,111606000,,,,,,22495000,306486000,194880000,5504000,5070000,,94181000,94181000,51056,CORT
2018-12-31,75247000,,92153000,,75410000,81289000,246032000,89496000,89496000,,,,,,16743000,251247000,161751000,5215000,2657000,,75410000,75410000,51056,CORT
2017-12-31,40376000,,52806000,,129122000,62416000,155647000,52855000,52855000,,-49000.0,,,,-76316000,159201000,106346000,3554000,-49000,,129122000,129122000,51056,CORT
2016-12-31,23844000,,8140000,,8140000,45240000,79263000,10179000,10179000,,-2039000.0,,,,0,81321000,71142000,2058000,-2039000,,8140000,8140000,51056,CORT
2020-12-31,179993000,,-114852000,,-98593000,115522000,245743000,-49772000,-49772000,,-12952000,,,,-16259000,478596000,528368000,232853000,-65080000,,-98593000,-98593000,51059,MXL
2019-12-31,98344000,,-32484000,,-19898000,88762000,167685000,-19421000,-19421000,,-11133000,,,,-12586000,317180000,336601000,149495000,-13063000,,-19898000,-19898000,51059,MXL
2018-12-31,120046000,,-32852000,,-26199000,101789000,208774000,-13061000,-13061000,,-14255000,,,,-6653000,384997000,398058000,176223000,-19791000,,-26199000,-26199000,51059,MXL
2017-12-31,112279000,,-33998000,,-9187000,105831000,233520000,15410000,15410000,,-10378000,,,,-24811000,420318000,404908000,186798000,-49408000,,-9187000,-9187000,51059,MXL
2020-12-31,,,6524000000,,4932000000,2442000000,8266000000,5718000000,5718000000,,-205000000,,,,1238000000,16205000000,10487000000,7939000000,806000000,,5286000000,4932000000,51060,BLK
2019-12-31,,,5787000000,1382000000.0,4476000000,1705000000,7406000000,5604000000,5604000000,,-203000000,,,,1261000000,14539000000,8935000000,7133000000,183000000,,4526000000,4476000000,51060,BLK
2018-12-31,,,5378000000,1166000000.0,4305000000,1573000000,7205000000,5582000000,5582000000,,-184000000,,,,1076000000,14198000000,8616000000,6993000000,-204000000,,4302000000,4305000000,51060,BLK
2017-12-31,,,5259000000,466000000.0,4952000000,1438000000,6789000000,5262000000,5262000000,,-205000000,,,,270000000,13600000000,8338000000,6811000000,-3000000,,4989000000,4952000000,51060,BLK
2019-12-31,244509000,,-206516000,,-182178000,419774000,829620000,22081000,22081000,,-43172000,,,,-23914000,1771677000,1749596000,942057000,-228597000,,-182602000,-182178000,51061,MDRX
2018-12-31,268409000,,13138000,29314000.0,363740000,449267000,827419000,-19720000,-19720000,,-50914000,,,,469000,1749962000,1769682000,922543000,32858000,346544000.0,12669000,363740000,51061,MDRX
2017-12-31,202282000,,-190037000,470725000.0,-196459000,400688000,717524000,12484000,12484000,,-37540000,,,,-5514000,1497708000,1485224000,780184000,-202521000,-13502000.0,-184523000,-196459000,51061,MDRX
2016-12-31,178534000,,31560000,428420000.0,-25652000,334521000,672514000,72360000,72360000,,-29478000,,,,309000,1386069000,1313709000,713555000,-40800000,-56757000.0,31251000,-25652000,51061,MDRX
2020-09-26,,,153738000,871000,120676000,584581000,796558000,197977000,197977000,,-44016000,,,,32218000,2695509000,2497532000,1898951000,-44239000,,121520000,120676000,51063,CENT
2019-09-28,,,119251000,170000,92786000,534933000,704041000,154608000,154608000,,-42614000,,,,26604000,2383010000,2228402000,1678969000,-35357000,,92647000,92786000,51063,CENT
2018-09-29,,,127425000,385000,123594000,495340000,675376000,167336000,167336000,,-39196000,,,,3305000,2215362000,2048026000,1539986000,-39911000,,124120000,123594000,51063,CENT
2017-09-30,,,126429000,1456000,78828000,467896000,632808000,156112000,156112000,,-28209000,,,,46699000,2054478000,1898366000,1421670000,-29683000,,79730000,78828000,51063,CENT
2020-12-31,,,35588000,-18036000,27660000,26581000,223454000,88581000,88581000,,-53440000,,,,0,344573000,255992000,121119000,-52993000,,35588000,27660000,51065,AAT
2019-12-31,,,61007000,-20245000,45718000,27409000,237299000,113685000,113685000,,-54008000,,,,819000,362581000,248896000,125282000,-52678000,,60188000,45718000,51065,AAT
2018-12-31,,,27529000,-506000,19686000,24892000,211520000,79535000,79535000,,-52248000,,,,327000,326534000,246999000,115014000,-52006000,,27202000,19686000,51065,AAT
2017-12-31,,,40346000,10434000,29077000,23435000,200359000,93646000,93646000,,-53848000,,,,214000,310529000,216883000,110170000,-53300000,,40132000,29077000,51065,AAT
2019-12-31,53941000,,-89169000,26259000,-87190000,100389000,68881000,-93210000,-93210000,,,,,,-803000,148857000,242067000,79976000,4041000,,-88366000,-87190000,51066,AMWL
2018-12-31,36273000,,-52312000,27435000,-52674000,68846000,55343000,-55106000,-55106000,,,,,,0,113955000,169061000,58612000,2794000,,-52312000,-52674000,51066,AMWL
2020-06-30,1126000,,-3446000,,-3446000,7547000,5124000,-3476000,-3476000,-73000,,,,,0,9680000,13156000,4556000,30000,,-3446000,-3457000,51067,ISR
2019-06-30,1474000,,-5144000,,-5144000,6851000,3047000,-5278000,-5278000,-73000,,,,,0,7314000,12592000,4267000,134000,,-5144000,-5155000,51067,ISR
2018-06-30,1746000,,-6700000,,-6700000,6825000,1842000,-6729000,-6729000,-73000,,,,,0,5923000,12652000,4081000,29000,,-6700000,-6711000,51067,ISR
2017-06-30,965000,,-6162000,,-6162000,6230000,838000,-6309000,-6309000,-48000,,,,,0,4761000,11070000,3923000,147000,,-6162000,-6173000,51067,ISR
2020-12-31,,,19100000,31900000,3700000,81400000,284800000,69700000,69700000,,-56300000,,,,10300000,1333000000,1263300000,1048200000,-50600000,,8800000,3700000,51069,SXC
2019-12-31,,,-203100000,26800000,-152300000,81800000,329700000,104100000,104100000,,-60300000,,,,-54700000,1600300000,1496200000,1270600000,-307200000,,-148400000,-152300000,51069,SXC
2018-12-31,,,51600000,219600000,26200000,65600000,328900000,121700000,121700000,,-61500000,,,,4600000,1450900000,1329200000,1122000000,-70100000,,47000000,26200000,51069,SXC
2017-12-31,,,21900000,233400000,122400000,79200000,309700000,102300000,102300000,,-61700000,,,,-81600000,1331500000,1229200000,1021800000,-80400000,,103500000,122400000,51069,SXC
2019-12-31,1131180,,-8035372,,-8035372,6538804,453006,-7216978,-7216978,,-961495,,,,0,453006,7669984,0,-818394,,-8035372,-8035372,51070,CRTD
2018-12-31,636180,,-12013542,,-12013542,5130973,80898,-5686255,-5686255,,-3013294,,,,0,80898,5767153,0,-6327287,,-12013542,-14204408,51070,CRTD
2017-12-31,590227,,-8751586,,-8751586,5067754,95653,-5562328,-5562328,,-2305032,,,,0,95653,5657981,0,-3189258,,-8751586,-9048909,51070,CRTD
2016-12-31,590227,,-7391907,,-7391907,3539651,180606,-3691756,-3691756,,-3710151,,,,0,223927,3915683,43321,-3700151,,-7391907,-7639035,51070,CRTD
2020-09-30,3329451,,-6363430,,-6364230,3382591,311200,-6400842,-6400842,,,,,,800,328801,6729643,17601,37412,,-6364230,-6364230,51071,EDSA
2019-09-30,1353817,,-3141583,,-3141583,2193646,309584,-3237879,-3237879,,,,,,0,410870,3648749,101286,96296,,-3141583,-3141583,51071,EDSA
2018-12-31,1075491,,-1536556,,-1536556,543155,0,-1618646,-1618646,,,,,,0,0,1618646,0,82090,,-1536556,-1536556,51071,EDSA
2017-12-31,301776,,-875707,,-875707,451029,0,-902848,-902848,,,,,,0,0,902848,0,27141,,-875707,-875707,51071,EDSA
2019-12-31,5038000,,43168000,,36761000,25121000,70688000,40529000,40529000,,,,,,6407000,155066000,114537000,84378000,2639000,,36761000,36761000,51073,ATRI
2018-12-31,5513000,,42036000,,34255000,24558000,71778000,41707000,41707000,,,,,,7781000,152448000,110741000,80670000,329000,,34255000,34255000,51073,ATRI
2017-12-31,5799000,,42340000,,36593000,23681000,70754000,41274000,41274000,,,,,,5747000,146595000,105321000,75841000,1066000,,36593000,36593000,51073,ATRI
2016-12-31,6574000,,39266000,,27581000,21930000,67630000,39126000,39126000,,,,,,11685000,143487000,104361000,75857000,140000,,27581000,27581000,51073,ATRI
2020-12-31,,,96100000,,73559000,288374000,425437000,105826000,105826000,,-9746000,,,,22541000,3495644000,3389818000,3070207000,-9726000,,73559000,73559000,51074,HUBG
2019-12-31,,,143870000,,107171000,340169000,521070000,152420000,152420000,,-10994000,,,,36699000,3668117000,3515697000,3147047000,-8550000,,107171000,107171000,51074,HUBG
2018-12-31,,,116725000,,201740000,307361000,445601000,121616000,121616000,,-9611000,,,,29064000,3683593000,3561977000,3237992000,-4891000,114079000.0,87661000,201740000,51074,HUBG
2017-12-31,,,66931000,,135153000,252806000,337630000,72669000,72669000,,-6754000,,,,-53083000,3123063000,3050394000,2785433000,-7438000,15139000.0,120014000,135153000,51074,HUBG
2019-12-31,145922000,,-95419000,185000,-95186000,61686000,-43494000,-105180000,-105180000,,,,,,0,102428000,207608000,145922000,9761000,,-95419000,-95186000,51076,SGMO
2018-12-31,114866000,,-68889000,739000,-68334000,46736000,-30414000,-77150000,-77150000,,,,,,0,84452000,161602000,114866000,5561000,,-68889000,-68334000,51076,SGMO
2017-12-31,114866000,,-54568000,739000,-54568000,27200000,-29161000,-56361000,-56361000,,,,,,0,36567000,92928000,65728000,1793000,,-54568000,-54568000,51076,SGMO
2016-12-31,114866000,,-71672000,739000,-71658000,22230000,-46229000,-68459000,-68459000,,,,,,-14000,19389000,87848000,65618000,-3213000,,-71658000,-71658000,51076,SGMO
2020-09-30,6265000,,20330000,,16660000,67662000,94575000,20471000,20471000,,-228000,,,,3670000,518499000,498028000,423924000,-141000,,16660000,16660000,51078,POWL
2019-09-30,6327000,,12334000,,9890000,69950000,86976000,9822000,9822000,700000.0,-230000,,,,2444000,517180000,507358000,430204000,2512000,,9890000,9890000,51078,POWL
2018-09-30,6717000,,-7699000,,-7152000,66768000,65355000,-8335000,-8335000,700000.0,-207000,,,,-547000,448716000,457051000,383361000,636000,,-7152000,-7152000,51078,POWL
2017-09-30,6906000,,-16919000,,-9486000,61524000,50769000,-18016000,-18016000,700000.0,-168000,,,,-7433000,395911000,413927000,345142000,1097000,,-9486000,-9486000,51078,POWL
2019-12-31,,,-419503000,,-419503000,60792000,-111991000,-172783000,-172783000,,-2000,,,,0,3648000,176431000,115639000,-246720000,,-419503000,-419503000,51079,ZGNX
2018-12-31,,,-123716000,,-123914000,38950000,-100925000,-139875000,-139875000,,-6000,,,,0,0,139875000,100925000,16159000,-198000.0,-123716000,-123914000,51079,ZGNX
2017-12-31,,,-126022000,,-126817000,25885000,-68357000,-94242000,-94242000,,-2644000,,,,0,9821000,104063000,78178000,-31780000,-795000.0,-126022000,-126817000,51079,ZGNX
2016-12-31,39940000.0,,-69634000,,-69707000,28896000,6382000,-62454000,-62454000,,-2825000,,,,-948000,28850000,91304000,22468000,-7180000,-1021000.0,-68686000,-69707000,51079,ZGNX
2019-12-31,1035623,,-3808978,,-3808978,,-2113716,-3149339,-3149339,,,,,,0,1564024,4713363,3677740,-1311664,,-3808978,-3808978,51082,REFR
2018-12-31,863401,,-2686128,,-2686128,,-1554818,-2418219,-2418219,,,,,,0,1488642,3906861,3043460,-267909,,-2686128,-2686128,51082,REFR
2017-12-31,799702,,-2413859,,-2413859,,-1618909,-2418611,-2418611,,,,,,0,1509070,3927681,3127979,4752,,-2413859,-2413859,51082,REFR
2016-12-31,1417634,,-4238410,,-4238410,,-2850311,-4267945,-4267945,,,,,,0,1236097,5504042,4086408,29535,,-4238410,-4238410,51082,REFR
2020-12-31,,,414758000,586463000,379802000,91826000,638991000,233497000,233497000,,-128473000,,,,0,1027549000,794052000,388558000,181261000,,414758000,356105000,51083,SLG
2019-12-31,,,291487000,769030000,281345000,100875000,752549000,381816000,381816000,-2500000.0,-206298000,,,,0,1211177000,829361000,458628000,-90329000,,291487000,253745000,51083,SLG
2018-12-31,,,270856000,734566000,258646000,92631000,782840000,413902000,413902000,-3200000.0,-223034000,,,,0,1231503000,817601000,448663000,-143046000,,270856000,231760000,51083,SLG
2017-12-31,,,101069000,1128050000,112775000,100498000,962447000,458629000,458629000,-3200000.0,-275127000,,,,0,1533365000,1074736000,570918000,-357560000,,101069000,85953000,51083,SLG
2020-06-30,,,-4390000,184000,-5103000,5479000,7825000,580000,580000,,-3107000,,,,713000,48710000,48130000,40885000,-4970000,,-5103000,-5103000,51084,VVPR
2019-06-30,,,-5416000,184000,-5784000,5164000,6628000,-284000,-284000,,-3092000,,,,368000,54468000,54752000,47840000,-5132000,,-5784000,-5784000,51084,VVPR
2019-03-31,,,-10666000,184000,-11223000,7685000,6310000,-2795000,-2795000,,-3243000,,,,557000,39036000,41831000,32726000,-7867000,,-11223000,-11223000,51084,VVPR
2018-03-31,,,-34137000,184000,-27879000,12814000,5123000,-8951000,-8951000,,-3145000,,,,-6258000,33647000,42598000,28524000,-25186000,,-27879000,-27879000,51084,VVPR
2019-12-31,38516000,,-9678000,,-13457000,61471000,101707000,-1383000,-1383000,,-3981000,,,,3585000,306882000,308265000,205175000,-8295000,,-13263000,-13457000,51085,DZSI
2018-12-31,35306000,,4560000,615000.0,2767000,48321000,91943000,7180000,7180000,,-1738000,,,,1724000,282348000,275168000,190405000,-2620000,,2836000,2767000,51085,DZSI
2017-12-31,36080000,,-899000,534000.0,1071000,44641000,83377000,722000,722000,,-1019000,,,,-2072000,247114000,246392000,163737000,-1621000,,1173000,1071000,51085,DZSI
2016-12-31,25778000,,-13841000,416000.0,-15326000,26452000,41910000,-12080000,-12080000,,-830000,,,,1487000,150304000,162384000,108394000,-1761000,,-15328000,-15326000,51085,DZSI
2019-12-31,,,78260000,,98620000,90760000,194200000,88420000,88420000,,-13950000,,,,16320000,723530000,635110000,529330000,-10160000,36680000,61940000,98620000,51086,TRS
2018-12-31,,,92360000,,83300000,85140000,200110000,100260000,100260000,,-13910000,,,,18650000,705030000,604770000,504920000,-7900000,9590000,73710000,83300000,51086,TRS
2017-12-31,,,69880000,,30960000,84660000,189280000,89560000,89560000,,-14390000,,,,33920000,656160000,566600000,466880000,-19680000,-5000000,35960000,30960000,51086,TRS
2016-12-31,,,-58230000,,-39800000,134230000,210800000,59010000,59010000,,-13720000,,,,-18430000,794020000,735010000,583220000,-117240000,-5000000,-39800000,-39800000,51086,TRS
2019-12-31,62343000,,2525000,,7601000,153306000,252813000,32732000,32732000,,-26712000,,,,-5076000,411788000,379056000,158975000,-30207000,,7601000,7601000,51087,AVID
2018-12-31,62379000,,-9403000,,-10674000,156503000,246964000,18832000,18832000,,-23474000,,,,1271000,413282000,394450000,166318000,-28235000,,-10674000,-10674000,51087,AVID
2017-12-31,68212000,,-13422000,,-13555000,165349000,249916000,7105000,7105000,,-19964000,,,,133000,419003000,411898000,169087000,-20527000,,-13555000,-13555000,51087,AVID
2016-12-31,81564000,,45344000,,48219000,171809000,340523000,76852000,76852000,,-18903000,,,,-2875000,511930000,435078000,171407000,-31508000,,48219000,48219000,51087,AVID
2020-12-31,,,1769521000,,1353152000,2632982000,5154761000,0,1838193000,683586000,,,,,416369000,5154761000,3316568000,0,-68672000,,1353152000,1279068000,51089,MTB
2019-12-31,,,2547261000,,1929149000,2587972000,5967943000,0,2658286000,721685000,,,,,618112000,5967943000,3309657000,0,-111025000,,1929149000,1849509000,51089,MTB
2018-12-31,,,2508240000,,1918080000,2371485000,5796302000,0,2736288000,688529000,,,,,590160000,5796302000,3060014000,0,-228048000,,1918080000,1836028000,51089,MTB
2017-12-31,,,2323862000,,1408306000,2233711000,5464187000,0,2457099000,773377000,,,,,915556000,5464187000,3007088000,0,-133237000,,1408306000,1327503000,51089,MTB
2020-12-31,149072000,,439472000,,359188000,525362000,1301279000,542870000,542870000,,-71317000,,,,80284000,1870346000,1327476000,569067000,-103398000,,359188000,359188000,51090,QGEN
2019-12-31,157448000,,-77776000,,-41455000,504168000,1076773000,269964000,269964000,17771000.0,-74185000,,,,-36321000,1526424000,1256460000,449651000,-347740000,,-41455000,-41455000,51090,QGEN
2018-12-31,161852000,,225737000,,190380000,496849000,1059300000,284507000,284507000,20337000.0,-67293000,,,,35357000,1501848000,1217341000,442548000,-58770000,,190380000,190380000,51090,QGEN
2017-12-31,154084000,,114375000,,40394000,477642000,1002249000,233980000,233980000,24396000.0,-49685000,,,,73981000,1417536000,1183556000,415287000,-119605000,,40394000,40394000,51090,QGEN
2019-12-31,17000000,,-88000000,168000000,-109000000,249000000,581000000,282000000,282000000,,-201000000,,,,14000000,2642000000,2360000000,2061000000,-370000000,5000000,-102000000,-109000000,51091,TROX
2018-12-31,11000000,,43000000,179000000,-7000000,161000000,498000000,298000000,298000000,,-193000000,,,,13000000,1819000000,1521000000,1321000000,-255000000,5000000,30000000,-7000000,51091,TROX
2017-12-31,8000000,,-87000000,186000000,-285000000,169000000,389000000,185000000,185000000,,-188000000,,,,6000000,1698000000,1513000000,1309000000,-272000000,-179000000,-93000000,-285000000,51091,TROX
2016-12-31,9000000,,-264000000,144000000,-61000000,153000000,133000000,-56000000,-56000000,,-185000000,,,,-125000000,1309000000,1365000000,1176000000,-208000000,79000000,-139000000,-61000000,51091,TROX
2019-12-31,,,-82442000,140531000,-88234000,37028000,537983000,211930000,211930000,,-180112000,,,,436000,1040155000,828225000,502172000,-294372000,,-82878000,-88234000,51093,DHC
2018-12-31,,,292890000,156758000,286872000,85885000,665389000,293269000,293269000,,-179287000,,,,476000,1117164000,823895000,451775000,-379000,,292414000,286872000,51093,DHC
2017-12-31,,,152257000,172238000,147610000,103694000,660834000,280279000,280279000,,-165019000,,,,454000,1074729000,794450000,413895000,-128022000,,151803000,147610000,51093,DHC
2016-12-31,,,141719000,172238000,141295000,46559000,656147000,321757000,321757000,,-167574000,,,,424000,1058022000,736265000,401875000,-180038000,,141295000,141295000,51093,DHC
2019-12-31,,,-1452682,20949672,-1033799,4346392,8714978,568527,568527,,-1341551,,,,39749,11289356,10720829,2574378,-2021209,,-1492431,-1497213,51096,PSTL
2018-12-31,,,1087399,44593,1136009,1410344,5816577,2573996,2573996,,-1491101,,,,-60763,7685135,5111139,1868558,-1486597,,1148162,1136009,51096,PSTL
2017-12-31,,,568813,44577,1102146,1458043,5176092,2060062,2060062,,-1491249,,,,-543287,6726672,4666610,1550580,-1491249,,1112100,1102146,51096,PSTL
2019-12-31,27275000,,-94347000,,-94347000,65015000,4066000,-88224000,-88224000,,-8480000,,,,0,6074000,94298000,2008000,-6123000,,-94347000,-94347000,51097,KALA
2018-12-31,29290000,,-66738000,,-66738000,35431000,0,-64721000,-64721000,,-3314000,,,,0,0,64721000,0,-2017000,,-66738000,-66738000,51097,KALA
2017-12-31,29008000,,-42211000,,-42211000,10867000,0,-39875000,-39875000,,-1019000,,,,0,0,39875000,0,-2336000,,-42211000,-42211000,51097,KALA
2016-12-31,25029000,,-33167000,,-33167000,7640000,0,-32669000,-32669000,,-767000,,,,0,0,32669000,0,-498000,,-33167000,-33167000,51097,KALA
2019-12-31,,,17462000,,17462000,1600000,9814000,8214000,8214000,,-1125000,,,,0,9814000,1600000,0,9248000,,17462000,16005000,51100,PNI
2018-12-31,,,-269000,,-269000,1686000,10518000,8832000,8832000,,-893000,,,,0,10518000,1686000,0,-9101000,,-269000,-1948000,51100,PNI
2017-12-31,,,13069000,,13069000,1666000,10023000,8357000,8357000,,-348000,,,,0,10023000,1666000,0,4712000,,13069000,11981000,51100,PNI
2016-12-31,,,1604000,,1604000,1689000,9739000,8050000,8050000,,-118000,,,,0,9739000,1689000,0,-6446000,,1604000,1018000,51100,PNI
2019-12-31,,,962000000,148000000,920000000,107000000,1591000000,822000000,822000000,,-222000000,,,,30000000,5483000000,4661000000,3892000000,140000000,,932000000,920000000,51101,HST
2018-12-31,,,1301000000,200000000,1087000000,104000000,1601000000,813000000,813000000,,-176000000,,,,150000000,5554000000,4741000000,3953000000,488000000,,1151000000,1087000000,51101,HST
2017-12-31,,,651000000,196000000,564000000,98000000,1541000000,735000000,735000000,,-167000000,,,,80000000,5417000000,4682000000,3876000000,-84000000,,571000000,564000000,51101,HST
2016-12-31,,,811000000,204000000,762000000,96000000,1520000000,700000000,700000000,,-154000000,,,,40000000,5451000000,4751000000,3931000000,111000000,,771000000,762000000,51101,HST
2020-12-31,,,506000000,91000000,348000000,628000000,1272000000,678000000,678000000,-34000000,-76000000,,,,152000000,5987000000,5309000000,4715000000,-172000000,,354000000,348000000,51103,INGR
2019-12-31,,,582000000,21000000,413000000,611000000,1312000000,698000000,698000000,3000000,-84000000,,,,158000000,6209000000,5511000000,4897000000,-116000000,,424000000,413000000,51103,INGR
2018-12-31,,,621000000,20000000,443000000,607000000,1368000000,771000000,771000000,-10000000,-81000000,,,,167000000,6289000000,5518000000,4921000000,-150000000,,454000000,443000000,51103,INGR
2017-12-31,,,769000000,26000000,519000000,610000000,1481000000,880000000,880000000,-9000000,-79000000,,,,237000000,6244000000,5364000000,4763000000,-111000000,,532000000,519000000,51103,INGR
2020-12-31,,,307102000,10505000,305527000,30288000,310812000,92241000,92241000,,-76815000,,,,-224000,516268000,424027000,205456000,214861000,,307326000,305117000,51106,BDN
2019-12-31,,,34541000,10426000,34267000,32156000,344649000,102488000,102488000,,-84280000,,,,12000,570495000,468007000,225846000,-67947000,,34529000,33871000,51106,BDN
2018-12-31,,,135895000,12201000,134518000,27802000,315091000,111289000,111289000,,-80697000,,,,423000,533190000,421901000,218099000,24606000,,135472000,134149000,51106,BDN
2017-12-31,,,120549000,17420000,120173000,28538000,310956000,102095000,102095000,,-84321000,,,,-628000,517031000,414936000,206075000,18454000,,121177000,114633000,51106,BDN
2019-12-31,,,-713880000,,-715075000,284812000,-236462000,-522123000,-522123000,,-30669000,,,,1195000,380833000,902956000,617295000,-191757000,,-715075000,-715075000,51109,SRPT
2018-12-31,,,-362610000,,-361918000,209983000,-131102000,-341950000,-341950000,,-33709000,,,,-692000,301034000,642984000,432136000,-20660000,,-361918000,-361918000,51109,SRPT
2017-12-31,166107000.0,,-48628000,,-50688000,122682000,147231000,-142611000,-142611000,,-5801000,,,,2060000,154584000,297195000,7353000,93983000,,-50688000,-50688000,51109,SRPT
2016-12-31,166107000.0,,-267265000,,-267265000,81200000,-180639000,-261868000,-261868000,,-1892000,,,,0,5421000,267289000,186060000,-5397000,,-267265000,-267265000,51109,SRPT
2019-12-31,4393000,,367000,,516000,17199000,21935000,343000,343000,,-28000,,,,-149000,45748000,45405000,23813000,24000,,516000,516000,51110,TACT
2018-12-31,4576000,,6466000,,5426000,15408000,26743000,6759000,6759000,,-27000,,,,1040000,54587000,47828000,27844000,-293000,,5426000,5426000,51110,TACT
2017-12-31,4303000,,6772000,,3211000,15545000,26662000,6814000,6814000,,-33000,,,,3561000,56311000,49497000,29649000,-42000,,3211000,3211000,51110,TACT
2016-12-31,4425000,,5170000,,3617000,14174000,23799000,5200000,5200000,,-33000,,,,1553000,57235000,52035000,33436000,-30000,,3617000,3617000,51110,TACT
2019-12-31,,,107296000,145811000,52007000,19032000,154472000,108393000,108393000,122000,-634000,,,,16936000,241687000,133294000,87215000,-1097000,,90360000,50887000,51113,SOI
2018-12-31,,,98913000,142428000,42431000,16758000,136294000,101065000,101065000,49000,-374000,,,,12961000,197196000,96131000,60902000,-2152000,,85952000,41201000,51113,SOI
2017-12-31,,,48386000,140850000,-509000,14286000,50508000,25959000,25959000,3628000,-97000,,,,33709000,67395000,41436000,16887000,22427000,,14677000,-4174000,51113,SOI
2016-12-31,,,2846000,140850000,2803000,5157000,11810000,2861000,2861000,3628000,-23000,,,,43000,18157000,15296000,6347000,-15000,,2803000,2803000,51113,SOI
2020-12-31,,,-109184000,,-120138000,70869000,352333000,-34858000,-34858000,,-107468000,,,,10954000,935753000,970611000,583420000,-74326000,,-120138000,-120138000,51115,PDS
2019-12-31,,,-8339000,,6618000,104010000,502353000,44464000,44464000,20263000.0,-120029000,,,,-14957000,1541320000,1496856000,1038967000,-52803000,,6618000,6618000,51115,PDS
2018-12-31,,,-323596000,,-294270000,111830000,473925000,-14949000,-14949000,-14200000.0,-128622000,,,,-29326000,1541189000,1556138000,1067264000,-308647000,,-294270000,-294270000,51115,PDS
2017-12-31,,,-232057000,,-132036000,90072000,395053000,-72765000,-72765000,-14200000.0,-139626000,,,,-100021000,1321224000,1393989000,926171000,-159292000,,-132036000,-132036000,51115,PDS
2020-12-31,,,24280000,,19493000,29030000,60542000,0,26287000,5225000,,,,,4787000,60542000,34255000,0,-2007000,,19493000,19493000,51116,LARK
2019-12-31,,,12115000,,10662000,26157000,44763000,0,13574000,5032000,,,,,1453000,44763000,31189000,0,-1459000,,10662000,10662000,51116,LARK
2018-12-31,,,11594000,,10426000,24166000,40459000,0,11596000,4697000,,,,,1168000,40459000,28863000,0,-2000,,10426000,10426000,51116,LARK
2017-12-31,,,3472000,,4369000,23110000,40949000,0,5260000,12579000,,,,,-897000,40949000,35689000,0,-1788000,,4369000,4369000,51116,LARK
2019-12-31,,,6196011,,6196011,2555880,10181715,0,7471857,90412,,,,,0,10181715,2709858,0,-1275846,,6196011,6196011,51119,SACH
2018-12-31,,,7771785,,7771785,2102430,9953615,0,7797949,20707,,,,,0,9972615,2174666,19000,-26164,,7771785,7771785,51119,SACH
2017-12-31,,,4860848,,4860848,1256109,6332564,0,4892752,155345,,,,,0,6332564,1439812,0,-31904,,4860848,4574748,51119,SACH
2016-12-31,,,3050627,,3050627,489766,3628360,0,3138594,155345,,,,,0,3628360,489766,0,-87967,,3050627,3050627,51119,SACH
2019-12-31,,,-2969630,,-3844463,6433256,4140838,-2996135,-2996135,,,,,,-177501,5025212,8021347,884374,26505,-1052334,-2792129,-3844463,51121,IPDN
2018-12-31,,,-14520616,,-15081012,10170084,6620954,-6149124,-6149124,,,,,,-1353535,7620918,13770042,999964,-8371492,-1913931,-13167081,-15081012,51121,IPDN
2017-12-31,,,-23263911,,-22287549,18881025,13386847,-8501842,-8501842,,-12399.0,,,,-1687370,16080255,24582097,2693408,-14762069,-711008,-21576541,-22287549,51121,IPDN
2016-12-31,,,-5398136,,-4108502,24647648,23144599,-4826760,-4826760,,-1567317.0,,,,-1289634,26227066,31053826,3082467,-571376,-711008,-4108502,-4108502,51121,IPDN
2019-12-31,184000,,-9652000,,-9658000,13860000,4861000,-9183000,-9183000,,-1053000,,,,6000,6599000,15782000,1738000,-469000,,-9658000,-10487000,51122,NBY
2018-12-31,259000,,-6541000,,-6545000,18617000,11005000,-7871000,-7871000,,-1053000,,,,4000,12508000,20379000,1503000,1330000,,-6545000,-6545000,51122,NBY
2017-12-31,410000,,-7400000,,-7403000,22347000,15446000,-7311000,-7311000,,-1053000,,,,3000,18230000,25541000,2784000,-89000,,-7403000,-7403000,51122,NBY
2016-12-31,1371000,,-13149000,,-13151000,19044000,9433000,-10982000,-10982000,,-1053000,,,,2000,11897000,22879000,2464000,-2167000,,-13151000,-13151000,51122,NBY
2020-06-30,,,-13083000,7776000,-12975000,6737000,37290000,395000,395000,25921000,-7195000,,,,44000,64098000,63703000,26808000,-13478000,,-13127000,-12975000,51124,GEG
2019-06-30,,,-9050000,7928000,-2908000,6935000,29010000,-1735000,-1735000,20127000,-6250000,,,,-2182000,51180000,52915000,22170000,-7315000,3736000.0,-6868000,-2908000,51124,GEG
2018-06-30,,,-11670000,222000,-11067000,6699000,-2646000,-10469000,-10469000,20127000,-1071000,,,,-329000,5935000,16404000,8581000,-1201000,-165000.0,-11341000,-11067000,51124,GEG
2017-06-30,,,-18650000,-10000,-15207000,4413000,148000,-4605000,-4605000,20127000,-6321000,,,,-1210000,4927000,9532000,4779000,-14045000,2203000.0,-17440000,-15207000,51124,GEG
2019-12-31,,,299400000,,214500000,140000000,395100000,255100000,255100000,,-38400000,,,,57100000,1038100000,783000000,643000000,44300000,-27800000,242300000,214000000,51125,AWI
2018-12-31,,,242700000,,185900000,126000000,347600000,221600000,221600000,,-39200000,,,,53100000,975300000,753700000,627700000,21100000,-3700000,189600000,185300000,51125,AWI
2017-12-31,,,222100000,,119600000,127300000,325000000,197700000,197700000,,-35400000,,,,1500000,893600000,695900000,568600000,24400000,-101000000,220600000,118900000,51125,AWI
2016-12-31,,,150600000,,104700000,191200000,307000000,115800000,115800000,,-49500000,,,,51300000,837300000,721500000,530300000,34800000,5400000,99300000,104400000,51125,AWI
2020-07-31,1392000000,,2198000000,,1826000000,2727000000,6323000000,2176000000,2176000000,,-14000000,,,,372000000,7679000000,5503000000,1356000000,22000000,,1826000000,1826000000,51127,INTU
2019-07-31,1233000000,,1881000000,,1557000000,2524000000,5637000000,1854000000,1854000000,,-15000000,,,,324000000,6784000000,4930000000,1147000000,27000000,,1557000000,1557000000,51127,INTU
2018-07-31,1186000000,,1566000000,,1329000000,2295000000,5062000000,1560000000,1560000000,,-20000000,,,,237000000,6025000000,4465000000,963000000,6000000,,1329000000,1329000000,51127,INTU
2017-07-31,998000000,,1390000000,,985000000,1968000000,4398000000,1418000000,1418000000,,-31000000,,,,405000000,5196000000,3778000000,798000000,-28000000,,985000000,985000000,51127,INTU
2019-12-31,,,266947000,4383113000,90260000,16516000,846553000,535332000,535332000,,-253824000,,,,7598000,881078000,345746000,34525000,-268385000,16216000,259349000,90260000,51130,MGP
2018-12-31,,,219918000,4279535000,67065000,16048000,729645000,446289000,446289000,,-215532000,,,,5779000,869495000,423206000,139850000,-226371000,30563000,214139000,67065000,51130,MGP
2017-12-31,,,170896000,4443089000,41775000,12189000,643419000,370089000,370089000,,-184175000,,,,4906000,765695000,395606000,122276000,-199193000,30563000,165990000,41775000,51130,MGP
2016-12-31,,,37610000,4274444000,29938000,9896000,394801000,163952000,163952000,,-116212000,,,,2264000,467548000,303596000,72747000,-126342000,30563000,35346000,29938000,51130,MGP
2020-10-31,,,163237073,,163237073,50036343,270784233,220747890,220747890,,-28881806,,,,0,270784233,50036343,0,-57510817,,163237073,163237073,51132,NEA
2019-10-31,,,542280819,,542280819,48223217,268307419,220084202,220084202,,-46377750,,,,0,268307419,48223217,0,322196617,,542280819,542280819,51132,NEA
2018-10-31,,,-61250824,,-61250824,48555673,268138438,219582765,219582765,,-37648813,,,,0,268138438,48555673,0,-280833589,,-61250824,-61250824,51132,NEA
2017-10-31,,,117648158,,117648158,48356955,262461923,214104968,214104968,,-20232819,,,,0,262461923,48356955,0,-96456810,,117648158,117648158,51132,NEA
2020-12-31,,,816000000,1554000000,486000000,1248000000,2830000000,1590000000,1590000000,-8000000,-508000000,,,,66000000,4968000000,3378000000,2138000000,-774000000,,750000000,486000000,51133,QSR
2019-12-31,,,1452000000,1769000000,643000000,1227000000,3250000000,2027000000,2027000000,-4000000,-552000000,,,,341000000,5603000000,3576000000,2353000000,-575000000,,1111000000,643000000,51133,QSR
2018-12-31,,,1382000000,2007000000,612000000,1159000000,3117000000,1947000000,1947000000,11000000,-550000000,,,,238000000,5357000000,3410000000,2240000000,-565000000,,1144000000,612000000,51133,QSR
2017-12-31,,,1101000000,2334000000,648000000,352000000,2248000000,1895000000,1895000000,1000000,-538000000,,,,-134000000,4576000000,2681000000,2328000000,-794000000,,1235000000,626000000,51133,QSR
2020-01-31,3555000,,-2841000,,-2863000,9811000,13263000,-103000,-103000,,-309000,,,,22000,20743000,20846000,7480000,-2738000,,-2863000,2031000,51134,STRM
2019-01-31,4261000,,-5865000,,-5865000,10554000,14228000,-587000,-587000,,-384000,,,,0,22365000,22952000,8137000,-5278000,,-5865000,-5865000,51134,STRM
2018-01-31,5352000,,-3183000,,-3099000,11434000,14164000,-2622000,-2622000,,-474000,,,,-84000,24338000,26960000,10174000,-561000,,-3099000,-3099000,51134,STRM
2017-01-31,7453638,,-5173590,,-5161566,12728074,15532794,-4648918,-4648918,,-508859,,,,-12024,27059905,31708823,11527111,-524672,,-5161566,-6037501,51134,STRM
2019-12-31,,,109012000,,84342000,81482000,258267000,128372000,128372000,13016000,-24586000,,,,24670000,473869000,345497000,215602000,-19360000,,84342000,83987000,51135,AWR
2018-12-31,,,81888000,,63871000,79353000,226673000,104140000,104140000,2755000,-23433000,,,,18017000,436816000,332676000,210143000,-22252000,,63871000,63538000,51135,AWR
2017-12-31,,,108341000,,69367000,80313000,239417000,120107000,120107000,-34000,-22582000,,,,38974000,440603000,320496000,201186000,-11766000,,69367000,68994000,51135,AWR
2016-12-31,,,94478000,,59743000,80556000,239155000,115154000,115154000,4595000,-21992000,,,,34735000,436087000,320933000,196932000,-20676000,,59743000,59411000,51135,AWR
2020-03-31,,,-1010,,-1010,,-1010,-1010,-1010,,,,,,0,0,1010,1010,0,,-1010,-1010,51137,CFII
2019-12-31,1568000,,-4631000,,-4631000,3391000,-1568000,-4959000,-4959000,,,,,,0,0,4959000,1568000,328000,,-4631000,-4631000,51138,SAVA
2018-12-31,1568000,,-6557000,,-6557000,3693000,-2969000,-6662000,-6662000,,,,,,0,0,6662000,2969000,105000,,-6557000,-6557000,51138,SAVA
2017-12-31,1568000,,-11911000,,-11911000,4334000,-7615000,-11949000,-11949000,,,,,,0,0,11949000,7615000,38000,,-11911000,-11911000,51138,SAVA
2016-12-31,1568000,,-14850000,,-14850000,5781000,-9176000,-14957000,-14957000,,,,,,0,0,14957000,9176000,107000,,-14850000,-14850000,51138,SAVA
2020-06-27,198600000,,174300000,,135500000,226000000,734500000,256100000,256100000,,-61200000,,,,38800000,1678600000,1422500000,944100000,-81800000,,135500000,135500000,51142,LITE
2019-06-29,184600000,,-33300000,,-36400000,182000000,554400000,141300000,141300000,,-36300000,,,,3100000,1565300000,1424000000,1010900000,-174600000,,-36400000,-37900000,51142,LITE
2018-06-30,156800000,,129400000,35800000.0,248100000,128200000,435300000,147100000,147100000,,-18200000,,,,-118700000,1247700000,1100600000,812400000,-17700000,,248100000,241500000,51142,LITE
2017-07-01,148300000,,-59800000,35800000.0,-102500000,110200000,324600000,59600000,59600000,,-5500000,,,,42700000,1001600000,942000000,677000000,-119400000,,-102500000,-103400000,51142,LITE
2019-12-31,2005717,,-10005713,,-10005713,13259693,3232629,-12032781,-12032781,,-132521,,,,0,10441364,22474145,7208735,2027068,,-10005713,-10005713,51143,DGLY
2018-12-31,1444063,,-15544551,,-15544551,13073802,3961808,-10556057,-10556057,,-1717982,,,,0,11291409,21847466,7329601,-4988494,,-15544551,-15544551,51143,DGLY
2017-12-31,3149011,,-12342457,,-12252457,12595427,4544973,-11199465,-11199465,,-733736,,,,-90000,14577600,25777065,10032627,-1142992,,-12252457,-12252457,51143,DGLY
2016-12-31,3186137,,-12710688,,-12710688,14601284,5301233,-12486188,-12486188,,-284672,,,,0,16574491,29060679,11273258,-224500,,-12710688,-12710688,51143,DGLY
2019-12-31,,,-345047000,,-342459000,54729000,552962000,302111000,302111000,-69624000,-62482000,,,,-2588000,837281000,535170000,284319000,-647158000,,-342459000,-342459000,51144,LPI
2018-12-31,,,328844000,,324595000,96138000,661779000,391476000,391476000,-38512000,-57904000,,,,4249000,1105775000,714299000,443996000,-62632000,,324595000,324595000,51144,LPI
2017-12-31,,,550774000,,548974000,96312000,509304000,250022000,250022000,4581000,-89377000,,,,1800000,822162000,572140000,312858000,300752000,,548974000,548974000,51144,LPI
2016-12-31,,,-260739000,,-260739000,91756000,318889000,-14323000,-14323000,93117000,-94140000,,,,0,597378000,611701000,278489000,-246416000,,-260739000,-260739000,51144,LPI
2019-12-31,,,27750000,,27750000,15125000,71945000,20009000,20009000,,-17805000,,,,0,146591000,126582000,74646000,7741000,,27750000,2566000,51145,UMH
2018-12-31,,,-36216000,,-36216000,14129000,64922000,19102000,19102000,,-16039000,,,,0,129587000,110485000,64665000,-55318000,,-36216000,-56532000,51145,UMH
2017-12-31,,,12668000,,12668000,12741000,56330000,16031000,16031000,,-15877000,,,,0,112648000,96617000,56318000,-3363000,,12668000,-7679000,51145,UMH
2016-12-31,,,11534559,,11534559,10857330,50108976,16037546,16037546,,-15432364,,,,0,99213829,83176283,49104853,-4502987,,11534559,-2568873,51145,UMH
2020-07-31,,,272896000,25787000,222974000,634119000,1118207000,386854000,386854000,,-107322000,,,,51512000,8167933000,7781079000,7049726000,-113958000,,221384000,222974000,51146,THO
2019-07-31,,,184666000,10803000,133275000,536044000,1034512000,422830000,422830000,,-68112000,,,,52201000,7864758000,7441928000,6830246000,-238164000,,132465000,133275000,51146,THO
2018-07-31,,,633029000,10803000,430151000,477444000,1164666000,632104000,632104000,,-5187000,,,,202878000,8328909000,7696805000,7164243000,925000,,430151000,430151000,51146,THO
2017-07-31,,,556386000,10803000,374254000,419847000,1043583000,559811000,559811000,,-9730000,,,,182132000,7246952000,6687141000,6203369000,-3425000,,374254000,374254000,51146,THO
2020-12-31,,,89160000,,69829000,111863000,214544000,0,93305000,9376000,,,,,19331000,214544000,121239000,0,-4145000,,69829000,69678000,51147,WASH
2019-12-31,,,88179000,,69118000,99330000,198919000,0,89740000,9849000,,,,,19061000,198919000,109179000,0,-1561000,,69118000,68979000,51147,WASH
2018-12-31,,,86692000,,68432000,94297000,192854000,0,88796000,9761000,,,,,18260000,192854000,104058000,0,-2104000,,68432000,68288000,51147,WASH
2017-12-31,,,77640000,,45925000,92465000,181740000,0,79679000,9596000,,,,,31715000,181740000,102061000,0,-2039000,,45925000,45817000,51147,WASH
2019-12-31,,,122800000,41300000,77300000,30000000,66900000,-62400000,-62400000,58600000,-17800000,,,,24200000,1070000000,1132400000,1003100000,185200000,-51800000,98600000,77300000,51148,CNNE
2018-12-31,,,6500000,75100000,27600000,34700000,19000000,-105200000,-105200000,43200000,-4700000,,,,15000000,1147500000,1252700000,1128500000,111700000,-2100000,-8500000,27600000,51148,CNNE
2017-12-31,,,-70900000,93700000,108800000,35500000,70000000,-67700000,-67700000,56000000,-7000000,,,,-14200000,1156600000,1224300000,1086600000,-3200000,149200000,-56700000,108800000,51148,CNNE
2016-12-31,,,-24300000,116300000,-12400000,36100000,126000000,600000,600000,44600000,-5200000,,,,-10400000,1178400000,1177800000,1052400000,-24900000,2000000,-13900000,-12400000,51148,CNNE
2019-12-31,,,555067000,863317000,530884000,74134000,709628000,351190000,351190000,,-181488000,,,,70117000,1624921000,1273731000,915293000,203877000,,484950000,522398000,51149,AQN
2018-12-31,,,132461000,860882000,184988000,57700000,691859000,373387000,373387000,,-152118000,,,,53372000,1648463000,1275076000,956604000,-240926000,,79089000,176961000,51149,AQN
2017-12-31,,,175132000,644189000,101705000,58675000,678482000,368493000,368493000,,-155678000,,,,73427000,1521938000,1153445000,843456000,-193361000,,101705000,93685000,51149,AQN
2016-12-31,,,129510000,591792000,92374000,46349000,467702000,234454000,234454000,,-131592000,,,,37136000,1096018000,861564000,628316000,-104944000,,92374000,81974000,51149,AQN
2019-12-31,,,-25033000,,-25124000,20785000,12765000,-8020000,-8020000,,-21154000,,,,91000,65896000,73916000,53131000,-17013000,,-25124000,-25124000,51150,TLGT
2018-12-31,,,-36318000,,-36256000,21484000,8309000,-13175000,-13175000,,-12298000,,,,-62000,65865000,79040000,57556000,-23143000,,-36256000,-36256000,51150,TLGT
2017-12-31,,,-15276000,,-15191000,19791000,8107000,-11684000,-11684000,,-11198000,,,,-85000,60202000,71886000,52095000,-3592000,,-15191000,-15191000,51150,TLGT
2016-12-31,,,-11698000,,-11985000,15005000,17547000,2542000,2542000,,-13304000,,,,287000,63012000,60470000,45465000,-14240000,,-11985000,-11985000,51150,TLGT
2020-12-31,,,-59456000,,-32819000,57476000,41645000,-15831000,-15831000,,-3655000,,,,-26587000,507411000,523242000,465766000,-43625000,,-32869000,-32819000,51151,NWHM
2019-12-31,,,-11816000,112000.0,-8037000,60292000,63342000,3050000,3050000,,-3655000,,,,-3815000,669349000,666299000,606007000,-14866000,,-8001000,-8037000,51151,NWHM
2018-12-31,,,-20305000,76000.0,-14216000,62031000,71900000,9869000,9869000,,-3655000,,,,-6075000,667566000,657697000,595666000,-30174000,,-14230000,-14216000,51151,NWHM
2017-12-31,,,32531000,90000.0,17152000,59032000,93126000,34094000,34094000,,-3655000,,,,15390000,751166000,717072000,658040000,-1563000,,17141000,17152000,51151,NWHM
2020-06-28,,,-8123000,23219000,-7605000,44577000,35446000,-9131000,-9131000,,-920000,,,,-2266000,385300000,394431000,349854000,1008000,,-5857000,-7605000,51154,STRT
2019-06-30,,,-20433000,24428000,-17029000,47875000,57800000,9925000,9925000,,-1615000,,,,-7740000,487006000,477081000,429206000,-30358000,,-12693000,-17029000,51154,STRT
2018-07-01,,,17698000,21088000,12283000,40721000,54443000,13722000,13722000,,-1137000,,,,2070000,439195000,425473000,384752000,3976000,,15628000,12283000,51154,STRT
2017-07-02,,,16394000,21626000,7197000,47253000,60955000,13702000,13702000,,-417000,,,,4284000,417325000,403623000,356370000,2692000,,12110000,7196000,51154,STRT
2020-09-27,,,227991000,54000,173859000,203015000,446535000,243520000,243520000,,-14475000,,,,54101000,2348572000,2105052000,1902037000,-15529000,,173890000,173859000,51155,TTEK
2019-09-29,,,175136000,178000,158668000,196930000,408183000,211253000,211253000,,-15358000,,,,16375000,2389637000,2178384000,1981454000,-36117000,,158761000,158668000,51155,TTEK
2018-09-30,,,174562000,129000,136883000,185720000,384458000,198738000,198738000,,-17348000,,,,37605000,2200734000,2001996000,1816276000,-24176000,,136957000,136883000,51155,TTEK
2017-10-01,,,171761000,171000,117874000,177219000,353638000,176419000,176419000,,-12310000,,,,53844000,2034010000,1857591000,1680372000,-4658000,,117917000,117874000,51155,TTEK
2017-12-31,,,16131000,-150318000,18769000,5286000,50944000,32121000,32121000,,-16724000,,,,-3145000,52625000,20504000,1681000,-15990000,,19276000,12096000,51156,LMRKN
2016-12-31,,,9921000,-135630000,9811000,3755000,37962000,23016000,23016000,,-11617000,,,,0,41171000,18155000,3209000,-13095000,,9921000,7103000,51156,LMRKN
2015-12-31,,,1205000,-47633000,1205000,2923000,29065000,17491000,17491000,,-11404000,,,,0,33597000,16106000,4532000,-16286000,,1205000,736000,51156,LMRKN
2014-12-31,,,2530000,12349,2530000,821000,22571000,15492000,15492000,,-9585000,,,,0,25141000,9649000,2570000,-12962000,,2530000,-2698000,51156,LMRKN
2021-01-02,,,200711000,,152318000,1674581000,2191849000,375884000,375884000,,-12094000,,,,48393000,4387991000,4012107000,2196142000,-175173000,,152318000,152318000,51157,FLO
2019-12-28,,,212083000,,164538000,1548572000,1968265000,275465000,275465000,,-38847000,,,,47545000,4123974000,3848509000,2155709000,-63382000,,164538000,164538000,51157,FLO
2018-12-29,,,197161000,,157160000,1471076000,1885024000,269824000,269824000,,-35686000,,,,40001000,3951852000,3682028000,2066828000,-72663000,,157160000,157160000,51157,FLO
2017-12-30,,,149293000,,150120000,1460173000,1911260000,304368000,304368000,,-36557000,,,,-827000,3920733000,3616365000,2009473000,-155075000,,150120000,150120000,51157,FLO
2019-12-31,,,6708000,,4911000,21675000,20958000,-717000,-717000,,-198000,,,,1797000,58674000,59391000,37716000,7425000,,4911000,4911000,51158,PFIN
2018-12-31,,,1109000,,856000,21705000,23187000,1482000,1482000,,-228000,,,,253000,64995000,63513000,41808000,-373000,,856000,856000,51158,PFIN
2017-12-31,,,-249000,,-884000,21034000,21084000,50000,50000,,-168000,,,,635000,58974000,58924000,37890000,-299000,,-884000,-884000,51158,PFIN
2016-12-31,,,-8638000,,6901000,19610000,18931000,-679000,-679000,,-181000,,,,-2955000,57276000,57955000,38345000,-7959000,12584000.0,-5683000,6901000,51158,PFIN
2019-12-31,,,39841000,,39838000,8815000,164294000,111567000,111567000,,-74994000,,,,3000,261102000,149535000,96808000,-71726000,,39838000,17567000,51159,GSL
2018-12-31,,,-57309000,,-57364000,9221000,106250000,61574000,61574000,,-48686000,,,,55000,157097000,95523000,50847000,-118883000,,-57364000,-60426000,51159,GSL
2017-12-31,,,-74226000,,-74266000,5367000,115619000,72271000,72271000,,-59413000,,,,40000,159278000,87007000,43659000,-146497000,,-74266000,-77328000,51159,GSL
2016-12-31,,,-65049000,,-65095000,6224000,120776000,71747000,71747000,,-44788000,,,,46000,166837000,95090000,46061000,-136796000,,-65095000,-68157000,51159,GSL
2020-09-25,613000000,,524000000,112000000,-241000000,1377000000,3735000000,1745000000,1745000000,,-48000000,,,,783000000,12172000000,10427000000,8437000000,-1221000000,18000000,-259000000,-241000000,51160,TEL
2019-09-27,644000000,,1931000000,112000000,1844000000,1489000000,4394000000,2261000000,2261000000,,-68000000,,,,-15000000,13448000000,11187000000,9054000000,-330000000,-102000000,1946000000,1844000000,51160,TEL
2018-09-28,680000000,,2240000000,112000000,2565000000,1591000000,4745000000,2486000000,2486000000,-12000000.0,-107000000,,,,-344000000,13988000000,11502000000,9243000000,-246000000,-19000000,2584000000,2565000000,51160,TEL
2017-09-29,611000000,,1720000000,112000000,1683000000,1577000000,4183000000,1994000000,1994000000,1000000.0,-130000000,,,,180000000,12185000000,10191000000,8002000000,-274000000,143000000,1540000000,1683000000,51160,TEL
2019-12-31,,,346403000,505000,345673000,6354000,58184000,24456000,24456000,,-12175000,,,,882000,139989000,115533000,81805000,321947000,,345521000,322696000,51163,CMCTP
2018-12-31,,,2067000,837000,1121000,9167000,91180000,28785000,28785000,,-26894000,,,,925000,196486000,167701000,105306000,-26718000,,1142000,-14298000,51163,CMCTP
2017-12-31,,,381134000,890000,379737000,5479000,85296000,21453000,21453000,,-34484000,,,,1376000,228677000,207224000,143381000,359681000,,379758000,377813000,51163,CMCTP
2016-12-31,,,32358000,912000,34547000,7961000,107006000,27077000,27077000,,-34385000,,,,1646000,265931000,238854000,158925000,5281000,3853000.0,30712000,34538000,51163,CMCTP
2020-12-31,,,80343000,,75733000,202005000,641722000,150906000,150906000,288811000,-72709000,,,,5895000,847396000,696490000,205674000,-70563000,1285000,74448000,75733000,51165,CURO
2019-12-31,,,142455000,,111488000,209249000,900565000,222765000,222765000,468551000,-69763000,,,,38557000,1141797000,919032000,241232000,-80310000,7590000,103898000,111488000,51165,CURO
2018-12-31,,,18118000,,-22053000,191764000,806433000,193069000,193069000,421600000,-84382000,,,,1659000,1045073000,852004000,238640000,-174951000,-38512000,16459000,-22053000,51165,CURO
2017-12-31,,,102256000,,49153000,184318000,694294000,197410000,197410000,312566000,-82696000,,,,41647000,924137000,726727000,229843000,-95154000,-11456000,60609000,49153000,51165,CURO
2019-12-31,9590000,,-20697000,-938000,-20855000,32414000,22775000,-19338000,-19338000,109000,-1690000,,,,158000,48780000,68118000,26005000,-1359000,,-20855000,-20855000,51167,CNTG
2018-12-31,6300000,,-11648000,-757000,-11338000,26084000,20537000,-10503000,-10503000,-1344000,-922000,,,,-310000,40478000,50981000,19941000,-1145000,,-11338000,-11338000,51167,CNTG
2017-12-31,6396000,,-5462000,-382000,-5476000,15395000,16750000,-4530000,-4530000,-511000,-827000,,,,14000,31689000,36219000,14939000,-932000,,-5476000,-5476000,51167,CNTG
2016-12-31,5885000,,-5767000,-267000,-5359000,14252000,14813000,-5026000,-5026000,-298000,-645000,,,,-408000,27669000,32695000,12856000,-741000,,-5359000,-5359000,51167,CNTG
2019-12-31,61800000,,50493000,48198000,-527646000,854680000,1409556000,357307000,357307000,,-122403000,,,,31630000,3327458000,2970151000,1917902000,-306814000,-536009000,18863000,-527646000,51170,CFX
2018-12-31,34200000,,92364000,207186000,140196000,456460000,729376000,195013000,195013000,,-50183000,,,,-29508000,2193083000,1998070000,1463707000,-102649000,32601000,121872000,140196000,51170,CFX
2017-12-31,32800000,,48559000,226849000,151090000,425351000,671579000,173631000,173631000,,-45106000,,,,2483000,1937282000,1763651000,1265703000,-125072000,123431000,46076000,151090000,51170,CFX
2016-12-31,39300000,,206524000,196473000,128111000,605635000,992382000,290082000,290082000,,-39476000,,,,51772000,3185753000,2895671000,2193371000,-83558000,-9561000,154752000,128111000,51170,CFX
2021-01-02,287887000,,15301000,,12531000,199839000,527526000,39800000,39800000,,-34142000,,,,2770000,886677000,846877000,359151000,-24499000,,12531000,12531000,51173,SLAB
2019-12-28,257150000,,49649000,,19265000,196437000,510284000,56697000,56697000,,-20233000,,,,30384000,837554000,780857000,327270000,-7048000,,19265000,19265000,51173,SLAB
2018-12-29,238347000,,72161000,,83591000,197844000,521399000,85208000,85208000,,-19694000,,,,-11430000,868267000,783059000,346868000,-13047000,,83591000,83591000,51173,SLAB
2017-12-30,209491000,,76903000,,47092000,159726000,454191000,84974000,84974000,,-14128000,,,,29811000,768867000,683893000,314676000,-8071000,,47092000,47092000,51173,SLAB
2019-12-31,17187000,,31458000,33000,23303000,88415000,140595000,32627000,32627000,2366000,-2217000,,,,8122000,444861000,412234000,304266000,-1169000,,23336000,23303000,51174,PLPC
2018-12-31,15107000,,32588000,33000,26581000,81756000,132231000,32934000,32934000,2434000,-1290000,,,,6007000,420878000,387944000,288647000,-346000,,26581000,26581000,51174,PLPC
2017-12-31,14327000,,25806000,33000,12654000,77208000,118628000,26108000,26108000,985000,-1061000,,,,13152000,378212000,352104000,259584000,-302000,,12654000,12654000,51174,PLPC
2016-12-31,14025000,,20953000,33000,15255000,73856000,109414000,21479000,21479000,54000,-844000,,,,5698000,336634000,315155000,227220000,-526000,,15255000,15255000,51174,PLPC
2020-02-29,21602000,,-40940000,-27950000,-26443000,107399000,109776000,-19225000,-19225000,,-3569000,,,,882000,394889000,414114000,285113000,-21715000,,-41822000,-26443000,51177,VOXX
2019-02-28,24387000,,-58963000,-12571000,-46091000,110850000,121417000,-13820000,-13820000,,-4449000,,,,-6131000,446816000,460636000,325399000,-45143000,,-52832000,-46091000,51177,VOXX
2018-02-28,26440000,,-24104000,-5830000,35304000,124956000,132297000,-19099000,-19099000,,-6009000,,,,-17445000,507092000,526191000,374795000,-5005000,34618000.0,-6659000,35304000,51177,VOXX
2017-02-28,29517000,,-8930000,1310000,4422000,122681000,144030000,-8168000,-8168000,,-7105000,,,,338000,514530000,522698000,370500000,-762000,6066000.0,-9268000,4422000,51177,VOXX
2019-12-31,1031204,,9527678,,9073954,5788869,16302329,9482256,9482256,,-171938,,,,453724,23834129,14351873,7531800,45422,,9073954,9073954,51178,BHAT
2018-12-31,286842,,8524836,,7919408,3818195,12422502,8317465,8317465,,-142641,,,,605428,18531178,10213713,6108676,207371,,7919408,7919408,51178,BHAT
2017-12-31,355730,,6080167,,5124973,2544619,8844807,5944458,5944458,,-183291,,,,955194,14144894,8200436,5300087,135709,,5124973,5124973,51178,BHAT
2016-12-31,159186,,3059975,,2574317,1797922,4775331,2818223,2818223,,-130826,,,,485658,9352650,6534427,4577319,241752,,2574317,2574317,51178,BHAT
2019-12-31,,,-3008000000,1765000000,-3553000000,406000000,4630000000,-1243000000,-1243000000,349000000,-400000000,,,,674000000,6213000000,7456000000,1583000000,-1765000000,,-3682000000,-3553000000,51181,APA
2018-12-31,,,958000000,1682000000,40000000,431000000,5628000000,1611000000,1611000000,340000000,-406000000,,,,672000000,7216000000,5605000000,1588000000,-653000000,,286000000,40000000,51181,APA
2017-12-31,,,918000000,1375000000,1304000000,395000000,4363000000,715000000,715000000,424000000,-415000000,,,,-585000000,5792000000,5077000000,1429000000,203000000,,1503000000,1304000000,51181,APA
2016-12-31,,,-1682000000,1441000000,-1405000000,410000000,3609000000,-1087000000,-1087000000,768000000,-424000000,,,,-442000000,5238000000,6325000000,1629000000,-595000000,-33000000.0,-1240000000,-1405000000,51181,APA
2019-12-31,2818000,,-8482000,3000,-8479000,5031000,-1000,-7850000,-7850000,,,,,,0,0,7850000,1000,-632000,,-8482000,-8479000,51182,CLIR
2018-12-31,3834000,,-9500000,3000,-9500000,5840000,103000,-9571000,-9571000,,,,,,0,530000,10101000,427000,-251000,,-9500000,-9500000,51182,CLIR
2017-12-31,4451000,,-9680000,3000,-9680000,5421000,160000,-9712000,-9712000,,,,,,0,540000,10252000,380000,32000,,-9680000,-9680000,51182,CLIR
2016-12-31,4624000,,-11173000,3000,-11173000,4746000,136000,-9234000,-9234000,,,,,,0,621000,9855000,485000,-1939000,,-11173000,-11173000,51182,CLIR
2019-12-31,,,13742000,,13742000,14527000,28757000,0,14230000,,,,,,0,28757000,14527000,0,-488000,,13742000,11142000,51183,AIW
2018-12-31,,,-91064000,,-91797000,13370000,-77694000,0,-91064000,,,,,,733000,-77694000,13370000,0,0,,-91797000,-92387000,51183,AIW
2017-12-31,,,57038000,,17435000,18570000,75608000,0,57038000,,,,,,39603000,75608000,18570000,0,0,,17435000,17184000,51183,AIW
2016-12-31,,,-13960000,,-41347000,16777000,6796000,0,-9981000,,,,,,27387000,6796000,16777000,0,-3979000,,-41347000,-41347000,51183,AIW
2020-12-31,,,228796000,4000,228799000,38161000,632319000,397459000,397459000,76000,-129431000,,,,0,660681000,263222000,28362000,-168663000,,228796000,210161000,51184,NNN
2019-12-31,,,299608000,7000,299180000,37651000,642831000,416048000,416048000,261000,-120023000,,,,0,670487000,254439000,27656000,-116440000,,299608000,257582000,51184,NNN
2018-12-31,,,292485000,355000,292447000,34248000,597562000,388916000,388916000,261000,-115847000,,,,0,622661000,233745000,25099000,-112861000,,292485000,257572000,51184,NNN
2017-12-31,,,265371000,317000,264973000,33805000,561828000,345348000,345348000,8955000,-109109000,,,,0,584933000,239585000,23105000,-79977000,,265371000,216662000,51184,NNN
2019-12-31,161851588,,-323873694,-15814216,-315833726,281398475,267413824,-175836239,-175836239,,-6750341,,,,652610,650282167,826118406,382868343,-148037455,,-324526304,-315833726,51186,RAAS
2018-12-31,125990376,,-259660303,-6406275,-246112580,236887912,188497674,-174380614,-174380614,,-1685245,,,,2672098,501488667,675869281,312990993,-85279689,,-262332401,-246112580,51186,RAAS
2019-12-31,,,389161000,,380064000,118209000,530069000,411860000,411860000,,-12176000,,,,-570000,2641393000,2229533000,2111324000,-22699000,-9667000,389731000,371445000,51191,REGI
2018-12-31,2037000.0,,309499000,,292316000,106739000,419991000,313252000,313252000,,-17534000,,,,5871000,2382987000,2069735000,1962996000,-3753000,-11312000,303628000,284492000,51191,REGI
2017-12-31,2418000.0,,-96769000,,-79079000,95843000,84354000,-11489000,-11489000,,-18755000,,,,-30490000,2154655000,2166144000,2070301000,-85280000,-12800000,-66279000,-79079000,51191,REGI
2016-12-31,4890000.0,,68109000,2831000.0,44327000,88285000,171385000,78210000,78210000,,-15987000,,,,4268000,2039232000,1961022000,1867847000,-10101000,-19128000,63841000,43076000,51191,REGI
2019-12-31,42333000,,-51939000,,-51930000,8358000,0,-50691000,-50691000,,-3031000,,,,-9000,0,50691000,0,-1248000,,-51930000,-59106000,51192,GRTX
2018-12-31,18663000,,-23899000,,-23676000,5592000,0,-24255000,-24255000,,-220000,,,,-223000,0,24255000,0,356000,,-23676000,-29586000,51192,GRTX
2017-12-31,20594000,,-23905000,,-23545000,3500000,0,-24094000,-24094000,,-220000,,,,-360000,0,24094000,0,189000,,-23545000,-28133000,51192,GRTX
2020-06-30,2315000,,7902000,,6112000,3766000,13142000,7061000,7061000,,-236000,,,,1790000,34834000,27773000,21692000,841000,,6112000,6112000,51193,PDEX
2019-06-30,1882000,,5447000,,4148000,2907000,9780000,4991000,4991000,,-220000,,,,1299000,27172000,22181000,17392000,456000,,4148000,4148000,51193,PDEX
2018-06-30,1893000,,2610000,,1621000,2645000,7943000,3405000,3405000,,-7000,,,,989000,22465000,19060000,14522000,-795000,,1621000,1621000,51193,PDEX
2017-06-30,1225000,,2752000,,5084000,3114000,7186000,2847000,2847000,,-12000,,,,-2089000,21943000,19096000,14757000,-95000,243000.0,4841000,5084000,51193,PDEX
2020-12-31,38153000,,-10904000,,-9656000,92471000,128617000,-2007000,-2007000,,-9354000,,,,-1248000,198420000,200427000,69803000,-8897000,,-9656000,-9656000,51194,VCRA
2019-12-31,34280000,,-17960000,,-17980000,88942000,109099000,-14123000,-14123000,,-8789000,,,,20000,180501000,194624000,71402000,-4147000,,-17980000,-17980000,51194,VCRA
2018-12-31,30879000,,-10025000,,-9674000,87313000,111887000,-6305000,-6305000,,-5241000,,,,-351000,179630000,185935000,67743000,-4030000,,-9674000,-9674000,51194,VCRA
2017-12-31,27685000,,-10138000,,-10897000,84077000,101062000,-10700000,-10700000,,-5241000,,,,759000,165989000,176689000,64927000,562000,,-10897000,-10897000,51194,VCRA
2020-06-30,,,-71776000,,-192654000,257839000,355569000,64744000,64744000,,-12224000,,,,7451000,3047734000,2982990000,2692165000,-136520000,-113427000,-79227000,-192654000,51195,SCSC
2019-06-30,,,83637000,,57597000,251730000,392803000,111152000,111152000,,-13162000,,,,18778000,3249799000,3138647000,2856996000,-27515000,-7262000,64859000,57597000,51195,SCSC
2018-06-30,,,63049000,,33153000,232291000,369306000,106049000,106049000,,-9121000,,,,27593000,3164709000,3058660000,2795403000,-43000000,-2303000,35456000,33153000,51195,SCSC
2017-06-30,,,101495000,,69246000,265178000,383596000,93450000,93450000,,-3215000,,,,32249000,3568186000,3474736000,3184590000,8045000,-2303000,69246000,69246000,51195,SCSC
2020-12-31,,,338890000,,286502000,742853000,1160895000,0,355686000,62356000,,,,,52388000,1160895000,805209000,0,-16796000,,286502000,286502000,51197,UMBF
2019-12-31,,,285965000,,243600000,716960000,1064825000,0,302960000,44905000,,,,,42365000,1064825000,761865000,0,-16995000,,243600000,243600000,51197,UMBF
2018-12-31,,,223594000,,195513000,656825000,941394000,0,242053000,42516000,,,,,27334000,941394000,699341000,0,-18459000,-747000.0,196260000,195513000,51197,UMBF
2017-12-31,,,236346000,,247105000,634679000,941475000,0,259199000,47597000,,,,,53370000,941475000,682276000,0,-22853000,64129000.0,182976000,247105000,51197,UMBF
2020-03-31,,,11882699,,11882699,842369,10255162,9412793,9412793,,,,,,0,10255162,842369,0,2469906,,11882699,11882699,51198,NXQ
2019-03-31,,,14987066,,14987066,802719,10147234,9344515,9344515,,,,,,0,10147234,802719,0,5642551,,14987066,14987066,51198,NXQ
2018-03-31,,,10208895,,10208895,835348,10049987,9214639,9214639,,,,,,0,10049987,835348,0,994256,,10208895,10208895,51198,NXQ
2017-03-31,,,1944252,,1944252,859017,10327153,9468136,9468136,,,,,,0,10327153,859017,0,-7523884,,1944252,1944252,51198,NXQ
2019-12-31,150000000,,3788000000,997000000,2805000000,292000000,4377000000,1755000000,1755000000,,-301000000,,,,832000000,9740000000,7985000000,5363000000,2033000000,-72000000,2956000000,2805000000,51199,NEM
2018-12-31,153000000,,705000000,1010000000,341000000,245000000,3254000000,1175000000,1175000000,,-207000000,,,,386000000,7253000000,6078000000,3999000000,-470000000,61000000,319000000,341000000,51199,NEM
2017-12-31,143000000,,1056000000,984000000,-114000000,250000000,3323000000,1567000000,1567000000,,-241000000,,,,1127000000,7379000000,5812000000,4056000000,-511000000,-38000000,-71000000,-114000000,51199,NEM
2016-12-31,134000000,,-233000000,1153000000,-629000000,258000000,3056000000,1434000000,1434000000,,-273000000,,,,579000000,6680000000,5246000000,3624000000,-1667000000,-403000000,-812000000,-629000000,51199,NEM
2020-12-31,,,9000000,,6950000,,33780000,0,9000000,24780000,,,,,1954000,33780000,24780000,0,0,,7046000,5405000,51200,PBHC
2019-12-31,,,5451000,235000.0,4276000,21387000.0,31108000,0,6284000,3437000,,,,,1165000,31108000,24824000,0,-833000,,4286000,3578000,51200,PBHC
2018-12-31,,,4555000,238000.0,4031000,19573000.0,28104000,0,5197000,3334000,,,,,546000,28104000,22907000,0,-642000,,4009000,4031000,51200,PBHC
2017-12-31,,,4345000,333000.0,3491000,18006000.0,25439000,0,4818000,2615000,,,,,922000,25439000,20621000,0,-473000,,3423000,3491000,51200,PBHC
2019-12-31,13600000,,138600000,,108500000,160500000,322800000,148700000,148700000,,-7900000,,,,30200000,1221300000,1072600000,898500000,-10100000,100000,108400000,108500000,51202,FSS
2018-12-31,13000000,,111600000,,94000000,146500000,282100000,122600000,122600000,,-9300000,,,,17900000,1089500000,966900000,807400000,-11000000,300000,93700000,94000000,51202,FSS
2017-12-31,13000000,,61000000,,61600000,131700000,221200000,76500000,76500000,,-7300000,,,,500000,898500000,822000000,677300000,-15500000,1100000,60500000,61600000,51202,FSS
2016-12-31,13400000,,56800000,,43800000,109200000,183400000,60800000,60800000,,-1900000,,,,17400000,707900000,647100000,524500000,-4000000,4400000,39400000,43800000,51202,FSS
2019-12-31,,,-411472000,,-411472000,132034000,-294299000,-426333000,-426333000,,,,,,0,117912000,544245000,412211000,14861000,,-411472000,-411472000,51203,AGIO
2018-12-31,,,-346028000,,-346028000,114145000,-248334000,-362479000,-362479000,,,,,,0,94387000,456866000,342721000,16451000,,-346028000,-346028000,51203,AGIO
2017-12-31,,,-314670000,,-314670000,71124000,-249670000,-320794000,-320794000,,,,,,0,43011000,363805000,292681000,6124000,,-314670000,-314670000,51203,AGIO
2016-12-31,,,-198471000,,-198471000,50714000,-150271000,-200985000,-200985000,,,,,,0,69892000,270877000,220163000,2514000,,-198471000,-198471000,51203,AGIO
2020-12-31,,,-610300000,2700000,-561300000,313900000,582700000,182200000,182200000,,-212300000,,,,-49200000,4710800000,4528600000,4128100000,-792500000,,-561100000,-561300000,51204,AXL
2019-12-31,,,-533000000,2800000,-484500000,379800000,902600000,427400000,427400000,,-217300000,,,,-48900000,6530900000,6103500000,5628300000,-960400000,,-484100000,-484500000,51204,AXL
2018-12-31,,,-113900000,2400000,-57500000,386000000,1140400000,655000000,655000000,,-216300000,,,,-57100000,7270400000,6615400000,6130000000,-768900000,,-56800000,-57500000,51204,AXL
2017-12-31,,,340000000,4000000,337100000,396400000,1119100000,647400000,647400000,,-195600000,,,,2500000,6266000000,5618600000,5146900000,-307400000,,337500000,329600000,51204,AXL
2019-12-31,137423,,-8869388,252333,-9470250,13985069,4572153,-9550339,-9550339,,-1937,,,,806803,4572153,14122492,0,680951,,-9676191,-9470250,51207,BTBT
2018-12-31,447884,,-3998297,467156,-3425981,11626161,7889201,-4184844,-4184844,,-9064,,,,-461171,7889201,12074045,0,186547,,-3537126,-3425981,51207,BTBT
2017-12-31,411852,,-1268366,605111,-942368,7827382,6953757,-1285477,-1285477,,-1703,,,,-271541,6953757,8239234,0,17111,,-996825,-942368,51207,BTBT
2016-12-31,417901,,219749,960056,160905,3071015,3705770,216854,216854,,-274,,,,54938,3705770,3488916,0,2895,,164811,160905,51207,BTBT
2020-12-31,,,1428100000,192800000,1199900000,,2890000000,1706100000,1706100000,208000000,-494900000,,,,227900000,7241700000,5535600000,4351700000,-278000000,,1200200000,1199900000,51208,WEC
2019-12-31,,,1258500000,141200000,1134000000,-30100000.0,2665600000,1567600000,1567600000,201800000,-502700000,,,,125000000,7523100000,5955500000,4857500000,-309100000,,1133500000,1134000000,51208,WEC
2018-12-31,,,1229100000,53800000,1059300000,-18900000.0,2518200000,1494400000,1494400000,196900000,-446300000,,,,169800000,7679500000,6185100000,5161300000,-265300000,,1059300000,1059300000,51208,WEC
2017-12-31,,,1587200000,30400000,1203700000,-1900000.0,2776800000,1785200000,1785200000,194900000,-416900000,,,,383500000,7648500000,5863300000,4871700000,-198000000,,1203700000,1203700000,51208,WEC
2020-12-31,,,695000000,,498000000,2922000000,3797000000,875000000,875000000,,-144000000,,,,197000000,10606000000,9731000000,6809000000,-180000000,,498000000,498000000,51210,CCEP
2019-12-31,,,1454000000,,1090000000,3046000000,4593000000,1547000000,1547000000,,-137000000,,,,364000000,12017000000,10470000000,7424000000,-93000000,,1090000000,1090000000,51210,CCEP
2018-12-31,,,1205000000,,909000000,3159000000,4482000000,1323000000,1323000000,,-134000000,,,,296000000,11518000000,10195000000,7036000000,-118000000,,909000000,909000000,51210,CCEP
2017-12-31,,,1159000000,,688000000,3033000000,4290000000,1257000000,1257000000,,-141000000,,,,471000000,11062000000,9805000000,6772000000,-164000000,,688000000,688000000,51210,CCEP
2019-12-31,16358962,,-12794493,,-12794493,9809423,-1698063,-27866448,-27866448,,,,,,0,0,27866448,1698063,15071955,,-12794493,-12794493,51212,CFRX
2018-12-31,21732370,,-37684424,,-37684424,8707774,-684281,-31124425,-31124425,,,,,,0,0,31124425,684281,-6559999,,-37684424,-37684424,51212,CFRX
2017-12-31,16831283,,-15517658,,-15517658,9049671,-482803,-26363757,-26363757,,,,,,0,0,26363757,482803,10846099,,-15517658,-15517658,51212,CFRX
2016-12-31,20511052,,-28538399,,-28538399,11430526,-1590668,-33532246,-33532246,,,,,,0,0,33532246,1590668,4993847,,-28538399,-28538399,51212,CFRX
2019-12-31,23348000,,4320000,3107000,1646000,84775000,109707000,7016000,7016000,-5432000,-3682000,,,,2595000,196679000,189663000,86972000,-2836000,,1725000,1646000,51213,MTLS
2018-12-31,22416000,,3452000,3107000,3027000,78613000,102422000,4918000,4918000,-3525000,-1747000,,,,425000,184721000,179803000,82299000,-1466000,,3027000,3027000,51213,MTLS
2017-12-31,19959000,,-1595000,3107000,-2117000,63202000,79621000,1236000,1236000,-4776000,-1026000,,,,522000,142573000,141337000,62952000,-2831000,,-2117000,-2117000,51213,MTLS
2016-12-31,17682000,,-1309000,3107000,-3019000,56194000,67771000,-345000,-345000,-5760000,-665000,,,,1710000,114477000,114822000,46706000,-964000,,-3019000,-3019000,51213,MTLS
2019-12-31,,,7507000,,7507000,75861000,131701000,27193000,27193000,,-16846000,,,,0,141532000,114339000,9831000,-19686000,,7507000,7507000,51215,NMCI
2018-12-31,,,12700000,,12700000,61185000,128429000,28692000,28692000,,-11785000,,,,0,133921000,105229000,5492000,-15992000,,12700000,12700000,51215,NMCI
2017-12-31,,,3957000,,3957000,28125000,55888500,7396500,7396500,,-3439500,,,,0,58782000,51385500,2893500,-3477000,,3957000,3957000,51215,NMCI
2020-10-31,,,-6844100,,-6844100,3564363,13645592,10081229,10081229,,-3275185,,,,0,13645592,3564363,0,-16925329,,-6844100,-6844100,51218,EVG
2019-10-31,,,10957308,,10957308,3703328,19773266,16069938,16069938,,-4450050,,,,0,19773266,3703328,0,-5112630,,10957308,10957308,51218,EVG
2018-10-31,,,5054671,,5054671,3863814,18662883,14799069,14799069,,-2256776,,,,0,18662883,3863814,0,-9744398,,5054671,5054671,51218,EVG
2017-10-31,,,22304556,,22304556,4076611,18569425,14492814,14492814,,-1909895,,,,0,18569425,4076611,0,7811742,,22304556,22304556,51218,EVG
2019-12-31,,,-290162000,,-290170000,58298000,-225990000,-285220000,-285220000,,-11197000,,,,8000,26517000,311737000,252507000,-4942000,,-290170000,-290170000,51219,RETA
2018-12-31,97288000.0,,-80520000,,-80546000,32748000,-43699000,-76878000,-76878000,,-6176000,,,,26000,53589000,130467000,97288000,-3642000,,-80546000,-80546000,51219,RETA
2017-12-31,97288000.0,,-47668000,,-47671000,23260000,-23215000,-46912000,-46912000,,-1454000,,,,3000,48058000,94970000,71273000,-756000,,-47671000,-47671000,51219,RETA
2016-12-31,97288000.0,,-6668000,,-6227000,16603000,10277000,-6882000,-6882000,-126000.0,-1454000,,,,-441000,49730000,56612000,39453000,214000,,-6227000,-6227000,51219,RETA
2019-12-31,,,1103118,,432541,1144123,0,-1144123,-1144123,,,,,,670577,0,1144123,0,2247241,,432541,-775405,51220,GIX
2020-03-31,15974000,,-25513000,,-25513000,8464000,0,-24438000,-24438000,,-247000,,,,0,0,24438000,0,-1075000,,-25513000,-25513000,51221,ACST
2019-03-31,29373000,,-39366000,,-39366000,4292000,0,-33665000,-33665000,,-278000,,,,0,0,33665000,0,-5701000,,-39366000,-39366000,51221,ACST
2018-03-31,15669000,,-21504000,,-21504000,4027000,0,-19696000,-19696000,,-366000,,,,0,0,19696000,0,-1808000,,-21504000,-21504000,51221,ACST
2017-03-31,7064308,,-10500924,,-10381847,3283385,0,-10347693,-10347693,,-36000,,,,-119077,0,10347693,0,-153230,,-10381847,-10381847,51221,ACST
2019-12-31,9269000,,-14113000,,-14113000,2730000,0,-11999000,-11999000,,-3260000,,,,0,0,11999000,0,-2114000,,-14113000,-15815000,51226,HYLN
2018-12-31,15733000,,-19281000,,-19281000,4070000,0,-19803000,-19803000,,-366000,,,,0,0,19803000,0,522000,,-19281000,-20697000,51226,HYLN
2020-12-31,78994000,,-8464000,,-8391000,76251000,194573000,24216000,24216000,-221000,-23188000,,,,-73000,454163000,429947000,259590000,-32680000,,-8391000,-8391000,51228,VECO
2019-12-31,90557000,,-77956000,,-78733000,79749000,158194000,-29155000,-29155000,-42000,-22085000,,,,777000,419349000,448504000,261155000,-48801000,,-78733000,-78733000,51228,VECO
2018-12-31,97755000,,-433834000,,-407088000,92060000,193719000,-29142000,-29142000,695000,-21518000,,,,-26746000,542082000,571224000,348363000,-404692000,,-407088000,-407088000,51228,VECO
2017-12-31,81987000,,-88990000,,-51396000,100250000,185828000,-31486000,-31486000,-398000,-19457000,,,,-37594000,475686000,507172000,289858000,-57504000,,-51396000,-51396000,51228,VECO
2019-12-31,,,203972000,216135000,174966000,13761000,301503000,183493000,183493000,,-657000,,,,0,429846000,246353000,128343000,20479000,,203972000,108703000,51229,PSB
2018-12-31,,,271901000,218091000,226702000,12072000,288886000,177572000,177572000,,-665000,,,,0,413516000,235944000,124630000,94329000,,271901000,172899000,51229,PSB
2017-12-31,,,179316000,196625000,155037000,12671000,279026000,172085000,172085000,,-1285000,,,,0,401374000,229289000,122348000,7231000,,179316000,90425000,51229,PSB
2016-12-31,,,144984000,197455000,128029000,14862000,263763000,149415000,149415000,,-5664000,,,,0,386871000,237456000,123108000,-4431000,,144984000,62872000,51229,PSB
2019-12-31,23438000,,-25446000,,-25446000,4673000,0,-28111000,-28111000,,-1829000,,,,0,0,28111000,0,2665000,,-25446000,-25446000,51233,BLRX
2018-12-31,19808000,,-22962000,,-22962000,5797000,0,-25605000,-25605000,,-290000,,,,0,0,25605000,0,2643000,,-22962000,-22962000,51233,BLRX
2017-12-31,19510000,,-24352000,,-24352000,5730000,0,-25240000,-25240000,,-290000,,,,0,0,25240000,0,888000,,-24352000,-24352000,51233,BLRX
2016-12-31,11177000,,-15841000,,-15841000,5336000,0,-16513000,-16513000,,-8000,,,,0,0,16513000,0,672000,,-15841000,-15841000,51233,BLRX
2019-12-31,,,185621574000,114873053000,130141692000,464519216000,914222507000,226029951000,226029951000,223673340000,-27720203000,,,,39975914000,1822540697000,1596510746000,908318190000,-40408377000,,145645660000,130141692000,51234,CCU
2018-12-31,,,458211348000,108989235000,306890792000,466767641000,923270945000,256187259000,256187259000,200316045000,-23560662000,,,,136126817000,1783282337000,1527095078000,860011392000,202024089000,,322084531000,306890792000,51234,CCU
2017-12-31,,,196474395000,125751551000,129607353000,432741778000,899622139000,224481391000,224481391000,242398970000,-24166313000,,,,48365976000,1698360794000,1473879403000,798738655000,-28006996000,,148108419000,129607353000,51234,CCU
2016-12-31,,,170328270000,123357563000,118457488000,426158117000,817077792000,189026564000,189026564000,201893111000,-20307238000,,,,30246383000,1558897708000,1369871144000,741819916000,-18698294000,,140081887000,118457488000,51234,CCU
2019-12-31,4843554,,-663085,500,-900337,13636259,19402263,922450,922450,,-165560,,,,237252,58308019,57385569,38905756,-1585535,,-900337,-900337,51235,OSS
2018-12-31,4001757,,-2969404,500,-1136278,9844162,11334724,-2511195,-2511195,,-65693,,,,-1396784,37027382,39538577,25692658,-458209,,-1572620,-1136278,51235,OSS
2017-12-31,2687249,,-619255,436842,96620,6361920,8664536,-384633,-384633,,-199257,,,,-402717,27538333,27922966,18873797,-234622,,-216538,96620,51235,OSS
2016-12-31,1599585,,-367374,436842,-184437,4026391,5513706,-112270,-112270,,-152877,,,,-182937,18879321,18991591,13365615,-255104,,-184437,-184437,51235,OSS
2021-01-02,,,282000000,,309000000,122000000,751000000,629000000,629000000,,-145000000,,,,-27000000,11651000000,11022000000,10900000000,-347000000,,309000000,309000000,51239,TXT
2020-01-04,,,942000000,,815000000,1039000000,2199000000,1160000000,1160000000,,-146000000,,,,127000000,13630000000,12470000000,11431000000,-218000000,,815000000,815000000,51239,TXT
2018-12-29,,,1384000000,,1222000000,1199000000,2347000000,1148000000,1148000000,,-135000000,,,,162000000,13972000000,12824000000,11625000000,236000000,,1222000000,1222000000,51239,TXT
2017-12-30,,,762000000,,307000000,1305000000,2342000000,1037000000,1037000000,,-145000000,,,,456000000,14198000000,13161000000,11856000000,-275000000,1000000.0,306000000,307000000,51239,TXT
2019-12-31,,,-43656,,-43656,43656,0,-43656,-43656,,,,,,0,0,43656,0,0,,-43656,-43656,51243,PAIC
2019-12-31,,,80400000,,62000000,104500000,298900000,145300000,145300000,,-24600000,,,,18400000,1514100000,1368800000,1215200000,-64900000,,62000000,62000000,51246,KALU
2018-12-31,,,120000000,,91700000,102300000,285200000,139000000,139000000,,-22700000,,,,28300000,1585900000,1446900000,1300700000,-19000000,,91700000,91700000,51246,KALU
2017-12-31,,,133000000,,45400000,102000000,311600000,169900000,169900000,,-22200000,,,,87600000,1397500000,1227600000,1085900000,-36900000,,45400000,45400000,51246,KALU
2016-12-31,,,147200000,,91700000,108400000,324900000,180500000,180500000,,-20300000,,,,55500000,1330600000,1150100000,1005700000,-33300000,,91700000,91700000,51246,KALU
2019-12-31,,,2058000,,1556000,6608000,9290000,0,2063000,619000,,,,,502000,9290000,7227000,0,-5000,,1556000,1556000,51247,FFBW
2018-12-31,,,1376000,,1058000,6477000,8687000,0,1412000,798000,,,,,318000,8687000,7275000,0,-36000,,1058000,1058000,51247,FFBW
2017-12-31,,,78000,,-186000,6180000,7630000,0,105000,1345000,,,,,264000,7630000,7525000,0,-27000,,-186000,-186000,51247,FFBW
2016-12-31,,,15000,,171000,6228000,7254000,0,55000,971000,,,,,-156000,7254000,7199000,0,-40000,,171000,171000,51247,FFBW
2020-12-31,107296000,,66127000,6470000,-55162000,355029000,664118000,137398000,137398000,,-58888000,,,,11724000,1862716000,1725318000,1198598000,-71271000,-109461000,54403000,-55162000,51249,BDC
2019-12-31,94360000,,152410000,5972000,-377015000,393193000,797522000,235360000,235360000,,-55814000,,,,42519000,2131278000,1895918000,1333756000,-82950000,-486667000,109891000,-395452000,51249,BDC
2018-12-31,91435000,,230080000,441000,160894000,402581000,847873000,278717000,278717000,,-60839000,,,,62936000,2165702000,1886985000,1317829000,-48637000,-6433000,167144000,125963000,51249,BDC
2017-12-31,88643000,,97988000,631000,93210000,380996000,841733000,281906000,281906000,,-82651000,,,,-4619000,2087185000,1805279000,1245452000,-183918000,-9754000,102607000,58279000,51249,BDC
2020-05-31,,,2153206,,2153206,3568037,21331401,17763364,17763364,,-4492096,,,,0,21331401,3568037,0,-15610158,,2153206,2153206,51251,NMY
2019-05-31,,,23681722,,23681722,3454885,21144866,17689981,17689981,,-5129945,,,,0,21144866,3454885,0,5991741,,23681722,23681722,51251,NMY
2018-05-31,,,5487332,,5487332,3506065,20791245,17285180,17285180,,-4088199,,,,0,20791245,3506065,0,-11797848,,5487332,5487332,51251,NMY
2017-05-31,,,5184467,,5184467,3554040,21251019,17696979,17696979,,-3539364,,,,0,21251019,3554040,0,-12512512,,5184467,5184467,51251,NMY
2019-12-31,,,-28385044,,-28385044,4244848,871798,-3654005,-3654005,,-4223902,,,,0,4959005,8613010,4087207,-24731039,,-28385044,-28385044,51254,GRIL
2018-12-31,,,-7204540,,-7202469,4358131,1409379,-3585846,-3585846,436209.0,-3258746,,,,0,6022669,9608515,4613290,-3618694,,-7204540,-7202469,51254,GRIL
2017-12-31,,,-15814278,-69928.0,-13210448,7983673,1136868,-7623541,-7623541,330367.0,-3972128,,,,-246527,7929137,15552678,6792269,-8190737,,-15567751,-13210448,51254,GRIL
2016-12-31,,,-4092405,159717.0,-3109581,4770613,1304181,-3966149,-3966149,295231.0,-138933,,,,127282,4953205,8919354,3649024,-126256,,-4219687,-3109581,51254,GRIL
2019-12-31,1099000,,-18234000,,-18242000,31445000,26187000,-6357000,-6357000,,-10308000,,,,8000,66200000,72557000,40013000,-11877000,,-18242000,-23756000,51255,TLMD
2018-12-31,1778000,,-19824000,,-18064000,30525000,23383000,-8920000,-8920000,,-7607000,,,,-1760000,53712000,62632000,30329000,-10904000,,-18064000,-22197000,51255,TLMD
2019-12-31,11817255,,-141261615,50391547,-122253989,116035728,35855665,-91409171,-91409171,-588147,,,,,-7149119,97770167,189179338,61914502,-49852444,4894197,-134112496,-128262480,51258,AACG
2018-12-31,19594484,,-68053474,39576017,854925914,49078025,-2912859,-67791950,-67791950,-3793418,,,,,0,1338592,69130542,4251451,-261524,918665587,-68053474,835591366,51258,AACG
2017-12-31,19712994,,-88022197,36647572,-24060357,42191087,2508887,-59395194,-59395194,-3793418,,,,,19920486,7493617,66888811,4984730,-28627003,82437963,-107942683,-31558626,51258,AACG
2017-03-31,19924466,,-58222793,1079928,-9716002,41304085,4424116,-56804435,-56804435,-3793418,,,,,1517806,8831390,65635825,4407274,-1418358,50024597,-59740599,-9716002,51258,AACG
2020-12-31,,,19560000,,15717000,23971000,49860000,0,19560000,6329000,,,,,3843000,49860000,30300000,0,0,,15717000,15082000,51260,MNSB
2019-12-31,,,17304000,,13950000,21863000,42680000,0,17984000,2833000,,,,,3354000,42680000,24696000,0,-680000,,13950000,13950000,51260,MNSB
2018-12-31,,,11303000,,9209000,17279000,31282000,0,12036000,1967000,,,,,2094000,31282000,19246000,0,-733000,,9209000,9209000,51260,MNSB
2017-12-31,,,6216765,,3882210,13199253,21874915,0,6699196,1976466,,,,,2334555,21874915,15175719,0,-482431,,3882210,3882210,51260,MNSB
2020-10-31,,,-54841591,,-54841591,2215388,8862025,6646637,6646637,,,,,,0,8862025,2215388,0,-61488228,,-54841591,-54841591,51263,CEE
2019-10-31,,,37575337,,37575337,2503220,11440974,8937754,8937754,,,,,,0,11440974,2503220,0,28637583,,37575337,37575337,51263,CEE
2018-10-31,,,-1339643,,-1339643,2551289,9634880,7083591,7083591,,,,,,0,9634880,2551289,0,-8423234,,-1339643,-1339643,51263,CEE
2017-10-31,,,41919314,,41919314,2538574,6500818,3962244,3962244,,,,,,0,6500818,2538574,0,37957070,,41919314,41919314,51263,CEE
2020-12-31,,,8067000,,6832000,21971000,37732000,0,8067000,7694000,,,,,1235000,37732000,29665000,0,0,,6832000,6832000,51264,GFED
2019-12-31,,,11098248,,9415090,22884690,38596382,0,11906887,3804805,,,,,1683158,38596382,26689495,0,-808639,,9415090,9415090,51264,GFED
2018-12-31,,,9186692,,7331879,21001579,38645025,0,13704862,3938584,,,,,1854813,38645025,24940163,0,-4518170,,7331879,7331879,51264,GFED
2017-12-31,,,7728413,,5157664,15757129,26744071,0,8124798,2862144,,,,,2570749,26744071,18619273,0,-396385,,5157664,5157664,51264,GFED
2020-09-30,,,17599000,,14416000,34793000,58187000,0,21029000,2365000,,,,,3183000,58187000,37158000,0,-3430000,,14416000,14416000,51267,ESSA
2019-09-30,,,15038000,,12623000,34619000,53091000,0,15683000,2789000,,,,,2415000,53091000,37408000,0,-645000,,12623000,12623000,51267,ESSA
2018-09-30,,,12195000,,6531000,34600000,52048000,0,13511000,3937000,,,,,5664000,52048000,38537000,0,-1316000,,6531000,6531000,51267,ESSA
2017-09-30,,,8930000,,7339000,36572000,49968000,0,9673000,3723000,,,,,1591000,49968000,40295000,0,-743000,,7339000,7339000,51267,ESSA
2020-12-31,873011000,,-50939000,,-1135626000,1450292000,2349961000,26658000,26658000,,-152878000,,,,1084687000,3716349000,3689691000,1366388000,-77597000,,-1135626000,-1135626000,51268,TWTR
2019-12-31,682281000,,390139000,,1465659000,1273634000,2322288000,366373000,366373000,,-138180000,,,,-1075520000,3459329000,3092956000,1137041000,23766000,,1465659000,1465659000,51268,TWTR
2018-12-31,553858000,,423544000,,1205596000,1070179000,2077362000,453325000,453325000,,-132606000,,,,-782052000,3042359000,2589034000,964997000,-29781000,,1205596000,1205596000,51268,TWTR
2017-12-31,542010000,,-95418000,,-108063000,1001307000,1582057000,38740000,38740000,,-105237000,,,,12645000,2443299000,2404559000,861242000,-134158000,,-108063000,-108063000,51268,TWTR
2019-12-31,,,-43306000,,-44415000,233755000,263691000,29936000,29936000,,-20378000,,,,1109000,734902000,704966000,471211000,-73242000,,-44415000,-44415000,51269,LCUT
2018-12-31,,,1169000,,-1720000,229932000,255757000,25825000,25825000,,-18004000,,,,2889000,704542000,678717000,448785000,-24656000,,-1720000,-1720000,51269,LCUT
2017-12-31,,,11186000,,2154000,198253000,215157000,16904000,16904000,,-4291000,,,,9032000,579476000,562572000,364319000,-5718000,,2154000,2154000,51269,LCUT
2016-12-31,,,22750000,,15720000,186203000,216900000,30697000,30697000,,-4803000,,,,7030000,592619000,561922000,375719000,-7947000,,15720000,15720000,51269,LCUT
2020-09-30,,,5805349,2743273,5063710,2728009,7539153,4811144,4811144,,-242877,,,,864908,50033200,45222056,42494047,994205,,4940441,5063710,51270,QLI
2019-09-30,,,6941919,2744576,5332318,3501374,9679912,6178538,6178538,,-223657,,,,1033440,46096684,39918146,36416772,763381,,5908479,5332318,51270,QLI
2018-09-30,,,6145972,2399406,5169507,2160873,8132240,5971367,5971367,,-216187,,,,943363,50369013,44397646,42236773,174605,,5202609,5169507,51270,QLI
2017-09-30,,,1859430,2222162,1435856,2251750,3382262,1130512,1130512,,-282842,,,,321458,22537345,21406833,19155083,728918,,1537972,1435856,51270,QLI
2019-12-31,,,14559000,15375000,10580000,9361000,7930000,-1651000,-1651000,220000,,,,,3980000,49523000,51174000,41593000,16210000,,10579000,10580000,51273,TRC
2018-12-31,,,5555000,15376000,4255000,9705000,10141000,377000,377000,59000,,,,,1320000,45619000,45242000,35478000,5178000,,4235000,4255000,51273,TRC
2017-12-31,,,-3104000,28568000,-1797000,9713000,2195000,-7793000,-7793000,275000,,,,,-1283000,35255000,43048000,33060000,4689000,,-1821000,-1797000,51273,TRC
2016-12-31,,,1253000,28592000,800000,11811000,5046000,-7346000,-7346000,581000,,,,,496000,45979000,53325000,40933000,8599000,,757000,800000,51273,TRC
2019-12-31,8240000,,-3177000,170000,-1465000,45782000,54449000,427000,427000,,-3089000,,,,-1446000,122661000,122234000,68212000,-3604000,,-1731000,-1465000,51274,HSKA
2018-12-31,3334000,,3735000,170000,5850000,42510000,56638000,10794000,10794000,,-310000,,,,-2115000,127446000,116652000,70808000,-7059000,,5850000,5850000,51274,HSKA
2017-12-31,2004000,,18369000,170000,9953000,38038000,58261000,18219000,18219000,,-245000,,,,8913000,129341000,111122000,71080000,150000,,9456000,9953000,51274,HSKA
2016-12-31,2147000,,16504000,170000,10508000,35212000,53892000,16533000,16533000,,-160000,,,,4339000,130083000,113550000,76191000,-29000,,12165000,10508000,51274,HSKA
2019-12-31,34285000,,-22643000,,-22803000,43285000,64445000,-19006000,-19006000,,-1507000,,,,160000,96460000,115466000,32015000,-3637000,,-22803000,-22803000,51275,BTRS
2018-12-31,23606000,,-18162000,,-18231000,39497000,53004000,-16139000,-16139000,,-814000,,,,69000,79571000,95710000,26567000,-2023000,,-18231000,-18231000,51275,BTRS
2017-12-31,19564000,,-18218000,,-16809000,35137000,43685000,-16455000,-16455000,,-812000,,,,-1409000,68802000,85257000,25117000,-1763000,,-16809000,-16809000,51275,BTRS
2019-12-31,4672000,,-18106000,,-18114000,16285000,2851000,-18106000,-18106000,,,,,,8000,5511000,23617000,2660000,0,,-18114000,-22623000,51277,CHFS
2018-12-31,3053000,,-17026000,,-17032000,15311000,1328000,-17036000,-17036000,,,,,,6000,4998000,22034000,3670000,10000,,-17032000,-17032000,51277,CHFS
2017-12-31,1481000,,-13376000,,-13382000,10170000,790000,-10861000,-10861000,,,,,,6000,3553000,14414000,2763000,-2515000,,-13382000,-24972000,51277,CHFS
2016-12-31,8109000,,-15846000,,-15792000,7229000,576000,-14762000,-14762000,,-504000.0,,,,-54000,1289000,16051000,713000,-1084000,,-15792000,-17692000,51277,CHFS
2019-12-31,72324000,,-83948000,,-83948000,22648000,0,-94972000,-94972000,,,,,,0,0,94972000,0,11024000,,-83948000,-83948000,51278,MDGL
2018-12-31,25389000,,-32811000,,-32811000,15293000,0,-40682000,-40682000,,,,,,0,0,40682000,0,7871000,,-32811000,-32811000,51278,MDGL
2017-12-31,24390000,,-31154000,,-31154000,7672000,0,-32062000,-32062000,,,,,,0,0,32062000,0,908000,,-31154000,-31154000,51278,MDGL
2016-12-31,15933000,,-26388000,,-26388000,6590000,0,-22523000,-22523000,,-1213000.0,,,,0,0,22523000,0,-3865000,,-26388000,-26388000,51278,MDGL
2019-12-31,,,185104000,767632000,69889000,2307627000,3080787000,355920000,355920000,,-157521000,,,,66892000,11547969000,11192049000,8467182000,-170816000,,118212000,-4882000,51281,LYV
2018-12-31,,,131105000,573117000,60249000,2136309000,2819868000,307530000,307530000,,-140976000,,,,40765000,10787800000,10480270000,7967932000,-176425000,,90340000,-17651000,51281,LYV
2017-12-31,,,-9380000,481675000,-6015000,1914684000,2505324000,238439000,238439000,,-107770000,,,,-17154000,9687222000,9448783000,7181898000,-247819000,,7774000,-97646000,51281,LYV
2016-12-31,,,48326000,570568000,2942000,1679226000,2187159000,189349000,189349000,,-106506000,,,,28029000,7826336000,7636987000,5639177000,-141023000,,20297000,-47010000,51281,LYV
2019-12-31,20431000,,-19125000,,-14647000,74219000,96520000,1870000,1870000,,-10105000,,,,-4478000,173428000,171558000,76908000,-20995000,,-14647000,-24631000,51283,ZIXI
2018-12-31,11323000,,10724000,,15444000,32031000,55292000,11938000,11938000,,-10105000,,,,-4720000,70478000,58540000,15186000,-460000,,15444000,15444000,51283,ZIXI
2017-12-31,10980000,,10549000,,-8057000,31385000,53061000,10696000,10696000,,-10105000,,,,18606000,65663000,54967000,12602000,-147000,,-8057000,-8057000,51283,ZIXI
2016-12-31,9553000,,9529000,,5837000,30742000,49611000,9316000,9316000,,-33000,,,,3692000,60144000,50828000,10533000,213000,,5837000,5837000,51283,ZIXI
2020-06-30,,,262632000,,183438000,262018000,538398000,0,268170000,8210000,,,,,79194000,538398000,270228000,0,-5538000,,183438000,183129000,51285,AX
2019-06-30,,,212806000,,155131000,238979000,464012000,0,222211000,2822000,,,,,57675000,464012000,241801000,0,-9405000,,155131000,154822000,51285,AX
2018-06-30,,,239699000,,152411000,169076000,413635000,0,244559000,2822000,,,,,87288000,413635000,169076000,0,-4860000,,152411000,152102000,51285,AX
2017-06-30,,,232693000,,134740000,132777000,370298000,0,237521000,2822000,,,,,97953000,370298000,132777000,0,-4828000,,134740000,134431000,51285,AX
2020-10-31,,,59046097,,59046097,10658239,87487938,76829699,76829699,,-356071,,,,0,87487938,10658239,0,-17783602,,59046097,59046097,51286,NUV
2019-10-31,,,228659966,,228659966,10790721,88844695,78053974,78053974,,-748000,,,,0,88844695,10790721,0,150605992,,228659966,228659966,51286,NUV
2018-10-31,,,-14247461,,-14247461,10631005,89799519,79168514,79168514,,-687693,,,,0,89799519,10631005,0,-93415975,,-14247461,-14247461,51286,NUV
2017-10-31,,,60739068,,60739068,10892014,92872282,81980268,81980268,,-153487,,,,0,92872282,10892014,0,-21241200,,60739068,60739068,51286,NUV
2019-12-31,298210000,,522583000,,451295000,514600000,1371329000,521640000,521640000,,-3461000,,,,71288000,1515892000,994252000,144563000,943000,,451295000,451295000,51287,ANSS
2018-12-31,233802000,,487085000,,419375000,410080000,1164785000,480074000,480074000,,-59000,,,,67710000,1293636000,813562000,128851000,7011000,,419375000,419375000,51287,ANSS
2017-12-31,195946000,,395694000,,259251000,337540000,981880000,398628000,398628000,,-86000,,,,136443000,1095250000,696622000,113370000,-2934000,,259251000,259251000,51287,ANSS
2016-12-31,183093000,,380315000,,265636000,269115000,879697000,376642000,376642000,,-86000,,,,114679000,988465000,611823000,108768000,3673000,,265636000,265636000,51287,ANSS
2020-03-31,,,28132000,-2272000,24837000,6782000,32044000,0,25034000,,,,,,6002000,107188000,82154000,75144000,3098000,,22130000,24837000,51288,FRHC
2019-03-31,,,8515000,-2272000,7147000,9319000,23701000,0,14382000,,,,,,1368000,63754000,49372000,40053000,-5867000,,7147000,7147000,51288,FRHC
2018-03-31,,,18615000,-2272000,18197000,4045000,21201000,0,17156000,,,,,,418000,41144000,23988000,19943000,1459000,,18197000,18197000,51288,FRHC
2017-03-31,,,5772000,-2272000,6287000,2129000,7808000,0,5679000,,,,,,-524000,15276000,9597000,7468000,93000,,6296000,6287000,51288,FRHC
2020-08-31,2974623,,11387049,,9332060,14944053,30939854,13021178,13021178,,,,,,2054989,41589084,28567906,10649230,-1634129,,9332060,9332060,51289,SLP
2019-08-31,2499980,,10556476,,8583329,11796027,24944736,10648729,10648729,,,,,,1973147,33970440,23321711,9025704,-92253,,8583329,8583329,51289,SLP
2018-08-31,1790656,,10138942,,8934812,9583852,21672296,10297788,10297788,,,,,,1204130,29666524,19368736,7994228,-158846,,8934812,8934812,51289,SLP
2017-08-31,1367645,,8240267,,5787597,7578184,17830113,8884284,8884284,,-38188.0,,,,2452670,24137913,15253629,6307800,-644017,,5787597,5787597,51289,SLP
2019-12-31,,,-2410673,,-2410673,2296534,0,-2296534,-2296534,,-81823,,,,0,0,2296534,0,-114139,,-2410673,-2410673,51290,ENVB
2018-12-31,,,-1919577,,-1919577,1919577,0,-1919577,-1919577,,-81823,,,,0,0,1919577,0,0,,-1919577,-1919577,51290,ENVB
2017-12-31,,,-846947,,-846947,846947,0,-846947,-846947,,-81823,,,,0,0,846947,0,0,,-846947,-846947,51290,ENVB
2020-12-31,252800000,,970800000,,846600000,681400000,1845000000,904200000,904200000,,,,,,124200000,2064900000,1160700000,219900000,66600000,,846600000,846600000,51291,CHKP
2019-12-31,239200000,,962400000,,825700000,658400000,1785000000,881800000,881800000,,-2300000.0,,,,136700000,1994800000,1113000000,209800000,80600000,,825700000,825700000,51291,CHKP
2018-12-31,211500000,,978900000,,821300000,589800000,1717900000,913800000,913800000,,-2300000.0,,,,157600000,1916500000,1002700000,198600000,65100000,,821300000,821300000,51291,CHKP
2017-12-31,192400000,,970900000,,802900000,525400000,1643900000,923900000,923900000,,-2100000.0,,,,168000000,1854700000,930800000,210800000,47000000,,802900000,802900000,51291,CHKP
2020-12-31,,,51863000,,40827000,60651000,122541000,0,52926000,8964000,,,,,11036000,122541000,69615000,0,-1063000,,40827000,40827000,51298,AROW
2019-12-31,,,47075000,,37475000,58099000,114525000,0,47232000,9194000,,,,,9600000,114525000,67293000,0,-157000,,37475000,37475000,51298,AROW
2018-12-31,,,45305000,,36279000,56181000,110360000,0,46186000,7993000,,,,,9026000,110360000,64174000,0,-881000,,36279000,36279000,51298,AROW
2017-12-31,,,39855000,,29326000,54097000,102560000,0,40746000,7717000,,,,,10529000,102560000,61814000,0,-891000,,29326000,29326000,51298,AROW
2019-12-31,8540000,,-11056000,-10000,-10963000,34872000,38364000,-5048000,-5048000,,-948000,,,,-75000,81915000,86963000,43551000,-6008000,,-10981000,-12047000,51299,PWFL
2018-12-31,6863000,,-5812000,-10000,-5812000,24671000,25798000,-5736000,-5736000,,-173000,,,,0,53064000,58800000,27266000,-76000,,-5812000,-5812000,51299,PWFL
2017-12-31,4538000,,-4181000,-10000,-3870000,20179000,20927000,-3790000,-3790000,,-342000,,,,-311000,40958000,44748000,20031000,-391000,,-3870000,-3870000,51299,PWFL
2016-12-31,5235000,,-6370000,-10000,-6370000,18790000,18294000,-5731000,-5731000,,-293000,,,,0,36822000,42553000,18528000,-639000,,-6370000,-6370000,51299,PWFL
2020-06-30,355000,,1195000,1180000,966000,7655000,7266000,-744000,-744000,,-230000,,,,-12000,34465000,35209000,27199000,1939000,-3000,1207000,966000,51300,TRT
2019-06-30,345000,,1409000,1195000,1545000,7875000,9001000,781000,781000,,-319000,,,,-42000,39198000,38417000,30197000,628000,-3000,1451000,1545000,51300,TRT
2018-06-30,451000,,2290000,1522000,1184000,8076000,10638000,2111000,2111000,,-233000,,,,987000,42361000,40250000,31723000,179000,-13000,1303000,1184000,51300,TRT
2017-06-30,208000,,1801000,1426000,1316000,7718000,9462000,1536000,1536000,,-202000,,,,341000,38538000,37002000,29076000,265000,-5000,1460000,1316000,51300,TRT
2019-12-31,,,-31221151,36737663,-31671869,27778422,14940356,-26131345,-26131345,,-811017,,,,585000,55363906,81495251,40423550,-5089806,,-31806151,-34976816,51307,CSSE
2018-12-31,,,29028,36737663,-844972,13412142,14513929,774799,774799,,-388036,,,,874000,26859519,26084720,12345590,-745771,,-844972,-1957882,51307,CSSE
2017-12-31,,,20356283,36737663,21081283,7003274,6419980,-593113,-593113,,-1190111,,,,-725000,10657151,11250264,4237171,20949396,,21081283,21081283,51307,CSSE
2016-12-31,,,1220133,36737663,781133,3182775,4962964,1780189,1780189,,-560069,,,,439000,8118632,6338443,3155668,-560056,,781133,781133,51307,CSSE
2020-04-30,,,-29240000,,-29116000,13029000,-27504000,-40533000,-40533000,,,,,,-124000,12690000,53223000,40194000,11293000,,-29116000,-29116000,51308,KALV
2019-04-30,,,-20692000,,-20816000,10926000,-18894000,-29820000,-29820000,,,,,,124000,16127000,45947000,35021000,9128000,,-20816000,-20816000,51308,KALV
2018-04-30,,,-15805000,,-15805000,8862000,-9843000,-18705000,-18705000,,,,,,0,8394000,27099000,18237000,2900000,,-15805000,-15805000,51308,KALV
2017-04-30,,,-18603000,,-18603000,11177000,-11162000,-22339000,-22339000,,,,,,0,1504000,23843000,12666000,3736000,,-18603000,-20775000,51308,KALV
2019-12-31,,,178367754,,178367754,14299788,108849204,94549416,94549416,,-12141828,,,,0,108849204,14299788,0,83818338,,178367754,178367754,51310,BTZ
2019-10-31,,,209279617,,209279617,15904097,115438816,99534719,99534719,,-17340318,,,,0,115438816,15904097,0,109744898,,209279617,209279617,51310,BTZ
2018-10-31,,,-41474892,,-41474892,14246593,114475456,100228863,100228863,,-14851078,,,,0,114475456,14246593,0,-141703755,,-41474892,-41474892,51310,BTZ
2017-10-31,,,118378911,,118378911,13674049,106089609,92415560,92415560,,-5556362,,,,0,106089609,13674049,0,25963351,,118378911,118378911,51310,BTZ
2019-12-31,,,215257000,15405000,148100000,611882000,834754000,222872000,222872000,,-34093000,,,,70697000,1529447000,1306575000,694693000,-7615000,,144560000,148100000,51311,REDU
2018-12-31,,,214199000,-14921000,142958000,487282000,695358000,208076000,208076000,,-33803000,,,,71763000,1271888000,1063812000,576530000,6123000,,142436000,142958000,51311,REDU
2017-12-31,,,-676000,-14399000,-47974000,478562000,517055000,38493000,38493000,,-26589000,,,,52924000,969275000,930782000,452220000,-39169000,,-53600000,-47974000,51311,REDU
2016-12-31,,,83045000,-8773000,53923000,276568000,347414000,70846000,70846000,,-6073000,,,,32202000,710993000,640147000,363579000,12199000,,50843000,53923000,51311,REDU
2020-11-30,,,-138820826,,-110770020,4353298,3412895,-940403,-940403,,-7092029,,,,-28050806,3412895,4353298,0,-137880423,,-110770020,-110770020,51313,FEN
2019-11-30,,,22697425,,18547493,6391616,13696729,7305113,7305113,,-5541389,,,,4149932,13696729,6391616,0,15392312,,18547493,18547493,51313,FEN
2018-11-30,,,-28578427,,17247659,7084753,10871424,3786671,3786671,,-5728395,,,,-45826086,10871424,7084753,0,-32365098,,17247659,17247659,51313,FEN
2017-11-30,,,-7909795,,-4963874,7328739,12579605,5250866,5250866,,-5640159,,,,-2945921,12579605,7328739,0,-13160661,,-4963874,-4963874,51313,FEN
2020-10-31,,,217234000,222854000,138516000,145488000,727780000,382698000,382698000,199594000,-70890000,,,,83900000,1730365000,1347667000,1002585000,-165464000,,133334000,138516000,51319,EV
2019-10-31,,,568128000,285915000,400035000,112232000,848020000,520871000,520871000,214917000,-76808000,,,,135252000,1683252000,1162381000,835232000,47257000,,432876000,400035000,51319,EV
2018-10-31,,,554608000,336097000,381938000,108457000,868388000,555202000,555202000,204729000,-34085000,,,,156703000,1692422000,1137220000,824034000,-594000,,397905000,381938000,51319,EV
2017-10-31,,,480039000,251687000,282131000,101200000,769147000,486273000,486273000,181674000,-27496000,,,,173666000,1532111000,1045838000,762964000,-6234000,,306373000,282131000,51319,EV
2020-12-31,,,-9242000,,-9755000,72706000,314058000,30592000,30592000,,-61186000,,,,3972000,1021643000,991051000,707585000,-39834000,,-13214000,-9755000,51322,CEIX
2019-12-31,,,98097000,137196000.0,76001000,67111000,448185000,178125000,178125000,-4148000.0,-66464000,,,,4539000,1411864000,1233739000,963679000,-80028000,,93558000,76001000,51322,CEIX
2018-12-31,,,187613000,141676000.0,152976000,65346000,533484000,276322000,276322000,-9448000.0,-83848000,,,,8828000,1519506000,1243184000,986022000,-88709000,,178785000,152976000,51322,CEIX
2017-12-31,,,169797000,139381000.0,67629000,83605000,405209000,166152000,166152000,-16550000.0,-26098000,,,,87228000,1365610000,1199458000,960401000,3645000,,82569000,67629000,51322,CEIX
2019-12-31,10468000,,-30726000,,-30726000,30637000,18478000,-22627000,-22627000,,-3008000,,,,0,24552000,47179000,6074000,-8099000,,-30726000,-30726000,51323,BDSX
2018-12-31,8188000,,-26166000,,-26166000,25899000,16026000,-18061000,-18061000,,-2916000,,,,0,20432000,38493000,4406000,-8105000,,-26166000,-26166000,51323,BDSX
2019-12-31,,,-1276700000,96340000,-1522164000,296987000,-427381000,-724368000,-724368000,,-74104000,,,,440982000,14348018000,15072386000,14775399000,-552332000,154068000,-1717682000,-1522164000,51324,FLR
2018-12-31,,,188000000,146128000,173468000,140328000,369220000,228892000,228892000,,-77144000,,,,132250000,15172454000,14943562000,14803234000,-40892000,164274000,55750000,173468000,51324,FLR
2017-12-31,,,53809000,150089000,153671000,183881000,277729000,93848000,93848000,,-67458000,,,,16356000,14806511000,14712663000,14528782000,-40039000,180751000,37453000,153671000,51324,FLR
2016-12-31,,,546600000,117640000,281401000,128073000,790316000,662243000,662243000,,-69689000,,,,219151000,19036525000,18374282000,18246209000,-115643000,180751000,327449000,281401000,51324,FLR
2019-12-31,57167000,,-47240000,3781000,-48545000,63803000,71218000,-46345000,-46345000,-3407000,-837000,,,,754000,121814000,168159000,50596000,-895000,,-47994000,-75793000,51326,EH
2018-12-31,60276000,,-80387000,3230000,-79113000,56113000,33747000,-74349000,-74349000,-8293000,-564000,,,,76000,66487000,140836000,32740000,-6038000,,-80463000,-79113000,51326,EH
2017-12-31,68669000,,-81391000,580000,-87433000,65744000,4184000,-125917000,-125917000,-4312000,-564000,,,,5184000,31695000,157612000,27511000,44526000,,-86575000,-94999000,51326,EH
2019-12-31,216097000,,-290964000,,-290976000,79584000,0,-295681000,-295681000,,,,,,12000,0,295681000,0,4717000,,-290976000,-290976000,51327,ATRA
2018-12-31,154957000,,-230743000,,-230699000,69654000,0,-224611000,-224611000,,,,,,-44000,0,224611000,0,-6132000,,-230699000,-230699000,51327,ATRA
2017-12-31,81206000,,-119505000,,-119491000,40326000,0,-121532000,-121532000,,,,,,-14000,0,121532000,0,4054000,,-119491000,-119491000,51327,ATRA
2016-12-31,56514000,,-79039000,,-79049000,24728000,0,-81242000,-81242000,,,,,,10000,0,81242000,0,2203000,,-79049000,-79049000,51327,ATRA
2020-12-31,,,704000000,,538000000,673000000,1861000000,0,741000000,447000000,,,,,166000000,1861000000,1120000000,0,-37000000,,538000000,538000000,51328,FBC
2019-12-31,,,266000000,,218000000,590000000,1129000000,0,276000000,263000000,,,,,48000000,1129000000,853000000,0,-10000000,,218000000,218000000,51328,FBC
2018-12-31,,,232000000,,187000000,490000000,944000000,0,274000000,180000000,,,,,45000000,944000000,670000000,0,-42000000,,187000000,187000000,51328,FBC
2017-12-31,,,211000000,,63000000,448000000,854000000,0,227000000,179000000,,,,,148000000,854000000,627000000,0,-16000000,,63000000,63000000,51328,FBC
2019-12-31,,,-16784000,8402000,-18553000,,-23211000,0,-23504000,293000,,,,,1619000,98919000,122423000,122130000,6720000,,-18403000,-18553000,51330,SRL
2018-12-31,,,167829000,8030000,112276000,,-18316000,0,-18728000,343000,,,,,55618000,102984000,121712000,121300000,186557000,,112211000,112276000,51330,SRL
2017-12-31,,,-38407000,2169000,-47855000,,-28648000,0,-35008000,3484000,,,,,8658000,245181000,280189000,273829000,-3399000,,-47065000,-47855000,51330,SRL
2016-12-31,,,-16706000,1910000,-25361000,,-24310000,0,-32661000,8351000,,,,,7014000,1115906000,1148567000,1140216000,15955000,,-23720000,-25361000,51330,SRL
2019-12-31,,,1624949,,1201080,393479,0,-787268,-787268,393789,,,,,423869,0,787268,0,2412217,,1201080,-393804,51332,APXT
2019-12-31,,,86100000,-800000,43900000,1242500000,2405700000,749000000,749000000,,-535600000,,,,43000000,5301400000,4552400000,2895700000,-662900000,,43100000,43900000,51333,PENN
2018-12-31,,,89900000,-5000,93500000,543800000,1539900000,727100000,727100000,,-539400000,,,,-3600000,3530600000,2803500000,1990700000,-637200000,,93500000,93500000,51333,PENN
2017-12-31,,,-25100000,-5000,473400000,521600000,1335100000,546400000,546400000,,-466800000,,,,-498500000,3121900000,2575500000,1786800000,-571500000,,473400000,473400000,51333,PENN
2016-12-31,,,120617000,-5000,109310000,461751000,1276532000,543567000,543567000,,-459243000,,,,11307000,3018383000,2474816000,1741851000,-422950000,,109310000,100648000,51333,PENN
2019-12-31,27272000,,-226490000,-498000,-226689000,264130000,75902000,-225673000,-225673000,10173000,-2576000,,,,575000,160408000,386081000,84506000,-817000,,-227065000,-226689000,51337,JMIA
2018-12-31,22432000,,-169494000,-117000,-170071000,181358000,44209000,-169735000,-169735000,10154000,-204000,,,,887000,129058000,298793000,84849000,241000,,-170381000,-170071000,51337,JMIA
2017-12-31,20586000,,-153902000,-15768000,-161579000,148826000,27229000,-154667000,-154667000,12484000,-62000,,,,11456000,93054000,247721000,65825000,765000,,-165358000,-161579000,51337,JMIA
2019-12-31,,,47167000,,35667000,272855000,321953000,49098000,49098000,,,,,,11500000,600993000,551895000,279040000,-1931000,,35667000,-5149000,51339,RVLV
2018-12-31,,,41167000,,30685000,223508000,265306000,41798000,41798000,,,,,,10529000,498739000,456941000,233433000,-631000,,30638000,19728000,51339,RVLV
2017-12-31,,,19091000,-623000.0,5347000,173168000,193690000,20522000,20522000,,,,,,14091000,399597000,379075000,205907000,-1431000,,5000000,3494000,51339,RVLV
2016-12-31,,,4646000,-276000.0,2403000,139834000,145375000,5541000,5541000,,,,,,2448000,312082000,306541000,166707000,-895000,,2198000,1570000,51339,RVLV
2020-12-31,,,134981000,,107898000,399676000,621687000,0,149639000,72372000,,,,,27083000,621687000,472048000,0,-14658000,,107898000,97810000,51340,FMBI
2019-12-31,,,265939000,,199738000,368113000,706455000,0,310226000,28116000,,,,,66201000,706455000,396229000,0,-44287000,,199738000,198057000,51340,FMBI
2018-12-31,,,197057000,,157870000,338851000,608133000,0,246273000,23009000,,,,,39187000,608133000,361860000,0,-49216000,,157870000,156558000,51340,FMBI
2017-12-31,,,187954000,,98387000,334595000,603863000,0,229612000,39656000,,,,,89567000,603863000,374251000,0,-41658000,,98387000,97471000,51340,FMBI
2020-04-30,163157000,,-169142000,,-167174000,287938000,305457000,-153131000,-153131000,7493000,,,,,-1968000,427620000,580751000,122163000,-16011000,,-167174000,-167174000,51341,ESTC
2019-04-30,99539000,,-97915000,,-102303000,192736000,193681000,-100408000,-100408000,1814000,,,,,4388000,271653000,372061000,77972000,2493000,,-102303000,-102303000,51341,ESTC
2018-04-30,54986000,,-49351000,,-52727000,110940000,119195000,-46731000,-46731000,1814000,-57000.0,,,,3376000,159935000,206666000,40740000,-2677000,,-52727000,-52727000,51341,ESTC
2017-04-30,32601000,,-47755000,,-51968000,82668000,68332000,-46937000,-46937000,1814000,-57000.0,,,,4213000,88177000,135114000,19845000,-818000,,-51968000,-51968000,51341,ESTC
2019-12-31,535000,,-123658000,,-99557000,40782000,222917000,-44001000,-44001000,7014000,-48447000,,,,-24101000,673266000,717267000,450349000,-79657000,,-99557000,-100109000,51342,HL
2018-12-31,5441000,,-33264000,,-26563000,39301000,213143000,32432000,32432000,-38657000,-40944000,,,,-6701000,567137000,534705000,353994000,-65696000,,-26563000,-27115000,51342,HL
2017-12-31,3276000,,-7557000,,-28520000,38913000,273048000,57539000,57539000,23763000,-38012000,,,,20963000,577775000,520236000,304727000,-65096000,,-28520000,-29072000,51342,HL
2016-12-31,243000,,89659000,,61569000,49005000,307632000,118166000,118166000,-1270000,-21796000,,,,28090000,645957000,527791000,338325000,-28507000,,61569000,61017000,51342,HL
2020-12-31,1569698,,-2092195,,-2092195,5424764,5249558,-1744904,-1744904,,,,,,0,7377975,9122879,2128417,-347291,,-2092195,-2092195,51343,NURO
2019-12-31,2126364,,-3773014,,-3773014,10929197,4141507,-8914054,-8914054,,,,,,0,9272522,18186576,5131015,5141040,,-3773014,-3773014,51343,NURO
2018-12-31,4506860,,23605,,23605,15167763,7383056,-12291567,-12291567,,,,,,0,16090138,28381705,8707082,12315172,,23605,23605,51343,NURO
2017-12-31,2826776,,-12859253,,-12859253,17112640,6856798,-13082618,-13082618,,,,,,0,17092336,30174954,10235538,223365,,-12859253,-19734033,51343,NURO
2020-12-31,,,961000000,,673000000,1480000000,2555000000,950000000,950000000,37000000,-102000000,,,,288000000,18375000000,17425000000,15820000000,11000000,,673000000,673000000,51344,MOH
2019-12-31,,,972000000,,737000000,1296000000,2435000000,1050000000,1050000000,37000000,-87000000,,,,235000000,16340000000,15290000000,13905000000,-63000000,,737000000,737000000,51344,MOH
2018-12-31,,,999000000,,707000000,1333000000,3007000000,1192000000,1192000000,383000000,-115000000,,,,292000000,18144000000,16952000000,15137000000,-193000000,,707000000,707000000,51344,MOH
2017-12-31,,,-612000000,,-512000000,1594000000,2372000000,149000000,149000000,492000000,-118000000,,,,-100000000,19445000000,19296000000,17073000000,-761000000,,-512000000,-512000000,51344,MOH
2019-12-31,,,-20000000,7000000,-175000000,182000000,238000000,50000000,50000000,6000000,-53000000,,,,150000000,2130000000,2080000000,1892000000,-70000000,,-170000000,-175000000,51345,VNTR
2018-12-31,,,-165000000,8000000,-163000000,212000000,715000000,491000000,491000000,12000000,-53000000,,,,-8000000,2265000000,1774000000,1550000000,-656000000,,-157000000,-163000000,51345,VNTR
2017-12-31,,,186000000,10000000,134000000,216000000,465000000,240000000,240000000,9000000,-100000000,,,,50000000,2209000000,1969000000,1744000000,-54000000,8000000.0,136000000,134000000,51345,VNTR
2016-12-31,,,-108000000,12000000,-87000000,221000000,150000000,-35000000,-35000000,-36000000,-59000000,,,,-23000000,2139000000,2174000000,1989000000,-73000000,8000000.0,-85000000,-87000000,51345,VNTR
2019-12-31,11860244000,,5735637000,410065000,9707614000,9243701000,21314972000,4739186000,4739186000,-5231498000,-2933815000,,,,-393130000,148201641000,143462455000,126886669000,996451000,,6128767000,9707614000,51346,UMC
2018-12-31,13025139000,,2184399000,466768000,7072990000,8725303000,22840027000,5660489000,5660489000,-4980141000,-2768672000,,,,-458653000,151252571000,145592082000,128412544000,-3476090000,,2643052000,7072990000,51346,UMC
2017-12-31,13669589000,,7671710000,956808000,9676698000,8473543000,27057758000,6485924000,6485924000,-1571298000,-2406872000,,,,992481000,149284706000,142798782000,122226948000,1185786000,,6679229000,9676698000,51346,UMC
2016-12-31,13532356000,,4721086000,2161729000,8621147000,10390373000,30379430000,6575638000,6575638000,-118937000,-1249583000,,,,552524000,147870124000,141294486000,117490694000,-1854552000,,4168562000,8621147000,51346,UMC
2020-12-31,,,242365000,,202034000,175525000,470303000,0,254975000,39803000,,,,,40331000,470303000,215328000,0,-12610000,,202034000,202034000,51347,FFIN
2019-12-31,,,198032000,,164812000,143347000,394553000,0,210117000,41089000,,,,,33220000,394553000,184436000,0,-12085000,,164812000,164812000,51347,FFIN
2018-12-31,,,178175000,,150638000,138666000,368859000,0,189346000,40847000,,,,,27537000,368859000,179513000,0,-11171000,,150638000,150638000,51347,FFIN
2017-12-31,,,147188000,,120371000,127305000,321174000,0,156958000,36911000,,,,,26817000,321174000,164216000,0,-9770000,,120371000,120371000,51347,FFIN
2020-09-30,,,-32241037,,-23952037,8024901,13383642,-5047623,-5047623,-907419,-1286788,,,,-8289000,23038052,28085675,9654410,-27193414,,-23952037,-23952037,51348,PHX
2019-09-30,,,-54225938,,-40744938,7895243,26566053,-69981004,-69981004,-6105145,-1995789,,,,-13481000,39054478,109035482,12488425,15755066,,-40744938,-40744938,51348,PHX
2018-09-30,,,1896669,,14635669,7342441,34417004,3747455,3747455,4932068,-1748101,,,,-12739000,47877282,44129827,13460278,-1850786,,14635669,14635669,51348,PHX
2017-09-30,,,4220933,,3531933,7441242,30853841,5601901,5601901,-1249840,-1275138,,,,689000,43536810,37934909,12682969,-1380968,,3531933,3531933,51348,PHX
2019-12-31,,,24713000,1297106000,9033000,103551000,53210000,-50341000,-50341000,,,,,,2445000,184380000,234721000,131170000,75054000,,22268000,8693000,51349,FPH
2018-12-31,,,-58762000,1261491000,-34714000,98676000,20116000,-78560000,-78560000,,,,,,9183000,48990000,127550000,28874000,19798000,,-67945000,-34493000,51349,FPH
2017-12-31,,,24196000,1320208000,73235000,122274000,32531000,-89743000,-89743000,,,,,,0,139431000,229174000,106900000,113939000,,24196000,71979000,51349,FPH
2016-12-31,,,-104505000,1265197000,-33266000,122383000,19234000,-103149000,-103149000,,,,,,-7888000,39368000,142517000,20134000,-1356000,,-96617000,-33771000,51349,FPH
2020-02-29,,,-58323000,28461000,-110195000,1647765000,1804739000,166441000,166441000,-9467000,-11820000,,,,69328000,3273308000,3106867000,1468569000,-224764000,,-127651000,-110195000,51350,TAL
2019-02-28,,,441018000,46730000,367236000,1063672000,1398530000,341582000,341582000,-6724000,-17628000,,,,76504000,2562984000,2221402000,1164454000,99436000,,364514000,367236000,51350,TAL
2018-02-28,,,239316000,19716000,198440000,628389000,832700000,208962000,208962000,-4651000,-16640000,,,,44653000,1715016000,1506054000,882316000,30354000,,194663000,198440000,51350,TAL
2017-02-28,,,146556000,36619425,116880000,389292000,520773000,134594000,134594000,-3113000,-13145000,,,,34066000,1043100000,908506000,522327000,11962000,,112490000,116880000,51350,TAL
2019-12-31,,,16642000,,14402000,9968000,41191000,22335000,22335000,1200000,-5124000,,,,2240000,51578000,29243000,10387000,-5693000,,14402000,14402000,51351,YORW
2018-12-31,,,15867000,,13376000,9380000,38767000,21232000,21232000,1145000,-5509000,,,,2491000,48437000,27205000,9670000,-5365000,,13376000,13376000,51351,YORW
2017-12-31,,,17517000,,12974000,9323000,39698000,22473000,22473000,1133000,-5348000,,,,4543000,48589000,26116000,8891000,-4956000,,12974000,12974000,51351,YORW
2016-12-31,,,17255000,,11846000,9129000,39553000,22888000,22888000,1114000,-5265000,,,,5409000,47584000,24696000,8031000,-5633000,,11846000,11846000,51351,YORW
2019-12-31,,,18077000,,10621000,,24381000,19145000,19145000,5236000,-1068000,,,,7456000,113296000,94151000,88915000,-1068000,,10621000,10621000,51352,PLMR
2018-12-31,,,18213000,,18219000,,23878000,20516000,20516000,3362000,-2303000,,,,-6000,72971000,52455000,49093000,-2303000,,18219000,18219000,51352,PLMR
2017-12-31,,,4928000,,3783000,,9298000,6673000,6673000,2625000,-1745000,,,,1145000,59466000,52793000,50168000,-1745000,,3783000,3783000,51352,PLMR
2016-12-31,,,6277000,,6614000,,7911000,7911000,7911000,2625000,-1634000,,,,-337000,42696000,34785000,34785000,-1634000,,6614000,6614000,51352,PLMR
2019-12-31,,,-475279000,,-445324000,275034000,444274000,31573000,31573000,20790000,-30774000,,,,-29955000,606682000,575109000,162408000,-506852000,,-445324000,-445324000,51360,CARS
2018-12-31,73970000.0,,56929000,,38809000,275630000,507805000,112877000,112877000,15488000,-27717000,,,,18120000,662127000,549250000,154322000,-55948000,,38809000,38809000,51360,CARS
2017-12-31,73970000.0,,122162000,,224443000,254716000,486559000,134256000,134256000,8948000,-12371000,,,,-102281000,626262000,492006000,139703000,-12094000,,224443000,224443000,51360,CARS
2016-12-31,73970000.0,,176958000,,176370000,234957000,503242000,176650000,176650000,8529000,-12371000,,,,588000,633106000,456456000,129864000,308000,,176370000,176370000,51360,CARS
2020-12-31,,,12412000,,8961000,17841000,33717000,0,13533000,2343000,,,,,3451000,33717000,20184000,0,-1121000,,8961000,8961000,51361,UBFO
2019-12-31,,,21269000,,15172000,18577000,42548000,0,21677000,2294000,,,,,6097000,42548000,20871000,0,-408000,,15172000,15172000,51361,UBFO
2018-12-31,,,19349000,,14017000,18202000,40110000,0,19678000,2230000,,,,,5332000,40110000,20432000,0,-329000,,14017000,14017000,51361,UBFO
2017-12-31,,,15679000,,8640000,16916000,35482000,0,16029000,2537000,,,,,7039000,35482000,19453000,0,-350000,,8640000,8640000,51361,UBFO
2019-12-31,331757000,,248069000,18434000,227857000,527069000,1191497000,333905000,333905000,-1234000,-28187000,,,,19414000,4508400000,4174495000,3316903000,-85836000,,228655000,227857000,51363,ESLT
2018-12-31,287352000,,235100000,21955000,206738000,445028000,1042815000,310302000,310302000,133000,-28285000,,,,26445000,3683684000,3373382000,2640869000,-75202000,,208655000,206738000,51363,ESLT
2017-12-31,265060000,,296207000,9662000,239109000,449890000,1003050000,288100000,288100000,133000,-17323000,,,,55585000,3377825000,3089725000,2374775000,8107000,,240622000,239109000,51363,ESLT
2016-12-31,255792000,,284425000,7401000,236909000,428092000,965285000,281476000,281476000,-75000,-13511000,,,,45617000,3260219000,2978743000,2294934000,2949000,,238808000,236909000,51363,ESLT
2020-10-02,24621000,,73702000,,55233000,169302000,264993000,71070000,71070000,,-143000,,,,18469000,594209000,523139000,329216000,2632000,,55233000,55233000,51366,JOUT
2019-09-27,21926000,,66507000,,51413000,164056000,249756000,63774000,63774000,,-172000,,,,15094000,562419000,498645000,312663000,2733000,,51413000,51413000,51366,JOUT
2018-09-28,20441000,,68106000,,40669000,158398000,241860000,63021000,63021000,,-203000,,,,27437000,544268000,481247000,302408000,5085000,,40669000,40669000,51366,JOUT
2017-09-29,19166000,,48210000,,35157000,146183000,210940000,45591000,45591000,,-757000,,,,13053000,490565000,444974000,279625000,2619000,,35157000,35157000,51366,JOUT
2019-12-31,,,-7458000,2818000,-7244000,23451000,294967000,100238000,100238000,-13787000,-111964000,,,,0,468404000,368166000,173437000,-107696000,,-7458000,-121033000,51369,APTS
2018-12-31,,,44538000,1239000,43467000,17093000,251650000,70077000,70077000,-6656000,-95564000,,,,0,397271000,327194000,145621000,-25539000,,44538000,-43290000,51369,APTS
2017-12-31,,,28667000,4879000,27681000,16558000,190994000,59388000,59388000,-1729000,-67468000,,,,0,294005000,234617000,103011000,-30721000,,28667000,-35985000,51369,APTS
2016-12-31,,,-9843000,1481209,-9533000,13255000,119979000,30170000,30170000,-1586000,-44284000,,,,0,200119000,169949000,80140000,-40013000,,-9843000,-50630000,51369,APTS
2020-12-31,9237000000,,-6871000000,60000000,-9015000000,7369000000,34045000000,7751000000,7751000000,,-1420000000,,,,2124000000,42518000000,34767000000,8473000000,-14622000000,,-8995000000,-9015000000,51371,BMY
2019-12-31,5891000000,,4975000000,100000000,3439000000,4799000000,18925000000,7100000000,7100000000,,-656000000,,,,1515000000,26145000000,19045000000,7220000000,-2125000000,,3460000000,3439000000,51371,BMY
2018-12-31,6253000000,,5968000000,96000000,4920000000,4523000000,16151000000,5278000000,5278000000,,-183000000,,,,1021000000,22561000000,17283000000,6410000000,690000000,,4947000000,4920000000,51371,BMY
2017-12-31,6085000000,,5131000000,106000000,1007000000,4749000000,14911000000,3980000000,3980000000,,-196000000,,,,4156000000,20776000000,16796000000,5865000000,1151000000,,975000000,1007000000,51371,BMY
2019-12-31,,,-13398000,,-13720000,57599000,69582000,-1463000,-1463000,,-1945000,,,,930000,169758000,171221000,100176000,-11935000,608000,-14328000,-13720000,51373,PRGX
2018-12-31,,,4672000,,4593000,50456000,66951000,5730000,5730000,,-1824000,,,,1321000,171776000,166046000,104825000,-1058000,1242000,3351000,4593000,51373,PRGX
2017-12-31,,,7518000,,3184000,46941000,59568000,4424000,4424000,,-1785000,,,,2962000,161620000,157196000,102052000,3094000,-1372000,4556000,3184000,51373,PRGX
2016-12-31,,,3471000,,905000,39399000,49545000,3281000,3281000,,-107000,,,,1242000,140844000,137563000,91299000,190000,-1324000,2229000,905000,51373,PRGX
2019-12-31,,,5745000,,-1370000,48440000,55731000,5745000,5745000,,,,,,7115000,250545000,244800000,194814000,0,,-1370000,-1370000,51374,CIA
2018-12-31,,,2002000,,-11062000,47632000,52092000,2002000,2002000,,,,,,13064000,244006000,242004000,191914000,0,,-11062000,-11062000,51374,CIA
2017-12-31,,,-2986000,,-38127000,41757000,45531000,1645000,1645000,,,,,,35141000,252627000,250982000,207096000,-4631000,,-38127000,-38127000,51374,CIA
2016-12-31,,,5483000,,1969000,33356000,40902000,5483000,5483000,,,,,,3514000,245406000,239923000,204504000,0,,1969000,1969000,51374,CIA
2020-12-31,27997000,,-44731000,,-44731000,14575000,-915000,-43487000,-43487000,,-1570000,,,,0,273000,43760000,1188000,-1244000,,-44731000,-44731000,51376,OTIC
2019-12-31,32805000,,-44675000,,-44675000,11690000,-312000,-44807000,-44807000,,-1591000,,,,0,600000,45407000,912000,132000,,-44675000,-44675000,51376,OTIC
2018-12-31,31844000,,-50368000,,-50368000,20008000,-201000,-52053000,-52053000,,-4000,,,,0,745000,52798000,946000,1685000,,-50368000,-50368000,51376,OTIC
2017-12-31,42701000,,-90130000,,-90130000,43038000,-1462000,-87201000,-87201000,,-4000,,,,0,1236000,88437000,2698000,-2929000,,-90130000,-90130000,51376,OTIC
2020-08-27,,,-10536,,-10536,10536,0,-10536,-10536,,,,,,0,0,10536,0,0,,-10536,-10536,51377,PTIC
2019-12-31,10817000,,-13088000,,-13088000,2290000,0,-13107000,-13107000,,-65000,,,,0,0,13107000,0,19000,,-13088000,-13088000,51378,SPRB
2018-12-31,8403000,,-9858000,,-9858000,1569000,0,-9972000,-9972000,,-65000,,,,0,0,9972000,0,114000,,-9858000,-9858000,51378,SPRB
2019-12-31,129997000,,248376000,717000,180234000,185342000,606209000,290870000,290870000,,,,,,68115000,1314581000,1023711000,708372000,-42494000,,180261000,180234000,51380,IPGP
2018-12-31,122769000,,534395000,687000,404027000,160244000,800268000,517255000,517255000,,,,,,130226000,1459874000,942619000,659606000,16584000,,404169000,404027000,51380,IPGP
2017-12-31,100870000,,551871000,687000,347614000,130469000,796911000,565572000,565572000,,,,,,204283000,1408889000,843317000,611978000,-13701000,,347588000,347614000,51380,IPGP
2016-12-31,78552000,,366565000,166000,260752000,102022000,552240000,371666000,371666000,,,,,,105849000,1006173000,634507000,453933000,-5101000,,260716000,260752000,51380,IPGP
2019-12-31,,,27668190,,27668190,3534558,22608097,19073539,19073539,,-2602693,,,,0,22608097,3534558,0,8594651,,27668190,27668190,51382,FTF
2018-12-31,,,-7514336,,-7514336,3563255,18461229,14897974,14897974,,-1284713,,,,0,18461229,3563255,0,-22412310,,-7514336,-9437760,51382,FTF
2017-12-31,,,13522411,,13522411,3550142,18114083,14563942,14563942,,-1284713,,,,0,18114083,3550142,0,-1041531,,13522411,11048444,51382,FTF
2017-03-31,,,39723278,,39723278,4516961,21030932,16513971,16513971,,-1284713,,,,0,21030932,4516961,0,23209307,,39723278,37866427,51382,FTF
2019-12-31,50329809,,17092176,,3055478,36836142,219395671,69418595,69418595,,-67242641,,,,14036698,1448204826,1378786231,1228809155,-52326419,,3055478,2519314,51383,CXDC
2018-12-31,60576574,,76026534,,68313421,47054671,219612789,111981544,111981544,,-51031735,,,,7713113,1274833282,1162851738,1055220493,-35955010,,68313421,51734484,51383,CXDC
2017-12-31,36838261,,122146113,,31621734,41672632,236665643,158154750,158154750,,-45370872,,,,90524379,1290447748,1132292998,1053782105,-36008637,,31621734,23803615,51383,CXDC
2016-12-31,47989665,,119035569,,101612750,31309147,246955281,167656469,167656469,,-41370432,,,,17422819,1201678898,1034022429,954723617,-48620900,,101612750,76143036,51383,CXDC
2020-10-31,,,-1174698,,-1174698,3519774,29128072,25608298,25608298,,-2924378,,,,0,29128072,3519774,0,-26782996,,-1174698,-1174698,51384,ERC
2019-10-31,,,39913278,,39913278,3958268,34538231,30579963,30579963,,-5389548,,,,0,34538231,3958268,0,9333315,,39913278,39913278,51384,ERC
2018-10-31,,,-235955,,-235955,4890726,38010398,33119672,33119672,,-4949712,,,,0,38010398,4890726,0,-33355627,,-235955,-235955,51384,ERC
2017-10-31,,,43712143,,43712143,5835809,46138803,40302994,40302994,,-3369579,,,,0,46138803,5835809,0,3409149,,43712143,43712143,51384,ERC
2019-12-31,,,-39024000,,-40474000,26800000,127464000,682000,682000,2410000,-12027000,,,,1450000,363944000,363262000,236480000,-39706000,,-40474000,-40474000,51385,AG
2018-12-31,,,-263047000,,-204164000,21428000,79658000,-193305000,-193305000,1495000,-10913000,,,,-58883000,300929000,494234000,221271000,-69742000,,-204164000,-204164000,51385,AG
2017-12-31,,,-75301000,,-53272000,17493000,93023000,-54445000,-54445000,935000,-2815000,,,,-22029000,252288000,306733000,159265000,-20856000,,-53272000,-53272000,51385,AG
2016-12-31,,,25491000,,8601000,17747000,128796000,26223000,26223000,830000,-3324000,,,,16890000,278077000,251854000,149281000,-732000,,8601000,8601000,51385,AG
2019-12-31,144535000,,-184925000,,-184594000,57473000,0,-202008000,-202008000,,,,,,-331000,0,202008000,0,17083000,,-184594000,-184594000,51387,ALLO
2018-12-31,151860000,,-211622000,,-211505000,40982000,0,-192842000,-192842000,,-3358000.0,,,,-117000,0,192842000,0,-18780000,,-211505000,-211505000,51387,ALLO
2017-12-31,151860000,,-24000,,-24000,24000,0,-24000,-24000,,-3358000.0,,,,0,0,24000,0,0,,-24000,-24000,51387,ALLO
2019-12-31,,,13843000,,6236000,37794000,190434000,93860000,93860000,-122000,-33401000,,,,7607000,321096000,227236000,130662000,-80017000,,6236000,6236000,51388,TH
2018-12-31,,,16711000,,4956000,19629000,137164000,85604000,85604000,-7197000,-26961000,,,,11755000,240600000,154996000,103436000,-68893000,,4956000,4956000,51388,TH
2017-12-31,,,26565000,,981000,15537000,77510000,32416000,32416000,-588000,-2846000,,,,25584000,134235000,101819000,56725000,-5851000,,981000,981000,51388,TH
2016-12-31,,,44219000,,26909000,15793000,97437000,40313000,40313000,2000,-2846000,,,,17310000,149467000,109154000,52030000,3906000,,26909000,26909000,51388,TH
2020-06-30,56188000,,-87355000,,-77940000,25609000,6847000,-75651000,-75651000,701000,-14716000,,,,-9415000,32156000,107807000,25309000,-11704000,,-77940000,-77940000,51389,MESO
2019-06-30,59815000,,-98754000,,-89799000,21625000,1364000,-80954000,-80954000,878000,-11704000,,,,-8955000,16722000,97676000,15358000,-17800000,,-89799000,-89799000,51389,MESO
2018-06-30,65927000,,-65977000,,-35290000,21907000,11833000,-74850000,-74850000,-1151000,-1829000,,,,-30687000,17341000,92191000,5508000,8873000,,-35290000,-35290000,51389,MESO
2017-06-30,58914000,,-90215000,,-76815000,23007000,-9653000,-90042000,-90042000,-1532000,-1829000,,,,-13400000,2412000,92454000,12065000,-173000,,-76815000,-76815000,51389,MESO
2019-12-31,,,2093124,,2093124,9437230,70319403,23188440,23188440,,-21066046,,,,0,144259312,121070872,73939909,-21095316,,2093124,2084202,51390,GASS
2018-12-31,,,-12276520,,-12276520,10074157,73439892,22057397,22057397,50196.0,-23020950,,,,0,164330202,142272805,90890310,-34333917,,-12276520,-12276520,51390,GASS
2017-12-31,,,-1218237,,-1218237,10104448,72122133,22037150,22037150,1058863.0,-15921738,,,,0,154311921,132274771,82189788,-23255387,,-1218237,-1218237,51390,GASS
2016-12-31,,,-7798300,,-7798300,10456589,62251465,12698287,12698287,1058863.0,-13971307,,,,0,144132183,131433896,81880718,-20496587,,-7798300,-7798300,51390,GASS
2019-12-31,776256,,-990980,,-990980,829366,0,-1605622,-1605622,,-40933,,,,0,0,1605622,0,614642,,-990980,-990980,51391,ANVS
2018-12-31,111608,,-713871,,-713871,602329,0,-713937,-713937,,-40933,,,,0,0,713937,0,66,,-713871,-713871,51391,ANVS
2017-12-31,273370,,-682349,,-682349,409063,0,-682433,-682433,,-40933,,,,0,0,682433,0,84,,-682349,-682349,51391,ANVS
2020-12-31,,,8683000,,6931000,24836000,42109000,0,8683000,8590000,,,,,1752000,42109000,33426000,0,0,,6931000,6931000,51394,CIZN
2019-12-31,,,7256000,,5902000,20679000,34814000,0,7814000,6321000,,,,,1354000,34814000,27000000,0,-558000,,5902000,5902000,51394,CIZN
2018-12-31,,,7501000,,6673000,20900000,35165000,0,7501000,6764000,,,,,828000,35165000,27664000,0,0,,6673000,6673000,51394,CIZN
2017-12-31,,,7775000,,3704000,20807000,36002000,0,7775000,7420000,,,,,4071000,36002000,28227000,0,0,,3704000,3704000,51394,CIZN
2019-12-31,6373000,,4372000,3072000,2293000,26349000,38761000,6039000,6039000,,-360000,,,,1553000,86831000,80792000,48070000,-1667000,,2819000,1717000,51397,MAGS
2018-12-31,6852000,,5116000,1755000,2949000,28650000,40303000,4801000,4801000,,-412000,,,,2072000,92602000,87801000,52299000,315000,,3044000,2722000,51397,MAGS
2017-12-31,6558000,,-5205000,1755000,-6914000,26011000,31325000,-1244000,-1244000,,-349000,,,,1695000,64292000,65536000,32967000,-3961000,,-6900000,-6914000,51397,MAGS
2016-12-31,6779000,,904000,-91000,1029000,24711000,33255000,1765000,1765000,,-299000,,,,-122000,67825000,66060000,34570000,-861000,,1026000,1029000,51397,MAGS
2020-12-31,,,17290000,,13806000,27627000,48431000,0,18514000,2290000,,,,,3484000,48431000,29917000,0,-1224000,,13806000,13806000,51399,BPRN
2019-12-31,,,12304000,,10142000,24532000,40043000,0,13511000,1954000,,,,,2162000,40043000,26532000,0,-1207000,,10142000,10142000,51399,BPRN
2018-12-31,,,17708000,,14708000,22645000,43006000,0,18588000,1687000,,,,,3000000,43006000,24418000,0,-880000,,14708000,14708000,51399,BPRN
2017-12-31,,,14863000,,11014000,21133000,38197000,0,15379000,1599000,,,,,3849000,38197000,22818000,0,-516000,,11014000,11014000,51399,BPRN
2020-02-29,,,51251000,,38292000,78265000,128924000,50659000,50659000,,-606000,,,,12959000,438412000,387753000,309488000,592000,,38292000,38292000,51400,EBF
2019-02-28,,,49934000,,37437000,73702000,123360000,49658000,49658000,,-1154000,,,,12497000,400782000,351124000,277422000,276000,,37437000,37437000,51400,EBF
2018-02-28,,,46909000,,32905000,69539000,117202000,47663000,47663000,,-777000,,,,14151000,370171000,322508000,252969000,-754000,147000.0,32758000,32905000,51400,EBF
2017-02-28,,,40033000,,1780000,63927000,104730000,40803000,40803000,,-613000,,,,13616000,356888000,316085000,252158000,-770000,-24637000.0,26417000,1780000,51400,EBF
2019-12-31,,,26440000,392000,22188000,80265000,112871000,32606000,32606000,,-1507000,,,,4145000,283958000,251352000,171087000,-6166000,,22295000,22188000,51401,VPG
2018-12-31,,,33989000,38000,23646000,81944000,121267000,39323000,39323000,,-1738000,,,,10344000,299794000,260471000,178527000,-5334000,,23645000,23646000,51401,VPG
2017-12-31,,,20563000,148000,14345000,74614000,98283000,23669000,23669000,,-1842000,,,,6169000,254350000,230681000,156067000,-3106000,,14394000,14345000,51401,VPG
2016-12-31,,,9607000,174000,6404000,67638000,82809000,15171000,15171000,,-1486000,,,,3199000,224929000,209758000,142120000,-5564000,,6408000,6404000,51401,VPG
2019-12-31,1597658,,29360569,,28924803,12370823,42911255,28942774,28942774,,,,,,435766,63464574,34521800,20553319,417795,,28924803,15891041,51402,YALA
2018-12-31,853127,,20504986,,20241623,7315829,28523665,20354709,20354709,,,,,,263363,42371174,22016465,13847509,150277,,20241623,-9083084,51402,YALA
2019-12-31,,,-35247000,,-35197000,30684000,133182000,12633000,12633000,31725000,-16855000,,,,-50000,275575000,262942000,142393000,-47880000,,-35197000,-35197000,51403,AMPY
2018-12-31,,,54609000,,54609000,35439000,202508000,92827000,92827000,18863000,-21923000,,,,0,340144000,247317000,137636000,-38218000,,54609000,52183000,51403,AMPY
2017-12-31,,,-91936000,,-89669000,60503000,175141000,7756000,7756000,33133000,-26179000,,,,-2267000,314680000,306924000,139539000,-99692000,,-89669000,-89704000,51403,AMPY
2016-12-31,,,-540225000,,-540230000,61629000,123426000,-437642000,-437642000,143392000,-146031000,,,,173000,284580000,722222000,161154000,-102583000,,-540398000,-540230000,51403,AMPY
2020-06-30,20523000,,-36140000,,-36140000,10891000,-624000,-32038000,-32038000,,-4573000,,,,0,1790000,33828000,2414000,-4102000,,-36140000,-36140000,51404,AKTS
2019-06-30,19075000,,-29248000,,-29248000,8922000,430000,-27567000,-27567000,,-2886000,,,,0,1443000,29010000,1013000,-1681000,,-29248000,-29248000,51404,AKTS
2018-06-30,13267000,,-21739000,,-21739000,8804000,188000,-21883000,-21883000,,-329000,,,,0,1208000,23091000,1020000,144000,,-21739000,-21739000,51404,AKTS
2017-06-30,5013260,,-9833244,,-9833244,6156807,486496,-10683571,-10683571,,-329000,,,,0,486496,11170067,0,850327,,-9833244,-9833244,51404,AKTS
2020-12-31,,,7877000,,6518000,,30481000,0,8952000,21529000,,,,,1359000,30481000,21529000,0,-1075000,,6518000,6518000,51406,STND
2019-12-31,,,11144000,,8806000,16218000.0,32769000,0,11876000,4675000,,,,,2338000,32769000,20893000,0,-732000,,8806000,8806000,51406,STND
2018-12-31,,,11049000,,8801000,15988000.0,33116000,0,12178000,4950000,,,,,2248000,33116000,20938000,0,-1639000,,8801000,8801000,51406,STND
2017-12-31,,,6787000,,4325000,13324000.0,28506000,0,10927000,4255000,,,,,2462000,28506000,17579000,0,-4140000,,4325000,4325000,51406,STND
2020-03-31,,,13314111,,9975225,3559369,16803201,13243832,13243832,,,,,,3338886,28601071,15357239,11797870,70279,,9975225,9975225,51412,EDTK
2019-03-31,,,11567558,,8675058,3731116,15210281,11479165,11479165,,-195.0,,,,2892500,24668840,13189675,9458559,88393,,8675058,8675058,51412,EDTK
2018-03-31,,,8014679,,6009968,2256655,10195124,7938469,7938469,,-114.0,,,,2004711,14910543,6972074,4715419,76210,,6009968,6009968,51412,EDTK
2020-12-31,,,642747000,35283000,475978000,449439000,1280532000,787579000,787579000,,-67494000,,,,167201000,2050844000,1263265000,770312000,-144832000,,475546000,475978000,51413,CIXX
2019-12-31,,,726805000,5368000,538396000,489272000,1348184000,826021000,826021000,,-56724000,,,,189281000,2122466000,1296445000,774282000,-99216000,,537524000,538396000,51413,CIXX
2018-12-31,,,843300000,2849000,617476000,512564000,1427138000,894028000,894028000,7674000.0,-44001000,,,,225453000,2236365000,1342337000,809227000,-50728000,,617847000,617476000,51413,CIXX
2017-12-31,,,807735000,2478000,549094000,459103000,1349895000,838903000,838903000,45465000.0,-25568000,,,,258796000,2111296000,1272393000,761401000,-31168000,,548939000,549094000,51413,CIXX
2019-12-31,,,-50878000,,-50878000,15426000,-39099000,-54525000,-54525000,,,,,,0,3573000,58098000,42672000,3647000,,-50878000,-50878000,51414,CLDX
2018-12-31,66449000.0,,-151949000,,-151184000,19269000,-55911000,-75404000,-75404000,,,,,,-765000,9538000,84942000,65449000,-76545000,,-151184000,-151184000,51414,CLDX
2017-12-31,66449000.0,,-117313000,,-93031000,25003000,-83428000,-109327000,-109327000,,,,,,-24282000,12743000,122070000,96171000,-7986000,,-93031000,-93031000,51414,CLDX
2016-12-31,66449000.0,,-128530000,,-128530000,33579000,-95240000,-129816000,-129816000,,,,,,0,6786000,136602000,102026000,1286000,,-128530000,-128530000,51414,CLDX
2020-03-31,,,144000000,,116800000,181400000,344400000,147300000,147300000,,-17000000,,,,27200000,928300000,781000000,583900000,-3300000,,116800000,116800000,51415,WNS
2019-03-31,,,131152000,,105433000,159834000,290884000,115267000,115267000,,-3204000,,,,25719000,809120000,693853000,518236000,15885000,,105433000,105433000,51415,WNS
2018-03-31,,,101867000,,86436000,159393000,254826000,79928000,79928000,,-4264000,,,,15431000,757956000,678028000,503130000,21939000,,86436000,86436000,51415,WNS
2017-03-31,,,55293000,,37763000,122038000,199222000,56645000,56645000,,-547000,,,,17530000,602546000,545901000,403324000,-1352000,,37763000,37763000,51415,WNS
2019-12-31,8061000,,-9781000,,-9781000,16421000,650000,-23896000,-23896000,,,,,,0,1496000,25392000,846000,14115000,,-9781000,-9781000,51418,HSDT
2018-12-31,9939000,,-28623000,,-28623000,17214000,478000,-26675000,-26675000,,,,,,0,478000,27153000,0,-1948000,,-28623000,-28623000,51418,HSDT
2017-12-31,14387000,,-28024000,,-28024000,8466000,0,-22853000,-22853000,,,,,,0,0,22853000,0,-5171000,,-28024000,-28024000,51418,HSDT
2016-12-31,5704733,,-15870320,,-15870320,7584557,0,-13289290,-13289290,,-20411.0,,,,0,0,13289290,0,-2581030,,-15870320,-15870320,51418,HSDT
2019-12-31,2349000,,-6615000,,-6200000,1973000,0,-4322000,-4322000,,-2194000,,,,-415000,0,4322000,0,-2293000,,-6200000,-6200000,51419,PBLA
2018-12-31,1783000,,-6159000,,-5905000,2108000,0,-3891000,-3891000,,-1814000,,,,-254000,0,3891000,0,-2268000,,-5905000,-5905000,51419,PBLA
2017-12-31,2593000,,-10910000,,-10374000,3423000,0,-6016000,-6016000,,-1617000,,,,-536000,0,6016000,0,-4894000,,-10374000,-10374000,51419,PBLA
2016-12-31,2504000,,-5453000,,-5112000,2664000,0,-5168000,-5168000,,-180000,,,,-341000,0,5168000,0,-285000,,-5112000,-5112000,51419,PBLA
2020-09-30,226234000,,10030000,,21396000,429677000,867770000,133152000,133152000,,-93968000,,,,-18752000,1478899000,1345747000,611129000,-123122000,-7386000,28782000,21396000,51420,NUAN
2019-09-30,192633000,,-93000,18144000.0,213810000,446669000,865203000,144279000,144279000,,-120095000,,,,12105000,1521271000,1376992000,656068000,-144372000,226008000,-12198000,213810000,51420,NUAN
2018-09-30,207189000,,-313997000,18144000.0,-159928000,500359000,864416000,51493000,51493000,,-137253000,,,,-77160000,1567600000,1516107000,703184000,-365490000,76909000,-236837000,-159928000,51420,NUAN
2017-09-30,239925000,,-154670000,18144000.0,-150996000,487435000,982229000,104138000,104138000,,-156889000,,,,23671000,1728175000,1624037000,745946000,-258808000,27345000,-178341000,-150996000,51420,NUAN
2019-12-31,,,64735000,39434000,57933000,16606000,87354000,0,66394000,4354000,,,,,1558000,87354000,20960000,0,-1659000,,63177000,56467000,51422,EFC
2018-12-31,,,49911000,31337000,46676000,15942000,79350000,0,62886000,107000,,,,,0,79350000,16464000,734000,-12975000,,49911000,45923000,51422,EFC
2017-12-31,,,35964000,20862000,33981000,15661000,60561000,0,31516000,12999000,,,,,0,60561000,29045000,720000,4448000,,35964000,33487000,51422,EFC
2016-12-31,,,-15702000,7116000,-16007000,16499000,57861000,0,-2887000,43849000,,,,,0,58984000,61871000,1123000,-12815000,,-15702000,-15789000,51422,EFC
2020-12-31,,,400477000,,308276000,789849000,1291240000,438717000,438717000,19331000,-48960000,,,,92201000,3709377000,3270660000,2418137000,-38240000,,308276000,308276000,51425,G
2019-12-31,,,399417000,,304881000,789995000,1225855000,406413000,406413000,-3165000,-50779000,,,,94536000,3520543000,3114130000,2294688000,-6996000,,304881000,304881000,51425,G
2018-12-31,,,362021000,,282019000,693695000,1079022000,346932000,346932000,-455000,-48507000,,,,80763000,3000790000,2653858000,1921768000,15089000,,281258000,282019000,51425,G
2017-12-31,,,320583000,4750000.0,263111000,686018000,1055491000,336238000,336238000,-3177000,-39917000,,,,59742000,2736929000,2400691000,1681438000,-15655000,,260841000,263111000,51425,G
2019-12-31,,,-8691834,,-8691834,18634884,66439991,47704788,47704788,100319,-13458070,,,,0,66439991,18735203,0,-56396622,,-8691834,-8691834,51426,ECC
2018-12-31,,,-54848492,,-54848492,20080125,69680994,49490819,49490819,110050,-14796919,,,,0,69680994,20190175,0,-104339311,,-54848492,-54848492,51426,ECC
2017-12-31,,,31130956,,31130956,18435353,65291679,46096126,46096126,760200,-12929131,,,,0,65291679,19195553,0,-14965170,,31130956,31130956,51426,ECC
2016-12-31,,,90580063,,90580063,15363476,55839799,39310929,39310929,1165394,-7936089,,,,0,55839799,16528870,0,51269134,,90580063,90580063,51426,ECC
2019-12-31,4964000,,2604000,,2322000,20787000,29225000,3474000,3474000,,,,,,282000,60660000,57186000,31435000,-870000,,2322000,2322000,51427,INTT
2018-12-31,4908000,,5043000,,3037000,22412000,39401000,12081000,12081000,,,,,,2006000,78563000,66482000,39162000,-7038000,,3037000,3037000,51427,INTT
2017-12-31,4301000,,3838000,,975000,18867000,34690000,11522000,11522000,,,,,,2863000,66801000,55279000,32111000,-7684000,,975000,975000,51427,INTT
2016-12-31,3660000,,4207000,,2658000,12062000,20378000,4656000,4656000,,,,,,1549000,40227000,35571000,19849000,-449000,,2658000,2658000,51427,INTT
2019-12-31,,,-16112000,,-16112000,22134000,7876000,-14258000,-14258000,,-1286000,,,,0,33820000,48078000,25944000,-1854000,,-16112000,-16117000,51430,REED
2018-12-31,,,-10325000,,-10325000,17829000,10678000,-7151000,-7151000,,-2201000,,,,0,38102000,45253000,27424000,-3174000,,-10325000,-10330000,51430,REED
2017-12-31,,,-18373000,,-18373000,12717000,6893000,-5824000,-5824000,,-3491000,,,,0,37714000,43538000,30821000,-12549000,,-18373000,-18378000,51430,REED
2016-12-31,,,-5009000,,-5009000,11557000,9242000,-2315000,-2315000,,-1978000,,,,0,42472000,44787000,33230000,-2694000,,-5009000,-5014000,51430,REED
2020-12-31,,,1018691000,2343529000,872727000,133112000,1733811000,905322000,905322000,11626000,-431717000,,,,0,2765686000,1860364000,1031875000,113369000,,1018691000,862227000,51432,BXP
2019-12-31,,,651999000,2329549000,521534000,140777000,1841363000,1032722000,1032722000,11626000,-412717000,,,,0,2927361000,1894639000,1085998000,-380723000,,651999000,511034000,51432,BXP
2018-12-31,,,712563000,2330797000,582847000,121722000,1692682000,925311000,925311000,11626000,-378168000,,,,0,2707300000,1781989000,1014618000,-212748000,,712563000,572246000,51432,BXP
2017-12-31,,,562481000,2288499000,462439000,113715000,1657811000,926549000,926549000,11626000,-374481000,,,,0,2620515000,1693966000,962704000,-364068000,,562481000,451939000,51432,BXP
2019-12-31,10474000,,-13836000,,-13836000,3595000,0,-14069000,-14069000,,,,,,0,0,14069000,0,233000,,-13836000,-13836000,51433,CHEK
2018-12-31,7618000,,-10590000,,-10589000,3164000,0,-10782000,-10782000,,,,,,-1000,0,10782000,0,192000,,-10589000,-10589000,51433,CHEK
2017-12-31,6837000,,-9765000,,-9771000,3164000,0,-10001000,-10001000,,,,,,6000,0,10001000,0,236000,,-9771000,-9771000,51433,CHEK
2016-12-31,5491000,,-8818000,,-8826000,3571000,0,-9062000,-9062000,,,,,,8000,0,9062000,0,244000,,-8826000,-8826000,51433,CHEK
2019-12-31,,,504892000,181926000,474083000,51509000,603876000,157576000,157576000,14620000,-168807000,,,,-3135000,915097000,757521000,311221000,347316000,,508027000,466144000,51435,AIV
2018-12-31,,,703576000,165513000,666227000,46268000,643665000,215833000,215833000,3778000,-200634000,,,,-13027000,972487000,756654000,328822000,487743000,,716603000,656597000,51435,AIV
2017-12-31,,,316243000,94146000,315774000,43657000,658547000,237558000,237558000,11148000,-194615000,,,,-30836000,1013131000,775573000,354584000,78685000,,347079000,306861000,51435,AIV
2016-12-31,,,464431000,254264000,430410000,46784000,619618000,246796000,246796000,-7028000,-196389000,,,,-18842000,974531000,727735000,354913000,217635000,,483273000,417781000,51435,AIV
2020-12-31,,,22497710,225065,17696388,58123523,90884372,0,23246721,9514128,,,,,4800544,90884372,67637651,0,-749011,,17697166,17696388,51437,BRBS
2019-12-31,,,5577000,224000,4580000,27668000,38422000,0,5997000,4757000,,,,,973000,38422000,32425000,0,-420000,,4604000,4580000,51437,BRBS
2018-12-31,,,5720000,213000,4560000,16547000,26184000,0,5970000,3667000,,,,,1147000,26184000,20214000,0,-250000,,4573000,4560000,51437,BRBS
2017-12-31,,,5407229,199604,3350520,12719272,21201454,0,5407229,3074953,,,,,2057105,21201454,15794225,0,0,,3350124,3350520,51437,BRBS
2019-12-31,3893000,,-34566000,26000,-33991000,16703000,4692000,-19533000,-19533000,,-2277000,,,,-584000,6301000,25834000,1609000,-15033000,,-33982000,-35241000,51439,INPX
2018-12-31,1231000,,-19783000,18000,-24572000,15875000,2680000,-17658000,-17658000,,-1241000,,,,0,3756000,21414000,1076000,-2125000,-4778000.0,-19783000,-44624000,51439,INPX
2017-12-31,964000,,-18081000,-2006000,-35013000,13234000,2703000,-14431000,-14431000,,-1884000,,,,0,3935000,18366000,1232000,-3650000,-16949000.0,-18081000,-35769000,51439,INPX
2016-12-31,2277000,,-26745000,-1995000,-27114000,23769000,14927000,-15447000,-15447000,,-1743000,,,,0,53167000,68614000,38240000,-11298000,-758000.0,-26745000,-27114000,51439,INPX
2019-12-31,4530000,,-56942000,,-56957000,51549000,-1651000,-57730000,-57730000,,-250000,,,,15000,7199000,64929000,8850000,788000,,-56957000,-56957000,51441,RMED
2018-12-31,2776000,,-30822000,,-30832000,30435000,2051000,-31160000,-31160000,,-14000,,,,10000,6257000,37417000,4206000,338000,,-30832000,-30832000,51441,RMED
2017-12-31,4518000,,-17764000,,-17765000,14747000,1705000,-17560000,-17560000,,-4000,,,,1000,5870000,23430000,4165000,-204000,,-17765000,-17765000,51441,RMED
2016-12-31,1715000,,-4201000,,-4202000,5321000,2838000,-4198000,-4198000,,-3000,,,,1000,5976000,10174000,3138000,-3000,,-4202000,-4202000,51441,RMED
2020-12-31,,,23212000,,19222000,45261000,88165000,0,32556000,10348000,,,,,3990000,88165000,55609000,0,-9344000,,19222000,19106000,51443,CZNC
2019-12-31,,,23409000,,19504000,36288000,72946000,0,27508000,9150000,,,,,3905000,72946000,45438000,0,-4099000,,19504000,19404000,51443,CZNC
2018-12-31,,,26263000,,22013000,31323000,65311000,0,26153000,7835000,,,,,4250000,65311000,39158000,0,110000,,22013000,21903000,51443,CZNC
2017-12-31,,,20590000,,13434000,29366000,57557000,0,20590000,7601000,,,,,7156000,57557000,36967000,0,-376000,,13434000,13365000,51443,CZNC
2020-12-31,2205000000,,-6980000000,1488000000,-6768000000,6249000000,4166000000,-4863000000,-4863000000,,-458000000,,,,-192000000,11139000000,16002000000,6973000000,-2117000000,,-6788000000,-6768000000,51444,UBER
2019-12-31,4836000000,,-8467000000,993000000,-8506000000,7925000000,4637000000,-8596000000,-8596000000,,-559000000,,,,45000000,14147000000,22743000000,9510000000,129000000,,-8512000000,-8506000000,51444,UBER
2018-12-31,1505000000,,1270000000,993000000,997000000,5036000000,4131000000,-2836000000,-2836000000,,-648000000,,,,283000000,11270000000,14106000000,7139000000,4106000000,,-8512000000,-8506000000,51444,UBER
2017-12-31,1201000000,,-4575000000,993000000,-4033000000,4564000000,2418000000,-3857000000,-3857000000,,-479000000,,,,-542000000,7932000000,11789000000,5514000000,-718000000,,-4033000000,-4033000000,51444,UBER
2019-12-31,49297000,,-105146000,,-105146000,60199000,18000,-109478000,-109478000,,,,,,0,18000,109496000,0,4332000,,-105146000,-105146000,51445,URGN
2018-12-31,34534000,,-75532000,,-75657000,32071000,-675000,-67280000,-67280000,,,,,,125000,1128000,68408000,1803000,-8252000,,-75657000,-75657000,51445,URGN
2017-12-31,18697000,,-19981000,,-20000000,8811000,7558000,-19950000,-19950000,,,,,,19000,8158000,28108000,600000,-31000,,-20000000,-20825000,51445,URGN
2016-12-31,10287000,,-1941000,,-1941000,6417000,17502000,798000,798000,,,,,,0,17530000,16732000,28000,-2739000,,-1941000,-4408000,51445,URGN
2020-12-31,,,5230000000,11532000000,18896000000,53287000000,74219000000,0,14751000000,6181000000,,,,,-9834000000,74219000000,59468000000,0,-9521000000,,15064000000,18896000000,51450,ITUB
2019-12-31,,,31243000000,12540000000,27113000000,52393000000,98512000000,0,38547000000,7572000000,,,,,3430000000,98512000000,59965000000,0,-7304000000,,27813000000,27113000000,51450,ITUB
2018-12-31,,,30608000000,13684000000,24907000000,53839000000,94018000000,0,33560000000,6619000000,,,,,4969000000,94018000000,60458000000,0,-2952000000,,25639000000,24907000000,51450,ITUB
2017-12-31,,,30582000000,12978000000,23193000000,50518000000,90557000000,0,33008000000,7031000000,,,,,7357000000,90557000000,57549000000,0,-2426000000,,23225000000,23193000000,51450,ITUB
2019-12-31,438371,,-11289213,1818860,-14802614,5262460,7360570,-6671605,-6671605,,-1253855,,,,1006905,29551727,36223332,22191157,-4617608,-2801131,-12296118,-14802614,51451,RETO
2018-12-31,656563,,3695862,2267985,4480618,6878441,14025421,4766284,4766284,,-1069758,,,,1042474,29294869,24528585,15269448,-1070422,1914294,2653388,4480618,51451,RETO
2017-12-31,478532,,6833278,2307727,5978390,5852758,14862106,7650421,7650421,,-971052,,,,2132297,25904393,18253972,11042287,-817143,1945805,4700981,5978390,51451,RETO
2016-12-31,503688,,6455436,5012260,4103521,4258625,14053041,8189030,8189030,,-1450389,,,,1952356,32424269,24235239,18371228,-1733594,1945805,4503080,4103521,51451,RETO
2019-12-31,,,76051000,,63316000,,63761000,76051000,76051000,-12290000,,,,,12735000,315888000,239837000,252127000,0,,63316000,63316000,51452,KNSL
2018-12-31,,,40480000,,33787000,,30200000,40480000,40480000,-10280000,,,,,6693000,222114000,181634000,191914000,0,,33787000,33787000,51452,KNSL
2017-12-31,,,38521000,,24901000,,29151000,38521000,38521000,-9370000,,,,,13620000,186776000,148255000,157625000,0,,24901000,24901000,51452,KNSL
2016-12-31,,,39536000,,26167000,,21535000,40836000,40836000,-19301000,-1300000.0,,,,13369000,141615000,100779000,120080000,-1300000,,26167000,26167000,51452,KNSL
2019-12-31,1050151,,-3119530,,-3927662,2065112,0,-3115263,-3115263,,-4267,,,,0,0,3115263,0,-4267,-808132,-3119530,-3927662,51454,IPWR
2018-12-31,871742,,-4271603,,-7904989,3711286,0,-4583028,-4583028,,-4267,,,,0,0,4583028,0,311425,-3633386,-4271603,-7904989,51454,IPWR
2017-12-31,715841,,-4210062,,-10435098,3511809,0,-4227650,-4227650,,-4267,,,,0,0,4227650,0,17588,-6225036,-4210062,-10435098,51454,IPWR
2016-12-31,5224992,,-10981091,,-10981091,5364204,-310972,-10900168,-10900168,,-4267,,,,0,1628740,12528908,1939712,-80923,-6225036,-10981091,-10981091,51454,IPWR
2019-12-31,,,36857611000,2893012000,23708123000,45043290000,143428809000,0,36638131000,61747388000,,,,,13038494000,147036379000,110398248000,3607570000,219480000,,23819117000,23708123000,51457,GGAL
2018-12-31,,,5190996000,2649815000,-5331559000,46107256000,109924534000,0,4850043000,58967235000,,,,,10633705000,112102162000,107252119000,2177628000,340953000,-448315000.0,-5442709000,-5331559000,51457,GGAL
2017-12-31,,,22949547000,2953480000,10450740000,43677359000,104516300000,0,22455465000,38383476000,,,,,11259035000,106109819000,83654354000,1593519000,370099000,-494971000.0,11690512000,10450740000,51457,GGAL
2016-12-31,,,9773586000,1462189000,6017877000,13521159000,23974521000,0,10029860000,423502000,,,,,3352541000,24450543000,14420683000,476022000,-256274000,-494971000.0,6421045000,6017877000,51457,GGAL
2019-12-31,34319000,,-41975000,,-41975000,9952000,0,-44271000,-44271000,,,,,,0,0,44271000,0,2296000,,-41975000,-41975000,51458,IDYA
2018-12-31,31749000,,-34346000,,-34346000,4668000,0,-36417000,-36417000,,,,,,0,0,36417000,0,2071000,,-34346000,-34346000,51458,IDYA
2017-12-31,12384000,,-11862000,,-11862000,2054000,0,-14438000,-14438000,,,,,,0,0,14438000,0,2576000,,-11862000,-11862000,51458,IDYA
2020-06-30,1721419,,-13620679,,-13620679,34102432,20079049,-20235268,-20235268,,,,,,0,27632080,47867348,7553031,6614589,,-13620679,-13620679,51460,AYTU
2019-06-30,589072,,-27131908,,-27131908,19239626,5118316,-16846637,-16846637,,,,,,0,7320357,24166994,2202041,-10285271,,-27131908,-27131908,51460,AYTU
2018-06-30,167595,,-10187863,,-10187863,17732490,1609576,-17844214,-17844214,,,,,,0,3660120,21504334,2050544,7656351,,-10187863,-10187863,51460,AYTU
2017-06-30,1347817,,-22508304,,-22508304,17177758,1804235,-18430111,-18430111,,-2534358.0,,,,0,3221590,21651701,1417355,-4078193,,-22508304,-22508304,51460,AYTU
2019-12-31,19009000,,-23463000,,-23463000,5107000,0,-24116000,-24116000,,,,,,0,0,24116000,0,653000,,-23463000,-23463000,51466,IMRA
2018-12-31,8239000,,-11337000,,-11337000,2438000,0,-10677000,-10677000,,,,,,0,0,10677000,0,-660000,,-11337000,-11337000,51466,IMRA
2017-12-31,7918000,,221000,,221000,987000,0,-8905000,-8905000,,,,,,0,0,8905000,0,9126000,,-11337000,-11337000,51466,IMRA
2020-04-30,,,5292020,,5292020,3031801,18731784,15699983,15699983,,-3230450,,,,0,18731784,3031801,0,-10407963,,5292020,5292020,51468,MHI
2019-04-30,,,21166907,,21166907,2924064,19681469,16757405,16757405,,-3230450,,,,0,19681469,2924064,0,4409502,,21166907,17695332,51468,MHI
2018-04-30,,,10912117,,10912117,2947483,20804256,17856773,17856773,,-3230450,,,,0,20804256,2947483,0,-6944656,,10912117,8859861,51468,MHI
2017-04-30,,,-681165,,-681165,2997126,19560960,16563834,16563834,,-3230450,,,,0,19560960,2997126,0,-17244999,,-681165,-1832111,51468,MHI
2019-12-31,,,-24734000,,-24734000,5112000,-12220000,-17332000,-17332000,,-7387000,,,,0,2319000,19651000,14539000,-7402000,,-24734000,-24734000,51470,RNA
2018-12-31,,,-11216000,,-11216000,2441000,-8057000,-10498000,-10498000,,-718000,,,,0,379000,10877000,8436000,-718000,,-11216000,-11216000,51470,RNA
2019-12-31,2160588,,-10713009,,-10713009,11554522,2920107,-10795003,-10795003,,-113631,,,,0,3837730,14632733,917623,81994,,-10713009,-10713009,51472,MYO
2018-12-31,1838633,,-10316739,,-10316739,10405609,1715825,-10528417,-10528417,,-113631,,,,0,2444104,12972521,728279,211678,,-10316739,-10316739,51472,MYO
2017-12-31,1751731,,-12097479,,-12097479,5849969,1053586,-6548114,-6548114,,-5529122,,,,0,1558866,8106980,505280,-5549365,,-12097479,-12659269,51472,MYO
2016-12-31,1120951,,-3617022,,-3617022,2975164,821113,-3275002,-3275002,,-342140,,,,0,1103277,4378279,282164,-342020,,-3617022,-4384054,51472,MYO
2019-12-31,840415000,,-1451950000,,-1451950000,654553000,30000000,-1464968000,-1464968000,,-2991000,,,,0,30000000,1494968000,0,13018000,,-1451950000,-1485001000,51473,IMAB
2018-12-31,426028000,,-401111000,,-402833000,66391000,53781000,-438638000,-438638000,,-11695000,,,,1722000,53781000,492419000,0,37527000,,-402833000,-402833000,51473,IMAB
2017-12-31,267075000,,-298240000,305708000.0,-298240000,25436000,11556000,-280955000,-280955000,,-5643000,,,,0,11556000,292511000,0,-17285000,,-298240000,-298240000,51473,IMAB
2020-12-31,5061734,,-9457871,,-9457871,4392873,0,-9454607,-9454607,,-3264,,,,0,0,9454607,0,-3264,,-9457871,-9457871,51474,CNSP
2019-12-31,1854334,,-3877211,,-3877211,1978643,0,-3832977,-3832977,,-44234,,,,0,0,3832977,0,-44234,,-3877211,-3877211,51474,CNSP
2018-12-31,21267,,-7391899,,-7391899,860520,0,-881787,-881787,,-46697,,,,0,0,881787,0,-6510112,,-7391899,-7391899,51474,CNSP
2017-12-31,78331,,-526469,,-526469,437921,0,-516252,-516252,,-10217,,,,0,0,516252,0,-10217,,-526469,-526469,51474,CNSP
2019-12-31,,,-10923000,,-10085000,4164000,-7169000,-11318000,-11318000,-15000,-97000,,,,-1785000,674000,11992000,7843000,395000,-947000,-9138000,-10085000,51476,MTP
2018-12-31,9359000.0,,-12400000,,-15030000,4394000,-7421000,-11815000,-11815000,-15000,-587000,,,,-2032000,1938000,13753000,9359000,-583000,-4662000,-10368000,-15030000,51476,MTP
2017-12-31,9359000.0,,-12970000,,-16064000,4436000,-7340000,-11776000,-11776000,-15000,-109000,,,,-1265000,989000,12765000,8329000,-1194000,-4359000,-11705000,-16064000,51476,MTP
2016-12-31,9359000.0,,-8388000,,-20162000,3245000,-6407000,-9652000,-9652000,-15000,-73000,,,,-2227000,1323000,10975000,7730000,1264000,-14001000,-6161000,-20162000,51476,MTP
2019-12-31,,,2294000000,2075000000,2069000000,2762000000,7392000000,3283000000,3283000000,,-720000000,,,,81000000,11144000000,7861000000,3752000000,-989000000,,2213000000,1845000000,51478,DISCB
2018-12-31,,,1022000000,2131000000,594000000,2510000000,6643000000,2735000000,2735000000,,-743000000,,,,341000000,10553000000,7818000000,3910000000,-1713000000,,681000000,529000000,51478,DISCB
2017-12-31,,,-137000000,413000000,-337000000,1689000000,4249000000,2230000000,2230000000,7000000.0,-458000000,,,,176000000,6873000000,4643000000,2624000000,-2367000000,,-313000000,-296000000,51478,DISCB
2016-12-31,,,1671000000,243000000,1194000000,1690000000,4130000000,2122000000,2122000000,-4000000.0,-353000000,,,,453000000,6497000000,4375000000,2367000000,-451000000,,1218000000,1055000000,51478,DISCB
2020-12-31,,,-2779000000,69000000,-2542000000,968000000,434000000,-534000000,-534000000,,-84000000,,,,-242000000,6090000000,6624000000,5656000000,-2245000000,,-2537000000,-2542000000,51480,NOV
2019-12-31,,,-6462000000,68000000,-6095000000,1303000000,845000000,-458000000,-458000000,,-100000000,,,,-369000000,8479000000,8937000000,7634000000,-6004000000,,-6093000000,-6095000000,51480,NOV
2018-12-31,,,41000000,70000000,-31000000,1233000000,1444000000,211000000,211000000,,-93000000,,,,63000000,8453000000,8242000000,7009000000,-170000000,,-22000000,-31000000,51480,NOV
2017-12-31,,,-392000000,66000000,-237000000,1169000000,892000000,-277000000,-277000000,,-102000000,,,,-156000000,7304000000,7581000000,6412000000,-115000000,,-236000000,-237000000,51480,NOV
2019-12-31,,,-2561000,,-2732000,8539000,9142000,603000,603000,,-3561000,,,,37000,54573000,53970000,45431000,-3164000,-134000,-2598000,-2732000,51481,AIRI
2018-12-31,,,-8551000,,-10992000,8315000,5445000,-2870000,-2870000,,-3916000,,,,3000,44530000,47400000,39085000,-5681000,-2441000,-8551000,-10992000,51481,AIRI
2017-12-31,,,-16270000,,-22551000,11430000,4867000,-6563000,-6563000,,-3378000,,,,-197000,49869000,56432000,45002000,-9707000,-6478000,-16073000,-22551000,51481,AIRI
2016-12-31,,,-12766000,,-15623000,14404000,4269000,-10135000,-10135000,,-2500000,,,,2101000,51321000,61456000,47052000,-2631000,-756000,-14867000,-15623000,51481,AIRI
2020-09-30,,,2335000000,42000000,1965000000,3986000000,7029000000,2848000000,2848000000,195000000,-175000000,,,,345000000,16785000000,13937000000,9756000000,-513000000,,1990000000,1965000000,51482,EMR
2019-09-30,,,2859000000,40000000,2306000000,4457000000,7815000000,3062000000,3062000000,296000000,-201000000,,,,531000000,18372000000,15310000000,10557000000,-203000000,,2328000000,2306000000,51482,EMR
2018-09-30,,,2667000000,43000000,2203000000,4269000000,7432000000,2906000000,2906000000,257000000,-202000000,,,,443000000,17408000000,14502000000,9976000000,-239000000,,2224000000,2203000000,51482,EMR
2017-09-30,,,2335000000,52000000,1518000000,3607000000,6431000000,2617000000,2617000000,207000000,-201000000,,,,660000000,15264000000,12647000000,8833000000,-282000000,-125000000.0,1675000000,1518000000,51482,EMR
2020-12-31,8548000000,,9878000000,68000000,8072000000,14093000000,35362000000,12051000000,12051000000,670000000,-869000000,,,,1807000000,49762000000,37711000000,14400000000,-2173000000,,8071000000,8072000000,51484,NVS
2019-12-31,8436000000,,8940000000,77000000,11732000000,14319000000,34681000000,11351000000,11351000000,575000000,-850000000,,,,1793000000,48611000000,37260000000,13930000000,-2411000000,4590000000.0,7147000000,11732000000,51484,NVS
2018-12-31,8489000000,,14095000000,78000000,12611000000,13717000000,31589000000,8924000000,8924000000,459000000,-932000000,,,,1295000000,46099000000,37175000000,14510000000,5171000000,-186000000.0,12800000000,12611000000,51484,NVS
2017-12-31,7995000000,,9102000000,59000000,7703000000,12468000000,29988000000,8944000000,8944000000,581000000,-750000000,,,,1603000000,43404000000,34460000000,13416000000,158000000,204000000.0,7499000000,7703000000,51484,NVS
2019-12-31,,,-328300000,72700000,-412600000,42000000,53700000,-59300000,-59300000,34200000,-8100000,,,,30400000,1065300000,1124600000,1011600000,-269000000,-39300000,-358700000,-412600000,51486,IAG
2018-12-31,,,15100000,60000000,-28200000,42100000,136900000,42100000,42100000,13500000,-2700000,,,,38000000,1111000000,1068900000,974100000,-27000000,3200000,-22900000,-28200000,51486,IAG
2017-12-31,,,608100000,55200000,501600000,40300000,152900000,581600000,581600000,16700000,-7100000,,,,97600000,1094900000,513300000,942000000,26500000,3200000,510500000,501600000,51486,IAG
2016-12-31,,,95200000,49400000,52600000,38800000,102200000,37800000,37800000,-6100000,-23000000,,,,33400000,987100000,949300000,884900000,57400000,3200000,61800000,52600000,51486,IAG
2020-07-31,32372000,,6952000,,13708000,329224000,462584000,100988000,100988000,,-41355000,,,,-6756000,1016048000,915060000,553464000,-94036000,,13708000,13707000,51491,CMD
2019-07-31,31320000,,75319000,,55042000,278704000,430234000,120210000,120210000,,-9505000,,,,20277000,918155000,797945000,487921000,-44891000,,55042000,54991000,51491,CMD
2018-07-31,24646000,,117513000,,91041000,260693000,416381000,131042000,131042000,,-5289000,,,,26472000,871922000,740880000,455541000,-13529000,,91041000,90721000,51491,CMD
2017-07-31,18367000,,106233000,,71378000,233005000,367513000,116141000,116141000,,-4303000,,,,34855000,770157000,654016000,402644000,-9908000,,71378000,70947000,51491,CMD
2019-12-31,8915058,,-14092912,,-14092912,5182566,0,-14097624,-14097624,,,,,,0,0,14097624,0,4712,,-14092912,-14092912,51492,CLRB
2018-12-31,6835229,,-13239027,,-13239027,4820073,0,-11655302,-11655302,,,,,,0,0,11655302,0,-1583725,,-13239027,-15480822,51492,CLRB
2017-12-31,9465666,,-13562290,,-13562290,4135304,0,-13600970,-13600970,,-1000.0,,,,0,0,13600970,0,-1161320,,-13562290,-15011235,51492,CLRB
2016-12-31,4750414,,-6180326,,-6180326,4699338,0,-9449752,-9449752,,-1500.0,,,,0,0,9449752,0,3269426,,-6180326,-9360307,51492,CLRB
2020-12-31,133400000,,-268800000,14600000,-269100000,858600000,1091500000,99500000,99500000,,-292700000,,,,-1000000,3902300000,3802800000,2810800000,-368300000,,-267800000,-269100000,51493,DBD
2019-12-31,144100000,,-227900000,44900000,-341300000,865800000,1076800000,66900000,66900000,,-202900000,,,,116700000,4408700000,4341800000,3331900000,-294800000,,-344600000,-341300000,51493,DBD
2018-12-31,154400000,,-491500000,157200000,-531400000,795700000,992900000,51800000,51800000,-9000000.0,-154900000,,,,37200000,4578600000,4526800000,3585700000,-543300000,,-528700000,-531400000,51493,DBD
2017-12-31,156600000,,-185600000,528900000,-241500000,912400000,1029000000,-40000000,-40000000,-9000000.0,-117300000,,,,28300000,4609300000,4649300000,3580300000,-145600000,,-213900000,-241500000,51493,DBD
2019-12-31,26928000,,-39030000,,-39050000,21455000,22595000,-27575000,-27575000,1787000,-1434000,,,,20000,106327000,133902000,83732000,-11455000,,-39050000,-39050000,51494,BLDP
2018-12-31,27039000,,-26953000,,-27323000,23171000,29674000,-20634000,-20634000,98000,-503000,,,,370000,96586000,117220000,66912000,-6319000,,-27323000,-27323000,51494,BLDP
2017-12-31,25022000,,-6477000,,-8048000,20901000,41600000,-4426000,-4426000,103000,-732000,,,,1571000,121288000,125714000,79688000,-2051000,,-8048000,-8048000,51494,BLDP
2016-12-31,19827000,,-21306000,-3301000.0,-21112000,20391000,24184000,-15971000,-15971000,-63000,-686000,,,,381000,85270000,101241000,61086000,-5335000,,-21687000,-21112000,51494,BLDP
2020-08-31,,,-16225834,-361632,-15278608,9344096,0,-10357091,-10357091,417580,-3429297,,,,-4077,0,10357091,0,-5868743,,-16221757,-15278608,51495,TRX
2019-08-31,,,-30368311,581517,-30298724,4121525,0,-28006439,-28006439,1111261,-1622337,,,,49206,0,28006439,0,-2361872,,-30417517,-30298724,51495,TRX
2018-08-31,,,-7096450,700310,-6897382,4246752,0,-4867308,-4867308,211086,-1393825,,,,947,0,4867308,0,-2229142,,-7097397,-6897382,51495,TRX
2017-08-31,,,-6392196,900325,-5965758,4207594,0,-4818422,-4818422,10934,-1120004,,,,41916,0,4818422,0,-1573774,,-6434112,-5965758,51495,TRX
2020-06-30,,,3182600000,,2466500000,2856000000,6511600000,3288700000,3288700000,,-107100000,,,,716100000,14589800000,11301100000,8078200000,-106100000,,2466500000,2466500000,51502,ADP
2019-06-30,,,3005600000,,2292800000,2871000000,6393000000,3217600000,3217600000,,-129900000,,,,712800000,14110200000,10892600000,7717200000,-212000000,,2292800000,2292800000,51502,ADP
2018-06-30,,,2282600000,,1884900000,2893600000,5791300000,2623200000,2623200000,,-102700000,,,,397700000,13274200000,10651000000,7482900000,-340600000,,1884900000,1884900000,51502,ADP
2017-06-30,,,2616900000,,1787800000,2630800000,5353700000,2496700000,2496700000,,-80000000,,,,829100000,12372000000,9875300000,7018300000,120200000,,1787800000,1787800000,51502,ADP
2019-12-31,41985000,,-55285000,,-55229000,15896000,0,-57881000,-57881000,,,,,,-56000,0,57881000,0,2596000,,-55229000,-55229000,51503,MIST
2018-12-31,16849000,,-23111000,,-23185000,6973000,0,-23822000,-23822000,,,,,,74000,0,23822000,0,711000,,-23185000,-23185000,51503,MIST
2017-12-31,5636000,,-8082000,,-8086000,2632000,0,-8268000,-8268000,,,,,,4000,0,8268000,0,186000,,-8086000,-8086000,51503,MIST
2019-12-31,,,31113000,,30335000,32728000,570385000,126829000,126829000,120943000,-134880000,,,,778000,678404000,551575000,108019000,-95716000,,30335000,30335000,51504,OPINL
2018-12-31,,,-27489000,,-21884000,24922000,350427000,73407000,73407000,89610000,-89865000,,,,117000,426560000,353153000,76133000,-100896000,5722000.0,-27606000,-22255000,51504,OPINL
2017-12-31,,,-9638000,20496000.0,12090000,18847000,257592000,63808000,63808000,65349000,-65406000,,,,101000,316532000,252724000,58940000,-73446000,21829000.0,-9739000,11815000,51504,OPINL
2016-12-31,,,23066000,20496000.0,57843000,14897000,210208000,67868000,67868000,54290000,-45060000,,,,101000,258180000,190312000,47972000,-44802000,34878000.0,22965000,57843000,51504,OPINL
2020-12-31,,,-191531000,159406000,-115583000,84098000,107806000,-156376000,-156376000,,-14505000,,,,-30857000,965787000,1122163000,857981000,-35155000,,-160674000,-115583000,51506,LBRT
2019-12-31,,,88916000,226665000,39003000,97589000,369166000,106198000,106198000,,-17485000,,,,14052000,1990346000,1884148000,1621180000,-17282000,,74864000,39003000,51506,LBRT
2018-12-31,,,289418000,307745000,135054000,99052000,526383000,302221000,302221000,,-17527000,,,,40385000,2155136000,1852915000,1628753000,-12803000,,249033000,126349000,51506,LBRT
2017-12-31,,,168501000,307745000,168501000,80089000,342847000,181285000,181285000,,-12689000,,,,38149000,1489855000,1308570000,1147008000,-12784000,,168501000,168501000,51506,LBRT
2019-12-31,,,399000000,37000000,396000000,526000000,1681000000,655000000,655000000,67000000,-190000000,,,,-1000000,2960000000,2305000000,1279000000,-256000000,,400000000,360000000,51507,ENBL
2018-12-31,,,522000000,38000000,521000000,495000000,1612000000,654000000,654000000,65000000,-152000000,,,,-1000000,3431000000,2777000000,1819000000,-132000000,,523000000,485000000,51507,ENBL
2017-12-31,,,436000000,12000000,436000000,462000000,1422000000,530000000,530000000,64000000,-120000000,,,,-1000000,2803000000,2273000000,1381000000,-94000000,,437000000,400000000,51507,ENBL
2016-12-31,,,314000000,12000000,312000000,465000000,1254000000,393000000,393000000,58000000,-99000000,,,,1000000,2272000000,1879000000,1018000000,-79000000,,313000000,290000000,51507,ENBL
2019-12-31,,,-551000,,-206000,10467000,11341000,0,49000,825000,,,,,-345000,11341000,11292000,0,-600000,,-206000,-206000,51508,BYFC
2018-12-31,,,871000,,815000,10244000,12232000,0,871000,1117000,,,,,56000,12232000,11361000,0,0,,815000,812000,51508,BYFC
2017-12-31,,,3732000,,1869000,10402000,14191000,0,2763000,1026000,,,,,1863000,14191000,11428000,0,969000,,1869000,1864000,51508,BYFC
2016-12-31,,,1255000,,3480000,10656000,12814000,0,1255000,903000,,,,,-2225000,12814000,11559000,0,0,,3480000,3477000,51508,BYFC
2019-12-31,40269000,,-26990000,,-25478000,86337000,99023000,-27583000,-27583000,,,,,,-1512000,156414000,183997000,57391000,593000,,-25478000,-25478000,51510,MGNI
2018-12-31,37863000,,-61465000,,-61822000,86987000,64682000,-60168000,-60168000,,,,,,357000,124685000,184853000,60003000,-1297000,,-61822000,-61822000,51510,MGNI
2017-12-31,47500000,,-156545000,,-154783000,107087000,98709000,-55878000,-55878000,,,,,,-1762000,155545000,211423000,56836000,-100667000,,-154783000,-154783000,51510,MGNI
2016-12-31,51184000,,-22913000,,-18053000,151898000,204974000,1892000,1892000,,,,,,-4860000,278221000,276329000,73247000,-24805000,,-18053000,-18053000,51510,MGNI
2019-12-31,662100000,,-52000000,,-52700000,667700000,1250300000,-79500000,-79500000,,-10300000,,,,700000,1661300000,1740800000,411000000,27500000,,-52700000,-52700000,51512,DBX
2018-12-31,768200000,,-480100000,,-484900000,722800000,997000000,-494000000,-494000000,,-9700000,,,,4800000,1391700000,1885700000,394700000,13900000,,-484900000,-484900000,51512,DBX
2017-12-31,380300000,,-111500000,,-111700000,471300000,737900000,-113700000,-113700000,,-14000000,,,,200000,1106800000,1220500000,368900000,2200000,,-111700000,-111700000,51512,DBX
2016-12-31,289700000,,-205000000,,-210200000,358000000,454200000,-193500000,-193500000,,-17300000,,,,5200000,844800000,1038300000,390600000,-11500000,,-210200000,-210200000,51512,DBX
2019-12-31,17640000,,-25600000,,-25600000,9087000,0,-26727000,-26727000,,-279000,,,,0,0,26727000,0,1127000,,-25600000,-25600000,51513,EQ
2018-12-31,4943000,,-13250000,,-13250000,3672000,0,-8615000,-8615000,,-2558000,,,,0,0,8615000,0,-4635000,,-13250000,-13250000,51513,EQ
2017-12-31,1600465,,-2714249,,-2714249,453994,0,-2054459,-2054459,,-455262,,,,0,0,2054459,0,-659790,,-2714249,-2714249,51513,EQ
2019-12-31,,,9541000,2903000,9628000,8613000,96621000,35969000,35969000,,-28279000,,,,0,114387000,78418000,17766000,-26428000,,9541000,-4760000,51514,GOODM
2018-12-31,,,12324000,4675000,12320000,7005000,90286000,35661000,35661000,,-26172000,,,,0,106798000,71137000,16512000,-23337000,,12324000,973000,51514,GOODM
2017-12-31,,,5937000,4675000,5937000,6060000,82152000,33297000,33297000,,-24570000,,,,0,94799000,61502000,12647000,-27360000,,5937000,-4939000,51514,GOODM
2016-12-31,,,3958000,4675000,3958000,6243000,76553000,32793000,32793000,,-27404000,,,,0,86372000,53579000,9819000,-28835000,,3958000,-3698000,51514,GOODM
2020-12-31,,,81042000,,63309000,175537000,329920000,0,132373000,22010000,,,,,17733000,329920000,197547000,0,-51331000,,63309000,61212000,51516,OCFC
2019-12-31,,,107358000,,88574000,142411000,296500000,0,133165000,20924000,,,,,18784000,296500000,163335000,0,-25807000,,88574000,88574000,51516,OCFC
2018-12-31,,,85502000,,71932000,131033000,271839000,0,123088000,17718000,,,,,13570000,271839000,148751000,0,-37586000,,71932000,71932000,51516,OCFC
2017-12-31,,,65325000,,42470000,93048000,191845000,0,84426000,14371000,,,,,22855000,191845000,107419000,0,-19101000,,42470000,42470000,51516,OCFC
2020-09-30,15400000,,82757000,,53429000,436926000,645585000,173603000,173603000,,-66544000,,,,29328000,2407522000,2233919000,1761937000,-90846000,,53429000,53429000,51517,GFF
2019-09-30,15400000,,72178000,,37287000,411235000,583474000,137813000,137813000,,-68066000,,,,26556000,2209289000,2071476000,1625815000,-65635000,-8335000.0,45622000,37287000,51517,GFF
2018-09-30,15400000,,33810000,,125678000,377065000,512818000,104047000,104047000,,-65568000,,,,555000,1977918000,1873871000,1465100000,-70237000,92423000.0,33255000,125678000,51517,GFF
2017-09-30,17700000,,16698000,,14912000,298787000,408126000,78644000,78644000,,-51513000,,,,-1085000,1524997000,1446353000,1116871000,-61946000,-2871000.0,17783000,14912000,51517,GFF
2020-12-31,,,-520000,3960000,-1072000,16865000,89942000,30965000,30965000,,-21974000,,,,0,135538000,104573000,45596000,-31485000,,-520000,-12062000,51520,CDR
2019-12-31,,,1566000,3514000,1076000,20304000,95736000,33871000,33871000,,-23509000,,,,0,144083000,110212000,48347000,-32305000,,1566000,-10234000,51520,CDR
2018-12-31,,,4358000,3291000,3889000,16915000,104126000,47158000,47158000,,-22146000,,,,0,152020000,104862000,47894000,-47629000,,4358000,-11109000,51520,CDR
2017-12-31,,,19653000,1775000,19143000,16907000,101523000,44501000,44501000,,-22199000,,,,0,146008000,101507000,44485000,-24848000,,19653000,-3153000,51520,CDR
2020-02-01,,,-11954000,,-12754000,711951000,712962000,1011000,1011000,,,,,,800000,2037875000,2036864000,1324913000,-12965000,,-12754000,-12754000,51521,CHS
2019-02-02,,,43313000,,35613000,719748000,774116000,54368000,54368000,,-353000.0,,,,7700000,2131140000,2076772000,1357024000,-11055000,,35613000,34734000,51521,CHS
2018-02-03,,,143600000,,101000000,719607000,864777000,145170000,145170000,,-1570000.0,,,,42600000,2282379000,2137209000,1417602000,-1570000,,101000000,98700000,51521,CHS
2017-01-28,,,138729000,,91229000,775107000,949336000,174229000,174229000,,-1973000.0,,,,47500000,2476410000,2302181000,1527074000,-35500000,,91229000,89314000,51521,CHS
2020-12-31,18447000000,,33180000000,,29146000000,18155000000,69273000000,32671000000,32671000000,,,,,,4034000000,85965000000,53294000000,16692000000,509000000,,29146000000,29146000000,51522,FB
2019-12-31,13600000000,,24812000000,,18485000000,15341000000,57927000000,28986000000,28986000000,,,,,,6327000000,70697000000,41711000000,12770000000,-4174000000,,18485000000,18485000000,51522,FB
2018-12-31,10273000000,,25361000000,,22112000000,11297000000,46483000000,24913000000,24913000000,,,,,,3249000000,55838000000,30925000000,9355000000,448000000,,22112000000,22111000000,51522,FB
2017-12-31,7754000000,,20594000000,,15934000000,7242000000,35199000000,20203000000,20203000000,,-6000000.0,,,,4660000000,40653000000,20450000000,5454000000,391000000,,15934000000,15920000000,51522,FB
2019-12-31,,,288450000,,216726000,501702000,817821000,307967000,307967000,,-19206000,,,,71724000,2352717000,2044750000,1534896000,-19517000,,216726000,216726000,51523,FCN
2018-12-31,,,207792000,,150611000,465157000,699803000,226484000,226484000,,-27149000,,,,57181000,2027877000,1801393000,1328074000,-18692000,,150611000,150611000,51523,FCN
2017-12-31,,,87105000,,107962000,429722000,592172000,151887000,151887000,,-25358000,,,,-20857000,1807732000,1655845000,1215560000,-64782000,,107962000,107962000,51523,FCN
2016-12-31,,,127803000,,85520000,434552000,599623000,154765000,154765000,,-24819000,,,,42283000,1810394000,1655629000,1210771000,-26962000,,85520000,85520000,51523,FCN
2019-12-31,,,201242000,3213000,167869000,791156000,1405789000,457063000,457063000,108433000,-226760000,,,,32333000,1405789000,948726000,0,-255821000,,168909000,167869000,51525,ECPG
2018-12-31,,,156488000,1679000,115886000,780568000,1320557000,405300000,405300000,134934000,-240048000,,,,46752000,1320557000,915257000,0,-248812000,,109736000,115886000,51525,ECPG
2017-12-31,,,131226000,142049000,83228000,717583000,1145802000,324540000,324540000,104938000,-204161000,,,,52049000,1145802000,821262000,0,-193314000,-199000.0,79177000,83228000,51525,ECPG
2016-12-31,,,57375000,38216000,76570000,648950000,1113435000,244703000,244703000,100737000,-198367000,,,,38205000,1113435000,868732000,0,-187328000,-2353000.0,19170000,76570000,51525,ECPG
2019-12-31,18421000,,-22335000,,-22454000,8837000,0,-27258000,-27258000,,,,,,119000,0,27258000,0,4923000,,-22454000,-26535000,51526,ITOS
2018-12-31,16433000,,-18046000,,-18057000,4312000,0,-20745000,-20745000,,-66000.0,,,,11000,0,20745000,0,2699000,,-18057000,-20066000,51526,ITOS
2020-03-31,96000000,,1144000000,1619000000,900000000,9086000000,12023000000,2841000000,2841000000,,-249000000,,,,18000000,231051000000,228210000000,219028000000,-1697000000,-6000000,1126000000,900000000,51527,MCK
2019-03-31,71000000,,610000000,1586000000,34000000,8403000000,11754000000,3259000000,3259000000,21000000.0,-264000000,,,,356000000,214319000000,211060000000,202565000000,-2649000000,1000000,254000000,34000000,51527,MCK
2018-03-31,125000000,,239000000,1712000000,67000000,8138000000,11184000000,2907000000,2907000000,14000000.0,-283000000,,,,-53000000,208357000000,205450000000,197173000000,-2668000000,5000000,292000000,67000000,51527,MCK
2017-03-31,341000000,,6891000000,1505000000,5070000000,7447000000,11271000000,3483000000,3483000000,14000000.0,-308000000,,,,1614000000,198533000000,195050000000,187262000000,3408000000,-124000000,5277000000,5070000000,51527,MCK
2020-03-31,,,670300000,,648700000,578800000,2454900000,1127400000,1127400000,,-72900000,,,,21600000,8494800000,7367400000,6039900000,-457100000,,648700000,648700000,51528,RYAAY
2019-03-31,,,948100000,,885000000,547300000,2204600000,1016800000,1016800000,,-59100000,,,,63100000,7697400000,6680600000,5492800000,-68700000,,885000000,885000000,51528,RYAAY
2018-03-31,,,1611300000,,1450200000,410400000,2638700000,1667300000,1667300000,,-60100000,,,,161100000,7151000000,5483700000,4512300000,-56000000,,1450200000,1450200000,51528,RYAAY
2017-03-31,,,1470300000,,1315900000,322300000,2353800000,1534000000,1534000000,,-67200000,,,,154400000,6647800000,5113800000,4294000000,-63700000,,1315900000,1315900000,51528,RYAAY
2019-12-31,,,225000000,12000000,138000000,1062000000,1767000000,564000000,564000000,,-132000000,,,,83000000,3247000000,2683000000,1480000000,-339000000,,142000000,138000000,51530,VAC
2018-12-31,,,103000000,5000000,55000000,725000000,1100000000,313000000,313000000,,-54000000,,,,51000000,2043000000,1730000000,943000000,-210000000,,52000000,55000000,51530,VAC
2017-12-31,,,240000000,5000000,235000000,494000000,765000000,250000000,250000000,,-10000000,,,,5000000,1433000000,1183000000,668000000,-10000000,,235000000,235000000,51530,VAC
2016-12-30,,,198000000,5000000,122000000,434000000,654000000,199000000,199000000,,-9000000,,,,76000000,1153000000,954000000,499000000,-1000000,,122000000,122000000,51530,VAC
2019-12-31,926231578,,-2684424971,491982898,-2688680705,5756740976,3929448548,-2723231650,-2723231650,-30292356,-26878316,,,,4842876,5570080604,8293312254,1640632056,38806679,,-2689267847,-2709228737,51532,QTT
2018-12-31,270107740,,-1946246753,93662330,-1942571687,4230763392,2518533056,-1981613184,-1981613184,-724892,-26878316,,,,-400541,3022145785,5003758969,503612729,35366431,,-1945846212,-2028941350,51532,QTT
2017-12-31,15317004,,-94759689,93662330,-94759689,520671848,440572455,-95416397,-95416397,-724892,-26878316,,,,0,517052950,612469347,76480495,656708,,-94759689,-100772472,51532,QTT
2016-12-31,2626972,,-10862379,93662330,-10862379,59060030,50775991,-10911011,-10911011,-724892,-26878316,,,,0,57954312,68865323,7178321,48632,,-10862379,-10862379,51532,QTT
2020-12-31,,,189124000,,153804000,300754000,564831000,0,194904000,69173000,,,,,35320000,564831000,369927000,0,-5780000,,153804000,153804000,51536,BOH
2019-12-31,,,285826000,,225913000,302360000,661293000,0,297218000,61715000,,,,,59913000,661293000,364075000,0,-11392000,,225913000,225913000,51536,BOH
2018-12-31,,,270226000,,219602000,294238000,638185000,0,277958000,65917000,,,,,50624000,638185000,360227000,0,-7732000,,219602000,219602000,51536,BOH
2017-12-31,,,268064000,,184672000,291507000,625755000,0,276730000,57518000,,,,,83392000,625755000,349025000,0,-8666000,,184672000,184672000,51536,BOH
2019-12-31,,,-113495000,1611000,-141743000,91792000,154553000,-39170000,-39170000,,-29068000,,,,27724000,486549000,525719000,331996000,-74325000,,-141219000,-141743000,51537,TDW
2018-12-31,,,-153519000,1087000,-171517000,91188000,131410000,-18071000,-18071000,,-30035000,,,,18252000,406520000,424591000,275110000,-135448000,,-171771000,-171517000,51537,TDW
2017-12-31,,,-1770085000,2215000,-1781030000,130248000,164257000,-71367000,-71367000,,-44921000,,,,2522000,490871000,562238000,326614000,-1698718000,,-1772607000,-1781030000,51537,TDW
2017-03-31,,,-643614000,16141000,-660118000,177831000,229711000,-115411000,-115411000,,-74444000,,,,6397000,601611000,717022000,371900000,-528203000,,-650011000,-660118000,51537,TDW
2020-12-31,,,585349000,,514151000,41118000,656303000,615185000,615185000,,-36323000,,,,71198000,9591627000,8976442000,8935324000,-29836000,,514151000,514151000,51539,RE
2019-12-31,,,1098987000,,1009461000,32966000,1175445000,1142479000,1142479000,,-31693000,,,,89526000,8242968000,7100489000,7067523000,-43492000,,1009461000,998182000,51539,RE
2018-12-31,,,-242182000,,89041000,30672000,-160403000,-191075000,-191075000,,-31031000,,,,-331223000,7381571000,7572646000,7541974000,-51107000,,89041000,88239000,51539,RE
2017-12-31,,,419411000,,482751000,25923000,491800000,465877000,465877000,,-31603000,,,,-63340000,6637161000,6171284000,6145361000,-46466000,,482751000,477771000,51539,RE
2019-12-31,,,4163000,18899000,4147000,21475000,216377000,58572000,58572000,,-77994000,,,,0,299744000,241172000,83367000,-54409000,,4163000,-3101000,51542,AFINP
2018-12-31,,,-37471000,8335000,-37409000,23233000,208339000,40433000,40433000,,-66789000,,,,0,291207000,250774000,82868000,-77904000,,-37471000,-37409000,51542,AFINP
2017-12-31,,,-46577000,4546000,-46494000,19791000,197257000,23411000,23411000,,-60305000,,,,0,270910000,247499000,73653000,-69988000,,-46577000,-46494000,51542,AFINP
2016-12-31,,,-54255000,4546000,-54255000,11168000,138991000,26680000,26680000,,-54253000,,,,0,177668000,150988000,38677000,-80935000,,-54255000,-54255000,51542,AFINP
2019-12-31,,,1006000000,5000000,766000000,380000000,1002000000,234000000,234000000,59000000,-75000000,,,,240000000,2559000000,2325000000,1557000000,772000000,,766000000,766000000,51544,H
2018-12-31,,,951000000,7000000,769000000,320000000,1004000000,332000000,332000000,25000000,-76000000,,,,182000000,2498000000,2166000000,1494000000,619000000,,769000000,769000000,51544,H
2017-12-31,,,722000000,16000000,389000000,377000000,1005000000,260000000,260000000,20000000,-80000000,,,,332000000,2700000000,2440000000,1695000000,462000000,,390000000,389000000,51544,H
2016-12-31,,,282000000,5000000,206000000,315000000,920000000,268000000,268000000,11000000,-76000000,,,,76000000,2534000000,2266000000,1614000000,14000000,,206000000,206000000,51544,H
2019-12-31,,,482970,,-1225300,1025145,1480977,455832,455832,,,,,,0,1738000,1282168,257023,27138,-1708270,482970,-1225300,51545,MFH
2018-12-31,,,-1808747,,-123239785,1808776,0,-1808776,-1808776,,,,,,0,0,1808776,0,29,-121431038,-1808747,-123239785,51545,MFH
2017-12-31,,,-1440476,,-161898979,1440476,0,-1440476,-1440476,,,,,,0,0,1440476,0,0,-160458503,-1440476,-161898979,51545,MFH
2016-12-31,,,-27526602,,-25293145,27936453,344353,-27592100,-27592100,,,,,,-2233457,73201161,100793261,72856808,65498,-160458503,-25293145,-25293145,51545,MFH
2019-12-31,,,1528000000,60000000,1492000000,296000000,2043000000,1764000000,1764000000,-17000000,-308000000,,,,36000000,7230000000,5466000000,5187000000,-236000000,,1492000000,1361000000,51546,PBA
2018-12-31,,,1742000000,60000000,1278000000,279000000,1894000000,1610000000,1610000000,5000000,-274000000,,,,464000000,7351000000,5741000000,5457000000,132000000,,1278000000,1153000000,51546,PBA
2017-12-31,,,1025000000,60000000,883000000,236000000,1429000000,1119000000,1119000000,74000000,-171000000,,,,142000000,5400000000,4281000000,3971000000,-94000000,,883000000,797000000,51546,PBA
2016-12-31,,,655000000,60000000,466000000,195000000,1072000000,808000000,808000000,69000000,-112000000,,,,189000000,4265000000,3457000000,3193000000,-153000000,,466000000,394000000,51546,PBA
2020-12-31,837000000,,-709000000,,-581000000,1453000000,2015000000,-275000000,-275000000,,-54000000,,,,-128000000,7880000000,8155000000,5865000000,-434000000,,-581000000,-581000000,51547,SPOT
2019-12-31,615000000,,-131000000,,-186000000,1161000000,1722000000,-54000000,-54000000,,-43000000,,,,55000000,6764000000,6818000000,5042000000,-77000000,,-186000000,-186000000,51547,SPOT
2018-12-31,493000000,,-173000000,,-78000000,903000000,1353000000,-43000000,-43000000,,-6000000,,,,-95000000,5259000000,5302000000,3906000000,-130000000,,-78000000,-78000000,51547,SPOT
2017-12-31,396000000,,-1233000000,,-1235000000,831000000,849000000,-378000000,-378000000,,-3000000,,,,2000000,4090000000,4468000000,3241000000,-855000000,,-1235000000,-1235000000,51547,SPOT
2019-12-28,,,884976000,919351000,694734000,2357920000,3090886000,732966000,732966000,,-50792000,,,,159515000,9985803000,9252837000,6894917000,152010000,-5957000,725461000,694734000,51548,HSIC
2018-12-29,,,557873000,892612000,535881000,2217273000,2910747000,693474000,693474000,,-76016000,,,,107432000,9417603000,8724129000,6506856000,-135601000,105164000,450441000,535881000,51548,HSIC
2017-12-30,,,627451000,845049000,406299000,2071576000,2746662000,675086000,675086000,,-51066000,,,,308975000,8883438000,8208352000,6136776000,-47635000,113127000,318476000,406299000,51548,HSIC
2016-12-31,,,774353000,615374000,506778000,2409008000,3226473000,817465000,817465000,,-31893000,,,,217958000,11571668000,10754203000,8345195000,-43112000,113127000,556395000,506778000,51548,HSIC
2020-12-31,152000000,,3469000000,2265000000,2501000000,3016000000,11860000000,4005000000,4005000000,61000000,-115000000,,,,847000000,27243000000,23238000000,15383000000,-536000000,4000000,2622000000,2501000000,51549,LIN
2019-12-31,184000000,,3041000000,2561000000,2285000000,3425000000,11596000000,3380000000,3380000000,-68000000,-246000000,,,,769000000,28228000000,24848000000,16632000000,-339000000,102000000,2272000000,2285000000,51549,LIN
2018-12-31,113000000,,5105000000,5500000000,4381000000,1625000000,6184000000,2583000000,2583000000,33000000,-277000000,,,,817000000,14836000000,12253000000,8652000000,2522000000,108000000,4288000000,4381000000,51549,LIN
2017-12-31,93000000,,2334000000,504000000,1247000000,1203000000,4976000000,2499000000,2499000000,-3000000,-202000000,,,,1026000000,11358000000,8859000000,6382000000,-165000000,108000000,1308000000,1247000000,51549,LIN
2020-06-30,10436975,,3914822,1268716,2938239,19403813,31119701,1278913,1278913,,,,,,835444,89415798,88136885,58296097,2635909,,3079378,2938239,51550,CLPS
2019-06-30,7978883,,-3245974,608162,-3269776,19563422,23754581,-3787724,-3787724,,,,,,186615,64932937,68720661,41178356,541750,,-3432589,-3269776,51550,CLPS
2018-06-30,7837873,,2602770,676282,2434463,8097324,17661338,1726141,1726141,,,,,,-112128,48938593,47212452,31277255,876629,,2714898,2434463,51550,CLPS
2017-06-30,4232788,,2102811,477110,2047445,6854283,12692164,1605093,1605093,,,,,,-118546,31361976,29756883,18669812,497718,,2221357,2047445,51550,CLPS
2019-12-31,,,124832000,,100443000,95245000,539963000,127263000,127263000,294266000,-1568000,,,,24389000,860969000,733706000,321006000,-2431000,,100443000,100164000,51553,MEDP
2018-12-31,,,93951000,,73185000,75681000,452305000,101048000,101048000,236775000,-8157000,,,,20766000,704589000,603541000,252284000,-7097000,,73185000,72894000,51553,MEDP
2017-12-31,,,56945000,,39122000,63357000,174689000,64858000,64858000,236775000,-7559000,,,,17823000,386462000,321604000,211773000,-7913000,,39122000,39032000,51553,MEDP
2016-12-31,,,21957000,,13425000,61507000,172111000,52490000,52490000,236775000,-19384000,,,,8532000,370621000,318131000,198510000,-30533000,,13425000,13392000,51553,MEDP
2019-12-31,,,186889000,16052000,146991000,191774000,1506386000,613437000,613437000,4097000,-415695000,,,,39605000,2014645000,1401208000,508259000,-426548000,,147284000,146991000,51555,SBAC
2018-12-31,,,51684000,16052000,47451000,141724000,1385939000,569311000,569311000,2791000,-399146000,,,,4233000,1865695000,1296384000,479756000,-517627000,,47451000,47451000,51555,SBAC
2017-12-31,,,116891000,16052000,103654000,130697000,1268995000,490751000,490751000,4447000,-348568000,,,,13237000,1727674000,1236923000,458679000,-373860000,,103654000,103654000,51555,SBAC
2016-12-31,,,87303000,16052000,76238000,125206000,1199088000,429418000,429418000,6275000,-352510000,,,,11065000,1633125000,1203707000,434037000,-342115000,,76238000,76238000,51555,SBAC
2019-12-31,,,-150989000,,-124619000,136579000,1805311000,524867000,524867000,235294000,-37154000,,,,-26370000,2362969000,1838102000,557658000,-675856000,,-124619000,-131216000,51557,XEC
2018-12-31,,,1022507000,,791851000,77843000,1799038000,1060868000,1060868000,46959000,-47369000,,,,230656000,2339017000,1278149000,539979000,-38361000,,791851000,780764000,51557,XEC
2017-12-31,,,681996000,,494329000,79996000,1388589000,750714000,750714000,85592000,-51873000,,,,187667000,1918249000,1167535000,529660000,-68718000,,494329000,485778000,51557,XEC
2016-12-31,,,-623204000,,-408803000,73901000,802833000,185783000,185783000,126278000,-62024000,,,,-214401000,1257345000,1071562000,454512000,-808987000,,-408803000,-408803000,51557,XEC
2020-10-03,,,2664000000,132000000,2061000000,2167000000,5901000000,3734000000,3734000000,,-485000000,,,,593000000,43185000000,39451000000,37284000000,-1070000000,,2071000000,2061000000,51560,TSN
2019-09-28,,,2374000000,144000000,1980000000,2222000000,5094000000,2872000000,2872000000,,-462000000,,,,381000000,42405000000,39533000000,37311000000,-498000000,,1993000000,1980000000,51560,TSN
2018-09-29,,,2682000000,8000000,2970000000,2045000000,5197000000,3152000000,3152000000,,-350000000,,,,-291000000,40052000000,36900000000,34855000000,-470000000,,2973000000,2970000000,51560,TSN
2017-09-30,,,2628000000,18000000,1774000000,2008000000,5141000000,3133000000,3133000000,,-279000000,,,,850000000,38260000000,35127000000,33119000000,-505000000,,1778000000,1774000000,51560,TSN
2019-12-31,,,-449305000,,-449305000,32058000,156513000,-32401000,-32401000,-1702000,-3065000,,,,0,266845000,299246000,110332000,-416904000,,-449305000,-449305000,51561,SD
2018-12-31,,,-9146000,,-9075000,40619000,236175000,33591000,33591000,16157000,-3148000,,,,-71000,349395000,315804000,113220000,-42737000,,-9075000,-9075000,51561,SD
2017-12-31,,,38313000,,47062000,75133000,240036000,56627000,56627000,-23611000,-4886000,,,,-8749000,357299000,300672000,117263000,-18314000,,47062000,47062000,51561,SD
2016-12-31,,,1106835000,,1106815000,125928000,228910000,-84393000,-84393000,35091000,-126471000,,,,20000,383515000,467908000,154605000,1191228000,,1106815000,1090494000,51561,SD
2020-06-30,29978000,,-48628000,,-33366000,79467000,197236000,55775000,55775000,,-66845000,,,,-15262000,545744000,489969000,348508000,-104403000,,-33366000,-33366000,51562,LCI
2019-06-30,38807000,,-346245000,,-272107000,87648000,275806000,117155000,117155000,,-84624000,,,,-74138000,655407000,538252000,379601000,-463400000,,-272107000,-272107000,51562,LCI
2018-06-30,29196000,,51093000,,28690000,82196000,320834000,177314000,177314000,,-85634000,,,,22403000,684563000,507249000,363729000,-126221000,,28690000,28690000,51562,LCI
2017-06-30,42073000,,550000,,-581000,73477000,337311000,189663000,189663000,,-89420000,,,,1097000,637341000,447678000,300030000,-189113000,,-547000,-581000,51562,LCI
2019-12-31,,,-3004878,,-3004878,3281626,1827027,0,-1483111,-35248,,,,,0,2785600,4268711,958573,-1521767,,-3004878,-3004878,51564,LMFA
2018-12-31,,,-472159,,-472159,2705611,1836166,0,-837132,-100576,,,,,0,2805605,3642737,969439,364973,,-472159,-472159,51564,LMFA
2017-12-31,,,-5195643,,-8627179,4347718,1872946,0,-2407699,-162520,,,,,3431536,3463698,5871397,1590752,-2787944,,-8627179,-8627179,51564,LMFA
2016-12-31,,,-3681349,,-2370390,5325148,2289561,0,-3026599,-81102,,,,,-1310959,4162129,7188728,1872568,-654750,,-2370390,-2370390,51564,LMFA
2018-12-31,,,-56616,,-56616,56616,0,-56616,-56616,,,,,,0,0,56616,0,0,,-56616,-56616,51565,LATNU
2020-03-28,484414000,,395089000,,334325000,343569000,1360389000,526142000,526142000,6264000,-60392000,,,,60764000,3239141000,2712999000,1878752000,-131053000,,334325000,334325000,51567,QRVO
2019-03-30,450482000,,91792000,,133125000,476074000,1216529000,285212000,285212000,4761000,-43963000,,,,-41333000,3090325000,2805113000,1873796000,-193420000,,133125000,133125000,51567,QRVO
2018-03-31,445103000,,17145000,,-40288000,527751000,1146966000,144182000,144182000,29930000,-59548000,,,,57433000,2973536000,2829354000,1826570000,-127037000,,-40288000,-40288000,51567,QRVO
2017-04-01,470836000,,27305000,,-16558000,545588000,1135512000,107059000,107059000,12029000,-58879000,,,,43863000,3032574000,2925515000,1897062000,-79754000,,-16558000,-16558000,51567,QRVO
2020-12-31,,,46616000,,42209000,54838000,120104000,0,46616000,18650000,,,,,4407000,120104000,73488000,0,0,,42209000,42209000,51568,CNBKA
2019-12-31,,,40809000,,39699000,55630000,112938000,0,41538000,15770000,,,,,1110000,112938000,71400000,0,-729000,,39699000,39699000,51568,CNBKA
2018-12-31,,,37781000,,36213000,54280000,107474000,0,39252000,13942000,,,,,1568000,107474000,68222000,0,-1471000,,36213000,36213000,51568,CNBKA
2017-12-31,,,33259000,,22301000,51864000,100378000,0,34840000,13674000,,,,,10958000,100378000,65538000,0,-1581000,,22301000,22301000,51568,CNBKA
2019-12-31,142678000,,-9203000,,-9019000,259880000,284133000,-118425000,-118425000,,-1087000,,,,-184000,311332000,429757000,27199000,109222000,,-9019000,-9019000,51569,GWPH
2018-12-31,146627000,,-305444000,,-305257000,165727000,8755000,-303599000,-303599000,,-1230000,,,,-187000,15399000,318998000,6644000,-1845000,,-305257000,-305257000,51569,GWPH
2018-09-30,153171000,,-291370000,,-295167000,141818000,6186000,-288803000,-288803000,,-1249000,,,,3797000,12737000,301540000,6551000,-2567000,,-295167000,-295167000,51569,GWPH
2017-09-30,111580000,,-171491000,,-170459000,58020000,3439000,-166161000,-166161000,,-951000,,,,-1032000,8629000,174790000,5190000,-5330000,,-170459000,-170459000,51569,GWPH
2020-12-31,,,389781000,,292990000,896362000,1429244000,0,424250000,108632000,,,,,96791000,1429244000,1004994000,0,-34469000,,292990000,271613000,51575,WTFCP
2019-12-31,,,480101000,,355697000,802683000,1408192000,0,504737000,100772000,,,,,124404000,1408192000,903455000,0,-24636000,,355697000,347497000,51575,WTFCP
2018-12-31,,,460133000,,343166000,718618000,1285620000,0,487432000,79570000,,,,,116967000,1285620000,798188000,0,-27299000,,343166000,334966000,51575,WTFCP
2017-12-31,,,389997000,,257682000,635623000,1120586000,0,412994000,71969000,,,,,132315000,1120586000,707592000,0,-22997000,,257682000,247904000,51575,WTFCP
2019-12-31,,,-4029851,,-4029851,2878988,-147026,-3233401,-3233401,,-34637,,,,0,10858594,14091995,11005620,-796450,,-4029851,-4029851,51576,LMPX
2018-12-31,,,-6490293,,-6490293,3278051,-1956989,-5736194,-5736194,,-31377,,,,0,16610786,22346980,18567775,-754099,,-6490293,-6490293,51576,LMPX
2017-12-31,,,-1423662,,-1423662,1114109,-235048,-1378448,-1378448,,-14356,,,,0,3759031,5137479,3994079,-45214,,-1423662,-1423662,51576,LMPX
2016-12-31,,,-73639,,-73639,73639,0,-73639,-73639,,-14356,,,,0,0,73639,0,0,,-73639,-73639,51576,LMPX
2020-06-30,,,-98048000,3551000,-182388000,319684000,243828000,-93396000,-93396000,,-4461000,,,,20593000,603319000,696715000,359491000,-4652000,-66089000,-118641000,-182388000,51579,MSGS
2019-06-30,,,-60641000,85887000,11427000,330171000,289323000,-60925000,-60925000,,-4970000,,,,-12619000,729404000,790329000,440081000,284000,57149000,-48022000,11427000,51579,MSGS
2018-06-30,,,-21288000,94236000,141594000,294899000,292878000,-22828000,-22828000,,-3492000,,,,-59392000,712415000,735243000,419537000,1540000,101354000,38104000,141594000,51579,MSGS
2017-06-30,,,-81193000,92328000,-72723000,410997000,466734000,-51651000,-51651000,,-4189000,,,,-4404000,1318452000,1370103000,851718000,-29542000,101354000,-76789000,-72723000,51579,MSGS
2020-10-31,,,13164238,,13164238,1725680,10523830,8798150,8798150,,-1284572,,,,0,10523830,1725680,0,4366088,,13164238,13164238,51581,JHS
2019-10-31,,,23477531,,23477531,1698843,11342819,9643976,9643976,,-2713913,,,,0,11342819,1698843,0,13833555,,23477531,23477531,51581,JHS
2018-10-31,,,-7127606,,-7127606,1736756,11679247,9942491,9942491,,-2274581,,,,0,11679247,1736756,0,-17070097,,-7127606,-7127606,51581,JHS
2017-10-31,,,10345305,,10345305,1766236,11940022,10173786,10173786,,-1467406,,,,0,11940022,1766236,0,171519,,10345305,10345305,51581,JHS
2019-12-31,110315000000,,3053277999350,3322834391530,1835086519910,1955734818000,6229239376140,3788531093140,3788531093140,78932000000,-755711000000,,,,1070640792110,64366847807960,60578316714820,58137608431820,-735253093790,,1982637207240,1828416519911,51583,PKX
2018-12-31,108352000000,,3562821170260,3388291231000,1690612430910,1936750418000,7948148094970,5479501730970,5479501730970,71973000000,-741296000000,,,,1670756763810,64977777434190,59498275703220,57029629339220,-1916680560710,,1892064406450,1672891444611,51583,PKX
2017-12-31,108352000000,,4179692000000,3731131000000,2790106000000,3469487000000,8337841000000,4565315000000,4565315000000,72826000000,-653115000000,,,,1206223000000,60655100000000,56089785000000,52317259000000,-385623000000,,2973469000000,2757057200003,51583,PKX
2016-12-31,108352000000,,1432854000000,3464956000000,1363310000000,3744925000000,6668145000000,2841035000000,2841035000000,78895000000,-658726000000,,,,384685000000,53083513000000,50242478000000,46415368000000,-1408181000000,,1048169000000,1330084836919,51583,PKX
2019-12-31,,,2334000,4267000,-26429000,25462000,57265000,9056000,9056000,,-7904000,,,,28837000,276768000,267712000,219503000,-6722000,,-26503000,-26429000,51584,RDI
2018-12-31,,,17464000,4337000,14034000,27337000,73236000,23624000,23624000,,-6837000,,,,3298000,308931000,285307000,235695000,-6160000,,14166000,14034000,51584,RDI
2017-12-31,,,34169000,4331000,30865000,27147000,62672000,18583000,18583000,,-6194000,,,,3293000,279556000,260973000,216884000,15586000,,30876000,30865000,51584,RDI
2016-12-31,,,13830000,4418000,9678000,26906000,62884000,20289000,20289000,,-6782000,,,,4138000,270866000,250577000,207982000,-6459000,,9692000,9678000,51584,RDI
2019-12-31,,,22077472,,114972858,9818075,37836579,12221226,12221226,,-12466062,,,,5472178,44941246,32720020,7104667,9856246,98367564,16605294,114972858,51587,CTO
2018-12-31,,,21014133,,37167790,9785370,34896425,9349532,9349532,,-10423286,,,,6025148,43657888,34308356,8761463,11664601,22178805,14988985,37167790,51587,CTO
2017-12-31,,,-740158,,41719424,10252610,30312265,7744955,7744955,,-8523136,,,,-22481523,38650570,30905615,8338305,-8485113,19978059,21741365,41719424,51587,CTO
2016-12-31,,,28699025,,16251248,10297877,45631524,27404304,27404304,,-8753338,,,,12092513,65884467,38480163,20252943,1294721,-407098,16606512,16251248,51587,CTO
2019-12-31,,,13760676,14828063,11089170,6512742,22358385,15845643,15845643,,-2149544,,,,1533794,138900357,123054714,116541972,-2084967,,12226882,11089170,51588,OSN
2018-12-31,,,13514370,13690351,10379453,5591279,20519064,14927785,14927785,,-1510462,,,,2129387,136104867,121177082,115585803,-1413415,,11384983,10379453,51588,OSN
2017-12-31,,,6589934,12684821,5345311,6600953,14654116,8053163,8053163,,-1533259,,,,691556,132375915,124322752,117721799,-1463229,,5898378,5345311,51588,OSN
2016-12-31,,,6249530,12131754,4823973,7110542,16096626,8986084,8986084,,-1296092,,,,926048,117029154,108043070,100932528,-2736554,,5323482,4823973,51588,OSN
2020-03-31,,,13124777,,13124777,3156356,19239061,16082705,16082705,,-4281850,,,,0,19239061,3156356,0,-2957928,,13124777,13124777,51591,MAV
2019-03-31,,,21143979,,21143979,3113320,20297729,17184409,17184409,,-4281850,,,,0,20297729,3113320,0,3959570,,21143979,16807673,51591,MAV
2018-03-31,,,10806116,,10806116,3281561,20741963,17460402,17460402,,-4281850,,,,0,20741963,3281561,0,-6654286,,10806116,8062033,51591,MAV
2017-03-31,,,2642072,,2642072,3298202,22373752,19075550,19075550,,-4281850,,,,0,22373752,3298202,0,-16433478,,2642072,1082925,51591,MAV
2020-04-30,,,100548000,,74861000,196942000,329186000,132244000,132244000,,-29027000,,,,25687000,1650333000,1518089000,1321147000,-31696000,,74861000,74861000,51592,AMWD
2019-04-30,,,110888000,,83688000,202792000,346473000,143681000,143681000,,-35652000,,,,27200000,1645319000,1501638000,1298846000,-32793000,,83688000,83688000,51592,AMWD
2018-04-30,,,94760000,,63141000,134796000,261737000,126941000,126941000,,-13054000,,,,31619000,1250274000,1123333000,988537000,-32181000,,63141000,63141000,51592,AMWD
2017-04-30,,,108925000,,71199000,116398000,224636000,108238000,108238000,,-13054000,,,,37726000,1030248000,922010000,805612000,687000,,71199000,71199000,51592,AMWD
2019-12-31,23608000,,-41118000,,-34844000,15555000,0,-39163000,-39163000,,-4606000,,,,-6274000,0,39163000,0,-1955000,,-34844000,-34844000,51593,MREO
2018-12-31,22703000,,-37306000,,-32029000,11775000,0,-34478000,-34478000,,-2612000,,,,-5277000,0,34478000,0,-2828000,,-32029000,-32029000,51593,MREO
2017-12-31,34607000,,-46951000,,-38799000,10697000,0,-45304000,-45304000,,-497000,,,,-8152000,0,45304000,0,-1647000,,-38799000,-38799000,51593,MREO
2016-12-31,24562502,,-33721551,,-28390280,11616816,0,-36179318,-36179318,,-179765,,,,-5331271,0,36179318,0,2331964,,-28390280,-28390280,51593,MREO
2019-12-31,205000,,-38346000,,-35716000,17424000,12698000,-4931000,-4931000,,-28012000,,,,1131000,201998000,206929000,189300000,-33415000,,-39477000,-35716000,51594,AMTX
2018-12-31,246000,,-36280000,-4740000.0,-33016000,16085000,5405000,-10926000,-10926000,,-25734000,,,,7000,171526000,182452000,166121000,-25354000,,-36287000,-33016000,51594,AMTX
2017-12-31,2367000,,-31764000,-1469000.0,-30301000,13191000,3375000,-12183000,-12183000,,-19304000,,,,6000,150157000,162340000,146782000,-19581000,,-31770000,-30301000,51594,AMTX
2016-12-31,369000,,-15630000,-1469000.0,-15636000,12011000,11599000,-781000,-781000,,-17216000,,,,6000,143158000,143939000,131559000,-14849000,,-15636000,-15636000,51594,AMTX
2019-12-31,286378000,,-355910000,,-356388000,169861000,160274000,-300740000,-300740000,,-18872000,,,,478000,182237000,482977000,21963000,-55170000,,-356388000,-356388000,51595,FOLD
2018-12-31,163902000,,-349089000,,-348995000,234200000,76841000,-325477000,-325477000,,-22402000,,,,-94000,91245000,416722000,14404000,-23612000,,-348995000,-348995000,51595,FOLD
2017-12-31,141210000,,-449121000,,-284002000,88271000,30694000,-202380000,-202380000,,-17240000,,,,-165119000,36930000,239310000,6236000,-246741000,,-284002000,-284002000,51595,FOLD
2016-12-31,104793000,,-203781000,,-200042000,71151000,4125000,-175061000,-175061000,,-5398000,,,,-3739000,4958000,180019000,833000,-28720000,,-200042000,-200042000,51595,FOLD
2020-06-30,,,2043000000,1668000000,1409000000,1832000000,7089000000,3494000000,3494000000,1763000000,-670000000,,,,589000000,11752000000,8258000000,4663000000,-1451000000,,1454000000,1409000000,51597,DEO
2019-06-30,,,4235000000,1795000000,3160000000,2035000000,8001000000,4123000000,4123000000,1843000000,-646000000,,,,898000000,12867000000,8744000000,4866000000,112000000,,3337000000,3160000000,51597,DEO
2018-06-30,,,3740000000,1765000000,3022000000,1893000000,7529000000,3808000000,3808000000,1828000000,-467000000,,,,596000000,12163000000,8355000000,4634000000,-68000000,,3144000000,3022000000,51597,DEO
2017-06-30,,,3559000000,1715000000,2662000000,1823000000,7370000000,3576000000,3576000000,1971000000,-518000000,,,,732000000,12050000000,8474000000,4680000000,-17000000,-55000000.0,2827000000,2662000000,51597,DEO
2019-12-31,64644000,,-109455000,,-98864000,339068000,368842000,-73822000,-73822000,,-37935000,,,,-10591000,553307000,627129000,184465000,-35633000,,-98864000,-98864000,51599,TDOC
2018-12-31,54373000,,-96966000,,-97084000,265160000,289172000,-65963000,-65963000,,-30385000,,,,118000,417907000,483870000,128735000,-31003000,,-97084000,-97084000,51599,TDOC
2017-12-31,34459000,,-107007000,,-106782000,180300000,171656000,-62198000,-62198000,,-10279000,,,,-225000,233279000,295477000,61623000,-44809000,,-106782000,-106782000,51599,TDOC
2016-12-31,21815000,,-73706000,,-74216000,113648000,91186000,-52547000,-52547000,,-2588000,,,,510000,123157000,175704000,31971000,-21159000,,-74216000,-74216000,51599,TDOC
2020-12-31,,,-1419000000,65000000,-1061000000,,934000000,-1235000000,-1235000000,2169000000,-184000000,,,,-363000000,8503000000,9738000000,7569000000,-184000000,,-1056000000,-1105000000,51600,BHF
2019-12-31,,,-1052000000,65000000,-740000000,,1405000000,-895000000,-895000000,2279000000,-157000000,,,,-317000000,6520000000,7415000000,5115000000,-157000000,,-735000000,-761000000,51600,BHF
2018-12-31,,,989000000,65000000,865000000,,3463000000,1046000000,1046000000,2377000000,-57000000,,,,119000000,8864000000,7818000000,5401000000,-57000000,,870000000,865000000,51600,BHF
2017-12-31,,,-615000000,65000000,-378000000,,1865000000,-465000000,-465000000,2330000000,-150000000,,,,-237000000,6839000000,7304000000,4974000000,-150000000,,-378000000,-378000000,51600,BHF
2020-12-31,21680000,,-18632000,,-19277000,74229000,104685000,-14394000,-14394000,,-3939000,,,,645000,230194000,244588000,125509000,-4238000,,-19277000,-19277000,51601,LLNW
2019-12-31,22534000,,-15294000,,-16044000,73863000,100737000,-15725000,-15725000,,-76000,,,,750000,200634000,216359000,99897000,431000,,-16044000,-16044000,51601,LLNW
2018-12-31,24075000,,10380000,,9842000,69018000,109750000,-1933000,-1933000,,-86000,,,,538000,195670000,197603000,85920000,12313000,,9842000,9842000,51601,LLNW
2017-12-31,25342000,,-7204000,,-7630000,62633000,105937000,-2552000,-2552000,,-80000,,,,426000,184360000,186912000,78423000,-4652000,,-7630000,-7630000,51601,LLNW
2019-12-31,48611000,,114707000,,101035000,276982000,488164000,162571000,162571000,,-549000,,,,13672000,1266208000,1103637000,778044000,-47864000,,101035000,101035000,51603,ICUI
2018-12-31,52867000,,22374000,,28793000,320002000,570028000,197159000,197159000,,-709000,,,,-6419000,1400040000,1202881000,830012000,-174785000,,28793000,28793000,51603,ICUI
2017-12-31,51253000,,51283000,,68644000,302169000,492395000,138973000,138973000,,-2047000,,,,-17361000,1292613000,1153640000,800218000,-87690000,,68644000,68644000,51603,ICUI
2016-12-31,12955000,,85164000,,63084000,89426000,201398000,99017000,99017000,,-118000,,,,22080000,379372000,280355000,177974000,-13853000,,63084000,63084000,51603,ICUI
2019-12-31,69460000,,-26108000,,-19482000,515530000,678262000,7016000,7016000,,-32821000,,,,-6626000,1189346000,1182330000,511084000,-33124000,,-19482000,-19482000,51604,VG
2018-12-31,52139000,,36525000,,35728000,437130000,621787000,61538000,61538000,,-15068000,,,,797000,1048782000,987244000,426995000,-25013000,,35728000,35728000,51604,VG
2017-12-31,29630000,,45793000,,-33933000,435788000,597332000,59391000,59391000,,-14868000,,,,79726000,1002286000,942895000,404954000,-13598000,,-33933000,-33933000,51604,VG
2016-12-31,29759000,,30845000,,13151000,454273000,600471000,44154000,44154000,,-13042000,,,,17694000,955621000,911467000,355150000,-7337000,,13151000,13151000,51604,VG
2020-12-31,,,116323000,,102273000,315323000,540469000,0,159149000,65997000,,,,,14050000,540469000,381320000,0,-42826000,,102273000,99597000,51605,FBP
2019-12-31,,,239372000,,167377000,296350000,610421000,0,262453000,51618000,,,,,71995000,610421000,347968000,0,-23081000,,167377000,164701000,51605,FBP
2018-12-31,,,190638000,,201608000,279413000,528767000,0,197026000,52328000,,,,,-10970000,528767000,331741000,0,-6388000,,201608000,198932000,51605,FBP
2017-12-31,,,61983000,,66956000,273066000,481208000,0,158229000,49913000,,,,,-4973000,481208000,322979000,0,-96246000,,66956000,64280000,51605,FBP
2020-10-03,,,2124000,6125000,1110000,19917000,22719000,2911000,2911000,-109000,-836000,,,,-60000,112868000,109957000,90149000,-787000,,2184000,1110000,51606,BDL
2019-09-28,,,6264000,6208000,3648000,20823000,26926000,6316000,6316000,-213000,-708000,,,,887000,115989000,109673000,89063000,-52000,,5377000,3648000,51606,BDL
2018-09-29,,,6761000,6149000,3677000,19947000,27174000,7444000,7444000,-217000,-753000,,,,1371000,113280000,105836000,86106000,-683000,,5390000,3677000,51606,BDL
2017-09-30,,,5760000,6195000,3020000,18696000,24721000,6258000,6258000,-233000,-600000,,,,1370000,106589000,100331000,81868000,-498000,,4390000,3020000,51606,BDL
2020-01-31,2766000000,,706000000,,126000000,9594000000,12863000000,503000000,503000000,,-131000000,,,,580000000,17098000000,16595000000,4235000000,203000000,,126000000,126000000,51609,CRM
2019-01-31,1886000000,,983000000,,1110000000,7386000000,9831000000,559000000,559000000,,-154000000,,,,-127000000,13282000000,12723000000,3451000000,424000000,,1110000000,1110000000,51609,CRM
2018-01-31,1553000000,,420000000,,360000000,5760000000,7767000000,454000000,454000000,,-154000000,,,,60000000,10540000000,10086000000,2773000000,-34000000,,360000000,360000000,51609,CRM
2017-01-31,1208000000,,179000000,,323000000,4777000000,6203000000,218000000,218000000,,-89000000,,,,-144000000,8437000000,8219000000,2234000000,-39000000,,323000000,323000000,51609,CRM
2019-12-31,142221000,,-195071000,,-195071000,70211000,9236000,-203196000,-203196000,,-293000,,,,0,12985000,216181000,3749000,8125000,,-195071000,-195071000,51612,ZLAB
2018-12-31,120278000,,-139075000,,-139075000,21576000,86000,-141768000,-141768000,,-40000,,,,0,129000,141897000,43000,2693000,,-139075000,-139075000,51612,ZLAB
2017-12-31,39342000,,-50384000,,-50384000,12049000,0,-51391000,-51391000,,-40000,,,,0,0,51391000,0,1007000,,-50384000,-50384000,51612,ZLAB
2016-12-31,32149157,,-37512212,,-37512212,6380144,0,-38529301,-38529301,,-40000,,,,0,0,38529301,0,1017089,,-37512212,-37512212,51612,ZLAB
2019-12-31,121351000,,178603000,,146549000,136741000,479338000,221246000,221246000,,-4805000,,,,33646000,1425660000,1204414000,946322000,-42643000,,144957000,146549000,51613,SEDG
2018-12-31,82245000,,137123000,8318000.0,128833000,97571000,319236000,139420000,139420000,,-2536000,,,,9077000,937237000,797817000,618001000,-2297000,,128046000,128833000,51613,SEDG
2017-12-31,54966000,,100244000,8318000.0,84172000,68714000,214766000,91086000,91086000,,-2536000,,,,16072000,607045000,515959000,392279000,9158000,,84172000,84172000,51613,SEDG
2016-12-31,38220000,,69723000,8318000.0,63453000,51517000,160747000,71010000,71010000,,-2536000,,,,6270000,489954000,418944000,329207000,-1287000,,63453000,63453000,51613,SEDG
2020-12-31,956500000,,265200000,,257800000,1167300000,2575500000,445700000,445700000,6000000,,,,,7400000,4445100000,3999400000,1869600000,-180500000,,257800000,257800000,51616,JNPR
2019-12-31,955700000,,414400000,,345000000,1167000000,2616800000,494100000,494100000,6000000,-88700000.0,,,,69400000,4445400000,3951300000,1828600000,-79700000,,345000000,345000000,51616,JNPR
2018-12-31,1003200000,,532700000,,566900000,1154100000,2741200000,583900000,583900000,7000000,-103200000.0,,,,-34200000,4647500000,4063600000,1906300000,-51200000,,566900000,566900000,51616,JNPR
2017-12-31,980700000,,811800000,,306200000,1175600000,3072100000,915800000,915800000,7000000,-101200000.0,,,,505600000,5027200000,4111400000,1955100000,-104000000,,306200000,306200000,51616,JNPR
2019-12-31,164944000,,-274233000,,-275597000,248360000,134493000,-278811000,-278811000,,,,,,1364000,218656000,497467000,84163000,4578000,,-275597000,-276418000,51618,IH
2018-12-31,49568000,,-15994000,,-17604000,38508000,66013000,-22063000,-22063000,,,,,,1610000,131867000,153930000,65854000,6069000,,-17604000,-17604000,51618,IH
2019-12-31,,,90017000,3432000,81564000,43470000,77340000,0,33870000,,,,,,8097000,77340000,43470000,0,56147000,,81920000,80164000,51619,HASI
2018-12-31,,,43942000,3423000,41577000,40742000,62522000,0,21780000,,,,,,2144000,62522000,40742000,0,22162000,,41798000,39777000,51619,HASI
2017-12-31,,,31920000,3597000,30856000,30884000,40515000,0,9631000,,,,,,885000,40515000,30884000,0,22289000,,31035000,28956000,51619,HASI
2016-12-31,,,14897000,3731000,14652000,27170000,35957000,0,8787000,,,,,,141000,35957000,27170000,0,6110000,,14756000,12852000,51619,HASI
2020-10-31,,,845427,,845427,1051599,5391896,4340297,4340297,,-916808,,,,0,5403896,1063599,12000,-3494870,,845427,845427,51620,NBW
2019-10-31,,,9935739,,9935739,1051901,5561504,4509603,4509603,,-1497256,,,,0,5575004,1065401,13500,5426136,,9935739,9935739,51620,NBW
2018-10-31,,,-1766000,,-1766000,1049000,5408000,4359000,4359000,,-1544000,,,,0,5430000,1071000,22000,-6125000,,-1766000,-1766000,51620,NBW
2017-10-31,,,1062000,,1062000,1054000,5661000,4607000,4607000,,-1216000,,,,0,5661000,1054000,0,-3545000,,1062000,1062000,51620,NBW
2019-12-31,,,4056000,113491000,4274000,58800000,424180000,94060000,94060000,,-153382000,,,,1296000,661484000,567424000,237304000,-90004000,,2760000,-9758000,51622,WPG
2018-12-31,,,110187000,151826000,93604000,46160000,481592000,177636000,177636000,,-141987000,,,,1532000,717479000,539843000,235887000,-67449000,,108655000,79572000,51622,WPG
2017-12-31,,,235010000,170983000,197063000,43999000,514470000,211731000,211731000,,-126541000,,,,3417000,753054000,541323000,238584000,23279000,,231593000,183031000,51622,WPG
2016-12-31,,,79648000,180028000,67131000,47692000,569829000,236479000,236479000,,-136225000,,,,2232000,843475000,606996000,273646000,-156831000,,77416000,53099000,51622,WPG
2019-12-31,,,-1771000,,-1792000,3657000,2885000,-1624000,-1624000,,,,,,21000,3037000,4661000,152000,-147000,,-1792000,-1792000,51623,NTIP
2018-12-31,,,10014000,,7706000,3890000,21000000,16133000,16133000,,,,,,2308000,22106000,5973000,1106000,-6119000,,7706000,7706000,51623,NTIP
2017-12-31,,,6229000,,4133000,4312000,11481000,6014000,6014000,,,,,,2096000,16451000,10437000,4970000,215000,,4133000,4133000,51623,NTIP
2016-12-31,,,32161000,,23223000,5372000,57490000,50796000,50796000,,,,,,8938000,65088000,14292000,7598000,-18635000,,23223000,23223000,51623,NTIP
2020-05-31,,,1058291000,,876037000,2061832000,3233748000,1171916000,1171916000,,-105393000,,,,181931000,7085120000,5913204000,3851372000,-113625000,-323000,876360000,867879000,51625,CTAS
2019-05-31,,,1102399000,,884981000,1980644000,3128588000,1147944000,1147944000,,-101736000,,,,219764000,6892303000,5744359000,3763715000,-45545000,2346000,882635000,875413000,51625,CTAS
2018-05-31,,,841001000,,842586000,1916792000,2908523000,991731000,991731000,,-110175000,,,,57069000,6476632000,5484901000,3568109000,-150730000,58654000,783932000,830792000,51625,CTAS
2017-05-31,,,687404000,,480708000,1527380000,2380295000,852915000,852915000,,-86524000,,,,230118000,5323381000,4470466000,2943086000,-165511000,23422000,457286000,472540000,51625,CTAS
2020-12-31,136057000,,354287000,,294969000,262552000,850312000,398611000,398611000,,-48600000,,,,59318000,1859313000,1460702000,1009001000,-44324000,,294969000,294969000,51626,ENTG
2019-12-31,121140000,,318049000,,254860000,248711000,720497000,284218000,284218000,,-46962000,,,,63189000,1591066000,1306848000,870569000,33831000,,254860000,254860000,51626,ENTG
2018-12-31,118456000,,254432000,,240755000,238176000,727159000,308375000,308375000,,-34094000,,,,13677000,1550497000,1242122000,823338000,-53943000,,240755000,240755000,51626,ENTG
2017-12-31,106067000,,184731000,,85066000,212008000,615085000,252987000,252987000,,-32343000,,,,99665000,1342532000,1089545000,727447000,-68256000,,85066000,85066000,51626,ENTG
2020-12-31,,,5812000,,4598000,36678000,50176000,0,6202000,7296000,,,,,1214000,50176000,43974000,0,-390000,,4598000,4598000,51627,ASRV
2019-12-31,,,7600000,,6028000,34926000,49415000,0,7700000,6789000,,,,,1572000,49415000,41715000,0,-100000,,6028000,6028000,51627,ASRV
2018-12-31,,,9445000,,7768000,33997000,50318000,0,10002000,6319000,,,,,1677000,50318000,40316000,0,-604000,,7768000,7768000,51627,ASRV
2017-12-31,,,8680000,,3293000,33839000,49406000,0,9308000,6259000,,,,,5387000,49406000,40098000,0,-628000,,3293000,3293000,51627,ASRV
2020-12-31,,,201333000,16981000,145535000,327425000,597158000,0,212831000,56902000,,,,,31900000,597158000,384327000,0,-11498000,,169433000,145535000,51630,TOWN
2019-12-31,,,176270000,12939000,138783000,313416000,554572000,0,189297000,51859000,,,,,32596000,554572000,365275000,0,-13027000,,143674000,138783000,51630,TOWN
2018-12-31,,,172001000,12894000,133793000,284461000,524125000,0,192139000,47525000,,,,,34227000,524125000,331986000,0,-20138000,,137774000,133793000,51630,TOWN
2017-12-31,,,147602000,11265000,87663000,242879000,443816000,0,157526000,43411000,,,,,54813000,443816000,286290000,0,-9924000,,92789000,87663000,51630,TOWN
2021-01-01,475900000,,395000000,1700000,389900000,767900000,1850100000,448500000,448500000,,-77600000,,,,4400000,3147700000,2699200000,1297600000,-53500000,,390600000,389900000,51632,TRMB
2020-01-03,469700000,,344800000,1400000,514300000,814300000,1876100000,424300000,424300000,,-82400000,,,,-169700000,3264300000,2840000000,1388200000,-79500000,,514500000,514300000,51632,TRMB
2018-12-28,446100000,,278000000,400000,282800000,792700000,1786900000,368500000,368500000,,-73200000,,,,-5300000,3108400000,2739900000,1321500000,-90500000,,283300000,282800000,51632,TRMB
2017-12-29,370200000,,248200000,400000,118400000,694400000,1469800000,256400000,256400000,,-25200000,,,,129700000,2646500000,2390100000,1176700000,-8200000,,118500000,118400000,51632,TRMB
2019-12-31,,,-11729110,-14729012,-14995895,51618825,101685000,46997698,46997698,,-39304488,,,,1156002,529644247,482646549,427959247,-58726808,,-12885112,-14995895,51634,AHCO
2018-12-31,,,22239408,2865125,23260347,23850563,60075444,33491074,33491074,,-7452737,,,,-2097705,345278337,311787263,285202893,-11251666,,24337113,23260347,51634,AHCO
2017-12-31,,,10723043,-34091883,9687397,12288435,29658753,16087854,16087854,,-5041137,,,,248808,192559144,176471290,162900391,-5364811,-206632.0,10474235,9687397,51634,AHCO
2016-12-31,,,-3438844,-34091883,-4183323,11396785,15627327,2322512,2322512,,-5761356,,,,-208445,174316366,171993854,158689039,-5761356,-389899.0,-3230399,-4183323,51634,AHCO
2019-12-31,,,112657000,,112563000,74963000,276507000,201544000,201544000,,-83026000,,,,94000,276507000,74963000,0,-88887000,,112563000,112563000,51635,NMFC
2018-12-31,,,72644000,,72353000,68092000,231465000,163373000,163373000,,-56139000,,,,291000,231465000,68092000,0,-90729000,,72353000,72353000,51635,NMFC
2017-12-31,,,109954000,,109398000,57952000,197806000,139854000,139854000,,-35941000,,,,556000,197806000,57952000,0,-29900000,,109398000,109398000,51635,NMFC
2016-12-31,,,111830000,,111678000,51372000,168084000,116712000,116712000,,-27302000,,,,152000,168084000,51372000,0,-4882000,,111678000,111678000,51635,NMFC
2019-12-31,,,83520000,,61257000,500891000,704292000,150847000,150847000,,-82916000,,,,22263000,1113445000,962598000,409153000,-67327000,,61257000,61257000,51638,CMLS
2018-12-31,,,568369000,,757581000,507063000,733307000,170138000,170138000,,-50978000,,,,-189212000,1140360000,970222000,407053000,398231000,,757581000,757581000,51638,CMLS
2017-12-31,,,-370291000,,-206565000,510870000,715565000,142456000,142456000,,-126952000,,,,-163726000,1135662000,993206000,420097000,-512747000,,-206565000,-206565000,51638,CMLS
2016-12-31,,,-536874000,,-510720000,506934000,699699000,105498000,105498000,,-138634000,,,,-26154000,1141400000,1035902000,441701000,-642372000,,-510720000,-510720000,51638,CMLS
2019-12-31,53249000,,-88435000,,-88275000,13743000,0,-66992000,-66992000,,-900000,,,,-160000,0,66992000,0,-21443000,,-88275000,-88275000,51639,SRRA
2018-12-31,41078000,,-53637000,,-53335000,14339000,0,-55417000,-55417000,,-200000,,,,-302000,0,55417000,0,1780000,,-53335000,-53335000,51639,SRRA
2017-12-31,30157000,,-41859000,,-42015000,12462000,0,-42619000,-42619000,,-200000,,,,156000,0,42619000,0,760000,,-42015000,-42015000,51639,SRRA
2016-12-31,31646000,,-47724000,,-47867000,13713000,0,-45359000,-45359000,,-200000,,,,143000,0,45359000,0,-2365000,,-47867000,-47867000,51639,SRRA
2020-02-01,,,122860000,,120043000,1251733000,1431154000,179421000,179421000,,-101307000,,,,2817000,4829897000,4650476000,3398743000,-56561000,,120043000,120043000,51641,ASO
2019-02-02,,,23393000,,21442000,1239002000,1367952000,128950000,128950000,,-108652000,,,,1951000,4783893000,4654943000,3415941000,-105557000,,21442000,21442000,51641,ASO
2018-02-03,,,61282000,,58501000,1241643000,1398964000,157321000,157321000,,-104857000,,,,2781000,4835582000,4678261000,3436618000,-96039000,,58501000,58501000,51641,ASO
2020-10-31,,,4436624,,4436624,1610110,6841901,5231791,5231791,,-1436250,,,,0,6841901,1610110,0,-795167,,4436624,4436624,51644,DTF
2019-10-31,,,14329334,,14329334,1532292,7114566,5582274,5582274,,-2211536,,,,0,7114566,1532292,0,8747060,,14329334,14329334,51644,DTF
2018-10-31,,,-3841687,,-3841687,1532741,7349524,5816783,5816783,,-1804295,,,,0,7349524,1532741,0,-9658470,,-3841687,-3841687,51644,DTF
2017-10-31,,,1090316,,1090316,1562671,7615340,6052669,6052669,,-1495858,,,,0,7615340,1562671,0,-4962353,,1090316,1090316,51644,DTF
2019-12-31,,,795794000,2191000,590395000,44002000,1047971000,766692000,766692000,186327000,,,,,203778000,8175426000,7408734000,7127455000,29102000,,592016000,590395000,51645,EXPD
2018-12-31,,,818329000,882000,618199000,45346000,1074301000,796563000,796563000,178373000,,,,,198539000,8138365000,7341802000,7064064000,21766000,,619790000,618199000,51645,EXPD
2017-12-31,,,718595000,2515000,489345000,44290000,932337000,696260000,696260000,142477000,,,,,228212000,6920948000,6224688000,5988611000,22335000,,490383000,489345000,51645,EXPD
2016-12-31,,,686856000,2575000,430807000,41763000,897589000,670163000,670163000,138867000,,,,,254323000,6098037000,5427874000,5200448000,16693000,,432533000,430807000,51645,EXPD
2019-12-31,3793000,,-87509000,-680000,-99941000,250138000,195015000,-58916000,-58916000,,,,,,12917000,583909000,642825000,388894000,-28593000,,-100426000,-99941000,51646,AMBO
2018-12-31,1513000,,48438000,-1786000,44990000,176469000,193365000,15383000,15383000,,,,,,3498000,531508000,516125000,338143000,33055000,,44940000,44990000,51646,AMBO
2017-12-31,6262000,,55539000,-1275000,46463000,178962000,187529000,2305000,2305000,,,,,,9614000,443924000,441619000,256395000,53234000,,45925000,46463000,51646,AMBO
2016-12-31,7572000,,-31107000,-1495000,-35700000,187331000,173274000,-21629000,-21629000,,,,,,5911000,412016000,433645000,238742000,-9478000,,-37018000,-35700000,51646,AMBO
2020-07-31,,,26259527,,26259527,6855033,33737539,26882506,26882506,,-4762609,,,,0,33737539,6855033,0,-622979,,26259527,26259527,51647,MYN
2019-07-31,,,45536337,,45536337,5872291,34048611,28176320,28176320,,-7483228,,,,0,34048611,5872291,0,17360017,,45536337,45536337,51647,MYN
2018-07-31,,,3026237,,3026237,5041838,34889659,29847821,29847821,,-7065505,,,,0,34889659,5041838,0,-26821584,,3026237,3026237,51647,MYN
2017-07-31,,,-6597224,,-6597224,5174880,36273660,31098780,31098780,,-5672583,,,,0,36273660,5174880,0,-37696004,,-6597224,-6597224,51647,MYN
2019-12-28,,,-3069000,,-4164000,49363000,54885000,1802000,1802000,,-4871000,,,,1095000,173181000,171379000,118296000,-4871000,,-4164000,-4164000,51648,SUMR
2018-12-29,,,-4815000,,-4251000,51310000,55119000,-373000,-373000,,-3924000,,,,-564000,173619000,173992000,118500000,-4442000,,-4251000,-4251000,51648,SUMR
2017-12-30,,,-77000,,-2249000,53107000,60195000,2891000,2891000,,-2968000,,,,2172000,189869000,186978000,129674000,-2968000,,-2249000,-2249000,51648,SUMR
2016-12-31,,,-5496000,,-4322000,54164000,61751000,2917000,2917000,,-2682000,,,,-1174000,194328000,191411000,132577000,-8413000,,-4322000,-4322000,51648,SUMR
2019-12-31,6537000,,-368000,,-411000,12312000,18421000,-428000,-428000,,,,,,43000,32528000,32956000,14107000,60000,,-411000,-411000,51650,FLGT
2018-12-31,5534000,,-5571000,,-5607000,10190000,10654000,-5070000,-5070000,,,,,,36000,21351000,26421000,10697000,-501000,,-5607000,-5607000,51650,FLGT
2017-12-31,4223000,,-3525000,,-2510000,9438000,10179000,-3482000,-3482000,,,,,,-1015000,18730000,22212000,8551000,-43000,,-2510000,-2510000,51650,FLGT
2016-12-31,3558000,,-4468000,,-5347000,7078000,11554000,918000,918000,,,,,,920000,18276000,17358000,6722000,-5386000,41000.0,-5388000,-13666000,51650,FLGT
2019-12-31,1667000,,-38647000,-169000,-38647000,9790000,0,-11457000,-11457000,,-2128000,,,,0,0,11457000,0,-27190000,,-38647000,-38647000,51652,GTBP
2018-12-31,9067000,,-259186000,-169000,-259186000,12487000,0,-21554000,-21554000,,-9117000,,,,0,0,21554000,0,-237632000,,-259186000,-259186000,51652,GTBP
2017-12-31,1068000,,-144172000,-169000,-144172000,134502000,0,-135570000,-135570000,,-8602000,,,,0,0,135570000,0,-8602000,,-144172000,-144172000,51652,GTBP
2016-12-31,975000,,9768000,-169000,9768000,8399000,0,-9374000,-9374000,,-6555000,,,,0,0,9374000,0,19142000,,9768000,9768000,51652,GTBP
2020-05-31,,,678105,,678105,445568,2029265,1583697,1583697,,-418970,,,,0,2029265,445568,0,-905592,,678105,678105,51654,NOM
2019-05-31,,,2048195,,2048195,412047,2076475,1664428,1664428,,-440447,,,,0,2076475,412047,0,383767,,2048195,2048195,51654,NOM
2018-05-31,,,366640,,366640,433318,2148236,1714918,1714918,,-383336,,,,0,2148236,433318,0,-1348278,,366640,366640,51654,NOM
2017-05-31,,,485022,,485022,421088,2277956,1856868,1856868,,-326905,,,,0,2277956,421088,0,-1371846,,485022,485022,51654,NOM
2019-12-31,,,-368659000,27450000,-369845000,49139000,283723000,123158000,123158000,1220000,-74429000,,,,1174000,444748000,321590000,161025000,-491817000,,-369833000,-398403000,51655,SMLP
2018-12-31,,,42384000,25250000,33135000,52877000,303669000,142137000,142137000,1555000,-60535000,,,,33000,508208000,366071000,204539000,-99753000,,42351000,4635000,51655,SMLP
2017-12-31,,,86391000,38733000,76211000,54681000,339177000,167466000,167466000,1555000,-68131000,,,,341000,490296000,322830000,151119000,-81075000,,86050000,72648000,51655,SMLP
2016-12-31,,,-38112000,40541000,-45462000,52410000,280029000,114958000,114958000,422000,-63810000,,,,75000,402784000,287826000,122755000,-153070000,,-38187000,-48207000,51655,SMLP
2019-12-31,,,362500000,40500000,226700000,194200000,423500000,41700000,41700000,,-215100000,,,,41400000,641500000,599800000,218000000,320800000,,321100000,223800000,51657,KW
2018-12-31,,,270100000,184500000,150000000,219600000,477900000,52200000,52200000,,-238200000,,,,58000000,818600000,766400000,340700000,217900000,,212100000,149100000,51657,KW
2017-12-31,,,121700000,211900000,100500000,219400000,488100000,56200000,56200000,,-217700000,,,,-16300000,827000000,770800000,338900000,65500000,,138000000,99400000,51657,KW
2016-12-31,,,90500000,1295100000,5600000,231900000,452600000,22500000,22500000,,-191600000,,,,14000000,714400000,691900000,261800000,68000000,,76500000,1100000,51657,KW
2019-12-31,,,-25659000,,-25659000,33201000,14687000,-18514000,-18514000,,-4547000,,,,0,35095000,53609000,20408000,-7145000,,-25659000,-25659000,51660,OTRK
2018-12-31,,,-14212000,,-14212000,17684000,4058000,-13626000,-13626000,,-570000,,,,0,15177000,28803000,11119000,-586000,,-14212000,-14212000,51660,OTRK
2017-12-31,,,-13599000,,-13605000,11811000,1326000,-10731000,-10731000,,-3409000,,,,6000,7717000,18448000,6391000,-2868000,,-13605000,-13605000,51660,OTRK
2016-12-31,,,-17927000,,-17936000,8838000,2405000,-6574000,-6574000,,-5354000,,,,9000,7075000,13649000,4670000,-11353000,,-17936000,-17936000,51660,OTRK
2020-08-01,,,-47722000,,-67117000,805874000,754210000,-51664000,-51664000,,,,,,19395000,1711733000,1763397000,957523000,3942000,,-67117000,-67117000,51661,SFIX
2019-08-03,,,30821000,,36881000,679634000,703129000,23495000,23495000,,,,,,-6060000,1577558000,1554063000,874429000,7326000,,36881000,36863000,51661,SFIX
2018-07-28,,,54713000,,44900000,492998000,536022000,43024000,43024000,,,,,,9813000,1226505000,1183481000,690483000,11689000,,44900000,35541000,51661,SFIX
2017-07-29,,,12801000,,-594000,402781000,434421000,31640000,31640000,,,,,,13395000,977139000,945499000,542718000,-18839000,,-594000,-594000,51661,SFIX
2019-12-31,,,77400000,,54500000,273500000,483100000,150900000,150900000,,-38400000,,,,22900000,1106000000,955100000,622900000,-73500000,,54500000,54500000,51662,EBS
2018-12-31,142800000.0,,81500000,,62700000,198000000,320400000,97400000,97400000,,-9900000,,,,18800000,782400000,685000000,462000000,-15900000,,62700000,62700000,51662,EBS
2017-12-31,142800000.0,,118600000,,82600000,142900000,283600000,132100000,132100000,,-6600000,,,,36000000,560900000,428800000,277300000,-13500000,,82600000,82600000,51662,EBS
2016-12-31,142800000.0,,99200000,,51800000,143100000,244800000,94700000,94700000,,-7600000,,,,36700000,488800000,394100000,244000000,4500000,-10700000.0,62500000,51800000,51662,EBS
2017-12-31,,,20445000,-184000,11556000,8911000,44247000,0,35336000,,,,,,8510000,301743000,266407000,257496000,-14891000,,11935000,11556000,51664,RILYH
2016-12-31,,,47047000,1045000,21526000,4661000,55277000,0,50616000,,,,,,14321000,188355000,137739000,133078000,-3569000,,32726000,21526000,51664,RILYH
2015-12-31,,,21265000,-118000,11805000,2895000,24143000,0,21248000,,,,,,7688000,111691000,90443000,87548000,17000,,13577000,11805000,51664,RILYH
2014-12-31,,,-8681000,18000,-5801000,2369000,-3776000,0,-6145000,,,,,,-2886000,75854000,81999000,79630000,-2536000,,-5795000,-5801000,51664,RILYH
2019-12-31,462759000,,862270000,,859867000,275805000,1544338000,805774000,805774000,,,,,,2403000,2410706000,1604932000,866368000,56496000,,859867000,859444000,51665,ANET
2018-12-31,442468000,,288801000,,328115000,249062000,1373377000,681847000,681847000,,-2701000.0,,,,-39314000,2151369000,1469522000,777992000,-393046000,,328115000,327926000,51665,ANET
2017-12-31,349594000,,474760000,,423201000,241903000,1061769000,470272000,470272000,,-2780000.0,,,,51559000,1646186000,1175914000,584417000,4488000,,423201000,422400000,51665,ANET
2016-12-31,273581000,,242225000,,184189000,206126000,723116000,243409000,243409000,,-3136000.0,,,,58036000,1129167000,885758000,406051000,-1184000,,184189000,182965000,51665,ANET
2019-12-31,,,2362000,,1788000,15091000,18615000,3524000,3524000,,-127000,,,,574000,29971000,26447000,11356000,-1162000,,1788000,1788000,51666,GAN
2018-12-31,,,-8636000,,-7702000,10230000,2129000,-8101000,-8101000,,-208000,,,,-934000,14023000,22124000,11894000,-535000,,-7702000,-7702000,51666,GAN
2017-12-31,,,-4216000,,-3478000,13013000,9120000,-3893000,-3893000,,-122000,,,,-738000,9120000,13013000,0,-323000,,-3478000,-3478000,51666,GAN
2016-12-31,,,-5199000,,-3759000,12469000,7803000,-4666000,-4666000,,-122000,,,,-1440000,7803000,12469000,0,-533000,,-3759000,-3759000,51666,GAN
2019-12-31,,,1324000000,164000000,1169000000,39000000,3417000000,1701000000,1701000000,414000000,-641000000,,,,152000000,12669000000,10968000000,9252000000,-377000000,,1172000000,1167000000,51669,DTE
2018-12-31,,,1216000000,480000000,1120000000,37000000,3150000000,1584000000,1584000000,405000000,-559000000,,,,98000000,14212000000,12628000000,11062000000,-368000000,,1118000000,1118000000,51669,DTE
2017-12-31,,,1287000000,478000000,1134000000,65000000,3173000000,1687000000,1687000000,391000000,-536000000,,,,175000000,12607000000,10920000000,9434000000,-400000000,,1112000000,1132000000,51669,DTE
2016-12-31,,,1105000000,488000000,868000000,41000000,2845000000,1458000000,1458000000,370000000,-472000000,,,,271000000,10630000000,9172000000,7785000000,-353000000,,834000000,866000000,51669,DTE
2020-12-31,,,-8822000000,,-7069000000,459000000,-2542000000,-8975000000,-8975000000,3486000000,-992000000,,,,-1753000000,15355000000,24330000000,17897000000,153000000,,-7069000000,-7069000000,51670,UAL
2019-12-31,,,3914000000,,3009000000,1863000000,14782000000,4568000000,4568000000,6063000000,-646000000,,,,905000000,43259000000,38691000000,28477000000,-654000000,,3009000000,3009000000,51670,UAL
2018-12-31,,,2648000000,,2122000000,1769000000,13194000000,3670000000,3670000000,5590000000,-605000000,,,,526000000,41303000000,37633000000,28109000000,-1022000000,,2122000000,2122000000,51670,UAL
2017-12-31,,,3023000000,,2143000000,1652000000,12771000000,3690000000,3690000000,5333000000,-552000000,,,,880000000,37784000000,34094000000,25013000000,-667000000,,2143000000,2143000000,51670,UAL
2020-12-31,,,46112000,,35926000,63446000,125737000,0,49881000,12410000,,,,,10186000,125737000,75856000,0,-3769000,,35926000,35926000,51671,FCBC
2019-12-31,,,49796000,,38802000,54395000,112564000,0,46620000,11549000,,,,,10994000,112564000,65944000,0,3176000,,38802000,38802000,51671,FCBC
2018-12-31,,,45122000,,36340000,52513000,114895000,0,50662000,11720000,,,,,8782000,114895000,64233000,0,-5540000,,36340000,36340000,51671,FCBC
2017-12-31,,,42113000,,21485000,53095000,109015000,0,44756000,11164000,,,,,20628000,109015000,64259000,0,-2643000,,21485000,21485000,51671,FCBC
2020-12-31,,,-91177000,4060000,-97637000,34033000,102125000,49627000,49627000,-2402000,-14372000,,,,5896000,487267000,437640000,385142000,-140804000,-424000,-97073000,-97637000,51672,CLB
2019-12-31,,,81994000,4275000,101983000,48023000,172631000,102019000,102019000,-16000,-14690000,,,,-12290000,668210000,566191000,495579000,-20025000,7833000,94284000,101983000,51672,CLB
2018-12-31,,,105294000,4141000,79526000,62910000,203882000,119855000,119855000,-1970000,-13328000,,,,25447000,700846000,580991000,496964000,-14561000,-58000,79847000,79526000,51672,CLB
2017-12-31,,,99234000,3888000,83125000,47737000,182861000,111386000,111386000,-786000,-10734000,,,,18249000,647819000,536433000,464958000,-12152000,2111000,80985000,83125000,51672,CLB
2020-12-31,,,42400000,200000,32200000,,149800000,71400000,71400000,23900000,-26400000,,,,10200000,418600000,347200000,268800000,-29000000,,32200000,32189000,51678,UTL
2019-12-31,,,58000000,200000,44200000,,147800000,73100000,73100000,22700000,-26600000,,,,13800000,438200000,365100000,290400000,-15100000,,44200000,44189000,51678,UTL
2018-12-31,,,41400000,200000,33000000,,144000000,71200000,71200000,22400000,-26400000,,,,8400000,444100000,372900000,300100000,-29800000,,33000000,32989000,51678,UTL
2017-12-31,,,46500000,200000,29000000,5700000.0,143400000,69700000,69700000,21100000,-25500000,,,,17500000,406200000,336500000,262800000,-23200000,,29000000,28989000,51678,UTL
2019-12-31,,,-99533000,,-99533000,41058000,-65310000,-106368000,-106368000,,,,,,0,43103000,149471000,108413000,6835000,,-99533000,-99533000,51681,NTLA
2018-12-31,,,-85343000,,-85343000,32189000,-58681000,-90870000,-90870000,,,,,,0,30434000,121304000,89115000,5527000,,-85343000,-85343000,51681,NTLA
2017-12-31,,,-67543000,,-67543000,28025000,-41530000,-69555000,-69555000,,,,,,0,26117000,95672000,67647000,2012000,,-67543000,-67543000,51681,NTLA
2016-12-31,,,-31634000,,-31634000,16798000,-15361000,-32159000,-32159000,,,,,,0,16479000,48638000,31840000,525000,,-31634000,-31634000,51681,NTLA
2020-03-31,,,433220000000,728029000000,305955000000,1888694000000,3796781000000,0,1191827000000,716260000000,,,,,114505000000,3796781000000,2604954000000,0,-758607000000,,318715000000,305955000000,51682,MUFG
2019-03-31,,,870842000000,785200000000,718645000000,1778945000000,3856312000000,0,1358870000000,718497000000,,,,,133237000000,3856312000000,2497442000000,0,-488028000000,,737605000000,718645000000,51682,MUFG
2018-03-31,,,1661819000000,675633000000,1228160000000,1764787000000,4406199000000,0,2059666000000,581746000000,,,,,407823000000,4406199000000,2346533000000,0,-397847000000,,1253996000000,1228160000000,51682,MUFG
2017-03-31,,,272543000000,779176000000,202680000000,1722167000000,3161298000000,0,619394000000,819737000000,,,,,94453000000,3161298000000,2541904000000,0,-346851000000,,178090000000,202680000000,51682,MUFG
2019-12-31,10345291,,-19784054,,-19784054,8651423,0,-19784327,-19784327,,-18338,,,,0,0,19784327,0,273,,-19784054,-19784054,51686,ZOM
2018-12-31,10272072,,-16647687,,-16647687,6101407,0,-16579246,-16579246,,-18338,,,,0,0,16579246,0,-68441,,-16647687,-16647687,51686,ZOM
2017-12-31,2712197,,-8065072,,-8065072,5279443,0,-8084050,-8084050,,-18338,,,,0,0,8084050,0,18978,,-8065072,-8065072,51686,ZOM
2016-12-31,1499325,,-5740492,,-5740492,4181050,0,-5726196,-5726196,,-18338,,,,0,0,5726196,0,-14296,,-5740492,-5740492,51686,ZOM
2020-12-31,,,5513173000,26309000,4179936000,1813643000,6720889000,5461936000,5461936000,-554690000,-53742000,,,,1334877000,35957161000,30495225000,29236272000,51237000,,4178296000,4179936000,51687,SIM
2019-12-31,,,1636416000,24800000,-1635909000,1637425000,4104060000,2323656000,2323656000,142979000,-55049000,,,,3276274000,34171201000,31847545000,30067141000,-687240000,,-1639858000,-1635909000,51687,SIM
2018-12-31,,,4199392000,-323369000,3653347000,1080012000,5114938000,4043573000,4043573000,-8647000,-16511000,,,,752462000,35678253000,31634680000,30563315000,155819000,,3446930000,3653347000,51687,SIM
2017-12-31,,,3017440000,-108572000,1894776000,1238943000,4705924000,3473915000,3473915000,-6934000,-54404000,,,,1122809000,28700450000,25226535000,23994526000,-456475000,,1894631000,1894776000,51687,SIM
2019-12-31,870780,,-679020,,-871800,19308612,23252570,67572,67572,,-382673,,,,192780,64438594,64371022,41186024,-746592,,-871800,-7257954,51688,MTBCP
2018-12-31,1029510,,-2295865,,-2138480,17631455,19293246,-2221546,-2221546,,-351168,,,,-157385,50545781,52767327,31252535,-74319,,-2138480,-6962467,51688,MTBCP
2017-12-31,1081832,,-5497351,,-5565156,12814899,14131565,-4065109,-4065109,,-1324219,,,,67805,31810635,35875744,17679070,-1432242,,-5565156,-7595451,51688,MTBCP
2016-12-31,902186,,-8599921,,-8796723,13207063,11076816,-8140468,-8140468,,-682083,,,,196802,24493443,32633911,13416627,-459453,,-8796723,-9549248,51688,MTBCP
2019-12-31,13303000,,-27124000,,-27124000,6245000,0,-19548000,-19548000,,-9000,,,,0,0,19548000,0,-7576000,,-27124000,-27124000,51691,ANCN
2018-12-31,7514000,,-13492000,,-13798000,5521000,0,-13035000,-13035000,,-25000,,,,306000,0,13035000,0,-457000,,-13798000,-13798000,51691,ANCN
2017-12-31,6229000,,-9483000,,-9806000,3163000,0,-9392000,-9392000,,-5000,,,,323000,0,9392000,0,-91000,,-9806000,-9806000,51691,ANCN
2016-12-31,2384000,,-4605000,,-4742000,2258000,0,-4642000,-4642000,,-7000,,,,137000,0,4642000,0,37000,,-4742000,-4742000,51691,ANCN
2020-10-31,,,-3898520,,-3898520,1244138,4572139,3328001,3328001,,-2015059,,,,0,4572139,1244138,0,-7226521,,-3898520,-3898520,51695,FCO
2019-10-31,,,5970777,,5970777,1356076,5482154,4126078,4126078,,-4093392,,,,0,5482154,1356076,0,1844699,,5970777,5970777,51695,FCO
2018-10-31,,,-2972517,,-2972517,1433139,6166501,4733362,4733362,,925038,,,,0,6166501,1433139,0,-7705879,,-2972517,-2972517,51695,FCO
2017-10-31,,,6875562,,6875562,1542934,6330607,4787673,4787673,,-63238,,,,0,6330607,1542934,0,2087889,,6875562,6875562,51695,FCO
2019-12-31,,,-2835778,-221690,-2814088,13067569,10557463,-2740057,-2740057,,-105919,,,,0,11766763,14506820,1209300,-95721,,-2835778,-2814088,51697,SMTI
2018-12-31,,,175464,-221690,175464,7646119,7927748,212135,212135,,-60608,,,,0,8779872,8567737,852124,-36671,,175464,7028,51697,SMTI
2017-12-31,,,331309,-221690,331309,5275402,5498703,120446,120446,,-126825,,,,0,6304741,6184295,806038,210863,,331309,192303,51697,SMTI
2016-12-31,,,-415747,-221690,-415747,3946124,4564274,546532,546532,,-174493,,,,0,5507853,4961321,943579,-962279,,-415747,-677463,51697,SMTI
2019-11-30,,,-75307764,,-54504084,6737516,4210224,-2527292,-2527292,,-7723993,,,,-20803680,4210224,6737516,0,-72780472,,-54504084,-54504084,51698,FMO
2018-11-30,,,-33331265,,12490831,7539745,3731698,-3808047,-3808047,,-7229892,,,,-45822096,3731698,7539745,0,-29523218,,12490831,12490831,51698,FMO
2017-11-30,,,-85368091,,-50425518,7700808,4291205,-3409603,-3409603,,-4521629,,,,-34942573,4291205,7700808,0,-81958488,,-50425518,-50425518,51698,FMO
2016-11-30,,,37906680,,25118338,7364864,3247036,-4117828,-4117828,,-3064925,,,,12788342,3247036,7364864,0,42024508,,25118338,25118338,51698,FMO
2020-12-31,,,14370000,,10302000,22794000,41363000,0,14370000,4199000,,,,,4068000,41363000,26993000,0,0,,10302000,10302000,51700,HMNF
2019-12-31,,,11117000,,7793000,22937000,38222000,0,11117000,4168000,,,,,3324000,38222000,27105000,0,0,,7793000,7793000,51700,HMNF
2018-12-31,,,11124000,,8236000,21439000,36511000,0,11124000,3948000,,,,,2888000,36511000,25387000,0,0,,8236000,8236000,51700,HMNF
2017-12-31,,,8806000,,4404000,21466000,34060000,0,8806000,3788000,,,,,4402000,34060000,25254000,0,72000,,4404000,4404000,51700,HMNF
2019-12-31,,,75700000,,55900000,314500000,569400000,216200000,216200000,,-95700000,,,,19800000,1593900000,1377700000,1024500000,-140500000,,55900000,55900000,51701,WBT
2018-12-31,,,89000000,,78200000,303500000,571100000,230600000,230600000,,-94500000,,,,10800000,1590100000,1359500000,1019000000,-141600000,,78200000,78200000,51701,WBT
2017-12-31,,,121400000,,132900000,278200000,536900000,227500000,227500000,,-92400000,,,,-11500000,1445400000,1217900000,908500000,-106100000,,132900000,132900000,51701,WBT
2016-12-31,,,102200000,,71500000,291100000,533800000,211500000,211500000,,-90000000,,,,30700000,1456100000,1244600000,922300000,-109300000,,71500000,71500000,51701,WBT
2021-01-03,205389000,,906364000,,727887000,910852000,2117814000,1001573000,1001573000,,-49712000,,,,178266000,3782745000,2781172000,1664931000,-95209000,-211000,728098000,727887000,51704,PKI
2019-12-29,189336000,,237142000,,227558000,827837000,1417645000,400472000,400472000,,-63627000,,,,9389000,2883673000,2483201000,1466028000,-163330000,-195000,227753000,227558000,51704,PKI
2018-12-30,193998000,,257683000,,237927000,787474000,1360211000,378739000,378739000,,-66976000,,,,20208000,2777996000,2399257000,1417785000,-121056000,452000,237475000,237927000,51704,PKI
2017-12-31,139464000,,296718000,,292633000,614656000,1073754000,319634000,319634000,,-43940000,,,,139828000,2256982000,1937348000,1183228000,-22916000,135743000,156890000,292633000,51704,PKI
2019-12-31,,,350300000,131700000,161600000,9100000,859900000,684600000,684600000,61300000,-89200000,,,,175600000,2967100000,2282500000,2107200000,-334300000,,174700000,161600000,51705,GFI
2018-12-31,,,-410700000,120800000,-348200000,3400000,472300000,271100000,271100000,54200000,-74300000,,,,-65900000,2577800000,2306700000,2105500000,-681800000,,-344800000,-348200000,51705,GFI
2018-01-01,,,152400000,127200000,-18700000,7400000,594700000,464300000,464300000,28700000,-68300000,,,,173200000,2761800000,2297500000,2167100000,-311900000,13100000.0,-20800000,-18700000,51705,GFI
2016-12-31,,,357400000,122600000,158200000,13300000,586800000,362200000,362200000,42400000,-67400000,,,,189500000,2666400000,2304200000,2079600000,-4800000,1200000.0,167900000,158200000,51705,GFI
2020-10-31,,,38730367,,38730367,9148799,32910403,23761604,23761604,,-12251554,,,,0,32910403,9148799,0,14968763,,38730367,38730367,51706,AVK
2019-10-31,,,53264511,,53264511,8806692,39338950,30532258,30532258,,-14250656,,,,0,39338950,8806692,0,22732253,,53264511,53264511,51706,AVK
2018-10-31,,,-16207968,,-16207968,6272755,26666887,20394132,20394132,,-8820219,,,,0,26666887,6272755,0,-36602100,,-16207968,-16207968,51706,AVK
2017-10-31,,,58346609,,58346609,5910947,26789743,20878796,20878796,,-4861042,,,,0,26789743,5910947,0,37467813,,58346609,58346609,51706,AVK
2020-06-30,588206,,-3163776,-28311,-3134602,2173951,188744,-2573413,-2573413,,-457745,,,,0,188744,2762157,0,-590363,,-3163776,-3134602,51707,GBS
2019-06-30,3179864,,-7394377,863,-7336686,2653687,0,-5833551,-5833551,,-664840,,,,0,0,5833551,0,-1560826,,-7394377,-7336686,51707,GBS
2018-06-30,2525798,,-5056775,1311775,-5020383,2077669,0,-4603467,-4603467,,-453872,,,,0,0,4603467,0,-453308,,-5056775,-5020383,51707,GBS
2017-06-30,2525798,,-340006,1311775,-340006,188724,0,-188724,-188724,,-151363,,,,0,0,188724,0,-151282,,-340006,-340006,51707,GBS
2020-12-31,,,40090000,,32743000,61056000,147416000,0,55352000,31008000,,,,,7347000,147416000,92064000,0,-15262000,,32743000,31596000,51708,CCNE
2019-12-31,,,48641000,,40081000,68599000,136149000,0,50630000,16920000,,,,,8560000,136149000,85519000,0,-1989000,,40081000,39934000,51708,CCNE
2018-12-31,,,40229000,,33719000,61804000,119571000,0,42523000,15244000,,,,,6510000,119571000,77048000,0,-2294000,,33719000,33569000,51708,CCNE
2017-12-31,,,36252000,,23860000,54641000,105753000,0,38127000,12985000,,,,,12392000,105753000,67626000,0,-1875000,,23860000,23725000,51708,CCNE
2019-12-31,8546108,,-14263830,,-14263830,5265438,-533334,-14344880,-14344880,,,,,,0,0,14344880,533334,162100,,-14263830,-15053424,51709,DARE
2018-12-31,6413956,,-16738815,,-16738815,4655837,-625000,-11694793,-11694793,,,,,,0,0,11694793,625000,-4900525,,-16738815,-16738815,51709,DARE
2017-12-31,984749,,-11503117,,-11503117,1744853,0,-2729602,-2729602,,-316805.0,,,,0,0,2729602,0,-8773515,,-11503117,-11503117,51709,DARE
2016-12-31,72666,,-672687,,-672687,157925,-400000,-630591,-630591,,-42096.0,,,,0,0,630591,400000,-42096,,-672687,-672687,51709,DARE
2020-12-31,3850000000,,42844000000,11319000000,33419000000,25969000000,70584000000,42360000000,42360000000,-1595000000,,,,,8125000000,207613000000,165253000000,137029000000,484000000,,34719000000,33419000000,51711,CHT
2019-12-31,3941000000,,41867000000,10115000000,32947000000,26978000000,71567000000,40729000000,40729000000,44000000,-104000000.0,,,,7946000000,207520000000,166791000000,135953000000,1138000000,,33921000000,32947000000,51711,CHT
2018-12-31,3725000000,,44986000000,9857000000,37557000000,27759000000,75938000000,43534000000,43534000000,-100000000,-18000000.0,,,,6405000000,215483000000,171949000000,139545000000,1452000000,,38581000000,37557000000,51711,CHT
2017-12-31,3886000000,,48009000000,8474000000,38988000000,29983000000,80677000000,46808000000,46808000000,-100000000,-22000000.0,,,,7849000000,227514000000,180706000000,146837000000,1201000000,,40160000000,38988000000,51711,CHT
2020-12-31,,,65536000,,53844000,80701000,178294000,0,65852000,31741000,,,,,11692000,178294000,112442000,0,-316000,,53844000,53844000,51712,THFF
2019-12-31,,,60999000,,48872000,70671000,165404000,0,61692000,33041000,,,,,12127000,165404000,103712000,0,-693000,,48872000,48872000,51712,THFF
2018-12-31,,,57728000,,46583000,64515000,149017000,0,58657000,25845000,,,,,11145000,149017000,90360000,0,-929000,,46583000,46583000,51712,THFF
2017-12-31,,,49753000,,29131000,64199000,138500000,0,50668000,23633000,,,,,20622000,138500000,87832000,0,-915000,,29131000,29131000,51712,THFF
2019-12-31,,,19231000,,19214000,18874000,68193000,49319000,49319000,,-20268000,,,,17000,68193000,18874000,0,-30088000,,19214000,19214000,51713,MRCC
2018-12-31,,,5859000,,5848000,14203000,58384000,44181000,44181000,,-12270000,,,,11000,58384000,14203000,0,-38322000,,5848000,5848000,51713,MRCC
2017-12-31,,,12252000,,12152000,16691000,51107000,34416000,34416000,,-8281000,,,,100000,51107000,16691000,0,-22164000,,12152000,12152000,51713,MRCC
2016-12-31,,,25044000,,24365000,15051000,45018000,29967000,29967000,,-6705000,,,,679000,45018000,15051000,0,-4923000,,24365000,24365000,51713,MRCC
2020-06-30,,,-40594000,,-40595000,81558000,46273000,-39592000,-39592000,,-2597000,,,,1000,163153000,202745000,116880000,-1002000,,-40595000,-41263000,51715,USAT
2019-06-30,,,-29620000,,-29882000,62600000,40185000,-26845000,-26845000,,-2992000,,,,262000,144466000,171311000,104281000,-2775000,,-29882000,-30550000,51715,USAT
2018-06-30,,,-11385000,,-11284000,34647000,35676000,-2175000,-2175000,,-3105000,,,,-101000,132508000,134683000,96832000,-9210000,,-11284000,-11952000,51715,USAT
2017-06-30,,,-7370000,,-7465000,28177000,25061000,-4134000,-4134000,,-2228000,,,,95000,101436000,105570000,76375000,-3236000,,-7465000,-8133000,51715,USAT
2020-09-30,1827286,,-6819929,1077645,-9933775,21570666,19364447,-4033505,-4033505,,-4607453,,,,2073835,43518384,47551889,24153937,-2786424,-812895,-8893764,-13105005,51717,CETX
2019-09-30,1481879,,-12638337,885874,-22364941,21528145,15562674,-7447350,-7447350,,-4785506,,,,-1335584,39265041,46712391,23702367,-5190987,-10559963,-11302753,-24330441,51717,CETX
2018-09-30,5558682,,-13888818,885874,-9240409,15207580,8215954,-12550308,-12550308,,-800398,,,,-2861672,22641417,35191725,14425463,-1338510,1786737,-11027146,-10155489,51717,CETX
2017-09-30,5558682,,4505563,885874,4389915,34797874,39913552,5115678,5115678,,-923952,,,,115648,120628200,115512522,80714648,-610115,1786737,4389915,3189044,51717,CETX
2020-02-02,,,127142000,,100263000,69469000,368979000,148079000,148079000,,-21056000,,,,26879000,1354691000,1206612000,985712000,-20937000,,100263000,100263000,51718,PLAY
2019-02-03,,,147887000,,117221000,61521000,360343000,157384000,157384000,,-13191000,,,,30666000,1265301000,1107917000,904958000,-9497000,,117221000,117221000,51718,PLAY
2018-02-04,,,156389000,,120949000,57015000,351849000,168322000,168322000,,-8650000,,,,35440000,1139791000,971469000,787942000,-11933000,,120949000,120949000,51718,PLAY
2017-01-29,,,143531000,,90795000,62424000,316659000,150516000,150516000,,-7108000,,,,52736000,1005158000,854642000,688499000,-6985000,,90795000,90795000,51718,PLAY
2019-12-31,21523000,,156541000,,149918000,15761000,193989000,155851000,155851000,,,,,,6623000,914626000,758775000,720637000,690000,,149918000,149918000,51720,SJ
2018-12-31,10957000,,111367000,,106740000,21270000,148934000,109881000,109881000,,,,,,4627000,743018000,633137000,594084000,1486000,,106740000,106740000,51720,SJ
2020-12-31,,,18229000,,13726000,49251000,76748000,0,18229000,9268000,,,,,4503000,76748000,58519000,0,0,,13726000,13726000,51721,BCML
2019-12-31,,,23691000,,17318000,38368000,75157000,0,30310000,6479000,,,,,6373000,75157000,44847000,0,-6619000,,17318000,17318000,51721,BCML
2018-12-31,,,20489000,,14493000,29198000,56381000,0,22101000,5082000,,,,,5996000,56381000,34280000,0,-2784000,,14493000,14493000,51721,BCML
2017-12-31,,,14149000,,5260000,23140000,44273000,0,17338000,3795000,,,,,8889000,44273000,26935000,0,-3189000,,5260000,5260000,51721,BCML
2019-12-31,8823000,,-10444000,,-10444000,1525000,0,-10348000,-10348000,,-106000,,,,0,0,10348000,0,-96000,,-10444000,-10444000,51723,IMNM
2018-12-31,6877000,,-7845000,,-7845000,866000,0,-7743000,-7743000,,-141000,,,,0,0,7743000,0,-102000,,-7845000,-7845000,51723,IMNM
2019-12-31,,,-7900000,,-5600000,118500000,164500000,42600000,42600000,3100000,-44900000,,,,-2300000,1761500000,1718900000,1597000000,-50500000,,-5600000,-5600000,51724,CLW
2018-12-31,,,-133500000,,-143800000,112700000,187500000,76300000,76300000,800000,-30700000,,,,10300000,1724200000,1647900000,1536700000,-209800000,,-143800000,-143800000,51724,CLW
2017-12-31,,,40900000,,97300000,120100000,209200000,91300000,91300000,600000,-31400000,,,,-56400000,1730400000,1639100000,1521200000,-50400000,,97300000,97300000,51724,CLW
2016-12-31,,,80666000,,49554000,130042000,236218000,106176000,106176000,600000,-30251000,,,,31112000,1734763000,1628587000,1498545000,-25510000,,49554000,49554000,51724,CLW
2020-10-25,31900000,,1114747000,4778000,908082000,729415000,1905964000,1144649000,1144649000,,-21069000,,,,206393000,9608462000,8463813000,7702498000,-29902000,,908354000,908082000,51727,HRL
2019-10-27,32500000,,1209715000,4077000,978806000,711584000,1884648000,1140564000,1140564000,,-18070000,,,,230567000,9497317000,8356753000,7612669000,69151000,,979148000,978806000,51727,HRL
2018-10-28,33800000,,1181284000,4007000,1012140000,807405000,1979473000,1138268000,1138268000,,-26494000,,,,168702000,9545700000,8407432000,7566227000,43016000,,1012582000,1012140000,51727,HRL
2017-10-29,34200000,,1278645000,3790000,846735000,725104000,1996636000,1237332000,1237332000,,-12683000,,,,431542000,9167519000,7930187000,7170883000,41313000,,847103000,846735000,51727,HRL
2020-03-31,,,-1848000000,199000000,-2269000000,2434000000,11812000000,6518000000,6518000000,,-8364000000,,,,489000000,12958000000,6440000000,1146000000,-8366000000,,-2337000000,-2269000000,51728,AZRE
2019-03-31,,,291000000,267000000,78000000,1314000000,9057000000,5606000000,5606000000,,-5736000000,,,,153000000,9926000000,4320000000,869000000,-5315000000,,138000000,78000000,51728,AZRE
2018-03-31,,,-1276000000,1157912000,-827000000,1188000000,7009000000,3938000000,3938000000,,-5842000000,,,,-253000000,7701000000,3763000000,692000000,-5214000000,,-1023000000,-827000000,51728,AZRE
2017-03-31,,,-535089000,1695556000,-1452571000,797161000,3807198000,1963472000,1963472000,,-2717337000,,,,892333000,4182985000,2219513000,375787000,-2498561000,,-1427422000,-1452571000,51728,AZRE
2020-12-31,,,145455000,193034000,87259000,628523000,900617000,173712000,173712000,,-24318000,,,,35865000,2772415000,2598703000,1871798000,-28257000,,109590000,87259000,51730,FSV
2019-12-31,,,-200484000,174662000,-251610000,546257000,773313000,147499000,147499000,,-32080000,,,,27147000,2407410000,2259911000,1634097000,-347983000,,-227631000,-251610000,51730,FSV
2018-12-31,,,115202000,151585000,65865000,426377000,611221000,132072000,132072000,,-12620000,,,,24922000,1931473000,1799401000,1320252000,-16870000,,90280000,65865000,51730,FSV
2017-12-31,,,96615000,117708000,51452000,385037000,540217000,113131000,113131000,,-9867000,,,,21568000,1729031000,1615900000,1188814000,-16516000,,75047000,51452000,51730,FSV
2019-12-31,,,-1636709000,3716479000,-1048807000,401806000,1249556000,437217000,437217000,-79259000,-535538000,,,,14003000,2376345000,1939128000,1126789000,-2073926000,1501797000,-1650712000,-1155698000,51732,CLNY
2018-12-31,,,-594727000,4149703000,-519607000,356126000,1187006000,434930000,434930000,-47352000,-552838000,,,,-59970000,2380696000,1945766000,1193690000,-1029657000,39582000,-534757000,-635213000,51732,CLNY
2017-12-31,,,-220556000,3975611000,-197891000,367140000,1538859000,706689000,706689000,-43484000,-536256000,,,,-100495000,2604913000,1898224000,1066054000,-927245000,55448000,-120061000,-342261000,51732,CLNY
2016-12-31,,,295508000,2843128000,115318000,187203000,711673000,366981000,366981000,-14193000,-170083000,,,,4782000,865139000,498158000,153466000,-71473000,55448000,290726000,64866000,51732,CLNY
2020-02-01,,,269182000,,220375000,716555000,1096539000,379984000,379984000,,-88509000,,,,48807000,2647437000,2267453000,1550898000,-110802000,,220375000,220375000,51733,RH
2019-02-02,,,160964000,,135731000,704228000,987118000,282890000,282890000,,-68603000,,,,25233000,2505653000,2222763000,1518535000,-121926000,,135731000,135731000,51733,RH
2018-02-03,,,22533000,,-2599000,712832000,845638000,132806000,132806000,,-56516000,,,,25132000,2440174000,2307368000,1594536000,-110273000,,-2599000,-2599000,51733,RH
2017-01-28,,,8554000,,5401000,597228000,696957000,99729000,99729000,,-47471000,,,,3153000,2134871000,2035142000,1437914000,-91175000,,5401000,5401000,51733,RH
2020-12-31,,,1209300000,,949700000,2111900000,3543000000,1431100000,1431100000,,-218900000,,,,259600000,5527100000,4096000000,1984100000,-221800000,,949700000,949700000,51737,ROP
2019-12-31,,,2227400000,,1767900000,1928700000,3427100000,1498400000,1498400000,,-186600000,,,,459500000,5366800000,3868400000,1939700000,729000000,,1767900000,1767900000,51737,ROP
2018-12-31,,,1198400000,,944400000,1883100000,3279500000,1396400000,1396400000,,-182100000,,,,254000000,5191200000,3794800000,1911700000,-198000000,,944400000,944400000,51737,ROP
2017-12-31,,,1034700000,,971800000,1654600000,2864800000,1210200000,1210200000,,-180600000,,,,62900000,4607500000,3397300000,1742700000,-175500000,,971800000,971800000,51737,ROP
2020-12-31,,,-931018000,,-803692000,97611000,322326000,-451959000,-451959000,8458000,-40770000,,,,-127326000,1124249000,1576208000,801923000,-479059000,,-803692000,-803692000,51741,PTEN
2019-12-31,,,-530378000,,-425703000,131313000,709388000,-244651000,-244651000,15070000,-75204000,,,,-104675000,2470685000,2715336000,1761297000,-285727000,,-425703000,-425703000,51741,PTEN
2018-12-31,,,-367408000,,-321421000,134071000,924510000,-71468000,-71468000,11389000,-51578000,,,,-45987000,3326997000,3398465000,2402487000,-295940000,,-321421000,-321421000,51741,PTEN
2017-12-31,,,-327801000,,5910000,105847000,639144000,-222036000,-222036000,992000,-37472000,,,,-333711000,2356684000,2578720000,1717540000,-105765000,,5910000,5740000,51741,PTEN
2019-12-31,12839000,,-33203000,,-33243000,90465000,68407000,-34897000,-34897000,,-2119000,,,,40000,82050000,116947000,13643000,1694000,,-33243000,-33243000,51742,INSP
2018-12-31,7388000,,-21828000,,-21828000,53527000,40537000,-20378000,-20378000,,-3304000,,,,0,50593000,70971000,10056000,-1450000,,-21828000,-21828000,51742,INSP
2017-12-31,6194000,,-17511000,,-17511000,32358000,22549000,-16003000,-16003000,,-1753000,,,,0,28567000,44570000,6018000,-1508000,,-17511000,-17511000,51742,INSP
2016-12-31,7091000,,-18528000,,-18528000,22684000,12522000,-17253000,-17253000,,-1303000,,,,0,16427000,33680000,3905000,-1275000,,-18528000,-18528000,51742,INSP
2020-12-31,27573000000,,48082000000,,40269000000,28998000000,97795000000,41224000000,41224000000,,-135000000,,,,7813000000,182527000000,141303000000,84732000000,6858000000,,40269000000,40269000000,51746,GOOG
2019-12-31,26018000000,,39625000000,,34343000000,27461000000,89961000000,36482000000,36482000000,,-100000000,,,,5282000000,161857000000,125375000000,71896000000,3143000000,,34343000000,34343000000,51746,GOOG
2018-12-31,21419000000,,34913000000,,30736000000,23256000000,77270000000,32595000000,32595000000,,-114000000,,,,4177000000,136819000000,104224000000,59549000000,2318000000,,30736000000,30736000000,51746,GOOG
2017-12-31,16625000000,,27193000000,,12662000000,19733000000,65272000000,28914000000,28914000000,,-109000000,,,,14531000000,110855000000,81941000000,45583000000,-1721000000,,12662000000,12662000000,51746,GOOG
2019-12-31,3281945,,-7678313,,-7678313,6016056,0,-9298001,-9298001,,,,,,0,0,9298001,0,1619688,,-7678313,-7678313,51749,INMB
2018-12-31,3354923,,-12440023,,-12440023,9085100,0,-12440023,-12440023,,,,,,0,0,12440023,0,0,,-12440023,-12440023,51749,INMB
2017-12-31,435362,,-831486,,-831486,546118,0,-981480,-981480,,,,,,0,0,981480,0,149994,,-831486,-831486,51749,INMB
2016-12-31,101495,,-277491,,-277491,125996,0,-227491,-227491,,,,,,0,0,227491,0,-50000,,-277491,-277491,51749,INMB
2019-12-31,,,15322523,,15322523,6235894,57575182,51339288,51339288,,-32426469,,,,0,57575182,6235894,0,-36016765,,15322523,15322523,51750,GIM
2018-12-31,,,19160278,,19160278,6818942,56596693,49777751,49777751,,7135095,,,,0,56596693,6818942,0,-30617473,,19160278,19160278,51750,GIM
2017-12-31,,,26881944,,26881944,6943356,55372118,48428762,48428762,,-3593640,,,,0,55372118,6943356,0,-21546818,,26881944,26881944,51750,GIM
2016-12-31,,,139734501,,139734501,6593301,45238950,38645649,38645649,,51828117,,,,0,45238950,6593301,0,101088852,,139734501,139734501,51750,GIM
2019-12-31,,,-11312500,,-11312500,13063526,1166036,-11897490,-11897490,,-23720,,,,0,5548119,17445609,4382083,584990,,-11312500,-11312500,51751,WORX
2018-12-31,,,-380603,,-380603,658795,507616,-151179,-151179,,-220091,,,,0,3421937,3573116,2914321,-229424,,-380603,-380603,51751,WORX
2017-12-31,,,-429196,,-429196,460216,163118,-297098,-297098,,-132098,,,,0,2514073,2811171,2350955,-132098,,-429196,-429196,51751,WORX
2016-12-31,1120190.0,,-348646,,-348646,551475,1329496,-342169,-342169,,-6477,,,,0,2160900,2503069,831404,-6477,,-348646,-348646,51751,WORX
2020-06-30,,,-35945000,2525000,-32903000,151248000,97724000,-53524000,-53524000,,,,,,-2394000,129483000,183007000,31759000,17579000,,-33551000,-32903000,51753,PUYI
2019-06-30,,,61419000,3173000,53531000,116059000,172139000,56080000,56080000,,-1048000.0,,,,9396000,203231000,147151000,31092000,5339000,,52023000,53531000,51753,PUYI
2018-06-30,,,71878000,8859000,64596000,74093000,136986000,62893000,62893000,,-1048000.0,,,,8261000,165811000,102918000,28825000,8985000,,63617000,64596000,51753,PUYI
2017-06-30,,,47535000,9838000,37813000,55057000,102294000,47237000,47237000,,-2311000.0,,,,7641000,155691000,108454000,53397000,298000,-254000.0,39894000,37813000,51753,PUYI
2019-12-31,12155000,,1165574000,-853000,1166506000,72417000,-15964000,-119584000,-119584000,5328000,-1244000,,,,0,23750000,143334000,39714000,1285158000,,1165574000,1166506000,51755,CRON
2018-12-31,1814000,,-21817000,100000,-21636000,16620000,6213000,-21341000,-21341000,5328000,-139000,,,,489000,12121000,33462000,5908000,-476000,,-21817000,-21636000,51755,CRON
2017-12-31,1814000,,-2345000,100000,-1483000,5347000,1574000,-6121000,-6121000,5328000,-101000,,,,-862000,3147000,9268000,1573000,3776000,,-1483000,-1483000,51755,CRON
2016-12-31,1814000,,-1758000,100000,-1190000,3435000,1993000,-2131000,-2131000,5328000,-232000,,,,-568000,554000,2685000,-1439000,373000,,-1190000,-1190000,51755,CRON
2019-12-31,6619597,,-11466494,,-11799379,4834284,0,-11551796,-11551796,,,,,,332885,0,11551796,0,85302,,-11799379,-11799379,51759,DFFN
2018-12-31,5751940,,-18807099,,-18369810,6167177,0,-12029488,-12029488,,,,,,-437289,0,12029488,0,-6777611,,-18369810,-26623698,51759,DFFN
2017-12-31,5088621,,-2420203,,-1364518,6191845,0,-11348447,-11348447,,-48006.0,,,,-1055685,0,11348447,0,8928244,,-1364518,-2616912,51759,DFFN
2016-12-31,6301241,,-18401415,,-18036619,8594146,0,-14920729,-14920729,,-29686.0,,,,-364796,0,14920729,0,-3480686,,-18036619,-18036619,51759,DFFN
2020-12-31,,,43363000,,31959000,85649000,141448000,0,51967000,3832000,,,,,11404000,141448000,89481000,0,-8604000,,31959000,31895000,51763,CATC
2019-12-31,,,33918000,,25257000,69964000,112093000,0,38930000,3199000,,,,,8661000,112093000,73163000,0,-5012000,,25257000,25047000,51763,CATC
2018-12-31,,,31088000,,23881000,60747000,95075000,0,32064000,2264000,,,,,7207000,95075000,63011000,0,-976000,,23881000,23642000,51763,CATC
2017-12-31,,,28174000,,14816000,55519000,87466000,0,28803000,3144000,,,,,13358000,87466000,58663000,0,-629000,,14816000,14659000,51763,CATC
2020-02-29,,,348494510,,348494510,26782863,146312254,119529391,119529391,,-25175070,,,,0,146312254,26782863,0,228965119,,348494510,348494510,51766,NAC
2019-02-28,,,63805742,,63805742,27269562,150019144,122749582,122749582,,-25325786,,,,0,150019144,27269562,0,-58943840,,63805742,63805742,51766,NAC
2018-02-28,,,92451221,,92451221,30039284,150889558,120850274,120850274,,-14471499,,,,0,150889558,30039284,0,-28399053,,92451221,92451221,51766,NAC
2017-02-28,,,-9046246,,-9046246,26158177,127660143,101501966,101501966,,-7643207,,,,0,127660143,26158177,0,-110548212,,-9046246,-9046246,51766,NAC
2020-09-30,20269000,,-6940000,,-7000000,24005000,35582000,-8692000,-8692000,,-304000,,,,60000,110128000,118820000,74546000,1752000,,-7000000,-7000000,51767,EMKR
2019-09-30,19443000,,-35930000,,-35984000,21280000,21089000,-19634000,-19634000,,-371000,,,,54000,87265000,106899000,66176000,-16296000,,-35984000,-35984000,51767,EMKR
2018-09-30,15387000,,-17902000,,-17453000,21377000,19487000,-17277000,-17277000,,-371000,,,,-449000,85617000,102894000,66130000,-625000,,-17453000,-17453000,51767,EMKR
2017-09-30,12542000,,8384000,,8235000,22246000,42534000,7791000,7791000,-45000.0,-155000,,,,163000,122895000,115104000,80361000,593000,14000.0,8221000,8235000,51767,EMKR
2020-03-31,,,378124000,,442048000,1054000,1176433000,538316000,538316000,,-160950000,,,,-63924000,3978868000,3440552000,2802435000,-160192000,,442048000,442048000,51768,UHAL
2019-03-31,,,477529000,,370857000,1013000,1174986000,619930000,619930000,,-142445000,,,,106672000,3768707000,3148777000,2593721000,-142401000,,370857000,370857000,51768,UHAL
2018-03-31,,,637613000,,790583000,927000,1113079000,568905000,568905000,,-126706000,,,,-152970000,3601114000,3032209000,2488035000,68708000,,790583000,790583000,51768,UHAL
2017-03-31,,,628358000,,398424000,902000,1164000000,714073000,714073000,,-113406000,,,,229934000,3421767000,2707694000,2257767000,-85715000,,398424000,398424000,51768,UHAL
2019-12-31,,,64006700,,64006700,2674470,1413489,-1260981,-1260981,,,,,,0,1413489,2674470,0,65267681,,64006700,64006700,51769,ASG
2018-12-31,,,-5184425,,-5184425,2076458,1291554,-784904,-784904,,,,,,0,1291554,2076458,0,-4399521,,-5184425,-5184425,51769,ASG
2017-12-31,,,34687311,,34687311,1775514,1131492,-644022,-644022,,,,,,0,1131492,1775514,0,35331333,,34687311,34687311,51769,ASG
2016-12-31,,,5825381,,5825381,1619216,1213040,-406176,-406176,,,,,,0,1213040,1619216,0,6231557,,5825381,5825381,51769,ASG
2020-08-31,3979455,,1739875,3045026,-1337709,19344998,16029417,-2682151,-2682151,-4612885,-16034,,,,2674635,47638691,50320842,31609274,4422026,,-934760,-1337709,51771,NTIC
2019-08-31,3822070,,6657459,3074679,5209622,20318151,17779893,-632749,-632749,-5727579,-13567,,,,841837,55750137,56382886,37970244,7290208,,5815622,5209622,51771,NTIC
2018-08-31,3524953,,8098950,2742309,6701366,19386501,17259381,490066,490066,-6142139,-17962,,,,876103,51424821,50934755,34165440,7608884,,7222847,6701366,51771,NTIC
2017-08-31,2912393,,4624098,2857448,3422126,17090873,13252612,-1297967,-1297967,-5452687,-20382,,,,699519,39569123,40867090,26316511,5922065,,3924579,3422126,51771,NTIC
2019-12-31,40166000,,-43173000,,-43850000,13770000,7000000,-46936000,-46936000,,,,,,677000,7000000,53936000,0,3763000,,-43850000,-43850000,51773,ETTX
2018-12-31,33046000,,-32480000,,-32952000,10161000,5000000,-38207000,-38207000,,,,,,472000,5000000,43207000,0,5727000,,-32952000,-42094000,51773,ETTX
2017-12-31,25745000,,-29923000,,-29923000,5599000,0,-31344000,-31344000,,,,,,0,0,31344000,0,1421000,,-29923000,-29923000,51773,ETTX
2016-12-31,15778000,,-19095000,,-19095000,3326000,0,-19104000,-19104000,,,,,,0,0,19104000,0,9000,,-19095000,-19095000,51773,ETTX
2020-05-31,,,407764000,2218000,304385000,1540429000,2113155000,567520000,567520000,5206000,-101003000,,,,102682000,5506994000,4939474000,3393839000,-159756000,,305082000,302429000,51775,RPM
2019-05-31,,,339845000,2653000,266558000,1567590000,2100420000,532926000,532926000,-96000,-102392000,,,,72158000,5564551000,5031625000,3464131000,-193081000,,267687000,265044000,51775,RPM
2018-05-31,,,417048000,2765000,337770000,1498479000,2054248000,555365000,555365000,404000,-104547000,,,,77791000,5321643000,4766278000,3267395000,-138317000,,339257000,333912000,51775,RPM
2017-05-31,,,244333000,2639000,181823000,1643520000,2165688000,519488000,519488000,2680000,-96954000,,,,59662000,4958175000,4438687000,2792487000,-275155000,,184671000,179028000,51775,RPM
2018-12-31,,,,,0,,0,0,,,,,,,0,0,0,0,0,,,,51777,CPTAG
2017-12-31,,,-5695000.0,,-6984000,14008000.0,51089000,37081000,37081000.0,,-17853000.0,,,,1289000,51089000,14008000,0,-42776000,,-6984000.0,-6984000.0,51777,CPTAG
2016-12-31,,,9152000.0,,9152000,19561000.0,68312000,48751000,48751000.0,,-19407000.0,,,,0,68312000,19561000,0,-39599000,,9152000.0,9152000.0,51777,CPTAG
2015-12-31,,,13850000.0,,13850000,19627000.0,63976000,44349000,44349000.0,,-18293000.0,,,,0,63976000,19627000,0,-30499000,,13850000.0,13850000.0,51777,CPTAG
2020-01-31,18623000,,-22073000,,-20293000,62815000,80064000,-15298000,-15298000,,-2445000,,,,-1780000,124784000,140082000,44720000,-6775000,,-20293000,-91423000,51781,PHR
2019-01-31,14349000,,-15062000,,-15062000,46443000,62892000,-9494000,-9494000,,-3504000,,,,0,99889000,109383000,36997000,-5568000,,-15062000,-45261000,51781,PHR
2018-01-31,11377000,,-18192000,,-18192000,43599000,50063000,-14553000,-14553000,,-3642000,,,,0,79834000,94387000,29771000,-3639000,,-18192000,-38173000,51781,PHR
2019-12-31,,,486186000,335175000,380486000,679444000,1594236000,813694000,813694000,,-157798000,,,,78470000,3060321000,2246627000,1466085000,-327508000,,407716000,380486000,51782,AMCX
2018-12-31,,,620273000,328086000,446187000,650157000,1576480000,835042000,835042000,,-154993000,,,,156306000,2971929000,2136887000,1395449000,-214769000,,463967000,446187000,51782,AMCX
2017-12-31,,,640378000,247605000,471316000,613342000,1514015000,815035000,815035000,,-134001000,,,,150741000,2805691000,1990656000,1291676000,-174657000,,489637000,471316000,51782,AMCX
2016-12-31,,,454825000,247769000,270510000,636028000,1501870000,781064000,781064000,,-123632000,,,,164862000,2755654000,1974590000,1253784000,-326239000,,289963000,270510000,51782,AMCX
2019-12-31,,,-28933000,,-28933000,4031000,-25973000,-30004000,-30004000,,-347000,,,,0,0,30004000,25973000,1071000,,-28933000,-28933000,51783,MTCR
2018-12-31,,,-25821000,,-25821000,5242000,-21487000,-26729000,-26729000,,-347000,,,,0,1450000,28179000,22937000,908000,,-25821000,-25821000,51783,MTCR
2017-12-31,,,-12263000,,-12263000,2334000,-10016000,-12350000,-12350000,,-347000,,,,0,1450000,13800000,11466000,87000,,-12263000,-12263000,51783,MTCR
2016-12-31,,,-10404000,,-10404000,2758000,-7654000,-10412000,-10412000,,-347000,,,,0,0,10412000,7654000,8000,,-10404000,-10404000,51783,MTCR
2019-12-31,,,-176946000,,-134830000,44759000,380637000,-112244000,-112244000,117061000,-58100000,,,,-42116000,429118000,541362000,48481000,-64702000,,-134830000,-134830000,51785,HPR
2018-12-31,,,123047000,,121220000,45130000,383761000,183251000,183251000,-73889000,-52703000,,,,1827000,416255000,233004000,32494000,-60204000,,121220000,121220000,51785,HPR
2017-12-31,,,-139627000,,-138225000,42476000,211525000,-66380000,-66380000,25829000,-57710000,,,,-1402000,238363000,304743000,26838000,-80127000,,-138225000,-138225000,51785,HPR
2016-12-31,,,-170378000,,-170378000,42169000,137930000,-118888000,-118888000,38676000,-59373000,,,,0,168181000,287069000,30251000,-51490000,,-170378000,-170378000,51785,HPR
2020-06-30,,,-5420145,1186520,-6628672,9609424,6176952,-3489612,-3489612,57140,-116438,,,,1090396,23684626,27174238,17507674,-1930533,,-6510541,-6628672,51786,TYHT
2019-06-30,,,1669387,1100613,796189,8856181,9044134,115415,115415,72538,-115384,,,,787600,31220040,31104625,22175906,1553972,,881787,796189,51786,TYHT
2018-06-30,,,9652149,1053449,7587916,5515609,14891959,9271683,9271683,104667,-133930,,,,2123587,43897618,34625935,29005659,380466,,7528562,7587916,51786,TYHT
2017-06-30,,,9872282,1087376,8469654,3294257,10816302,7446071,7446071,75974,-148793,,,,1252637,33592337,26146266,22776035,2426211,,8619645,8469654,51786,TYHT
2020-12-31,123047000,,-61957000,,-66783000,202996000,315795000,-10248000,-10248000,,-20257000,,,,4826000,891925000,902173000,576130000,-51709000,,-66783000,-66783000,51789,GPRO
2019-12-31,142309000,,-19070000,,-14642000,271413000,412843000,-879000,-879000,,-19229000,,,,-4428000,1194651000,1195530000,781808000,-18191000,,-14642000,-14642000,51789,GPRO
2018-12-31,154502000,,-107675000,,-109034000,279530000,362813000,-71219000,-71219000,,-18683000,,,,1359000,1148337000,1219556000,785524000,-36456000,,-109034000,-109034000,51789,GPRO
2017-12-31,219173000,,-176387000,,-182873000,309159000,385164000,-143168000,-143168000,,-13660000,,,,6486000,1179741000,1322909000,794577000,-33219000,,-182873000,-182873000,51789,GPRO
2020-12-31,,,3237000000,,2697000000,4509000000,8085000000,3576000000,3576000000,,-339000000,,,,540000000,31981000000,28405000000,23896000000,-339000000,,2697000000,2678000000,51791,TRV
2019-12-31,,,3138000000,,2622000000,4365000000,7847000000,3482000000,3482000000,,-344000000,,,,516000000,31581000000,28099000000,23734000000,-344000000,,2622000000,2603000000,51791,TRV
2018-12-31,,,2961000000,,2523000000,4297000000,7610000000,3313000000,3313000000,,-352000000,,,,438000000,30282000000,26969000000,22672000000,-352000000,,2523000000,2504000000,51791,TRV
2017-12-31,,,2730000000,,2056000000,4170000000,7269000000,3099000000,3099000000,,-369000000,,,,674000000,28902000000,25803000000,21633000000,-369000000,,2056000000,2041000000,51791,TRV
2019-12-31,,,6420000,2146000,-171447000,41433000,145010000,43472000,43472000,45000,-52087000,,,,1900000,847118000,803646000,702108000,-37052000,-179466000,4520000,-171488000,51792,MMLP
2018-12-31,,,-7254000,6627000,54773000,39116000,144616000,44016000,44016000,45000,-52685000,,,,577000,1020104000,976088000,875488000,-51270000,63486000,-7831000,43195000,51792,MMLP
2017-12-31,,,-1025000,7314000,19573000,39080000,152433000,48251000,48251000,-6000,-49019000,,,,158000,973386000,925135000,820953000,-49276000,21099000,-1183000,16750000,51792,MMLP
2016-12-31,,,27729000,7412000,23233000,34320000,196873000,70421000,70421000,-6000,-49291000,,,,726000,827391000,756970000,630518000,-42692000,4649000,27003000,23143000,51792,MMLP
2019-12-31,,,64579000,,39745000,41212000,150761000,84049000,84049000,,-18797000,,,,24834000,647899000,563850000,497138000,-19470000,,39745000,39745000,51793,ARRY
2018-12-31,,,-80696000,,-60764000,46878000,11555000,-62031000,-62031000,,-19043000,,,,-19932000,290783000,352814000,279228000,-18665000,,-60764000,-60764000,51793,ARRY
2019-12-31,,,-943586000,16150000,-948628000,388249000,-570316000,-959891000,-959891000,,-10298000,,,,6992000,428212000,1388103000,998528000,16305000,,-950578000,-948628000,51795,BGNE
2018-12-31,679005000.0,,-689829000,14445000,-673769000,195385000,-509490000,-705769000,-705769000,,-9460000,,,,-15796000,198220000,903989000,707710000,15940000,,-674033000,-673769000,51795,BGNE
2017-12-31,269018000.0,,-91064000,14422000,-93105000,62602000,-35605000,-98457000,-98457000,,-8295000,,,,2235000,238387000,336844000,273992000,7393000,,-93299000,-93105000,51795,BGNE
2016-12-31,269018000.0,,-119163000,14422000,-119217000,20097000,-96963000,-117060000,-117060000,,-851000,,,,54000,1070000,118130000,98033000,-2103000,,-119217000,-119217000,51795,BGNE
2020-03-31,,,1754000000,22000000,1264000000,23000000,14540000000,3164000000,3164000000,11119000000,-980000000,,,,480000000,14540000000,11376000000,0,-1410000000,-9000000,1274000000,1264000000,51799,NGG
2019-03-31,,,1841000000,20000000,1511000000,22000000,14933000000,3558000000,3558000000,11172000000,-927000000,,,,339000000,14933000000,11375000000,0,-1717000000,12000000,1502000000,1511000000,51799,NGG
2018-03-31,,,2660000000,16000000,3550000000,65000000,15250000000,3552000000,3552000000,11597000000,-1000000000,,,,-889000000,15250000000,11698000000,0,-892000000,2000000,3549000000,3550000000,51799,NGG
2017-03-31,,,2184000000,16000000,7795000000,1673000000,11705000000,3740000000,3740000000,4811000000,-894000000,,,,374000000,15035000000,11295000000,3330000000,-1556000000,5984000000,1810000000,7795000000,51799,NGG
2020-11-30,,,8679075,,8679075,1731693,11166104,9434411,9434411,,-1828254,,,,0,11166104,1731693,0,-755336,,8679075,8675259,51800,FMN
2019-11-30,,,19552129,,19552129,1730340,11881763,10151423,10151423,,-2114731,,,,0,11881763,1730340,0,9400706,,19552129,18814732,51800,FMN
2018-11-30,,,156945,,156945,1700881,12201495,10500614,10500614,,-1939245,,,,0,12201495,1700881,0,-10343669,,156945,-503614,51800,FMN
2017-11-30,,,7095948,,7095948,955660,6634568,5678908,5678908,,-663352,,,,0,6634568,955660,0,1417040,,7095948,6894518,51800,FMN
2020-12-31,66836000,,13964000,,9636000,131491000,204943000,6616000,6616000,,,,,,4328000,250027000,243411000,45084000,7348000,,9636000,9636000,51801,RDWR
2019-12-31,60341000,,25709000,,22566000,127840000,206898000,18717000,18717000,,,,,,3143000,252072000,233355000,45174000,6992000,,22566000,22566000,51801,RDWR
2018-12-31,57674000,,14798000,,11735000,126971000,192729000,8084000,8084000,,,,,,3063000,234404000,226320000,41675000,6714000,,11735000,11735000,51801,RDWR
2017-12-31,59003000,,-1841000,,-7493000,124221000,171753000,-11471000,-11471000,,,,,,5652000,211369000,222840000,39616000,9630000,,-7493000,-7493000,51801,RDWR
2020-03-31,1339000,,-2825000,,-2946000,13665000,8333000,-6671000,-6671000,,-16000,,,,121000,18936000,25607000,10603000,3846000,,-2946000,-2946000,51802,SNOA
2019-03-31,1518000,,-11340000,,-11798000,18620000,8880000,-11258000,-11258000,,-33000,,,,458000,18970000,30228000,10090000,-82000,,-11798000,-11798000,51802,SNOA
2018-03-31,1575000,,-14278000,,-14328000,19924000,7310000,-14189000,-14189000,,-40000,,,,50000,16658000,30847000,9348000,-89000,,-14328000,-14328000,51802,SNOA
2017-03-31,1576000,,-12937000,,9274000,17066000,5668000,-12974000,-12974000,,-3000,,,,-4268000,12825000,25799000,7157000,37000,17943000.0,-8669000,9274000,51802,SNOA
2019-12-31,,,88881000,,66922000,94645000,346513000,165632000,165632000,,-66889000,,,,21959000,409160000,243528000,62647000,-76751000,,66922000,63588000,51804,WLFC
2018-12-31,,,56274000,,43231000,83163000,287322000,127345000,127345000,,-64220000,,,,13043000,348347000,221002000,61025000,-71071000,,43231000,39898000,51804,WLFC
2017-12-31,,,36011000,,62158000,65466000,232704000,101215000,101215000,,-48720000,,,,-26147000,273552000,172337000,40848000,-65204000,,62158000,60299000,51804,WLFC
2016-12-31,,,23946000,,14069000,54773000,189381000,68928000,68928000,-600000.0,-41144000,,,,9877000,202674000,133746000,13293000,-44982000,,14069000,13780000,51804,WLFC
2019-12-31,8849000,,-15219000,,-15229000,24687000,22569000,-15338000,-15338000,,-131000,,,,10000,113981000,129319000,91412000,119000,,-15229000,-15229000,51805,AUTO
2018-12-31,13838000,,-38822000,,-38816000,28496000,24274000,-22957000,-22957000,,-131000,,,,-6000,125589000,148546000,101315000,-15865000,,-38816000,-38816000,51805,AUTO
2017-12-31,12567000,,-39525000,,-64964000,26316000,42773000,-891000,-891000,,-366000,,,,25439000,142125000,143016000,99352000,-38634000,,-64964000,-64964000,51805,AUTO
2016-12-31,13986000,,6686000,,3871000,32731000,57913000,6128000,6128000,,-900000,,,,2815000,156684000,150556000,98771000,558000,,3871000,3871000,51805,AUTO
2020-03-31,,,-291132713,,-291132713,33733029,122151901,88418872,88418872,,-15479924,,,,0,122151901,33733029,0,-379551585,,-291132713,-291132713,51806,OXLC
2019-03-31,,,-20981998,,-20981998,25262087,89398979,64136892,64136892,,-15051475,,,,0,89398979,25262087,0,-85118890,,-20981998,-20981998,51806,OXLC
2018-03-31,,,38005588,,38005588,21061618,74815772,53754154,53754154,,-13400159,,,,0,74815772,21061618,0,-15748566,,38005588,38005588,51806,OXLC
2017-03-31,,,105201826,,105201826,16089994,57944128,41854134,41854134,,-11711709,,,,0,57944128,16089994,0,63347692,,105201826,105201826,51806,OXLC
2020-12-31,69503000,,-79009000,,-79582000,225662000,224323000,-70842000,-70842000,,-7882000,,,,573000,287471000,358313000,63148000,-8167000,,-79582000,-79582000,51808,TLND
2019-12-31,63017000,,-61320000,,-61469000,182488000,186981000,-58524000,-58524000,,-2540000,,,,149000,247861000,306385000,60880000,-2796000,,-61469000,-61469000,51808,TLND
2018-12-31,42359000,,-39350000,,-39027000,153451000,156305000,-39505000,-39505000,,-2540000,,,,-323000,205799000,245304000,49494000,155000,,-39027000,-39027000,51808,TLND
2017-12-31,26835000,,-30884000,,-31208000,116338000,114436000,-28737000,-28737000,,-2540000,,,,324000,148595000,177332000,34159000,-2147000,,-31208000,-31208000,51808,TLND
2020-09-30,,,4558000,,3601000,14417000,22860000,0,4801000,3642000,,,,,957000,22860000,18059000,0,-243000,,3601000,3601000,51809,MLVF
2019-09-30,,,11801000,,9332000,13727000,29288000,0,12214000,3347000,,,,,2469000,29288000,17074000,0,-413000,,9332000,9332000,51809,MLVF
2018-09-30,,,11582000,,7306000,14629000,28199000,0,10694000,2876000,,,,,4276000,28199000,17505000,0,888000,,7306000,7306000,51809,MLVF
2017-09-30,,,8739000,,5817000,12503000,23886000,0,8811000,2572000,,,,,2922000,23886000,15075000,0,-72000,,5817000,5817000,51809,MLVF
2020-12-31,,,35137000,,25823000,83875000,133888000,0,35206000,14807000,,,,,9314000,133888000,98682000,0,-69000,,25823000,25823000,51811,CBNK
2019-12-31,,,22714000,,16895000,57395000,89239000,0,22836000,9008000,,,,,5819000,89239000,66403000,0,-122000,,16895000,16895000,51811,CBNK
2018-12-31,,,17749000,,12767000,47251000,71872000,0,17777000,6844000,,,,,4982000,71872000,54095000,0,-28000,,12767000,12767000,51811,CBNK
2017-12-31,,,14099000,,7109000,38790000,61405000,0,16406000,6209000,,,,,6990000,61405000,44999000,0,-2307000,,7109000,7109000,51811,CBNK
2020-09-30,,,30307000,,24269000,26904000,64468000,0,31641000,5923000,,,,,6038000,64468000,32827000,0,-1334000,,24269000,24269000,51818,TSBK
2019-09-30,,,29921000,,24020000,27850000,64466000,0,30597000,6019000,,,,,5901000,64466000,33869000,0,-676000,,24020000,24020000,51818,TSBK
2018-09-30,,,22422000,,16721000,22921000,51701000,0,23808000,4972000,,,,,5701000,51701000,27893000,0,-1386000,,16721000,16721000,51818,TSBK
2017-09-30,,,21243000,,14167000,21880000,48754000,0,21832000,5042000,,,,,7076000,48754000,26922000,0,-589000,,14167000,14167000,51818,TSBK
2019-12-31,51222000,,-338918000,,-341017000,497862000,301250000,-247834000,-247834000,,-109728000,,,,252000,4740583000,4988417000,4439333000,-91084000,,-339170000,-341017000,51820,OPENW
2018-12-31,28458000,,-239552000,1491000.0,-241291000,268642000,133428000,-163672000,-163672000,,-60456000,,,,377000,1838066000,2001738000,1704638000,-75880000,,-239929000,-248515000,51820,OPENW
2017-12-31,16123000,,-84767000,1491000.0,-84829000,111866000,66347000,-61642000,-61642000,,-23342000,,,,0,711066000,772708000,644719000,-23125000,,-84767000,-84829000,51820,OPENW
2019-12-31,38900000,,300700000,,241700000,272800000,605700000,292300000,292300000,1700000,-8500000,,,,59000000,1839900000,1547600000,1234200000,8400000,,241700000,241700000,51823,WST
2018-12-31,40300000,,248300000,,206900000,256200000,545400000,248000000,248000000,900000,-8400000,,,,41400000,1717400000,1469400000,1172000000,300000,,206900000,206900000,51823,WST
2017-12-31,39100000,,231600000,,150700000,242900000,512900000,239200000,239200000,-8300000,-7800000,,,,80900000,1599100000,1359900000,1086200000,-7600000,,150700000,150700000,51823,WST
2016-12-31,36800000,,198000000,,143600000,238000000,501400000,228900000,228900000,-2300000,-8100000,,,,54400000,1509100000,1280200000,1007700000,-30900000,,143600000,143600000,51823,WST
2019-12-31,52843000,,1367000,,28000,23742000,77046000,-1462000,-1462000,,,,,,1339000,87152000,88614000,10106000,2829000,,28000,28000,51825,CEVA
2018-12-31,47755000,,1303000,,574000,22515000,69926000,-1245000,-1245000,,,,,,729000,77877000,79122000,7951000,2548000,,574000,574000,51825,CEVA
2017-12-31,40385000,,18899000,,17028000,23060000,80554000,15873000,15873000,,,,,,1871000,87507000,71634000,6953000,3026000,,17028000,17028000,51825,CEVA
2016-12-31,30838000,,16425000,,13100000,20107000,66567000,14386000,14386000,,,,,,3325000,72653000,58267000,6086000,2039000,,13100000,13100000,51825,CEVA
2019-12-31,,,932656000,452959000,938089000,473086000,1394494000,921408000,921408000,,-52541000,,,,4437000,2573111000,1651703000,1178617000,11248000,,928219000,902175000,51826,ESGR
2018-12-31,,,-218396000,470599000,-150221000,407375000,191316000,-216059000,-216059000,,-26217000,,,,-6124000,839134000,1055193000,647818000,-2337000,,-212272000,-162354000,51826,ESGR
2017-12-31,,,314411000,488870000,311458000,435985000,806480000,370495000,370495000,,-28102000,,,,-6395000,1100952000,730457000,294472000,-56084000,10993000.0,320806000,311458000,51826,ESGR
2016-12-31,,,327324000,463042000,264807000,423734000,777765000,354031000,354031000,,-20642000,,,,34874000,1136395000,782364000,358630000,-26707000,11963000.0,292450000,264807000,51826,ESGR
2019-12-31,,,-2635000000,1638000000,-5390000000,21712000000,22439000000,0,729000000,-2000000,,,,,2630000000,22439000000,21710000000,0,-3364000000,,-5265000000,-5720000000,51828,DB
2018-12-31,,,1331000000,1568000000,267000000,22758000000,24832000000,0,2073000000,1000000,,,,,989000000,24832000000,22759000000,0,-742000000,,342000000,-25000000,51828,DB
2017-12-31,,,1227000000,250000000,-751000000,23890000000,25921000000,0,2031000000,1000000,,,,,1963000000,25921000000,23890000000,0,-804000000,,-736000000,-1049000000,51828,DB
2016-12-31,,,-811000000,316000000,-1402000000,24734000000,28629000000,0,3523000000,372000000,,,,,546000000,28629000000,25106000000,0,-4334000000,,-1357000000,-1678000000,51828,DB
2020-07-31,553978000,,-855221000,,-872883000,1295936000,1021530000,-828384000,-828384000,,-31312000,,,,17662000,1307682000,2136066000,286152000,-26837000,,-872883000,-872883000,51831,NTNX
2019-07-31,500719000,,-613060000,,-621179000,1029337000,932178000,-597878000,-597878000,,-29313000,,,,8119000,1236143000,1834021000,303965000,-15182000,,-621179000,-621179000,51831,NTNX
2018-07-31,313777000,,-289714000,,-297161000,734958000,769427000,-279308000,-279308000,,-14685000,,,,7447000,1155457000,1434765000,386030000,-10406000,,-297161000,-297161000,51831,NTNX
2017-07-31,288619000,,-374786000,,-379638000,576438000,518572000,-346485000,-346485000,,-14685000,,,,4852000,845903000,1192388000,327331000,-28301000,,-379638000,-379638000,51831,NTNX
2019-12-31,,,-1156000000,-407600000,11521400000,2099900000,8302800000,940300000,940300000,1606500000,-1385900000,,,,253000000,11541500000,10601200000,3238700000,-2096300000,13047200000,-1409000000,11521400000,51832,LBTYA
2018-12-31,,,161800000,-533100000,725300000,2031000000,8711800000,1105400000,1105400000,1712800000,-1478700000,,,,1573300000,11957900000,10852500000,3246100000,-943600000,2261500000,-1411500000,725300000,51832,LBTYA
2017-12-31,,,-2111100000,-412000000,-2778100000,1980400000,8302800000,840800000,840800000,1686300000,-1416100000,,,,238900000,11276400000,10435600000,2973600000,-2951900000,-370600000,-2350000000,-2778100000,51832,LBTYA
2016-12-31,,,243300000,970700000,1705300000,2479900000,10231700000,1709300000,1709300000,1921400000,-1866100000,,,,-1407000000,13731100000,12021800000,3499400000,-1466000000,117000000,1650300000,1705300000,51832,LBTYA
2020-12-31,68803000,,-19328000,36931000,-6283000,1136686000,1294644000,-6368000,-6368000,,-14178000,,,,-15168000,1467925000,1474293000,173281000,-12960000,,-4160000,-6283000,51836,ANGI
2019-12-31,62436000,,33646000,35927000,34829000,1046741000,1279919000,75345000,75345000,,-11509000,,,,-1668000,1326205000,1250860000,46286000,-41699000,,35314000,34829000,51836,ANGI
2018-12-31,61143000,,70024000,27209000,77318000,799031000,1076502000,129806000,129806000,,-11741000,,,,-7483000,1132241000,1002435000,55739000,-59782000,,77507000,77318000,51836,ANGI
2017-12-31,47907000,,-153633000,31048000,-103118000,764473000,702313000,-147871000,-147871000,,-7736000,,,,-49106000,736386000,884257000,34073000,-5762000,,-104527000,-103118000,51836,ANGI
2020-12-31,,,-499790000,,-549177000,2171934000,2172471000,537000,537000,,-47259000,,,,49387000,4474667000,4474130000,2302196000,-500327000,,-549177000,-549177000,51837,UAA
2019-12-31,,,162163000,,92139000,2222163000,2470533000,242270000,242270000,,-21240000,,,,70024000,5267132000,5024862000,2796599000,-80107000,,92139000,92139000,51837,UAA
2018-12-31,,,-66854000,,-46302000,2176239000,2361271000,178932000,178932000,,-33568000,,,,-20552000,5193185000,5014253000,2831914000,-245786000,,-46302000,-46302000,51837,UAA
2017-12-31,,,-10309000,,-48260000,2091322000,2256491000,156969000,156969000,,-34538000,,,,37951000,4989244000,4832275000,2732753000,-167278000,,-48260000,-48260000,51837,UAA
2019-12-31,24283000,,-42994000,,-42994000,108480000,87369000,-45394000,-45394000,,,,,,0,109142000,154536000,21773000,2400000,,-42994000,-42994000,51838,XENT
2018-12-31,19262000,,-22922000,,-22922000,91603000,85859000,-25006000,-25006000,,,,,,0,108472000,133478000,22613000,2084000,,-22922000,-22922000,51838,XENT
2017-12-31,18360000,,-16363000,,-16363000,80045000,80802000,-17603000,-17603000,,,,,,0,96301000,113904000,15499000,1240000,,-16363000,-16363000,51838,XENT
2016-12-31,18890000,,-25222000,,-25222000,72926000,65705000,-26111000,-26111000,,,,,,0,78708000,104819000,13003000,889000,,-25222000,-25222000,51838,XENT
2020-06-30,339073000,,-63928000,,-67029000,396598000,907250000,171579000,171579000,,-89409000,,,,3101000,2380071000,2208492000,1472821000,-235507000,,-67029000,-67029000,51839,IIVI
2019-06-30,139163000,,128813000,,107517000,217918000,521349000,164268000,164268000,,-22417000,,,,21296000,1362496000,1198228000,841147000,-35455000,,107517000,107517000,51839,IIVI
2018-06-30,116875000,,122194000,,88002000,208565000,462203000,136763000,136763000,,-18352000,,,,34192000,1158794000,1022031000,696591000,-14569000,,88002000,88002000,51839,IIVI
2017-06-30,96806000,,118788000,,95274000,173500000,388362000,118056000,118056000,,-6809000,,,,23514000,972046000,853990000,583684000,732000,,95274000,95274000,51839,IIVI
2019-12-31,,,-6943191,,14890704,11339067,8346137,-5065226,-5065226,,-617310,,,,-1528808,21364810,26430036,13018673,-1877965,20305087,-5414383,14890704,51840,CTEK
2018-12-31,,,-5267932,,1893592,11022650,10189284,-2791854,-2791854,,-1437862,,,,-1305534,21311717,24103571,11122433,-2476078,5855990,-3962398,1893592,51840,CTEK
2017-12-31,,,1923125,,-442351,13410244,20899588,5025179,5025179,,-1526653,,,,2365476,71638947,66613768,50739359,-3102054,5855990,-442351,-442351,51840,CTEK
2016-12-31,,,-64638,,5009801,8897818,12312087,2660948,2660948,,-91885,,,,-5074439,60200383,57539435,47888296,-2725586,5855990,5009801,5009801,51840,CTEK
2019-12-31,24090000,,718453000,,668629000,7143000,0,-31233000,-31233000,,,,,,49824000,0,31233000,0,749686000,,668629000,668629000,51843,XBIT
2018-12-31,15725000,,-21138000,,-21138000,5269000,0,-20994000,-20994000,,,,,,0,0,20994000,0,-144000,,-21138000,-21138000,51843,XBIT
2017-12-31,26424000,,-33150000,,-33150000,7635000,0,-34059000,-34059000,,,,,,0,0,34059000,0,909000,,-33150000,-33150000,51843,XBIT
2016-12-31,41725000,,-52761000,,-52761000,11038000,0,-52763000,-52763000,,,,,,0,0,52763000,0,2000,,-52761000,-52761000,51843,XBIT
2019-12-31,,,-6920540,,-6920540,4421420,677347,-3765359,-3765359,,-178995,,,,0,2984835,6750194,2307488,-3155181,,-6920540,-6920540,51844,SGBX
2018-12-31,,,-4844021,,-4844021,5314267,542733,-4846163,-4846163,,-178995,,,,0,8190712,13036875,7647979,2142,,-4844021,-4844021,51844,SGBX
2017-12-31,,,-4512680,,-4512680,3837774,633807,-3261159,-3261159,,-330388,,,,0,5061585,8322744,4427778,-1251521,,-4512680,-4512680,51844,SGBX
2016-12-31,,,-1971313,,-1971313,2082190,313929,-1824822,-1824822,,-696734,,,,0,1924389,3749211,1610460,-146491,,-1971313,-1971313,51844,SGBX
2020-12-31,,,142291000,,111515000,233185000,425930000,0,154067000,38678000,,,,,30776000,425930000,271863000,0,-11776000,,111515000,111515000,51845,HOPE
2019-12-31,,,226350000,,171040000,249946000,508978000,0,238590000,20442000,,,,,55310000,508978000,270388000,0,-12240000,,171040000,171040000,51845,HOPE
2018-12-31,,,255481000,,189589000,238728000,533207000,0,275973000,18506000,,,,,65892000,533207000,257234000,0,-20492000,,189589000,189589000,51845,HOPE
2017-12-31,,,263834000,,139445000,225313000,530435000,0,287750000,17372000,,,,,124389000,530435000,242685000,0,-23916000,,139445000,139445000,51845,HOPE
2020-06-30,51252000,,-17909000,138199000,-6596000,64816000,102731000,-13337000,-13337000,,-3972000,,,,348000,464909000,478246000,362178000,-4572000,,-18257000,-6596000,51846,AOSL
2019-06-30,46431000,,-13382000,152265000,1861000,75967000,115378000,-7020000,-7020000,,-6362000,,,,1256000,450920000,457940000,335542000,-6067000,,-14638000,1861000,51846,AOSL
2018-06-30,37344000,,5656000,147568000,14263000,66164000,111928000,8420000,8420000,,-2764000,,,,708000,421553000,413133000,309625000,-2764000,,4948000,14263000,51846,AOSL
2017-06-30,29835000,,12912000,27779000,13829000,48842000,91821000,13144000,13144000,,-91000,,,,3652000,383337000,370193000,291516000,-232000,,9260000,13829000,51846,AOSL
2020-12-31,,,839000000,1220000000,1377000000,,11471000000,5429000000,5429000000,1337000000,-2162000000,,,,-236000000,23868000000,18439000000,12397000000,-4590000000,7000000,1075000000,1270000000,51849,DUK
2019-12-31,,,4097000000,1129000000,3748000000,,11560000000,5705000000,5705000000,1307000000,-2204000000,,,,519000000,24658000000,18953000000,13098000000,-1608000000,-7000000,3578000000,3687000000,51849,DUK
2018-12-31,,,3073000000,17000000,2666000000,,10717000000,5362000000,5362000000,1281000000,-2094000000,,,,448000000,24116000000,18754000000,13399000000,-2289000000,19000000,2625000000,2661000000,51849,DUK
2017-12-31,,,4266000000,-2000000,3059000000,241000000.0,10703000000,5938000000,5938000000,1238000000,-1986000000,,,,1196000000,23189000000,17251000000,12486000000,-1672000000,-6000000,3070000000,3053000000,51849,DUK
2019-12-31,,,40996000,,28636000,80544000,130111000,49567000,49567000,,-8523000,,,,12360000,511305000,461738000,381194000,-8571000,,28636000,28636000,51854,HRTG
2018-12-31,,,38994000,,27155000,88544000,158080000,69536000,69536000,,-20015000,,,,11839000,480171000,410635000,322091000,-30542000,,27155000,27155000,51854,HRTG
2017-12-31,,,-5892000,,-1119000,71714000,121249000,49535000,49535000,,-13210000,,,,-4773000,406623000,357088000,285374000,-55427000,,-1119000,-1119000,51854,HRTG
2016-12-31,,,56403000,,33865000,58910000,115675000,56765000,56765000,,-362000,,,,22538000,438958000,382193000,323283000,-362000,,33865000,33865000,51854,HRTG
2019-12-31,18777000,,-4946000,1026000,-466000,125040000,165727000,21910000,21910000,,-26485000,,,,74000,190674000,168764000,24947000,-26856000,,-5020000,-466000,51856,UPST
2018-12-31,8415000,,-11218000,12001000,-12319000,83453000,110380000,18512000,18512000,,-26483000,,,,0,125796000,107284000,15416000,-29730000,,-11218000,-12319000,51856,UPST
2017-12-31,5324000,,-8855000,12001000,-7717000,49269000,56477000,1884000,1884000,,-9420000,,,,6000,66709000,64825000,10232000,-10739000,,-8861000,-7717000,51856,UPST
2020-06-30,,,-20818000,,-23233000,284926000,449902000,-10192000,-10192000,33656000,-21233000,,,,2415000,509041000,519233000,59139000,-10626000,,-23233000,-23233000,51857,MANU
2019-06-30,,,27476000,,18881000,334353000,561803000,44833000,44833000,41737000,-20160000,,,,8595000,627122000,582289000,65319000,-17357000,,18881000,18881000,51857,MANU
2018-06-30,,,25833000,,-37629000,295701000,515123000,28582000,28582000,41705000,-19652000,,,,63462000,589758000,561176000,74635000,-2749000,,-37629000,-37629000,51857,MANU
2017-06-30,,,56588000,,39209000,263041000,502452000,67875000,67875000,36874000,-20894000,,,,17379000,581254000,513379000,78802000,-11287000,,39209000,39209000,51857,MANU
2020-02-01,,,62331000,12368000,39358000,2015858000,2150918000,136112000,136112000,-1052000,-19908000,,,,17371000,3623073000,3486961000,1472155000,-73781000,,44960000,39358000,51861,ANF
2019-02-02,,,116367000,9721000,74541000,2018484000,2159916000,142080000,142080000,-648000,-22788000,,,,37559000,3590109000,3448029000,1430193000,-25713000,,78808000,74541000,51861,ANF
2018-02-03,,,55161000,10092000,7094000,2011946000,2083842000,81877000,81877000,-9981000,-22973000,,,,44636000,3492690000,3410813000,1408848000,-26716000,,10525000,7094000,51861,ANF
2017-01-28,,,-3478000,8604000,3956000,2037662000,2028568000,4436000,4436000,-13530000,-23078000,,,,-11196000,3326740000,3322304000,1298172000,-7914000,,7718000,3956000,51861,ANF
2019-12-31,,,-101302000,7265000,-88949000,35453000,-9938000,-45391000,-45391000,,-20206000,,,,-20000,1424881000,1470272000,1434819000,-55911000,,-101282000,-90214000,51864,ALTO
2018-12-31,,,-68498000,19598000,-60273000,36373000,-15164000,-51537000,-51537000,,-17132000,,,,-562000,1515371000,1566908000,1530535000,-16961000,,-67936000,-61538000,51864,ALTO
2017-12-31,,,-38395000,27261000,-34964000,35116000,5931000,-29185000,-29185000,,-12938000,,,,-321000,1632255000,1661440000,1626324000,-9210000,,-38074000,-36229000,51864,ALTO
2016-12-31,,,545000,30371000,1419000,31949000,54358000,22409000,22409000,,-22406000,,,,-981000,1624758000,1602349000,1570400000,-21864000,,1526000,148000,51864,ALTO
2020-12-31,,,36283000,,29608000,37096000,76886000,0,36871000,2919000,,,,,6675000,76886000,40015000,0,-588000,,29608000,27328000,51867,CFBK
2019-12-31,,,12041000,,9601000,19557000,33420000,0,12561000,1302000,,,,,2440000,33420000,20859000,0,-520000,,9601000,9390000,51867,CFBK
2018-12-31,,,5330000,,4273000,13780000,20605000,0,5821000,1004000,,,,,1057000,20605000,14784000,0,-491000,,4273000,4335000,51867,CFBK
2017-12-31,,,3461000,,1346000,9787000,14416000,0,3761000,868000,,,,,2115000,14416000,10655000,0,-300000,,1346000,680000,51867,CFBK
2019-12-31,,,-19294285,,-19297664,18682396,-277709,-18960105,-18960105,,-957535,,,,3379,19203888,38163993,19481597,-334180,,-19297664,-19297664,51868,HTGM
2018-12-31,,,-16450392,,-16453918,19974616,3815385,-16159231,-16159231,,-901820,,,,3526,21503894,37663125,17688509,-291161,,-16453918,-16453918,51868,HTGM
2017-12-31,,,-18957096,,-18960017,17513742,-208866,-17722608,-17722608,,-1307674,,,,2921,14759567,32482175,14968433,-1234480,,-18960017,-18960017,51868,HTGM
2016-12-31,7900311.0,,-26029432,,-26039550,17427777,996846,-24331242,-24331242,,-1867466,,,,10118,5132730,29463972,4135884,-1698190,,-26039550,-26039550,51868,HTGM
2019-12-31,7027212,,-16393084,,-16393084,9515998,0,-16543210,-16543210,,,,,,0,0,16543210,0,150126,,-16393084,-16393084,51869,RLMD
2019-06-30,7024747,,-17318060,,-17318060,4597583,0,-11622330,-11622330,,-761038.0,,,,0,0,11622330,0,-5695730,,-17318060,-17318060,51869,RLMD
2018-06-30,2942625,,-8960852,,-8960852,3974850,0,-6917475,-6917475,,-1336826.0,,,,0,0,6917475,0,-2043377,,-8960852,-8960852,51869,RLMD
2017-06-30,1293498,,-6286521,,-6286521,5714317,0,-7007815,-7007815,,-550.0,,,,0,0,7007815,0,721294,,-6286521,-6286521,51869,RLMD
2019-12-31,56000000,,-122300000,,-102300000,855700000,1011200000,99500000,99500000,,-329900000,,,,-20000000,2438100000,2338600000,1426900000,-221800000,,-102300000,-102300000,51870,RXT
2018-12-31,75000000,,-500500000,,-470600000,874300000,1028000000,78700000,78700000,,-281100000,,,,-29900000,2452800000,2374100000,1424800000,-579200000,,-470600000,-470600000,51870,RXT
2017-12-31,93000000,,-360700000,,-59900000,849200000,790600000,-151600000,-151600000,,-223400000,,,,-300800000,2144700000,2296300000,1354100000,-209100000,,-59900000,-59900000,51870,RXT
2019-12-31,,,-69193000,,-69193000,15751000,0,-68765000,-68765000,,-134000,,,,0,0,68765000,0,-428000,,-69193000,-69193000,51871,NAK
2018-12-31,,,-15957000,,-15957000,15805000,0,-66214000,-66214000,,-134000,,,,0,0,66214000,0,50257000,,-15957000,-15957000,51871,NAK
2017-12-31,,,-64865000,,-64865000,35742000,0,-64194000,-64194000,,-134000,,,,0,0,64194000,0,-671000,,-64865000,-64865000,51871,NAK
2016-12-31,,,-26982000,,-26982000,16171000,0,-27116000,-27116000,,-134000,,,,0,0,27116000,0,134000,,-26982000,-26982000,51871,NAK
2020-12-31,,,49850000,,39264000,50546000,116443000,0,53360000,12537000,,,,,10586000,116443000,63083000,0,-3510000,,39264000,39264000,51872,FSBW
2019-12-31,,,28130000,,22717000,46532000,90489000,0,30997000,12960000,,,,,5413000,90489000,59492000,0,-2867000,,22717000,22644000,51872,FSBW
2018-12-31,,,28570000,,24347000,37069000,70065000,0,23486000,9510000,,,,,4223000,70065000,46579000,0,5084000,,24347000,24347000,51872,FSBW
2017-12-31,,,20579000,,14085000,34201000,63510000,0,20452000,8857000,,,,,6494000,63510000,43058000,0,127000,,14085000,14085000,51872,FSBW
2020-06-30,201946000,,733088000,,621674000,676689000,1767389000,809059000,809059000,,-40377000,,,,111414000,2957013000,2147954000,1189624000,-75971000,,621674000,621674000,51873,RMD
2019-06-30,180651000,,518847000,,404592000,645010000,1536585000,635986000,635986000,,-36156000,,,,114255000,2606572000,1970586000,1069987000,-117139000,,404592000,404592000,51873,RMD
2018-06-30,155149000,,521312000,,315588000,600369000,1362164000,560263000,560263000,,-28355000,,,,205724000,2340196000,1779933000,978032000,-38951000,,315588000,315588000,51873,RMD
2017-06-30,144467000,,418743000,,342284000,553968000,1201745000,456732000,456732000,,-28236000,,,,76459000,2066737000,1610005000,864992000,-37989000,,342284000,342284000,51873,RMD
2019-12-31,42994000,,-56047000,,-56047000,16062000,1517000,-57539000,-57539000,,,,,,0,1517000,59056000,0,1492000,,-56047000,-56047000,51876,SNDX
2018-12-31,60106000,,-73961000,,-73961000,17287000,1517000,-75876000,-75876000,,,,,,0,1517000,77393000,0,1915000,,-73961000,-73961000,51876,SNDX
2017-12-31,48201000,,-60802000,,-60802000,15861000,2108000,-61954000,-61954000,,,,,,0,2108000,64062000,0,1152000,,-60802000,-60802000,51876,SNDX
2016-12-31,31665000,,-44472000,,-44472000,13321000,1220000,-43766000,-43766000,,,,,,0,1220000,44986000,0,-706000,,-44472000,-47070000,51876,SNDX
2020-05-31,,,2887000000,,2539000000,13126000000,16241000000,3115000000,3115000000,,-151000000,,,,348000000,37403000000,34288000000,21162000000,-228000000,,2539000000,2539000000,51877,NKE
2019-05-31,,,4801000000,,4029000000,12702000000,17474000000,4772000000,4772000000,,-131000000,,,,772000000,39117000000,34345000000,21643000000,29000000,,4029000000,4029000000,51877,NKE
2018-05-31,,,4325000000,,1933000000,11511000000,15956000000,4445000000,4445000000,,-124000000,,,,2392000000,36397000000,31952000000,20441000000,-120000000,,1933000000,1933000000,51877,NKE
2017-05-31,,,4886000000,,4240000000,10563000000,15312000000,4749000000,4749000000,,-86000000,,,,646000000,34350000000,29601000000,19038000000,137000000,,4240000000,4240000000,51877,NKE
2019-12-31,132873000,,-210873000,,-210935000,82166000,1777000,-213262000,-213262000,,-36000,,,,62000,3781000,217043000,2004000,2389000,,-210935000,-210935000,51879,SPCE
2018-12-31,117932000,,-137992000,,-138139000,50902000,1648000,-167186000,-167186000,,-10000,,,,147000,2849000,170035000,1201000,29194000,,-138139000,-138139000,51879,SPCE
2017-12-31,93085000,,-138032000,,-138187000,46886000,1266000,-138705000,-138705000,,-21000,,,,155000,1754000,140459000,488000,673000,,-138187000,-138187000,51879,SPCE
2019-12-31,,,-8129000,2080000,-8039000,6658000,44035000,16058000,16058000,,-18985000,,,,15000,63162000,47104000,19127000,-24187000,,-8144000,-22668000,51880,WHLRD
2018-12-31,,,-17769000,2194000,-16500000,8303000,46802000,12535000,12535000,250000.0,-20228000,,,,40000,65275000,52740000,18473000,-30304000,903000.0,-17809000,-29327000,51880,WHLRD
2017-12-31,,,-14159000,7088000,-12094000,6251000,40325000,9583000,9583000,250000.0,-17165000,,,,137000,58535000,48952000,18210000,-23742000,1518000.0,-14296000,-22063000,51880,WHLRD
2016-12-31,,,-12955000,10359000,-11203000,11491000,31837000,-291000,-291000,250000.0,-13356000,,,,107000,44160000,44451000,12323000,-12664000,824000.0,-13062000,-15916000,51880,WHLRD
2020-08-31,,,11220930,,11220930,3956865,25613118,21656253,21656253,,-3522611,,,,0,25613118,3956865,0,-10435323,,11220930,11220930,51882,BYM
2019-08-31,,,43578560,,43578560,3842972,26069256,22226284,22226284,,-6062720,,,,0,26069256,3842972,0,21352276,,43578560,43578560,51882,BYM
2018-08-31,,,1419667,,1419667,3825305,26534231,22708926,22708926,,-4969570,,,,0,26534231,3825305,0,-21289259,,1419667,1419667,51882,BYM
2017-08-31,,,-3317980,,-3317980,3884735,27575124,23690389,23690389,,-3837952,,,,0,27575124,3884735,0,-27008369,,-3317980,-3317980,51882,BYM
2019-12-31,,,12075000,,12075000,919052,12994052,12075000,12075000,,,,,,0,12994052,919052,0,0,,12075000,12075000,51887,MVO
2018-12-31,,,16330000,,16330000,821136,17151136,16330000,16330000,,,,,,0,17151136,821136,0,0,,16330000,16330000,51887,MVO
2017-12-31,,,8280000,,8280000,838031,9118031,8280000,8280000,,,,,,0,9118031,838031,0,0,,8280000,8280000,51887,MVO
2016-12-31,,,4600000,,4600000,898736,5498736,4600000,4600000,,,,,,0,5498736,898736,0,0,,4600000,4600000,51887,MVO
2019-12-28,,,145900000,11700000,128500000,669400000,923800000,170900000,170900000,83500000,-30000000,,,,17000000,2273700000,2102800000,1349900000,-25000000,,128900000,125900000,51888,WWW
2018-12-29,,,227400000,5600000,200100000,659600000,921300000,246400000,246400000,15300000,-24500000,,,,27100000,2239200000,1992800000,1317900000,-19000000,,200300000,192600000,51888,WWW
2017-12-30,,,-10600000,5600000,300000,713700000,923400000,174400000,174400000,35300000,-32100000,,,,-9900000,2350000000,2175600000,1426600000,-185000000,,-700000,300000,51888,WWW
2016-12-31,,,110500000,7600000,87700000,758000000,968200000,210200000,210200000,35300000,-34800000,,,,23000000,2494600000,2284400000,1526400000,-99700000,,87500000,85600000,51888,WWW
2019-12-31,,,152364000,43117000,136309000,609397000,593102000,-16295000,-16295000,,-23905000,,,,14036000,869050000,885345000,275948000,168659000,,138328000,136309000,51889,AIH
2018-12-31,,,-233972000,29054000,-255237000,449011000,502739000,53728000,53728000,,-9244000,,,,18508000,761306000,707578000,258567000,-287700000,,-252480000,-255237000,51889,AIH
2017-12-31,,,-53169000,24625000,-76675000,393198000,462874000,69676000,69676000,,-6581000,,,,19260000,697396000,627720000,234522000,-122845000,,-72429000,-76675000,51889,AIH
2016-12-31,,,64240000,19094000,50350000,313790000,367518000,53728000,53728000,,-2920000,,,,13713000,584857000,531129000,217339000,10512000,,50527000,50350000,51889,AIH
2019-12-31,,,-21533000,,-21533000,21301000,948000,-20707000,-20707000,,-734000,,,,0,3771000,24478000,2823000,-826000,,-21533000,-21533000,51890,MDVL
2018-12-31,,,-17005000,,-17005000,17564000,2588000,-16338000,-16338000,,-667000,,,,0,4665000,21003000,2077000,-667000,,-17005000,-17005000,51890,MDVL
2019-12-31,,,215154000,-1000,172363000,215090000,706461000,320915000,320915000,,-116896000,,,,42789000,1474925000,1154010000,768464000,-105761000,,172365000,172363000,51893,FUN
2018-12-31,,,161396000,-1000,126652000,193333000,649447000,300585000,300585000,,-93129000,,,,34743000,1348530000,1047945000,699083000,-139189000,,126653000,126652000,51893,FUN
2017-12-31,,,216588000,-1000,215474000,193770000,653054000,306062000,306062000,,-85558000,,,,1112000,1321967000,1015905000,668913000,-89474000,,215476000,215474000,51893,FUN
2016-12-31,,,249106000,-1000,177686000,181830000,643232000,329526000,329526000,,-82666000,,,,71418000,1288721000,959195000,645489000,-80420000,,177688000,177686000,51893,FUN
2020-11-30,,,-76381980,,-76381980,1695746,2882121,1186375,1186375,,-1646362,,,,0,2882121,1695746,0,-77568355,,-76381980,-76381980,51896,TTP
2019-11-30,,,-19442398,,-19442398,2963193,4278169,1314976,1314976,,-2529883,,,,0,4278169,2963193,0,-20757374,,-19442398,-19442398,51896,TTP
2018-11-30,,,-8988727,,-8988727,3449655,4582508,1132853,1132853,,-2620222,,,,0,4582508,3449655,0,-10121580,,-8988727,-8988727,51896,TTP
2017-11-30,,,-29695158,,-29695158,3703935,5573740,1869805,1869805,,-2309982,,,,0,5573740,3703935,0,-31564963,,-29695158,-29695158,51896,TTP
2020-12-31,,,568694000,,447286000,755425000,1312260000,445887000,445887000,,-609000,,,,121408000,1684058000,1238171000,371798000,122807000,,447286000,447286000,51897,SEIC
2019-12-31,,,631441000,,501426000,722636000,1287929000,459856000,459856000,,-630000,,,,130015000,1649885000,1190029000,361956000,171585000,,501426000,501426000,51897,SEIC
2018-12-31,,,614206000,,505868000,712120000,1255600000,441988000,441988000,,-645000,,,,108338000,1624167000,1182179000,368567000,172218000,,505868000,505868000,51897,SEIC
2017-12-31,,,557039000,,404389000,645094000,1153990000,396944000,396944000,,-781000,,,,152650000,1526552000,1129608000,372562000,160095000,,404389000,404389000,51897,SEIC
2017-12-31,,,-8785000,,-7965000,,178583000,178583000,178583000,,-176897000,,,,-820000,496454000,317871000,317871000,-187368000,,-7965000,-7965000,51898,NSS
2016-12-31,,,-2309000,,-3916000,,209551000,209551000,209551000,,-139827000,,,,1607000,511650000,302099000,302099000,-211860000,,-3916000,-3916000,51898,NSS
2015-12-31,,,110326000,,110718000,,254251000,254251000,254251000,,-137847000,,,,-392000,547959000,293708000,293708000,-143925000,,110718000,110718000,51898,NSS
2014-12-31,,,70380000,,70206000,,223219000,223219000,223219000,,-132274000,,,,5000,510833000,287614000,287614000,-152839000,-169000.0,70375000,70206000,51898,NSS
2020-07-31,,,-24426277,,-24426277,3379877,21681612,18301735,18301735,,-3692188,,,,0,21681612,3379877,0,-42728012,,-24426277,-24426277,51902,NSL
2019-07-31,,,4589356,,4589356,3646818,25795967,22149149,22149149,,-4233709,,,,0,25795967,3646818,0,-17559793,,4589356,4589356,51902,NSL
2018-07-31,,,15222813,,15222813,3826652,24201236,20374584,20374584,,-4678702,,,,0,24201236,3826652,0,-5151771,,15222813,15222813,51902,NSL
2017-07-31,,,25951792,,25951792,3870166,24966314,21096148,21096148,,-3642205,,,,0,24966314,3870166,0,4855644,,25951792,25951792,51902,NSL
2020-12-31,,,-192000000,11709000000,-304000000,235000000,2664000000,1062000000,1062000000,,-976000000,,,,-147000000,3938000000,2876000000,1274000000,-1254000000,,-45000000,-304000000,51903,BEP
2019-12-31,,,123000000,11683000000,-59000000,155000000,2787000000,1375000000,1375000000,-14000000.0,-1001000000,,,,43000000,4030000000,2655000000,1243000000,-1252000000,,80000000,-59000000,51903,BEP
2018-12-31,,,240000000,10857000000,118000000,118000000,2601000000,1332000000,1332000000,-14000000.0,-973000000,,,,-343000000,3850000000,2518000000,1249000000,-1092000000,,583000000,118000000,51903,BEP
2018-01-01,,,73000000,8194000000,-28000000,110000000,1769000000,812000000,812000000,-14000000.0,-685000000,,,,69000000,2778000000,1966000000,1009000000,-739000000,,4000000,-28000000,51903,BEP
2020-03-31,12839200,,-20771400,,-20774000,7962300,0,-20801500,-20801500,,-14900,,,,2600,0,20801500,0,30100,,-20774000,-22037600,51904,VTGN
2019-03-31,17098500,,-24587000,,-24589600,7457800,0,-24556300,-24556300,,-8000,,,,2600,0,24556300,0,-30700,,-24589600,-25729500,51904,VTGN
2018-03-31,7350500,,-14343500,,-14345900,6849100,0,-14199600,-14199600,,-8900,,,,2400,0,14199600,0,-143900,,-14345900,-15575500,51904,VTGN
2017-03-31,4893700,,-10253100,,-10255500,6604800,1250000,-10248500,-10248500,,-4600,,,,2400,1250000,11498500,0,-4600,,-10255500,-11623600,51904,VTGN
2020-09-30,124738979,,-84550826,,-84553226,56411890,87992066,-93158803,-93158803,,,,,,2400,87992066,181150869,0,8607977,,-84553226,-84553226,51905,ARWR
2019-09-30,78399686,,68148402,-555188.0,67974849,29205257,168795577,61190634,61190634,,,,,,173553,168795577,107604943,0,6957768,,67974849,67974849,51905,ARWR
2018-09-30,52968505,,-54448078,-555188.0,-54450478,19110051,16142321,-55936235,-55936235,,,,,,2400,16142321,72078556,0,1488157,,-54450478,-54450478,51905,ARWR
2017-09-30,48604466,,-34377895,-555188.0,-34380295,19799152,31407709,-36995909,-36995909,,,,,,2400,31407709,68403618,0,2618014,,-34380295,-34380295,51905,ARWR
2019-12-31,113857000,,339903000,,461466000,880458000,1491612000,497297000,497297000,,-80270000,,,,-122078000,2595362000,2098065000,1103750000,-157394000,-515000,461981000,461466000,51908,TFX
2018-12-31,106208000,,219628000,,200802000,825711000,1384442000,452523000,452523000,,-103020000,,,,23196000,2448383000,1995860000,1063941000,-232895000,4370000,196432000,200802000,51908,TFX
2017-12-31,84770000,,284911000,,152530000,696388000,1171802000,390644000,390644000,,-82546000,,,,129648000,2146303000,1755659000,974501000,-105733000,-2733000,155263000,152530000,51908,TFX
2016-12-31,58579000,,245725000,,237377000,569753000,1004700000,376368000,376368000,,-54941000,,,,8074000,1868027000,1491659000,863327000,-130643000,190000,237651000,237377000,51908,TFX
2019-12-31,13376000,,-51205000,,-51059000,55899000,21311000,-47964000,-47964000,,-5096000,,,,-146000,48104000,96068000,26793000,-3241000,,-51059000,-51059000,51910,VAPO
2018-12-31,8771000,,-42468000,,-42468000,45113000,16772000,-37112000,-37112000,,-3064000,,,,0,42377000,79489000,25605000,-5356000,,-42468000,-42549000,51910,VAPO
2017-12-31,7569000,,-31005000,,-31005000,34241000,13240000,-28570000,-28570000,,-2232000,,,,0,35597000,64167000,22357000,-2435000,,-31005000,-31128000,51910,VAPO
2016-12-31,6211000,,-23072000,,-23072000,25965000,9939000,-22237000,-22237000,,-716000,,,,0,30122000,52359000,20183000,-835000,,-23072000,-23077000,51910,VAPO
2019-12-31,,,225524000,,212107000,,272649000,263154000,263154000,,-39622000,,,,13417000,364051000,100897000,91402000,-37630000,,212107000,212107000,51913,BUR
2018-12-31,,,305114000,,317577000,,354599000,345105000,345105000,4365000.0,-38538000,,,,-12463000,426430000,81325000,71831000,-78534000,,317577000,317577000,51913,BUR
2017-12-31,,,249181000,,249304000,3838000.0,287334000,271793000,271793000,4365000.0,-24251000,,,,-123000,340975000,69182000,53641000,-22612000,,249304000,249304000,51913,BUR
2016-12-31,,,104053000,,108870000,3838000.0,124135000,123864000,123864000,4365000.0,-14108000,,,,-4817000,163161000,39297000,39026000,-19811000,,108870000,108270000,51913,BUR
2020-02-29,1447637,,-9454686,,-9454686,4231403,88806,-5967615,-5967615,,-164177,,,,0,441769,6409384,352963,-3487071,,-9454686,-9454686,51915,MKGI
2019-02-28,1071553,,4298563,,4298563,3311466,104373,-5227780,-5227780,89475.0,-163195,,,,0,505187,5732967,400814,9526343,,4298563,4298563,51915,MKGI
2018-02-28,506339,,-10037142,,-10037142,4287533,102462,-5638653,-5638653,89475.0,-198038,,,,0,430797,6069450,328335,-4398489,,-10037142,-10037142,51915,MKGI
2017-02-28,244484,,-7097275,,-7097275,3725740,-1498074,-6931778,-6931778,89475.0,-248200,,,,0,400277,7332055,1898351,-165497,,-7097275,-7097275,51915,MKGI
2019-12-28,5342000,,-10111000,,-31548000,87031000,84223000,-8250000,-8250000,,-1897000,,,,21437000,280657000,288907000,196434000,-1861000,,-31548000,-31709000,51916,PRTS
2018-12-29,4188000,,-5218000,,-4889000,79355000,78721000,-5007000,-5007000,,-1598000,,,,-329000,289467000,294474000,210746000,-211000,,-4889000,-5050000,51916,PRTS
2017-12-30,4711000,,3034000,,24015000,79995000,89660000,4635000,4635000,,-1655000,,,,-21540000,303366000,298731000,213706000,-1601000,-559000.0,24574000,23826000,51916,PRTS
2016-12-31,5625000,,3073000,469000.0,-603000,81708000,92047000,4265000,4265000,,-1238000,,,,100000,303324000,299059000,211277000,-1192000,-3576000.0,2973000,-844000,51916,PRTS
2019-12-31,,,19421131,,19421131,1089302,20510433,19421131,19421131,,,,,,0,20510433,1089302,0,0,,19421131,19421131,51918,PBT
2018-12-31,,,30789460,,30789460,1324828,32114288,30789460,30789460,,,,,,0,32114288,1324828,0,0,,30789460,30789460,51918,PBT
2017-12-31,,,29325416,,29325416,1246786,30572202,29325416,29325416,,,,,,0,30572202,1246786,0,0,,29325416,29325416,51918,PBT
2016-12-31,,,19348835,,19348835,1191716,21090551,19348835,19348835,550000.0,,,,,0,21090551,1741716,0,0,,19348835,19348835,51918,PBT
2019-12-31,514000,,-5811000,,-5794000,4918000,281000,-5151000,-5151000,,-15000,,,,-17000,530000,5681000,249000,-660000,,-5794000,-5794000,51919,NAOV
2018-12-31,614000,,-4281000,,-4154000,3849000,160000,-4303000,-4303000,,-15000,,,,-127000,318000,4621000,158000,22000,,-4154000,-4154000,51919,NAOV
2017-12-31,693000,,-4927000,,-4965000,2549000,151000,-3091000,-3091000,,-1234000,,,,38000,239000,3330000,88000,-1836000,,-4965000,-5806000,51919,NAOV
2016-12-31,584000,,-2714000,,-2831000,1873000,141000,-2316000,-2316000,,-1234000,,,,117000,229000,2545000,88000,-398000,,-2831000,-2831000,51919,NAOV
2019-12-31,60459000,,-33699000,,-31188000,184344000,317190000,29225000,29225000,,-43437000,,,,-2511000,458752000,429527000,141562000,-62924000,,-31188000,-31188000,51920,MSP
2018-12-31,54017000,,-47764000,,-37723000,156096000,260407000,8418000,8418000,,-55380000,,,,-10041000,387355000,378937000,126948000,-56182000,,-37723000,-37723000,51920,MSP
2020-10-31,,,-34076375,,-34076375,3015531,4945654,1930123,1930123,,,,,,0,4945654,3015531,0,-36006498,,-34076375,-34076375,51921,MXF
2019-10-31,,,12405277,,12405277,3751306,8100897,4349591,4349591,,,,,,0,8100897,3751306,0,8055686,,12405277,12405277,51921,MXF
2018-10-31,,,-26953767,,-26953767,4439977,6623423,2183446,2183446,,,,,,0,6623423,4439977,0,-29137213,,-26953767,-26953767,51921,MXF
2017-10-31,,,-443233,,-443233,4346430,7522802,3176372,3176372,,,,,,0,7522802,4346430,0,-3619605,,-443233,-443233,51921,MXF
2020-09-30,,,219186000,,173438000,234168000,548527000,0,249808000,64551000,,,,,45748000,548527000,298719000,0,-30622000,,173438000,173438000,51924,WAFD
2019-09-30,,,262775000,,210256000,211122000,545028000,0,271773000,62133000,,,,,52519000,545028000,273255000,0,-8998000,,210256000,210256000,51924,WAFD
2018-09-30,,,257243000,,203850000,194650000,521667000,0,268937000,58080000,,,,,53393000,521667000,252730000,0,-11694000,,203850000,203850000,51924,WAFD
2017-09-30,,,256216000,,173532000,176376000,486241000,0,266132000,43733000,,,,,82684000,486241000,220109000,0,-9916000,,173532000,173532000,51924,WAFD
2020-05-31,,,-1810049,28380,-1126428,10110648,9177996,-932652,-932652,,-79386,,,,-712000,59121401,60054053,49943405,-877397,,-1098049,-1126428,51929,TSRI
2019-05-31,,,-1837055,28792,-1335995,11672946,9825392,-1847554,-1847554,,-79386,,,,-538000,63340028,65187582,53514636,10499,,-1299055,-1335995,51929,TSRI
2018-05-31,,,937030,44552,486208,9471523,10380900,909377,909377,,-79386,,,,381000,64989995,64080618,54609095,27653,,556030,486208,51929,TSRI
2017-05-31,,,576967,21457,268189,9683601,10246064,562463,562463,,-79386,,,,263000,62572585,62010122,52326521,14504,,313967,268189,51929,TSRI
2019-12-31,,,-8490000,46739000,-15018000,91363000,110896000,19533000,19533000,,-14109000,,,,4791000,657910000,638377000,547014000,-28023000,,-13281000,-15018000,51936,SRT
2018-12-31,,,-23554000,45356000,-30464000,74425000,85883000,11458000,11458000,,-14509000,,,,3902000,535412000,523954000,449529000,-35012000,,-27456000,-30464000,51936,SRT
2018-03-31,,,5023000,47452000,-4152000,48030000,70389000,22359000,22359000,,-8635000,,,,4483000,480077000,457718000,409688000,-17336000,,540000,-4152000,51936,SRT
2017-03-31,,,47872000,45510000,29668000,36209000,69867000,33658000,33658000,,-4942000,,,,11548000,414818000,381160000,344951000,14214000,,36324000,29668000,51936,SRT
2019-12-31,,,806000,100000,773000,2378000,3076000,698000,698000,,,,,,0,6783000,6085000,3707000,108000,,806000,773000,51937,TAIT
2018-12-31,,,1376000,96000,1378000,2199000,3618000,1419000,1419000,,,,,,6000,8222000,6803000,4604000,-43000,,1370000,1378000,51937,TAIT
2017-12-31,,,701000,100000,701000,2209000,3000000,791000,791000,,-38000.0,,,,5000,7622000,6831000,4622000,-90000,,696000,701000,51937,TAIT
2016-12-31,,,-3098000,104000,-3111000,2124000,-748000,-2872000,-2872000,,-48000.0,,,,20000,6915000,9787000,7663000,-226000,,-3118000,-3111000,51937,TAIT
2019-12-31,13612000,,-78653000,7585000,-60832000,49615000,125016000,14670000,14670000,,-33784000,,,,-17143000,170065000,155395000,45049000,-93323000,,-61510000,-60832000,51940,AGFS
2018-12-31,13873000,,-28400000,8263000,-30060000,56070000,132515000,16626000,16626000,,-34451000,,,,1840000,178786000,162160000,46271000,-45026000,,-30240000,-30060000,51940,AGFS
2017-12-31,13779000,,18983000,8443000,23471000,61847000,131371000,13835000,13835000,,-35755000,,,,-4579000,164026000,150191000,32655000,5148000,,23562000,23471000,51940,AGFS
2016-12-31,14767000,,-98540000,8443000,-111560000,61892000,130069000,13083000,13083000,,-58239000,,,,13020000,159669000,146586000,29600000,-111623000,,-111560000,-111560000,51940,AGFS
2020-12-26,86145000,,-13177000,,-13801000,127598000,275539000,23050000,23050000,,-13759000,,,,666000,636007000,612957000,360468000,-36227000,42000,-13843000,-13801000,51943,COHU
2019-12-28,86147000,,-72077000,,-69700000,141336000,238558000,-28515000,-28515000,,-20556000,,,,-3082000,583329000,611844000,344771000,-43562000,-697000,-68995000,-69700000,51943,COHU
2018-12-29,56434000,,-31912000,-299000.0,-32181000,85397000,193161000,34133000,34133000,,-4977000,,,,631000,451768000,417635000,258607000,-66045000,119000,-32543000,-32181000,51943,COHU
2017-12-30,40737000,,35365000,-299000.0,32843000,60737000,143407000,37725000,37725000,,-54000,,,,2244000,352704000,314979000,209297000,-2360000,-278000,33121000,32843000,51943,COHU
2019-12-31,,,-12310000,,-11613000,13340000,0,-13461000,-13461000,121000,-146000,,,,-697000,0,13461000,0,1151000,,-11613000,-11613000,51946,SA
2018-12-31,,,-14973000,,-19940000,12370000,0,-19978000,-19978000,7608000,-144000,,,,4967000,0,19978000,0,5005000,,-19940000,-19940000,51946,SA
2017-12-31,,,-8123000,,-10287000,13673000,0,-15729000,-15729000,2056000,-32000,,,,2164000,0,15729000,0,7606000,,-10287000,-10287000,51946,SA
2016-12-31,,,-4315000,,-7289000,9679000,0,-9679000,-9679000,2056000,-32000,,,,2974000,0,9679000,0,5364000,,-7289000,-7289000,51946,SA
2020-12-31,,,35901000,,22738000,368663000,540824000,0,137764000,34397000,,,,,13163000,540824000,403060000,0,-101863000,,22738000,22738000,51948,EBC
2019-12-31,,,174579000,,135098000,354877000,587263000,0,192904000,39482000,,,,,39481000,587263000,394359000,0,-18325000,,135098000,135098000,51948,EBC
2018-12-31,,,157611000,,122727000,339259000,555539000,0,179177000,37103000,,,,,34884000,555539000,376362000,0,-21566000,,122727000,122727000,51948,EBC
2010-12-31,,,84527000,-52000.0,60435000,212770000,351073000,0,97803000,40500000,,,,,24089000,351073000,253270000,0,-13276000,,60438000,60435000,51948,EBC
2019-12-31,,,2975523,,-289979,10892297,15876460,4584031,4584031,,-559585,,,,3480996,15876460,11292429,0,-1608508,215494,-505473,-289979,51949,HQI
2018-12-31,,,7082119,,7117187,5325000,12329628,6912020,6912020,,-19697,,,,21029,12329628,5417608,0,170099,56097,7061090,7117187,51949,HQI
2017-12-31,,,2836845,,2836845,7921001,10775747,2769467,2769467,,-297,,,,0,11277700,8508233,501953,67378,56097,2836845,2836845,51949,HQI
2016-12-31,,,3031664,,3031664,6126721,9077049,1934296,1934296,944064.0,-2660,,,,0,10085170,8150874,1008121,1097368,56097,3031664,3031664,51949,HQI
2019-12-31,,,2283000,,2015000,145176000,149847000,4671000,4671000,,-2963000,,,,268000,273342000,268671000,123495000,-2388000,,2015000,1923000,51950,LINC
2018-12-31,,,-6345000,,-6545000,141244000,137827000,-3417000,-3417000,,-2422000,,,,200000,263200000,266617000,125373000,-2928000,,-6545000,-6545000,51950,LINC
2017-12-31,,,-11758000,,-11484000,138779000,132440000,-6339000,-6339000,,-7098000,,,,-274000,261853000,268192000,129413000,-5419000,,-11484000,-11484000,51950,LINC
2016-12-31,,,-28104000,,-28304000,148447000,141133000,-7314000,-7314000,,-6131000,,,,200000,285559000,292873000,144426000,-20790000,,-28304000,-28304000,51950,LINC
2020-10-31,,,-6103183,,-6121224,19245502,14086378,-5533064,-5533064,331934,-569812,,,,18041,55277400,60810464,41191022,-570119,,-6121224,-6121224,51953,OCC
2019-10-31,,,-5675126,,-5669321,23434360,18304747,-5161701,-5161701,-6510,-521142,,,,-5805,71324446,76486147,53019699,-513425,,-5669321,-5669321,51953,OCC
2018-10-31,,,1052102,,1068753,26130956,27873200,1740374,1740374,-32898,-608417,,,,-16651,87828590,86088216,59955390,-688272,,1068753,1068753,51953,OCC
2017-10-31,,,-1744209,,-1738771,21968757,20797927,-1317012,-1317012,120478,-523035,,,,-5438,64092848,65409860,43294921,-427197,,-1738771,-1738771,51953,OCC
2019-12-31,5751000,,-9165000,,-9181000,11316000,10096000,-6971000,-6971000,,,,,,16000,59283000,66254000,49187000,-2194000,,-9181000,-9181000,51954,BSQR
2018-12-31,8629000,,-13724000,,-13737000,17074000,15510000,-10193000,-10193000,,,,,,13000,73414000,83607000,57904000,-3324000,,-13737000,-13737000,51954,BSQR
2017-12-31,6561000,,-9207000,,-9058000,20982000,18122000,-9421000,-9421000,,,,,,-149000,80811000,90232000,62689000,214000,,-9058000,-9058000,51954,BSQR
2016-12-31,2859000,,-911000,,-1052000,14102000,16788000,-173000,-173000,,,,,,141000,97441000,97614000,80653000,-738000,,-1052000,-1052000,51954,BSQR
2019-12-31,,,627341986,156591494,442718263,259671358,752966656,514840915,514840915,-21545617,-2505904,,,,189567817,1091793135,576952220,338826479,112501071,,437774169,442718263,51957,GHG
2018-12-31,,,553799756,8379047,394104841,145654303,664051589,540030543,540030543,-21633257,-541876,,,,160185845,945005934,404975391,280954345,13769213,,393613911,394104841,51957,GHG
2017-12-31,,,471702787,360120,285400182,128641933,544485761,425498208,425498208,-9654380,-1442709,,,,186651155,778131813,352633605,233646052,46204579,,285051632,285400182,51957,GHG
2016-12-31,,,349724169,708670,265973599,104542054,407656399,312263518,312263518,-9149173,-1442709,,,,83923610,647788607,335525089,240132208,37460651,,265800559,265973599,51957,GHG
2019-12-31,,,-7944,,-7944,4554,0,-7944,-7944,3390,,,,,0,0,7944,0,0,,-7944,-7944,51959,SVAC
2019-12-31,,,-41873000,,-41873000,11346000,-28633000,-39979000,-39979000,,-835000,,,,0,4461000,44440000,33094000,-1894000,,-41873000,-41873000,51960,VRDN
2018-12-31,30421000.0,,-32703000,,-32703000,11049000,-22035000,-33084000,-33084000,,-873000,,,,0,8386000,41470000,30421000,281000,,-32703000,-32703000,51960,VRDN
2017-12-31,30421000.0,,-26512000,,-26512000,10912000,-15620000,-26532000,-26532000,,-283000,,,,0,4003000,30535000,19623000,20000,,-26512000,-26517000,51960,VRDN
2016-12-31,30421000.0,,-17274000,,-17274000,6772000,-10215000,-16987000,-16987000,,-326000,,,,0,3477000,20464000,13692000,-287000,,-17274000,-17323000,51960,VRDN
2019-12-31,,,-42375000,,-42517000,55663000,11216000,-44447000,-44447000,,,,,,142000,18026000,62473000,6810000,2072000,,-42517000,-58414000,51961,CURI
2018-12-31,,,-34929000,,-34972000,28290000,-5085000,-33375000,-33375000,,-1837000.0,,,,43000,9345000,42720000,14430000,-1554000,,-34972000,-36706000,51961,CURI
2020-07-31,,,17718000,-3633000,21430000,214846000,261760000,24295000,24295000,2213000,,,,,-3700000,1345769000,1321474000,1084009000,-6577000,,21418000,21430000,51962,IDT
2019-07-31,,,453000,-2687000,134000,204366000,235157000,184000,184000,7975000,,,,,123000,1409172000,1408988000,1174015000,269000,,330000,134000,51962,IDT
2018-07-31,,,8101000,639000,4208000,203251000,241458000,15406000,15406000,7975000,,,,,2902000,1547495000,1532089000,1306037000,-7305000,,5199000,4208000,51962,IDT
2017-07-31,,,7620000,8823000,8177000,188293000,226021000,16024000,16024000,7975000,,,,,-2021000,1501729000,1485705000,1275708000,-8404000,,9641000,8177000,51962,IDT
2019-12-31,39404000,,-25972000,41000,-24571000,48404000,49093000,-38715000,-38715000,,,,,,-291000,85543000,124258000,36450000,12743000,,-25681000,-24571000,51964,SDGR
2018-12-31,34523000,,-28348000,41000,-28425000,36383000,42937000,-27969000,-27969000,,,,,,77000,66639000,94608000,23702000,-379000,,-28425000,-28425000,51964,SDGR
2017-12-31,27669000,,-17060000,41000,-17392000,31152000,39800000,-19021000,-19021000,,,,,,332000,55693000,74714000,15893000,1961000,,-17392000,-17392000,51964,SDGR
2019-12-31,1316667,,-14588700,,-14588700,5036820,-193717,-6547204,-6547204,,-1069134,,,,0,2267528,8814732,2461245,-8041496,,-14588700,-14588700,51966,BKYI
2018-12-31,1415401,,-6868875,,-6868875,5333906,-119648,-6868955,-6868955,,-1069134,,,,0,4044542,10913497,4164190,80,,-6868875,-8495874,51966,BKYI
2017-12-31,1659875,,-4275338,,-4275338,5676323,3060833,-4275365,-4275365,,-1069134,,,,0,6302984,10578349,3242151,27,,-4275338,-5044496,51966,BKYI
2016-12-31,2008942,,-4189704,,-4189704,4438950,2246073,-4201819,-4201819,,-1069134,,,,0,2975756,7177575,729683,12115,,-4189704,-4992204,51966,BKYI
2020-04-30,,,21484000,,15663000,26264000,35354000,9090000,9090000,,,,,,5821000,40299000,31209000,4945000,12394000,,15663000,15663000,51968,VALU
2019-04-30,,,15226000,,11150000,25622000,31035000,5413000,5413000,,,,,,4076000,36257000,30844000,5222000,9813000,,11150000,11150000,51968,VALU
2018-04-30,,,11898000,,14738000,27439000,30011000,2572000,2572000,,,,,,-2840000,35868000,33296000,5857000,9326000,,14738000,14738000,51968,VALU
2017-04-30,,,15485000,,10367000,26175000,25511000,-664000,-664000,,,,,,5118000,34574000,35238000,9063000,16149000,,10367000,10367000,51968,VALU
2020-05-31,,,1669000000,,1286000000,427000000,16837000000,2730000000,2730000000,10065000000,-672000000,,,,383000000,69217000000,66487000000,52380000000,-1061000000,,1286000000,1284000000,51969,FDX
2019-05-31,,,655000000,,540000000,468000000,14929000000,1581000000,1581000000,9527000000,-588000000,,,,115000000,69693000000,68112000000,54764000000,-926000000,,540000000,539000000,51969,FDX
2018-05-31,,,4353000000,,4572000000,442000000,18005000000,5460000000,5460000000,9008000000,-558000000,,,,-219000000,65450000000,59990000000,47445000000,-1107000000,,4572000000,4566000000,51969,FDX
2017-05-31,,,4579000000,,2997000000,458000000,16784000000,5098000000,5098000000,8233000000,-512000000,,,,1582000000,60319000000,55221000000,43535000000,-519000000,,2997000000,2993000000,51969,FDX
2020-12-31,,,-685000000,,-720000000,378000000,5229000000,3349000000,3349000000,125000000,-896000000,,,,2000000,8505000000,5156000000,3276000000,-4034000000,,-687000000,-842000000,51970,MPLX
2019-12-31,,,1462000000,249000000.0,1434000000,374000000,5033000000,3292000000,3292000000,113000000,-862000000,,,,0,8745000000,5453000000,3712000000,-1830000000,,1462000000,910000000,51970,MPLX
2018-12-31,,,2014000000,156000000.0,1990000000,316000000,3750000000,2494000000,2494000000,83000000,-595000000,,,,8000000,6761000000,4267000000,3011000000,-480000000,,2006000000,1743000000,51970,MPLX
2017-12-31,,,837000000,-491000000.0,512000000,241000000,2091000000,1146000000,1146000000,54000000,-298000000,,,,1000000,3789000000,2643000000,1698000000,-309000000,,836000000,411000000,51970,MPLX
2019-12-31,,,317502000,,259175000,187213000,464533000,269097000,269097000,,-11311000,,,,58327000,778643000,509546000,314110000,48405000,,259175000,259175000,51971,LOPE
2018-12-31,,,287000000,,229011000,147388000,423907000,276519000,276519000,,-1536000,,,,57989000,845501000,568982000,421594000,10481000,,229011000,229011000,51971,LOPE
2017-12-31,,,283528000,,203319000,136249000,419565000,283316000,283316000,,-2169000,,,,80209000,974134000,690818000,554569000,212000,,203319000,203319000,51971,LOPE
2016-12-31,,,236124000,,148514000,126671000,365010000,238339000,238339000,,-1328000,,,,87610000,873344000,635005000,508334000,-2215000,,148514000,148514000,51971,LOPE
2019-12-31,15658000,,-30770000,,-30770000,16819000,2173000,-30304000,-30304000,,-1034000,,,,0,2173000,32477000,0,-466000,,-30770000,-30770000,51972,CLSD
2018-12-31,68291000,,-82818000,,-82818000,14684000,30000,-82945000,-82945000,,-1057000,,,,0,30000,82975000,0,127000,,-82818000,-82818000,51972,CLSD
2017-12-31,49053000,,-58975000,,-58975000,9700000,345000,-58408000,-58408000,,-1076000,,,,0,345000,58753000,0,-567000,,-58975000,-58975000,51972,CLSD
2016-12-31,19455000,,-25882000,,-25882000,6263000,520000,-25198000,-25198000,,-831000,,,,0,520000,25718000,0,-684000,,-25882000,-25882000,51972,CLSD
2019-12-31,,,82831000,,67659000,198899000,335856000,84976000,84976000,,-13612000,,,,15172000,991346000,906370000,655490000,-2145000,,67659000,67659000,51973,EXLS
2018-12-31,,,60123000,250000.0,56726000,179861000,298257000,69830000,69830000,,-7227000,,,,3397000,883112000,813282000,584855000,-9707000,,56726000,56726000,51973,EXLS
2017-12-31,,,85034000,224000.0,48888000,156394000,267168000,72225000,72225000,,-1889000,,,,36146000,762310000,690085000,495142000,12809000,,48888000,48888000,51973,EXLS
2016-12-31,,,83884000,193000.0,61733000,139468000,238270000,64222000,64222000,,-1343000,,,,22151000,685988000,621766000,447718000,19662000,,61733000,61733000,51973,EXLS
2020-12-31,,,-533028000,,-533017000,239173000,307211000,0,38755000,29283000,,,,,-19853000,307211000,268456000,0,-571783000,-19842000,-513175000,-533330000,51975,BHLB
2019-12-31,,,123984000,,97450000,222287000,412490000,0,160477000,29726000,,,,,22463000,412490000,252013000,0,-36493000,-4071000,101521000,96490000,51975,BHLB
2018-12-31,,,138180000,,105765000,210133000,404613000,0,170600000,23880000,,,,,28961000,404613000,234013000,0,-32420000,-3454000,109219000,104847000,51975,BHLB
2017-12-31,,,91204000,,55247000,190230000,343886000,0,132460000,21196000,,,,,42088000,343886000,211426000,0,-41256000,6131000,49116000,55028000,51975,BHLB
2020-12-31,287900000,,729800000,,551500000,676400000,2052000000,1087700000,1087700000,,-151200000,,,,150900000,4642100000,3554400000,2590100000,-357900000,-28300000,578900000,551500000,51980,FMC
2019-12-31,298100000,,655000000,29100000.0,477400000,715100000,2083600000,1070400000,1070400000,,-160400000,,,,111500000,4609800000,3539400000,2526200000,-415400000,-63300000,543500000,475900000,51980,FMC
2018-12-31,287700000,,608400000,89300000.0,502100000,703100000,1949400000,958600000,958600000,,-134500000,,,,70800000,4285300000,3326700000,2335900000,-350200000,-26100000,537600000,499700000,51980,FMC
2017-12-31,138400000,,95800000,25300000.0,535800000,451500000,972000000,382100000,382100000,,-80000000,,,,228900000,2531200000,2149100000,1559200000,-286300000,671500000,-133100000,535800000,51980,FMC
2020-03-31,1826140,,-9603871,,-9603871,5491769,-520000,-7837909,-7837909,,-1497352,,,,0,100000,7937909,620000,-1765962,,-9603871,-9603871,51982,CRKN
2019-03-31,712116,,-4295753,,-4295753,1791103,-109212,-2612431,-2612431,,-1121210,,,,0,504788,3117219,614000,-1683322,,-4295753,-4295753,51982,CRKN
2018-03-31,248929,,-1210312,,-1210312,921575,-17830,-1188334,-1188334,,-29731,,,,0,0,1188334,17830,-21978,,-1210312,-1210312,51982,CRKN
2020-12-31,,,10868000000,65000000,8458000000,13590000000,24356000000,8784000000,8784000000,,-1438000000,,,,2379000000,160550000000,151766000000,136194000000,2084000000,,8489000000,8458000000,51983,CI
2019-12-31,,,6570000000,41000000,5104000000,13261000000,25256000000,9046000000,9046000000,,-1600000000,,,,1450000000,153743000000,144697000000,128487000000,-2476000000,,5120000000,5104000000,51983,CI
2018-12-31,,,3581000000,44000000,2637000000,11141000000,16248000000,4872000000,4872000000,,-280000000,,,,935000000,48569000000,43697000000,32321000000,-1291000000,,2646000000,2637000000,51983,CI
2017-12-31,,,3606000000,49000000,2237000000,9830000000,14324000000,4379000000,4379000000,9214000000.0,-243000000,,,,1374000000,42043000000,37664000000,27719000000,-773000000,,2232000000,2237000000,51983,CI
2020-11-30,,,-22363042,,-22363042,2852361,13823332,10968891,10968891,2080,-908227,,,,0,13823332,2854441,0,-33331933,,-22363042,-22363042,51984,SCD
2019-11-30,,,46785509,,46785509,3089863,13377437,10284074,10284074,3500,-2457598,,,,0,13377437,3093363,0,36501435,,46785509,46785509,51984,SCD
2018-11-30,,,2444670,,2444670,3390640,15359683,11963280,11963280,5763,-2369516,,,,0,15359683,3396403,0,-9518610,,2444670,2444670,51984,SCD
2017-11-30,,,22419961,,22419961,3507669,13476604,9964105,9964105,4830,-1531968,,,,0,13476604,3512499,0,12455856,,22419961,22419961,51984,SCD
2019-12-31,,,135988000,33151000,108923000,323212000,1267221000,404532000,404532000,375433000,-187094000,,,,25866000,3107462000,2702930000,1840241000,-268544000,,110122000,108923000,51986,ACHC
2018-12-31,,,-168954000,28806000,-175750000,307707000,1233780000,412743000,412743000,354498000,-185410000,,,,6532000,3012442000,2599699000,1778662000,-581697000,,-175486000,-175750000,51986,ACHC
2017-12-31,,,236798000,22417000,199835000,272998000,1185717000,437882000,437882000,331827000,-176007000,,,,37209000,2836316000,2398434000,1650599000,-201084000,,199589000,199835000,51986,ACHC
2016-12-31,,,32955000,17754000,6143000,258834000,1151635000,445142000,445142000,312556000,-181325000,,,,28779000,2810914000,2365772000,1659279000,-412187000,,4176000,6143000,51986,ACHC
2019-12-31,79386000,,-92877000,,-92877000,30056000,22238000,-87204000,-87204000,,-182000,,,,0,22238000,109442000,0,-5673000,,-92877000,-92877000,51988,DTIL
2018-12-31,43691000,,-46037000,,-46037000,15104000,10883000,-47912000,-47912000,,-182000,,,,0,10883000,58795000,0,1875000,,-46037000,-46037000,51988,DTIL
2017-12-31,19492000,,-21102000,,-21102000,8848000,6484000,-21856000,-21856000,,-182000,,,,0,6484000,28340000,0,754000,,-21102000,-21102000,51988,DTIL
2016-12-31,9225000,,-8256000,,-8251000,6618000,7015000,-8828000,-8828000,,-182000,,,,-5000,7015000,15843000,0,572000,,-8251000,-8251000,51988,DTIL
2020-12-31,,,84710000,,64024000,185961000,306784000,0,94560000,26263000,,,,,20686000,306784000,212224000,0,-9850000,,64024000,62323000,51989,TBKCP
2019-12-31,,,75446000,,58544000,165448000,279530000,0,84875000,29207000,,,,,16902000,279530000,194655000,0,-9429000,,58544000,58544000,51989,TBKCP
2018-12-31,,,66500000,,51708000,130824000,232782000,0,79132000,22826000,,,,,14792000,232782000,153650000,0,-12632000,,51708000,51130000,51989,TBKCP
2017-12-31,,,61098000,,36220000,101790000,163852000,0,46640000,15422000,,,,,24878000,163852000,117212000,0,14458000,,36220000,35446000,51989,TBKCP
2019-12-31,16267000,,-30774000,,-30774000,6930000,0,-23197000,-23197000,,,,,,0,0,23197000,0,-7577000,,-30774000,-30774000,51991,SLNO
2018-12-31,7178000,,-11841000,,-13335000,6556000,0,-13734000,-13734000,,-62000.0,,,,0,0,13734000,0,1893000,-1494000.0,-11841000,-13335000,51991,SLNO
2017-12-31,3069000,,-13442000,,-15385000,6610000,0,-9679000,-9679000,,-590000.0,,,,-1650000,0,9679000,0,-3763000,-3593000.0,-11792000,-15385000,51991,SLNO
2016-12-31,2247141,,-6737620,,-12065214,5901976,0,-8149117,-8149117,,-590000.0,,,,0,0,8149117,0,1411497,-5327594.0,-6737620,-15716386,51991,SLNO
2020-07-31,,,-63588013,,-63588013,12969463,91653116,78683653,78683653,,-44719569,,,,0,91653116,12969463,0,-142271666,,-63588013,-63588013,51992,JPC
2019-07-31,,,73671202,,73671202,13384608,103143001,89758393,89758393,,-40716130,,,,0,103143001,13384608,0,-16087191,,73671202,73671202,51992,JPC
2018-07-31,,,6915466,,6915466,14179647,106465824,92286177,92286177,,740647,,,,0,106465824,14179647,0,-85370711,,6915466,6915466,51992,JPC
2017-07-31,,,109480915,,109480915,12458683,89711126,77252443,77252443,,-962860,,,,0,89711126,12458683,0,32228472,,109480915,109480915,51992,JPC
2020-12-31,17000000,,171000000,,261000000,277000000,1381000000,808000000,808000000,,-381000000,,,,-40000000,5259000000,4451000000,3878000000,-637000000,50000000,211000000,259000000,51994,HWM
2019-12-31,70000000,,575000000,14000000.0,470000000,820000000,2965000000,1539000000,1539000000,,-338000000,,,,105000000,14192000000,12653000000,11227000000,-964000000,50000000,470000000,468000000,51994,HWM
2018-12-31,103000000,,868000000,12000000.0,642000000,812000000,2617000000,1126000000,1126000000,,-378000000,,,,226000000,14014000000,12888000000,11397000000,-258000000,50000000,642000000,640000000,51994,HWM
2017-12-31,109000000,,470000000,14000000.0,-74000000,851000000,2739000000,1228000000,1228000000,12000000.0,-496000000,,,,544000000,12960000000,11732000000,10221000000,-758000000,50000000,-74000000,-127000000,51994,HWM
2020-06-30,,,1512627000,14546000,1206341000,1548339000,3538002000,1989663000,1989663000,,-308161000,,,,305924000,13695520000,11705857000,10157518000,-477036000,,1206703000,1206341000,51998,PH
2019-06-30,,,1933425000,6183000,1512364000,1553759000,3631490000,2077731000,2077731000,,-190138000,,,,420494000,14320324000,12242593000,10688834000,-144306000,,1512931000,1512364000,51998,PH
2018-06-30,,,1702277000,5627000,1060801000,1643000000,3609596000,1966596000,1966596000,,-213873000,,,,640962000,14302392000,12335796000,10692796000,-264319000,,1061315000,1060801000,51998,PH
2017-06-30,,,1328641000,5697000,983412000,1504657000,2946215000,1441558000,1441558000,,-162436000,,,,344797000,12029312000,10587754000,9083097000,-112917000,,983844000,983412000,51998,PH
2019-12-31,,,-3763000,,-3036000,32627000,30773000,-1854000,-1854000,,-3959000,,,,-727000,305168000,307022000,274395000,-1909000,,-3036000,-3036000,52001,SYNL
2018-12-31,,,16473000,,13097000,27991000,51237000,23246000,23246000,,-2191000,,,,3376000,280841000,257595000,229604000,-6773000,,13097000,13097000,52001,SYNL
2017-12-31,,,1478000,,1341000,24875000,28081000,3206000,3206000,,-889000,,,,137000,201148000,197942000,173067000,-1728000,,1341000,1341000,52001,SYNL
2016-12-31,,,-9191967,,-7093301,22507872,16904479,-5603393,-5603393,,-945569,,,,-2198000,138565782,144169175,121661303,-3588574,-99334.0,-6993967,-7093301,52001,SYNL
2019-12-31,13090530,,-196168740,-43835229,-190622766,115981519,-1000771,-130042580,-130042580,-30240,-34501556,,,,0,341495,130384075,1342266,-66126160,,-196168740,-190622766,52005,NCTY
2018-12-31,24555308,,-239284796,-32114413,-258011699,91909149,996268,-115238651,-115238651,-229538,-104776674,,,,0,17431858,132670509,16435590,-124046145,,-239284796,-258011699,52005,NCTY
2017-12-31,45112396,,-112092907,-22538436,-175292083,117914649,49366502,-113310589,-113310589,-349954,-83922200,,,,0,73148556,186459145,23782054,1217682,,-112092907,-175292083,52005,NCTY
2016-12-31,77991408,,-673169227,-115666516,-676671777,150334493,7680507,-216440645,-216440645,-4204749,-56471609,,,,-6079282,56199286,272639931,48518779,-456728582,,-667089945,-676671777,52005,NCTY
2019-12-31,,,7661737000,7613021000,5465822000,250183000,8526759000,8276576000,8276576000,,-1084293000,,,,1978102000,16821638000,8545062000,8294879000,-614839000,,5683635000,5465822000,52006,ASR
2018-12-31,,,6916699000,7575204000,4987601000,235264000,7879596000,7644332000,7644332000,-134637000.0,-1230651000,,,,1796893000,15410241000,7765909000,7530645000,-727633000,,5119806000,4987601000,52006,ASR
2017-12-31,,,8386544000,7648223000,5834484000,204418000,6400347000,6195929000,6195929000,-134637000.0,-618831000,,,,1636379000,12589818000,6393889000,6189471000,2190615000,,6750165000,5834484000,52006,ASR
2016-12-31,,,5031378000,7648223000,3629262000,204843000,5137442000,4932599000,4932599000,-134637000.0,-126186000,,,,1402116000,9753491000,4820892000,4616049000,98779000,,3629262000,3629262000,52006,ASR
2020-11-30,,,6599000,,6599000,6028000,20819000,14791000,14791000,,-2884000,,,,0,20819000,6028000,0,-8192000,,6599000,6599000,52007,ZTR
2019-11-30,,,33284000,,33284000,4354000,12604000,8250000,8250000,,-2915000,,,,0,12604000,4354000,0,25034000,,33284000,33284000,52007,ZTR
2018-11-30,,,-33638179,,-33638179,3879272,15983999,12104726,12104726,,-3112363,,,,0,15983999,3879272,0,-45742904,,-33638179,-33638179,52007,ZTR
2017-12-31,,,53820000,,53820000,4778000,17344000,12566000,12566000,,-2347000,,,,0,17344000,4778000,0,41254000,,53820000,53820000,52007,ZTR
2020-06-30,4136051,,6443338,14570087,3359175,37632708,78930599,36668787,36668787,493053,-19397098,,,,2206710,172350699,135681912,93420100,-30225449,,4236628,3359175,52010,BIOX
2019-06-30,3632996,,-9372607,14793003,-18369045,33890016,73072388,31073124,31073124,4476252,-22783441,,,,6986284,160308979,129235855,87236591,-40445731,,-16358891,-18369045,52010,BIOX
2018-06-30,3863988,,-25239763,19420172,-11039533,30835213,56006599,17847754,17847754,3459644,-15560578,,,,-10928517,133491118,115643364,77484519,-43087517,,-14311246,-11039533,52010,BIOX
2017-06-30,3895790,,-22391600,41397445,-11817854,27387782,33847528,-706924,-706924,3270880,-15886338,,,,-5634502,93706738,94413662,59859210,-21684676,,-16757098,-11817854,52010,BIOX
2019-12-31,2070158000,,-3691672000,,-3691673000,1164569000,-558141000,-3780574000,-3780574000,-12294000,-32017000,,,,1000,2321219000,6101793000,2879360000,88902000,,-3691673000,-4642754000,52011,XPEV
2018-12-31,1051219000,,-1398823000,,-1398823000,642541000,-2361000,-1694634000,-1694634000,-1487000,-5822000,,,,0,9706000,1704340000,12067000,295811000,,-1398823000,-2254864000,52011,XPEV
2020-12-31,,,62077000,,47635000,142999000,222921000,0,67577000,12345000,,,,,14442000,222921000,155344000,0,-5500000,,47635000,47635000,52013,BRKL
2019-12-31,,,116029000,,87717000,139312000,273510000,0,120262000,13936000,,,,,28269000,273510000,153248000,0,-4233000,,87760000,87717000,52013,BRKL
2018-12-31,,,112740000,10479000.0,83062000,133159000,267972000,0,121329000,13484000,,,,,26189000,267972000,146643000,0,-8589000,,86551000,83062000,52013,BRKL
2017-12-31,,,97255000,8753000.0,50518000,121497000,236366000,0,103081000,11788000,,,,,43636000,236366000,133285000,0,-5826000,,53619000,50518000,52013,BRKL
2019-12-31,9839000,,-101839000,49000,-101060000,84414000,4798000,-89082000,-89082000,-373000,-2609000,,,,-218000,10845000,99927000,6047000,-12757000,,-101621000,-101060000,52014,ANPC
2018-12-31,10106000,,-42495000,49000,-42063000,38674000,4578000,-43609000,-43609000,-593000,-925000,,,,-199000,10250000,53859000,5672000,1114000,,-42296000,-42063000,52014,ANPC
2017-12-31,11405000,,-39311000,-61000,-39076000,31428000,1732000,-40923000,-40923000,-178000,-338000,,,,9000,5686000,46609000,3954000,1612000,,-39320000,-39076000,52014,ANPC
2019-11-30,,,-7787892,1786401,-7581384,3896014,-1749169,-6920450,-6920450,,-389922,,,,-162576,429236,7349686,2178405,-867442,,-7625316,-7581384,52015,YVR
2018-11-30,,,-7498612,1838941,-7537749,1613018,-430958,-2182853,-2182853,,-133915,,,,1621,687381,2870234,1118339,-5315759,,-7500233,-7537749,52015,YVR
2017-11-30,,,-1928870,1838941,-1928870,735021,-362655,-1673676,-1673676,,-217604,,,,0,0,1673676,362655,-255194,,-1928870,-1928870,52015,YVR
2016-11-30,,,-465644,1838941,-465644,291445,0,-291445,-291445,,-47297,,,,0,0,291445,0,-174199,,-465644,-465644,52015,YVR
2019-12-31,56850000,,-67909000,,-67226000,41731000,29768000,-68813000,-68813000,,-77000,,,,-683000,101398000,170211000,71630000,904000,,-67226000,-67226000,52016,VLDR
2018-12-31,51993000,,-55672000,,-62300000,35039000,30880000,-56152000,-56152000,,-14000,,,,6628000,142946000,199098000,112066000,480000,,-62300000,-62300000,52016,VLDR
2017-12-31,31610000,,25571000,,15761000,23934000,80377000,24833000,24833000,,-14000,,,,9810000,182090000,157257000,101713000,738000,,15761000,12139000,52016,VLDR
2020-04-30,46477000,,47183000,,41074000,60322000,153102000,46303000,46303000,,,,,,5848000,367296000,320993000,214194000,880000,-265000,41335000,41074000,52017,AVAV
2019-04-30,34234000,,46534000,4000.0,47438000,55945000,128403000,38224000,38224000,,,,,,4641000,314274000,276050000,185871000,8310000,5526000,41893000,47438000,52017,AVAV
2018-04-30,26433000,,31334000,23000.0,17863000,49805000,107685000,31447000,31447000,,,,,,9800000,268424000,236977000,160739000,-113000,-3887000,21534000,17863000,52017,AVAV
2017-04-30,28465000,,22437000,239000.0,13100000,46861000,97428000,22102000,22102000,,,,,,4758000,233105000,211003000,135677000,335000,-4601000,17679000,13100000,52017,AVAV
2019-12-31,714281,,-8664693,,-8664693,7978430,198309,-8494402,-8494402,,-172479,,,,0,890152,9384554,691843,-170291,,-8664693,-8664693,52018,AYRO
2018-12-31,768382,,-4196491,,-4196491,3577802,294264,-4051920,-4051920,,-144618,,,,0,5302964,9354884,5008700,-144571,,-4196491,-4196491,52018,AYRO
2017-12-31,171376,,-1081086,,-1081086,905946,967,-1076355,-1076355,,-12331,,,,0,39415,1115770,38448,-4731,,-1081086,-1081086,52018,AYRO
2020-02-29,,,59473037,,59473037,5506304,29545826,24039522,24039522,,-5571484,,,,0,29545826,5506304,0,35433515,,59473037,59473037,52019,NAN
2019-02-28,,,19056125,,19056125,5525467,29833035,24307568,24307568,,-5525750,,,,0,29833035,5525467,0,-5251443,,19056125,19056125,52019,NAN
2018-02-28,,,14901927,,14901927,5711911,30513943,24802032,24802032,,-4096011,,,,0,30513943,5711911,0,-9900105,,14901927,14901927,52019,NAN
2017-02-28,,,-47327618,,-47327618,5760036,31207274,25447238,25447238,,-3537346,,,,0,31207274,5760036,0,-72774857,,-47327618,-47327618,52019,NAN
2020-09-30,,,7951343,,7951343,4442152,34935575,30493423,30493423,,-3811417,,,,0,34935575,4442152,0,-22542080,,7951343,6748164,52020,LEO
2019-09-30,,,53260637,,53260637,4468539,37478299,33009760,33009760,,-4764410,,,,0,37478299,4468539,0,20250877,,53260637,51172389,52020,LEO
2018-09-30,,,5228610,,5228610,4874294,40091646,35217352,35217352,,-3964967,,,,0,40091646,4874294,0,-29988742,,5228610,3138634,52020,LEO
2017-09-30,,,3604408,,3604408,5213131,39196294,33983163,33983163,,-2090658,,,,0,39196294,5213131,0,-30378755,,3604408,1801546,52020,LEO
2019-12-31,,,-3953000,,-3949000,14650000,9883000,-4767000,-4767000,,-903000,,,,-4000,87891000,92658000,78008000,814000,,-3949000,-3949000,52021,SYPR
2018-12-31,,,-3710000,,-3505000,11058000,7572000,-3486000,-3486000,,-850000,,,,-205000,87969000,91455000,80397000,-224000,,-3505000,-3505000,52021,SYPR
2017-12-31,38000.0,,-11440000,,-10822000,13476000,3330000,-10184000,-10184000,,-809000,,,,-618000,82294000,92478000,78964000,-1256000,,-10822000,-10822000,52021,SYPR
2016-12-31,330000.0,,6344000,,6043000,21508000,749000,-21089000,-21089000,,-4882000,,,,301000,91797000,112886000,91048000,27433000,,6043000,5859000,52021,SYPR
2019-12-31,213866000,,-572881000,,-574781000,1116051000,749698000,-577829000,-577829000,-2390000,,,,,1900000,1023213000,1601042000,273515000,4948000,,-574781000,-574781000,52022,LAIX
2018-12-31,155154000,,-463906000,,-488066000,770837000,462493000,-463498000,-463498000,-2390000,,,,,24160000,637224000,1100722000,174731000,-408000,,-488066000,-516083000,52022,LAIX
2017-12-31,53162000,,-237154000,,-242760000,302862000,107870000,-248154000,-248154000,-2390000,,,,,5606000,165561000,413715000,57691000,11000000,,-242760000,-269577000,52022,LAIX
2016-12-31,30013000,,-89169000,,-89169000,37288000,-15171000,-82472000,-82472000,-2390000,,,,,0,12332000,94804000,27503000,-6697000,,-89169000,-104318000,52022,LAIX
2020-12-31,6173000000,,3398000000,,4616000000,9883000000,31709000000,15653000000,15653000000,,-2006000000,,,,-1224000000,45804000000,30151000000,14095000000,-12255000000,,4622000000,4616000000,52023,ABBV
2019-12-31,5377000000,,8426000000,,7882000000,6763000000,25827000000,13697000000,13697000000,-10000000.0,-1421000000,,,,544000000,33266000000,19569000000,7439000000,-5271000000,,7882000000,7842000000,52023,ABBV
2018-12-31,5259000000,,5197000000,,5687000000,7003000000,25035000000,12273000000,12273000000,500000000.0,-1348000000,,,,-490000000,32753000000,20480000000,7718000000,-7076000000,,5687000000,5657000000,52023,ABBV
2017-12-31,5007000000,,7727000000,,5309000000,6248000000,21528000000,10273000000,10273000000,500000000.0,-1150000000,,,,2418000000,28216000000,17943000000,6688000000,-2546000000,,5309000000,5283000000,52023,ABBV
2019-12-31,,,90173000,,68938000,394817000,525338000,102339000,102339000,,-10719000,,,,21235000,1478525000,1376186000,953187000,-12166000,,68938000,68938000,52024,ICFI
2018-12-31,,,82827000,,61400000,359747000,480465000,93512000,93512000,,-8710000,,,,21427000,1337973000,1244461000,857508000,-10685000,,61400000,61400000,52024,ICFI
2017-12-31,,,73986000,,62876000,346440000,457437000,82418000,82418000,,-8553000,,,,11110000,1229162000,1146744000,771725000,-10132000,,62876000,62876000,52024,ICFI
2016-12-31,,,74507000,,46584000,328048000,439960000,82793000,82793000,,-9470000,,,,27923000,1185097000,1102304000,745137000,-8286000,,46584000,46584000,52024,ICFI
2019-12-31,,,392000000,,480000000,353000000,3808000000,502000000,502000000,383000000,-280000000,,,,-88000000,5125000000,4623000000,1317000000,-110000000,,480000000,480000000,52025,MRO
2018-12-31,,,1427000000,,1096000000,408000000,4635000000,1109000000,1109000000,313000000,-280000000,,,,331000000,6052000000,4943000000,1417000000,318000000,,1096000000,1096000000,52025,MRO
2017-12-31,,,-454000000,,-5723000000,390000000,3172000000,-447000000,-447000000,219000000,-324000000,,,,376000000,4487000000,4934000000,1315000000,-7000000,-4893000000.0,-830000000,-5723000000,52025,MRO
2016-12-31,,,-1164000000,,-2140000000,473000000,1840000000,-1396000000,-1396000000,217000000,-367000000,,,,923000000,3198000000,4594000000,1358000000,232000000,-53000000.0,-2087000000,-2140000000,52025,MRO
2020-12-31,,,1499000000,,1216000000,,1658000000,1553000000,1553000000,105000000,-54000000,,,,283000000,7536000000,5983000000,5878000000,-54000000,,1216000000,1216000000,52026,CINF
2019-12-31,,,2472000000,,1997000000,,2634000000,2525000000,2525000000,109000000,-53000000,,,,475000000,7924000000,5399000000,5290000000,-53000000,,1997000000,1997000000,52026,CINF
2018-12-31,,,251000000,,287000000,,395000000,304000000,304000000,91000000,-53000000,,,,-36000000,5407000000,5103000000,5012000000,-53000000,,287000000,287000000,52026,CINF
2017-12-31,,,730000000,,1045000000,,875000000,783000000,783000000,92000000,-53000000,,,,-315000000,5732000000,4949000000,4857000000,-53000000,,1045000000,1045000000,52026,CINF
2020-02-29,,,-945200000,342500000,-11800000,1585800000,4285500000,2716600000,2716600000,-16900000,-428700000,,,,-966600000,8343500000,5626900000,4058000000,-3661800000,,21400000,-11800000,52027,STZ
2019-02-28,,,4145000000,286200000,3435900000,1482100000,4103400000,2623300000,2623300000,-2000000,-367100000,,,,685900000,8116000000,5492700000,4012600000,1521700000,,3459100000,3435900000,52027,STZ
2018-02-28,,,2338000000,16600000,2303400000,1370800000,3850300000,2490000000,2490000000,-10500000,-332000000,,,,22700000,7580300000,5090300000,3730000000,-152000000,,2315300000,2303400000,52027,STZ
2017-02-28,,,2083000000,-6400000,1528600000,1284800000,3539100000,2254300000,2254300000,-10500000,-333300000,,,,550300000,7321100000,5066800000,3782000000,-171300000,,1532700000,1528600000,52027,STZ
2020-08-31,,,386878000,9302000,422439000,697678000,981807000,284129000,284129000,,-116977000,,,,-36731000,28406365000,28122236000,27424558000,102749000,,423609000,253771000,52028,CHSCM
2019-08-31,,,815601000,7390000,829880000,691877000,1384333000,692456000,692456000,,-167065000,,,,-12456000,31900453000,31207997000,30516120000,123145000,,828057000,661212000,52028,CHSCM
2018-08-31,,,671230000,9446000,775907000,635519000,1092120000,456601000,456601000,,-149202000,,,,-104076000,32683347000,32226746000,31591227000,214629000,,775306000,607239000,52028,CHSCM
2017-08-31,,,-110166000,12505000,71592000,609590000,893877000,284287000,284287000,,-171239000,,,,-181124000,32037426000,31753139000,31143549000,-394453000,,70958000,-96051000,52028,CHSCM
2019-12-31,578500000,,-1074000000,,-929500000,1082100000,2622900000,369100000,369100000,,-577200000,,,,-144500000,8345100000,7976000000,5722200000,-1443100000,,-929500000,-973200000,52029,COMM
2018-12-31,185700000,,170700000,,140200000,687300000,1633300000,495700000,495700000,,-242000000,,,,30500000,4568500000,4072800000,2935200000,-325000000,,140200000,140200000,52029,COMM
2017-12-31,185600000,,209800000,,193800000,732100000,1705500000,516800000,516800000,,-257000000,,,,16000000,4560600000,4043800000,2855100000,-307000000,,193800000,193800000,52029,COMM
2016-12-31,201321000,,272569000,,222838000,874561000,2029250000,656166000,656166000,,-277534000,,,,49731000,4923621000,4267455000,2894371000,-383597000,,222838000,222838000,52029,COMM
2019-12-31,,,47724912,,47724912,3158263,13980620,10822357,10822357,,-5849605,,,,0,13980620,3158263,0,36902555,,47724912,47724912,52031,JDD
2018-12-31,,,-27497801,,-27497801,3343638,14068054,10724416,10724416,,-2451653,,,,0,14068054,3343638,0,-38222217,,-27497801,-27497801,52031,JDD
2017-12-31,,,29585614,,29585614,3552341,15141815,11589474,11589474,,-1560779,,,,0,15141815,3552341,0,17996140,,29585614,29585614,52031,JDD
2016-12-31,,,21275552,,21275552,3549442,14215639,10666197,10666197,,-1822693,,,,0,14215639,3549442,0,10609355,,21275552,21275552,52031,JDD
2020-06-30,,,15834000000,357000000,13027000000,20142000000,36314000000,16172000000,16172000000,,-465000000,,,,2731000000,70950000000,54778000000,34636000000,-338000000,,13103000000,12764000000,52032,PG
2019-06-30,,,6069000000,385000000,3897000000,19083000000,33437000000,14354000000,14354000000,,-509000000,,,,2103000000,67684000000,53330000000,34247000000,-8285000000,,3966000000,3634000000,52032,PG
2018-06-30,,,13326000000,590000000,9750000000,19037000000,32400000000,13363000000,13363000000,,-506000000,,,,3465000000,66832000000,53469000000,34432000000,-37000000,,9861000000,9485000000,52032,PG
2017-06-30,,,13257000000,594000000,15326000000,18654000000,32420000000,13766000000,13766000000,,-465000000,,,,3063000000,65058000000,51292000000,32638000000,-509000000,5217000000.0,10194000000,15079000000,52032,PG
2019-12-31,,,-98895000,,-98895000,9601000,-23657000,-33878000,-33878000,-1458000,-64844000,,,,0,13709000,47587000,37366000,-65017000,,-98895000,-98895000,52034,HYMCW
2018-12-31,,,-55658000,,-55803000,14303000,-5060000,-8151000,-8151000,-15716000,-50893000,,,,145000,0,8151000,5060000,-47507000,,-55803000,-55803000,52034,HYMCW
2017-12-31,,,-74293000,,-74148000,15225000,-4425000,-25201000,-25201000,1164000,-41161000,,,,-145000,0,25201000,4425000,-49092000,,-74148000,-74148000,52034,HYMCW
2014-12-31,,,-514099000,,-518925000,20658000,28482000,-56859000,-56859000,1091000,-39839000,,,,4826000,310425000,367284000,281943000,-457240000,,-518925000,-518925000,52034,HYMCW
2019-12-31,,,762092000,242679000,532318000,1572305000,2828056000,1205785000,1205785000,49966000,-10966000,,,,235890000,4000025000,2794240000,1171969000,-443693000,,526202000,532318000,52035,JOBS
2018-12-31,,,1486875000,248955000,1252319000,1550735000,2743180000,1150200000,1150200000,42245000,-37191000,,,,242434000,3781946000,2631746000,1038766000,336675000,,1244441000,1252319000,52035,JOBS
2017-12-31,,,542256000,237383000,371889000,1214392000,2117775000,870760000,870760000,32623000,-37799000,,,,169493000,2881215000,2010455000,763440000,-328504000,,372763000,371889000,52035,JOBS
2016-12-31,,,699886000,8279000,565978000,1063494000,1675333000,611839000,611839000,32623000,-37298000,,,,134699000,2338334000,1726495000,663001000,88047000,,565187000,565978000,52035,JOBS
2020-12-31,,,48764000,,36394000,32227000,89864000,0,48764000,8873000,,,,,12370000,89864000,41100000,0,0,,36394000,36394000,52038,MCBS
2019-12-31,,,60868000,,44718000,31350000,100868000,0,60868000,8650000,,,,,16150000,100868000,40000000,0,0,,44718000,44718000,52038,MCBS
2018-12-31,,,56001000,,41334000,29110000,94576000,0,56001000,9465000,,,,,14667000,94576000,38575000,0,-395000,,41334000,41334000,52038,MCBS
2017-12-31,,,50050000,,31897000,22359000,81242000,0,50050000,8833000,,,,,18153000,81242000,31192000,0,-403000,,31897000,31897000,52038,MCBS
2019-12-31,,,-53608000,3035000,-52554000,148485000,108640000,-54113000,-54113000,,-474000,,,,87000,276258000,330371000,167618000,505000,,-53695000,-52554000,52040,ONEM
2018-12-31,,,-45476000,4176000,-44415000,111597000,76498000,-45046000,-45046000,,-804000,,,,25000,212678000,257724000,136180000,-430000,,-45501000,-44415000,52040,ONEM
2017-12-31,,,-31560000,5262000,-30797000,77136000,56064000,-31758000,-31758000,,-834000,,,,126000,176769000,208527000,120705000,198000,,-31686000,-30797000,52040,ONEM
2020-12-31,,,-4334000,,-1722000,158463000,174475000,0,8285000,7727000,,,,,-2612000,174475000,166190000,0,-12619000,,-1722000,-1722000,52042,AMTBB
2019-12-31,,,64031000,,51334000,188383000,274234000,0,74306000,11545000,,,,,12697000,274234000,199928000,0,-10275000,,51334000,51334000,52042,AMTBB
2018-12-31,,,57566000,,45833000,186261000,271657000,0,75975000,9421000,,,,,11733000,271657000,195682000,0,-18409000,,45833000,45833000,52042,AMTBB
2017-12-31,,,77049000,,43057000,180045000,284685000,0,89918000,14722000,,,,,33992000,284685000,194767000,0,-12869000,,43057000,43057000,52042,AMTBB
2019-12-31,,,228137000,,196979000,14312000,905805000,221165000,221165000,452981000,-100180000,,,,31374000,1345622000,1124457000,439817000,6972000,,196763000,196979000,52043,AVA
2018-12-31,,,162658000,825000.0,136429000,5156000,902157000,259675000,259675000,448283000,-96997000,,,,26060000,1396893000,1137218000,494736000,-97017000,,136598000,136429000,52043,AVA
2017-12-31,,,198690000,656000.0,115916000,7670000,921363000,299127000,299127000,435186000,-92882000,,,,82758000,1445929000,1146802000,524566000,-100437000,,115932000,115916000,52043,AVA
2016-12-31,,,215402000,-251000.0,137228000,10058000,891117000,289803000,289803000,422082000,-84479000,,,,78086000,1442483000,1152680000,551366000,-74401000,,137316000,137228000,52043,AVA
2020-09-30,,,4494338,,4494338,2635171,13750620,11115449,11115449,,-2240036,,,,0,13750620,2635171,0,-6621111,,4494338,4494338,52044,ENX
2019-09-30,,,22075558,,22075558,2536564,14085942,11549378,11549378,,-3176592,,,,0,14085942,2536564,0,10526180,,22075558,22075558,52044,ENX
2018-09-30,,,-4416397,,-4416397,2457275,13676915,11219640,11219640,,-2779610,,,,0,13676915,2457275,0,-15636037,,-4416397,-4416397,52044,ENX
2017-09-30,,,-946002,,-946002,2586630,13980756,11394126,11394126,,-2007004,,,,0,13980756,2586630,0,-12340128,,-946002,-946002,52044,ENX
2019-12-31,,,-4976000,319850000,-12872000,231705000,482455000,109357000,109357000,,-61743000,,,,7049000,1218341000,1108984000,735886000,-114333000,,-12025000,-12872000,52045,FOCS
2018-12-31,,,-31637000,342858000,-590000,168508000,326526000,59267000,59267000,,-59946000,,,,9450000,910880000,851613000,584354000,-90904000,,-41087000,-590000,52045,FOCS
2017-12-31,,,-49860000,342858000,-48359000,134615000,233715000,28047000,28047000,,-45945000,,,,-1501000,662887000,634840000,429172000,-77907000,,-48359000,-48359000,52045,FOCS
2016-12-31,,,16703000,342858000,15722000,98643000,192405000,37140000,37140000,,-23809000,,,,981000,485444000,448304000,293039000,-20437000,,15722000,15722000,52045,FOCS
2020-12-31,,,-839243000,1467769000,-713529000,31200000,707225000,32859000,32859000,,-693656000,,,,-35367000,1348250000,1315391000,641025000,-872102000,,-803876000,-713529000,52046,BPYUP
2019-12-31,,,490594000,1594975000,432880000,28397000,993395000,463362000,463362000,,-678460000,,,,9683000,1604927000,1141565000,611532000,27232000,,480911000,416943000,52046,BPYUP
2018-12-31,,,3569583000,1627292000,4090541000,54228000,1479228000,779835000,779835000,,-576700000,,,,-594186000,2167804000,1387969000,688576000,6474645000,,4163769000,4078589000,52046,BPYUP
2017-12-31,,,655977000,352874000,657334000,67176000,1806260000,1035056000,1035056000,,-541945000,,,,-10896000,2524661000,1489605000,718401000,-379079000,,666873000,641398000,52046,BPYUP
2020-12-31,,,2007640000,,1843690000,6099294000,9271197000,3115519000,3115519000,56384000,-925936000,,,,163950000,17267812000,14152293000,7996615000,-1107879000,,1843690000,1843690000,52047,TIMB
2019-12-31,,,4774723000,,3860162000,6679393000,9943463000,3215062000,3215062000,49008000,-991167000,,,,914561000,17377194000,14162132000,7433731000,1559661000,,3860162000,3860162000,52047,TIMB
2018-12-31,,,708724000,,1533732000,1051632000,1827005000,820556000,820556000,-45183000,-57934000,,,,-825008000,3367619000,2547063000,1540614000,-111832000,,1533732000,1533732000,52047,TIMB
2017-12-31,,,66383000,,101500000,95577000,170247000,56878000,56878000,17792000,-5045000,,,,-35117000,736137000,679259000,565890000,9505000,,101500000,101500000,52047,TIMB
2020-01-26,2829000000,,2970000000,,2796000000,1093000000,6768000000,2846000000,2846000000,,-52000000,,,,174000000,10918000000,8072000000,4150000000,124000000,,2796000000,2796000000,52048,NVDA
2019-01-27,2376000000,,3896000000,,4141000000,991000000,7171000000,3804000000,3804000000,,-58000000,,,,-245000000,11716000000,7912000000,4545000000,92000000,,4141000000,4141000000,52048,NVDA
2018-01-28,1797000000,,3196000000,,3047000000,815000000,5822000000,3210000000,3210000000,,-61000000,,,,149000000,9714000000,6504000000,3892000000,-14000000,,3047000000,3047000000,52048,NVDA
2017-01-29,1463000000,,1905000000,,1666000000,663000000,4063000000,1937000000,1937000000,,-58000000,,,,239000000,6910000000,4973000000,2847000000,-32000000,,1666000000,1666000000,52048,NVDA
2019-12-31,,,-13186000,,-18360000,18676000,122499000,55705000,55705000,719000,-16818000,,,,7138000,281697000,225992000,159198000,-68891000,,-20324000,-18360000,52049,EQX
2018-12-31,,,-37070000,14519000.0,-65534000,16461000,11131000,-32046000,-32046000,383000,-6315000,,,,2335000,30159000,62205000,19028000,-5024000,-27491000.0,-39405000,-65534000,52049,EQX
2017-12-31,,,-12581000,8131000.0,-17342000,10320000,-8754000,-27676000,-27676000,326000,-3100000,,,,308000,0,27676000,8754000,15095000,-4453000.0,-12889000,-17342000,52049,EQX
2016-12-31,,,-2711000,1156000.0,-2404000,1140000,-1224000,-3397000,-3397000,326000,-409000,,,,0,887000,4284000,2111000,686000,-4453000.0,-2711000,-2404000,52049,EQX
2020-12-31,,,-266000000,,-266000000,56000000,-173000000,0,-266000000,37000000,,,,,0,-173000000,93000000,0,0,,-266000000,-362000000,52050,AGNCN
2019-12-31,,,688000000,,688000000,47000000,771000000,0,688000000,35500000,,,,,0,771000000,83000000,0,0,,688000000,628000000,52050,AGNCN
2018-12-31,,,129000000,,129000000,45000000,229000000,0,156000000,27500000,,,,,0,229000000,73000000,0,-27000000,,129000000,93000000,52050,AGNCN
2017-12-31,,,771000000,,771000000,42000000,844000000,0,771000000,30500000,,,,,0,844000000,73000000,0,0,,771000000,733000000,52050,AGNCN
2019-12-31,275367000,,-634916000,936000,-637396000,696173000,370622000,-600918000,-600918000,,-18169000,,,,2432000,1304883000,1905801000,934261000,-33998000,,-637348000,-637396000,52051,DAO
2018-12-31,184020000,,-228312000,888000,-239221000,251582000,216465000,-219137000,-219137000,,-23507000,,,,11294000,731598000,950735000,515133000,-9175000,,-239606000,-239221000,52051,DAO
2017-12-31,133092000,,-158770000,-243080000,-133577000,158888000,161939000,-130041000,-130041000,,-29327000,,,,5162000,455746000,585787000,293807000,-28729000,,-163932000,-133577000,52051,DAO
2020-06-30,1528062,,-8372388,614669,-8441559,8083041,3591370,-6019733,-6019733,,,,,,164537,19171358,25191091,15579988,-2352655,,-8536925,-8441559,52052,DOGZ
2019-06-30,673131,,1783474,117486,1421781,8117304,9430005,639570,639570,,,,,,380296,26216515,25576945,16786510,1143904,,1403178,1421781,52052,DOGZ
2018-06-30,580379,,5529080,117486,4603708,5612984,12134587,5941224,5941224,,-23961.0,,,,925372,30135295,24194071,18000708,-412144,,4603708,4603708,52052,DOGZ
2017-06-30,208447,,5888961,117486,4945764,2317007,8334872,5809418,5809418,,-332249.0,,,,943197,21172091,15362673,12837219,79543,,4945764,4945764,52052,DOGZ
2020-12-31,,,1298000000,,1057000000,3447000000,5289000000,0,1423000000,419000000,,,,,241000000,5289000000,3866000000,0,-125000000,,1057000000,950000000,52053,CFG
2019-12-31,,,2251000000,,1791000000,3483000000,6098000000,0,2251000000,364000000,,,,,460000000,6098000000,3847000000,0,0,,1791000000,1718000000,52053,CFG
2018-12-31,,,2183000000,,1721000000,3253000000,5802000000,0,2183000000,366000000,,,,,462000000,5802000000,3619000000,0,-54000000,,1721000000,1692000000,52053,CFG
2017-12-31,,,1912000000,,1652000000,3037000000,5386000000,0,1912000000,437000000,,,,,260000000,5386000000,3474000000,0,2000000,,1652000000,1638000000,52053,CFG
2019-12-31,,,-25414000,335000,-23369000,16730000,177610000,-2266000,-2266000,,-47453000,,,,0,210348000,212614000,32738000,-23148000,956000,-25414000,-53369000,52054,NRP
2018-12-31,,,122360000,2079000,137346000,16496000,173256000,116791000,116791000,,-70178000,,,,0,202765000,85974000,29509000,5569000,17687000,122360000,107346000,52054,NRP
2017-12-31,,,82485000,-1537000,87403000,18502000,177440000,132557000,132557000,,-82028000,,,,0,202323000,69766000,24883000,-50072000,6182000,82485000,61950000,52054,NRP
2016-12-31,,,90626000,-2507000,95229000,20570000,180225000,114088000,114088000,,-90531000,,,,0,210115000,96027000,29890000,-23462000,6266000,90626000,95229000,52054,NRP
2019-12-31,,,-1300200000,1467700000,62100000,,9610900000,6340500000,6340500000,2902000000,-2608300000,,,,-1733000000,72925400000,66584900000,63314500000,-7640700000,,432800000,62100000,52055,SBSW
2018-12-31,,,-1436900000,936000000,-2499600000,,2527400000,742800000,742800000,1414200000,-2630500000,,,,1083800000,50656400000,49913600000,48129000000,-2179700000,,-2520700000,-2499600000,52055,SBSW
2017-12-31,,,-7379700000,19800000,-4437400000,,3729200000,709000000,709000000,1289800000,-2568300000,,,,-2946600000,45911600000,45202600000,42182400000,-8088700000,,-4433100000,-4437400000,52055,SBSW
2016-12-31,,,4244800000,17700000,3473300000,,6489700000,5211500000,5211500000,782000000,-611700000,,,,1202100000,31240700000,26029200000,24751000000,-966700000,,3042700000,3473300000,52055,SBSW
2019-12-31,,,900224000,,681070000,92770000,1333834000,878816000,878816000,-63755000,-54952000,,,,219154000,1985469000,1106653000,651635000,21408000,,681070000,681070000,52060,COG
2018-12-31,,,698137000,,557043000,96641000,1393141000,786991000,786991000,-21790000,-73201000,,,,141094000,2143716000,1356725000,750575000,-88854000,,557043000,557043000,52060,COG
2017-12-31,,,-228435000,,100393000,97786000,1148292000,-39209000,-39209000,16561000,-82130000,,,,-328828000,1747293000,1786502000,599001000,-189226000,,100393000,100393000,52060,COG
2016-12-31,,,-659599000,,-417124000,85633000,646604000,-560611000,-560611000,68173000,-88336000,,,,-242475000,1194627000,1755238000,548023000,-98988000,,-417124000,-417124000,52060,COG
2020-05-31,,,-89700000,1400000,-43800000,705100000,736100000,-30500000,-30500000,,-3000000,,,,-46000000,1487100000,1517600000,751000000,-59200000,,-43700000,-43800000,52062,SCHL
2019-05-31,,,26000000,1300000,15600000,782300000,874000000,35600000,35600000,,-2200000,,,,10400000,1653900000,1618300000,779900000,-9600000,,15600000,15500000,52062,SCHL
2018-05-31,,,-1500000,1300000,-5000000,766600000,883900000,75900000,75900000,,-2000000,,,,3500000,1628400000,1552500000,744500000,-77400000,,-5000000,-5000000,52062,SCHL
2017-05-31,,,87900000,1300000,52300000,777800000,927600000,111100000,111100000,,-2400000,,,,35400000,1741600000,1630500000,814000000,-23200000,-200000.0,52500000,52200000,52062,SCHL
2020-07-31,,,17862946,,17862946,2964506,19650558,16686052,16686052,,-3013478,,,,0,19650558,2964506,0,1176894,,17862946,17862946,52063,MUE
2019-07-31,,,21719105,,21719105,2872502,20252747,17380245,17380245,,-4544609,,,,0,20252747,2872502,0,4338860,,21719105,21719105,52063,MUE
2018-07-31,,,1945798,,1945798,2965766,22346985,19381219,19381219,,-3899353,,,,0,22346985,2965766,0,-17435421,,1945798,1945798,52063,MUE
2017-07-31,,,-2788765,,-2788765,3061216,22965716,19904500,19904500,,-3123902,,,,0,22965716,3061216,0,-22693265,,-2788765,-2788765,52063,MUE
2019-12-31,,,74631810,,74631810,3843351,4956455,1113104,1113104,,-730938,,,,0,4956455,3843351,0,73518706,,74631810,74631810,52065,RMT
2018-12-31,,,-47150600,,-47150600,4385807,6054734,1668927,1668927,,-1239044,,,,0,6054734,4385807,0,-48819527,,-47150600,-47150600,52065,RMT
2017-12-31,,,60920086,,60920086,2352675,5489050,3136375,3136375,,-1010324,,,,0,5489050,2352675,0,57783711,,60920086,60920086,52065,RMT
2016-12-31,,,64356538,,64356538,3304528,5120047,1815519,1815519,,-775138,,,,0,5120047,3304528,0,62541019,,64356538,64356538,52065,RMT
2019-12-31,,,-1336,,-1336,,0,0,,,,,,,0,0,0,0,-1336,,-1336,-1336,52068,ROCC
2020-02-01,,,4190000000,,3281000000,16163000000,23248000000,4728000000,4728000000,,-467000000,,,,921000000,78112000000,73384000000,54864000000,-538000000,12000000,3269000000,3281000000,52069,TGT
2019-02-02,,,3676000000,,2937000000,15606000000,22057000000,4227000000,4227000000,,-461000000,,,,746000000,75356000000,71129000000,53299000000,-551000000,7000000,2930000000,2937000000,52069,TGT
2018-02-03,,,3630000000,,2914000000,14990000000,21589000000,4374000000,4374000000,,-530000000,,,,722000000,72714000000,68340000000,51125000000,-744000000,6000000,2908000000,2914000000,52069,TGT
2017-01-28,,,3961000000,,2734000000,14086000000,21126000000,4995000000,4995000000,,-569000000,,,,1295000000,70271000000,65276000000,49145000000,-1034000000,68000000,2666000000,2734000000,52069,TGT
2019-12-31,,,-35034000,792000,-42058000,57647000,40376000,-17271000,-17271000,,-16835000,,,,4190000,554868000,572139000,514492000,-17763000,,-39224000,-42058000,52070,CHRA
2018-12-31,,,-8843000,805000,-8902000,45312000,97728000,52416000,52416000,,-19726000,,,,-2427000,740462000,688046000,642734000,-61259000,,-6416000,-8902000,52070,CHRA
2017-12-31,,,15032000,598000,12788000,51665000,84160000,32495000,32495000,,-18327000,,,,0,430369000,397874000,346209000,-27663000,,15032000,18316000,52070,CHRA
2016-12-31,,,23129000,686000,20931000,35170000,61840000,26670000,26670000,,-6244000,,,,0,265068000,238398000,203228000,-3541000,,23129000,20931000,52070,CHRA
2019-12-31,,,-11093000,,-11230000,19927000,48743000,19071000,19071000,,-10930000,,,,137000,238296000,219225000,189553000,-30164000,,-11230000,-11230000,52071,DMS
2018-12-31,,,1403000,,1403000,12104000,34107000,16708000,16708000,,-4614000,,,,0,137681000,120973000,103574000,-15305000,,1403000,1403000,52071,DMS
2017-12-31,,,4275000,,4275000,9758000,16938000,5035000,5035000,,-800000,,,,0,66794000,61759000,49856000,-760000,,4275000,4275000,52071,DMS
2020-12-31,,,209445000,,164089000,324527000,577434000,0,226613000,26294000,,,,,45356000,577434000,350821000,0,-17168000,,164089000,159269000,52074,UCBI
2019-12-31,,,238712000,,185721000,280991000,559307000,0,250581000,25976000,,,,,52991000,559307000,308726000,0,-11869000,,185721000,184346000,52074,UCBI
2018-12-31,,,215926000,,166111000,259643000,522211000,0,236677000,25553000,,,,,49815000,522211000,285534000,0,-20751000,,166111000,164927000,52074,UCBI
2017-12-31,,,172834000,,67821000,221857000,440445000,0,197418000,20187000,,,,,105013000,440445000,243027000,0,-24584000,,67821000,67250000,52074,UCBI
2020-12-31,80251000,,446191000,66118000,350576000,366017000,957654000,479106000,479106000,,-32991000,,,,98973000,2485200000,2006094000,1527546000,-32915000,,347218000,350576000,52077,GNRC
2019-12-31,68394000,,319607000,61696000,252007000,328551000,797752000,372163000,372163000,,-41544000,,,,67299000,2204336000,1832173000,1406584000,-52556000,,252308000,253260000,52077,GNRC
2018-12-31,50019000,,311076000,61716000,238257000,295728000,725040000,357181000,357181000,,-40956000,,,,69856000,2023464000,1666283000,1298424000,-46105000,,241220000,220287000,52077,GNRC
2017-12-31,42869000,,203699000,44208000,157808000,262422000,584786000,250634000,250634000,,-42667000,,,,44142000,1679373000,1428739000,1094587000,-46935000,,159557000,158717000,52077,GNRC
2020-03-31,,,-5228000000,344000000,-5369000000,1074000000,4676000000,1660000000,1660000000,,-383000000,,,,130000000,19577000000,17917000000,14901000000,-6888000000,,-5358000000,-5369000000,52078,DXC
2019-03-31,,,1515000000,323000000,1257000000,1376000000,5807000000,2463000000,2463000000,,-334000000,,,,288000000,20753000000,18290000000,14946000000,-948000000,35000000.0,1227000000,1257000000,52078,DXC
2018-03-31,,,1304000000,350000000,1751000000,1381000000,5416000000,2240000000,2240000000,,-320000000,,,,-242000000,21733000000,19493000000,16317000000,-936000000,236000000.0,1546000000,1751000000,52078,DXC
2017-03-31,,,-174000000,278000000,-123000000,1258000000,2058000000,153000000,153000000,,-117000000,,,,-74000000,7607000000,7454000000,5549000000,-327000000,236000000.0,-100000000,-123000000,52078,DXC
2019-12-31,22457000,,-36036000,,-36320000,15122000,0,-37579000,-37579000,,-19000,,,,284000,0,37579000,0,1543000,,-36320000,-36320000,52079,CHMA
2018-12-31,22362000,,-31292000,,-31261000,9974000,0,-32336000,-32336000,,-6000,,,,-31000,0,32336000,0,1044000,,-31261000,-31261000,52079,CHMA
2017-12-31,17948000,,-27416000,,-26826000,9146000,0,-27094000,-27094000,,-131000,,,,-590000,0,27094000,0,-322000,,-26826000,-26826000,52079,CHMA
2016-12-31,31317000,,-60764000,,-61111000,21815000,0,-53132000,-53132000,,-264000,,,,347000,0,53132000,0,-7632000,,-61111000,-61111000,52079,CHMA
2020-09-30,22859000,,9409000,,7814000,46730000,88118000,18529000,18529000,,,,,,1595000,101310000,82781000,13192000,-9120000,,7814000,7814000,52080,MITK
2019-09-30,21873000,,-3988000,,-724000,45411000,72324000,5040000,5040000,,,,,,-3264000,84590000,79550000,12266000,-9028000,,-724000,-724000,52080,MITK
2018-09-30,18118000,,-8741000,,-11807000,36321000,54873000,434000,434000,,,,,,3066000,63559000,63125000,8686000,-9175000,,-11807000,-11807000,52080,MITK
2017-09-30,10430000,,3171000,,14092000,25794000,41349000,5125000,5125000,,,,,,-10921000,45390000,40265000,4041000,-1954000,,14092000,14092000,52080,MITK
2019-12-31,265011000,,-60919000,,-59937000,291372000,495224000,-61159000,-61159000,,-2366000,,,,-982000,1128921000,1190080000,633697000,240000,,-59937000,-59937000,52081,ROKU
2018-12-31,170692000,,-9333000,,-8857000,174752000,332148000,-13296000,-13296000,,-346000,,,,-476000,742506000,755802000,410358000,3963000,,-8857000,-8857000,52081,ROKU
2017-12-31,107945000,,-63194000,,-63509000,111504000,199833000,-19616000,-19616000,,-1612000,,,,315000,512763000,532379000,312930000,-43578000,,-63509000,-63509000,52081,ROKU
2016-12-31,76177000,,-42547000,,-42758000,88229000,121045000,-43361000,-43361000,,-1612000,,,,211000,398649000,442010000,277604000,814000,,-42758000,-42758000,52081,ROKU
2020-08-31,,,123195,,123195,1064521,5178787,4114266,4114266,,-469175,,,,0,5178787,1064521,0,-3991071,,123195,123195,52082,ERH
2019-08-31,,,13037169,,13037169,1198520,9521715,8323195,8323195,,-684225,,,,0,9521715,1198520,0,4713974,,13037169,13037169,52082,ERH
2018-08-31,,,-1406988,,-1406988,1145534,9493006,8347472,8347472,,-552279,,,,0,9493006,1145534,0,-9754460,,-1406988,-1406988,52082,ERH
2017-08-31,,,15097019,,15097019,1115229,9578869,8463640,8463640,,-342098,,,,0,9578869,1115229,0,6633379,,15097019,15097019,52082,ERH
2021-01-02,,,-183122000,,-75579000,1744927000,2557215000,812288000,812288000,,-166491000,,,,-107543000,6664350000,5852062000,4107135000,-995410000,,-75579000,-75579000,52083,HBI
2019-12-28,51520000.0,,679727000,,600720000,1783251000,2777597000,934168000,934168000,,-182192000,,,,79007000,6966923000,6032755000,4189326000,-254441000,,600720000,600720000,52083,HBI
2018-12-29,59313000.0,,643581000,,539666000,1692018000,2691574000,924430000,924430000,,-194675000,,,,103915000,6803955000,5879525000,4112381000,-280849000,,539666000,539666000,52083,HBI
2017-12-30,65457000.0,,529095000,,73881000,1564419000,2544421000,907903000,907903000,,-174435000,,,,453117000,6471410000,5563507000,3926989000,-378808000,-2097000.0,75978000,73881000,52083,HBI
2020-12-31,,,6240000,,4303000,26877000,44049000,0,6240000,10932000,,,,,1937000,44049000,37809000,0,0,,4303000,4303000,52084,CALB
2019-12-31,,,9637000,,7001000,25466640,42860000,0,9637000,6965970,,,,,2636000,42860000,33223000,0,0,,7001000,7001000,52084,CALB
2018-12-31,,,11742000,,8713000,19272370,38113000,0,11742000,6120283,,,,,3029000,38113000,26371000,0,0,,8713000,8713000,52084,CALB
2017-12-31,,,11286319,,5627418,15413608,32231594,0,11286319,4797588,,,,,5658901,32231594,20945275,0,0,,5627418,5627418,52084,CALB
2019-12-31,14467000,,-3944000,,-3913000,15827000,24157000,-6137000,-6137000,,-16000,,,,-31000,65623000,71760000,41466000,2193000,,-3913000,-3913000,52086,UTSI
2018-12-31,12745000,,4442000,,4820000,15156000,32268000,4367000,4367000,,-47000,,,,-378000,115944000,111577000,83676000,75000,,4820000,4820000,52086,UTSI
2017-12-31,9853000,,8244000,,6981000,16777000,33146000,6516000,6516000,,-48000,,,,1263000,98292000,91776000,65146000,1728000,,6981000,6981000,52086,UTSI
2016-12-31,8502000,,920000,,290000,18146000,28356000,1708000,1708000,,-55000,,,,788000,86512000,84804000,58156000,-788000,,132000,290000,52086,UTSI
2019-12-31,,,32296000,79733000,11725000,193803000,299317000,63388000,63388000,,-14342000,,,,4476000,795122000,731734000,495805000,-31092000,,27820000,11725000,52087,FNKO
2018-12-31,,,30494000,138546000,7463000,154290000,255327000,61921000,61921000,,-21739000,,,,5432000,686073000,624152000,430746000,-31427000,,25062000,7463000,52087,FNKO
2017-12-31,,,7252000,149988000,3939000,120944000,201999000,49080000,49080000,,-30636000,,,,1266000,516084000,467004000,314085000,-41828000,,5986000,1038000,52087,FNKO
2016-12-31,,,26880000,149988000,26880000,67466000,159755000,68780000,68780000,,-17267000,,,,0,426717000,357937000,266962000,-41900000,,26880000,26880000,52087,FNKO
2020-12-31,,,20630000,,16136000,30085000,58633000,0,25360000,3188000,,,,,4494000,58633000,33273000,0,-4730000,,16136000,16136000,52089,TCFC
2019-12-31,,,20937000,,15272000,30589000,57170000,0,22922000,3659000,,,,,5665000,57170000,34248000,0,-1985000,,15272000,15272000,52089,TCFC
2018-12-31,,,15401000,,11228000,29104000,53550000,0,21121000,3325000,,,,,4173000,53550000,32429000,0,-5720000,,11228000,11228000,52089,TCFC
2017-12-31,,,16365000,,7208000,25045000,46419000,0,18535000,2839000,,,,,9157000,46419000,27884000,0,-2170000,,7208000,7208000,52089,TCFC
2019-12-31,1486056,,-4132873,,-4132873,2007362,177635,-3315783,-3315783,,-819482,,,,0,177635,3493418,0,-817090,,-4132873,-4132873,52090,KBNT
2018-12-31,2058660,,-3729097,,-3729097,1820942,106422,-3773180,-3773180,,-51129,,,,0,106422,3879602,0,44083,,-3729097,-3729097,52090,KBNT
2017-12-31,2058660,,-1283446,,-1283446,1613736,330290,-1283446,-1283446,,-51129,,,,0,330290,1613736,0,0,,-1283446,-1283446,52090,KBNT
2019-12-31,,,-13313000,,-13243000,9623000,219000,-9404000,-9404000,,-2343000,,,,-70000,3127000,12531000,2908000,-3909000,,-13243000,-13243000,52091,PRPO
2018-12-31,,,-15973000,,-15694000,9452000,225000,-9227000,-9227000,,-1597000,,,,-279000,2864000,12091000,2639000,-6746000,,-15694000,-19916000,52091,PRPO
2017-12-31,,,-20694000,,-20694000,6488000,292000,-6196000,-6196000,,-2324000,,,,0,1723000,7919000,1431000,-14498000,,-20694000,-33209000,52091,PRPO
2016-12-31,,,-2227000,,-2227000,2465000,753000,-1712000,-1712000,,-518000,,,,0,1723000,3435000,970000,-515000,,-2227000,-4082000,52091,PRPO
2019-12-31,,,75728000,,58129000,94212000,165971000,71529000,71529000,,-200000,,,,17599000,1274994000,1203465000,1109023000,4199000,,58129000,58129000,52092,WIRE
2018-12-31,,,101684000,,78150000,90212000,189722000,99510000,99510000,,-300000,,,,23534000,1288683000,1189173000,1098961000,4348000,,78150000,78150000,52092,WIRE
2017-12-31,,,79876000,,67017000,76715000,156175000,79449000,79449000,,-200000,,,,12859000,1164248000,1084799000,1008073000,427000,,67017000,67017000,52092,WIRE
2016-12-31,,,50814000,,33839000,69322000,120117000,50766000,50766000,,-200000,,,,16975000,940790000,890024000,820673000,48000,,33839000,33839000,52092,WIRE
2019-12-31,,,-90719000,-126634000,-60591000,1136935000,1329892000,133025000,133025000,,-109471000,,,,29582000,4892019000,4758994000,3562127000,-223744000,,-120301000,-60591000,52095,CWH
2018-12-31,,,96371000,-11621000,10398000,1069359000,1362932000,244251000,244251000,,-101644000,,,,30790000,4792017000,4547766000,3429085000,-147880000,,65581000,10398000,52095,CWH
2017-12-31,,,385602000,21252000,29853000,853160000,1240914000,356209000,356209000,,-70649000,,,,154910000,4279830000,3923621000,3038916000,29393000,,230692000,29853000,52095,CWH
2016-12-31,,,204276000,-114397000,188885000,691884000,993733000,277154000,277154000,,-67172000,,,,5800000,3516307000,3239153000,2522574000,-72878000,,198476000,1522000,52095,CWH
2019-12-31,1284000,,-7363000,,-7373000,7449000,1974000,-6759000,-6759000,,-317000,,,,10000,12705000,19464000,10731000,-604000,,-7373000,-7373000,52097,EFOI
2018-12-31,2597000,,-9100000,,-9111000,9789000,3412000,-8974000,-8974000,,-8000,,,,11000,18107000,27081000,14695000,-126000,,-9111000,-9111000,52097,EFOI
2017-12-31,2940000,,-11382000,,-11267000,11315000,4821000,-9434000,-9434000,,-2000,,,,-115000,19846000,29280000,15025000,-2047000,,-11267000,-11267000,52097,EFOI
2016-12-31,3537000,,-16848000,,-16887000,20113000,7677000,-15973000,-15973000,,-2000,,,,27000,30998000,46971000,23321000,-875000,-12000.0,-16875000,-16887000,52097,EFOI
2020-01-31,,,-2272846,-2229705,-1741688,2743519,3130915,-1027809,-1027809,513541,-566682,,,,-294402,6568171,7595980,3437256,-1245037,,-1978444,-1741688,52098,IHT
2019-01-31,,,-1577783,-1471912,1419701,2918208,2815822,-1305124,-1305124,357045,-381310,,,,407727,6168965,7474089,3353143,-272659,13091393.0,-1985510,1419701,52098,IHT
2018-01-31,,,-1821545,-1551940,1397601,3186463,2581962,-1594011,-1594011,270279,-332533,,,,341000,5566203,7160214,2984241,-227534,8970446.0,-2162545,1397601,52098,IHT
2017-01-31,,,-2814990,-805931,-2191972,5378319,4824908,-2355467,-2355467,339484,-489792,,,,-227568,9197179,11552646,4372271,-459523,-39332.0,-2587422,-2191972,52098,IHT
2019-12-31,,,-86372000,,-86372000,46613000,-39189000,-85802000,-85802000,,-6101000,,,,0,4227000,90029000,43416000,-570000,,-86372000,-86372000,52099,OCUL
2018-12-31,,,-59978000,,-59978000,23728000,-35390000,-59118000,-59118000,,-1739000,,,,0,1990000,61108000,37380000,-860000,,-59978000,-59978000,52099,OCUL
2017-12-31,,,-63386000,,-63386000,30693000,-28724000,-59417000,-59417000,,-1892000,,,,0,1923000,61340000,30647000,-3969000,,-63386000,-63386000,52099,OCUL
2016-12-31,,,-44703000,,-44703000,17705000,-25621000,-43326000,-43326000,,-1680000,,,,0,1887000,45213000,27508000,-1377000,,-44703000,-44703000,52099,OCUL
2018-12-31,,,-23000,,-23000,,12260000,0,-554000,12814000,,,,,0,12260000,12814000,0,531000,,-23000,-23000,52101,GBNY
2017-12-31,,,715000,,715000,,11382000,0,715000,10667000,,,,,0,11382000,10667000,0,0,,715000,715000,52101,GBNY
2016-12-31,,,-1951000,,-1495000,,9012000,0,-1951000,10963000,,,,,-456000,9012000,10963000,0,0,,-1495000,-1495000,52101,GBNY
2015-12-31,,,1537000,,1092000,,11673000,0,1537000,10136000,,,,,445000,11673000,10136000,0,0,,1092000,1092000,52101,GBNY
2019-12-31,,,37590000,,28844000,26213000,64053000,37840000,37840000,,-702000,,,,8746000,168956000,131116000,104903000,-250000,,28844000,28844000,52102,LEGH
2018-12-31,,,30645000,,21513000,21846000,54646000,32800000,32800000,,-2507000,,,,9132000,161877000,129077000,107231000,-2155000,,21513000,21513000,52102,LEGH
2017-12-31,,,26472000,,26348000,18143000,46238000,28095000,28095000,,-2044000,,,,124000,128736000,100641000,82498000,-1623000,,26348000,26348000,52102,LEGH
2016-12-31,,,17497000,,17339000,14791000,33216000,18425000,18425000,,-1244000,,,,158000,110545000,92120000,77329000,-928000,,17339000,17339000,52102,LEGH
2021-01-03,,,469700000,,401900000,688700000,1180900000,492200000,492200000,,-15300000,,,,67800000,3086200000,2594000000,1905300000,-22500000,,401900000,401900000,52105,TDY
2019-12-29,,,473700000,,402300000,741200000,1244100000,502900000,502900000,,-22000000,,,,71400000,3163600000,2660700000,1919500000,-29200000,,402300000,402300000,52105,TDY
2018-12-30,,,393900000,,333800000,677800000,1115700000,437900000,437900000,,-29200000,,,,60100000,2901800000,2463900000,1786100000,-44000000,,333800000,333800000,52105,TDY
2017-12-31,,,287000000,,227200000,629800000,988300000,358500000,358500000,,-33200000,,,,59800000,2603800000,2245300000,1615500000,-71500000,,227200000,227200000,52105,TDY
2020-06-30,19440916,,15241709,,10634709,56873446,91580566,15266204,15266204,,-619398,,,,4607000,104670769,89404565,13090203,-24495,,10634709,10634709,52108,ABST
2019-06-30,20291140,,11110150,,7579150,54441852,85634051,10901059,10901059,,-619398,,,,3531000,98909025,88007966,13274974,209091,,7579150,7579150,52108,ABST
2018-06-30,20516523,,2859853,,3110853,55651851,79046749,2878375,2878375,,-1128,,,,-251000,93621832,90743457,14575083,-18522,,3110853,3110853,52108,ABST
2017-06-30,17381818,,-2007177,,-4951177,59044361,77216485,790306,790306,,-454,,,,2944000,91210550,90420244,13994065,-2797483,,-4951177,-4951177,52108,ABST
2020-12-31,,,-3126000,,342000,63930000,69322000,0,5392000,,,,,,-3468000,69322000,63930000,0,-8518000,,342000,339000,52109,MRLN
2019-12-31,,,36853000,,27116000,70081000,107186000,0,36853000,252000.0,,,,,9737000,107186000,70333000,0,-1181000,,27116000,26777000,52109,MRLN
2018-12-31,,,32701000,,24980000,64031000,97366000,0,32701000,634000.0,,,,,7721000,97366000,64665000,0,0,,24980000,24548000,52109,MRLN
2017-12-31,,,23636000,,25292000,65193000,89477000,0,23636000,648000.0,,,,,-1656000,89477000,65841000,0,-4700000,,25292000,24664000,52109,MRLN
2019-12-31,146573000,,72210000,,67062000,236780000,640841000,145956000,145956000,,-64033000,,,,5148000,1258294000,1112338000,617453000,-73746000,,67062000,67062000,52110,ACIW
2018-12-31,143630000,,91799000,,68921000,218903000,579429000,132311000,132311000,,-41530000,,,,22878000,1009780000,877469000,430351000,-40512000,,68921000,68921000,52110,ACIW
2017-12-31,136921000,,43572000,,5135000,211817000,571905000,133740000,133740000,,-39013000,,,,38437000,1024191000,890451000,452286000,-90168000,,5135000,5135000,52110,ACIW
2016-12-31,169900000,,185581000,,129535000,226699000,560787000,74667000,74667000,,-40184000,,,,56046000,1005701000,931034000,444914000,110914000,,129535000,129535000,52110,ACIW
2019-12-31,,,-82442000,140531000,-88234000,37028000,537983000,211930000,211930000,,-180112000,,,,436000,1040155000,828225000,502172000,-294372000,,-82878000,-88234000,52112,DHCNL
2018-12-31,,,292890000,156758000,286872000,85885000,665389000,293269000,293269000,,-179287000,,,,476000,1117164000,823895000,451775000,-379000,,292414000,286872000,52112,DHCNL
2017-12-31,,,152257000,172238000,147610000,103694000,660834000,280279000,280279000,,-165019000,,,,454000,1074729000,794450000,413895000,-128022000,,151803000,147610000,52112,DHCNL
2016-12-31,,,141719000,172238000,141295000,46559000,656147000,321757000,321757000,,-167574000,,,,424000,1058022000,736265000,401875000,-180038000,,141295000,141295000,52112,DHCNL
2019-12-28,,,135194000,,96654000,789686000,1015174000,225488000,225488000,,-35787000,,,,38540000,2548839000,2323351000,1533665000,-90294000,,96654000,96654000,52118,KTB
2018-12-29,,,340078000,,263073000,772436000,1125863000,353427000,353427000,,-1173000,,,,77005000,2763998000,2410571000,1638135000,-13349000,,263073000,263073000,52118,KTB
2017-12-30,,,359153000,,116191000,808003000,1174962000,366959000,366959000,,-1263000,,,,242962000,2830106000,2463147000,1655144000,-7806000,,116191000,116191000,52118,KTB
2016-12-31,,,410487000,,315030000,803013000,1233645000,430632000,430632000,,-1263000,,,,95457000,2926464000,2495832000,1692819000,-20145000,,315030000,315030000,52118,KTB
2020-07-31,,,-23381530,,-23381530,4973132,29697521,24724389,24724389,,-24557680,,,,0,29697521,4973132,0,-48105919,,-23381530,-23381530,52119,PPT
2019-07-31,,,22142837,,22142837,5232911,33097318,27864407,27864407,,-7547793,,,,0,33097318,5232911,0,-5721570,,22142837,22142837,52119,PPT
2018-07-31,,,35940669,,35940669,5500063,38588032,33087969,33087969,,23383683,,,,0,38588032,5500063,0,2852700,,35940669,35940669,52119,PPT
2017-07-31,,,63665036,,63665036,5446072,36199191,30753119,30753119,,14629291,,,,0,36199191,5446072,0,32911917,,63665036,63665036,52119,PPT
2020-12-31,,,685765000,,567797000,529353000,1332005000,0,709633000,93019000,,,,,117968000,1332005000,622372000,0,-23868000,,567797000,567797000,52121,EWBC
2019-12-31,,,843917000,,674035000,529721000,1492990000,0,856845000,106424000,,,,,169882000,1492990000,636145000,0,-12928000,,674035000,674035000,52121,EWBC
2018-12-31,,,818696000,,703701000,504341000,1412064000,0,808437000,99286000,,,,,114995000,1412064000,603627000,0,10259000,,703701000,703701000,52121,EWBC
2017-12-31,,,735100000,,505624000,456854000,1304794000,0,755028000,92912000,,,,,229476000,1304794000,549766000,0,-19928000,,505624000,505624000,52121,EWBC
2019-12-31,,,233507174,101650383,68344527,250447619,560309621,309862002,309862002,,-113775360,,,,150478372,2482632812,2172770810,1922323191,-76354828,,83028802,68344527,52122,XIN
2018-12-31,,,250399267,65274668,73034549,240047821,615478302,375430481,375430481,,-99245696,,,,144447247,2217551285,1842120804,1602072983,-125031214,,105952020,73034549,52122,XIN
2017-12-31,,,193228531,64441277,63627551,212568458,459628213,247059755,247059755,,-66153440,,,,113117126,1976907231,1729847476,1517279018,-53831224,,80111405,63627551,52122,XIN
2016-12-31,,,165710555,15891713,72977548,178629347,357988313,179358966,179358966,,-29856832,,,,86247875,1561624693,1382265727,1203636380,-13648411,,79462680,72977548,52122,XIN
2019-12-31,,,-61039000,,-61081000,193058000,175733000,-48176000,-48176000,10000,-8943000,,,,42000,454868000,503044000,279135000,-12863000,,-61081000,-61081000,52123,APRN
2018-12-31,,,-122061000,,-122149000,311795000,234104000,-112178000,-112178000,-30000,-7683000,,,,88000,667600000,779778000,433496000,-9883000,,-122149000,-122149000,52123,APRN
2017-12-31,,,-210128000,,-210143000,402436000,253227000,-176204000,-176204000,157000,-6384000,,,,15000,881191000,1057395000,627964000,-33924000,,-210143000,-210143000,52123,APRN
2016-12-31,,,-54778000,,-54886000,309320000,262734000,-54803000,-54803000,157000,-6384000,,,,108000,795416000,850219000,532682000,25000,,-54886000,-54886000,52123,APRN
2020-12-31,,,13294000,,10340000,37120000,54758000,0,13749000,3889000,,,,,2954000,54758000,41009000,0,-455000,,10340000,10340000,52124,FNWB
2019-12-31,,,11091000,,9014000,29349000,44208000,0,11517000,3342000,,,,,2077000,44208000,32691000,0,-426000,,9014000,9014000,52124,FNWB
2018-12-31,,,8680000,,7105000,29366000,41537000,0,8987000,3184000,,,,,1575000,41537000,32550000,0,-307000,,7105000,7105000,52124,FNWB
2017-12-31,,,7789000,,4938000,28202000,38605000,0,7290000,3113000,,,,,2851000,38605000,31315000,0,499000,,4938000,4938000,52124,FNWB
2020-12-31,,,3004000000,25000000,2498000000,7390000000,8835000000,3370000000,3370000000,-1925000000,-355000000,,,,495000000,43337000000,39967000000,34502000000,-366000000,,2509000000,2404000000,52125,SLF
2019-12-31,,,3003000000,19000000,2713000000,7018000000,8644000000,3351000000,3351000000,-1725000000,-333000000,,,,286000000,39679000000,36328000000,31035000000,-348000000,,2717000000,2618000000,52125,SLF
2018-12-31,,,3213000000,19000000,2616000000,6432000000,8304000000,3518000000,3518000000,-1646000000,-305000000,,,,597000000,26997000000,23479000000,18693000000,-305000000,,2616000000,2522000000,52125,SLF
2017-12-31,,,2544000000,19000000,2242000000,6350000000,5263000000,2907000000,2907000000,-3994000000,-303000000,,,,302000000,29334000000,26427000000,24071000000,-363000000,,2242000000,2149000000,52125,SLF
2019-12-31,1300000,,-17611000,45196000,-11453000,94753000,118670000,22617000,22617000,,-14895000,,,,-3309000,709431000,686814000,590761000,-40228000,,-14302000,-11453000,52126,PETQ
2018-12-31,200000,,-574000,64496000,-782000,72060000,85437000,13177000,13177000,,-8322000,,,,-661000,528614000,515437000,443177000,-13751000,,87000,-782000,52126,PETQ
2017-12-31,500000,,11787000,38130000,-3493000,37405000,51194000,13289000,13289000,,-1663000,,,,3970000,266687000,253398000,215493000,-1502000,,7817000,-3493000,52126,PETQ
2016-12-31,310000,,-3395000,-19000,0,28235000,32547000,4002000,4002000,,-3078000,,,,0,200162000,196160000,167615000,-7397000,,7817000,-3493000,52126,PETQ
2020-03-31,119281000,,-218533000,,-418024000,428158000,433321000,-170847000,-170847000,,-42697000,,,,199491000,545803000,716650000,112482000,-47686000,,-418024000,-418024000,52127,DT
2019-03-31,76759000,,-139911000,,-116194000,270664000,342503000,-70944000,-70944000,,-69845000,,,,-23717000,430966000,501910000,88463000,-68967000,,-116194000,-116194000,52127,DT
2018-03-31,58320000,,-51775000,,9222000,209264000,319461000,-16569000,-16569000,,-35220000,,,,-60997000,398047000,414616000,78586000,-35206000,,9222000,9222000,52127,DT
2017-03-31,52885000,,-16393000,,796000,179203000,323466000,20170000,20170000,,-25481000,,,,-17189000,406377000,386207000,82911000,-36563000,,796000,796000,52127,DT
2020-12-31,55577000,,31655000,,23337000,140510000,224804000,27239000,27239000,,,,,,8318000,248168000,220929000,23364000,4416000,,23337000,23337000,52132,VNDA
2019-12-31,48649000,,29028000,,115553000,129736000,202700000,22810000,22810000,,,,,,-86525000,227188000,204378000,24488000,6218000,,115553000,115553000,52132,VNDA
2018-12-31,43594000,,25346000,,25208000,105751000,172610000,21738000,21738000,,,,,,138000,193118000,171380000,20508000,3608000,,25208000,25208000,52132,VNDA
2017-12-31,38547000,,-15431000,,-15567000,123841000,147235000,-16903000,-16903000,,,,,,136000,165083000,181986000,17848000,1472000,,-15567000,-15567000,52132,VNDA
2020-10-31,,,8496621,,8496621,4115645,25380611,21264966,21264966,,-4515524,,,,0,25380611,4115645,0,-12768345,,8496621,8496621,52133,AFB
2019-10-31,,,54519656,,54519656,4131882,26182841,22050959,22050959,,-6698225,,,,0,26182841,4131882,0,32468697,,54519656,54189929,52133,AFB
2018-10-31,,,-12884685,,-12884685,4142060,26001344,21859284,21859284,,-4319324,,,,0,26001344,4142060,0,-34743969,,-12884685,-14855358,52133,AFB
2017-10-31,,,7393881,,7393881,4142359,26461580,22319221,22319221,,-3351759,,,,0,26461580,4142359,0,-14925340,,7393881,6248875,52133,AFB
2020-01-31,453664000,,-567768000,15089000,-571058000,633745000,533231000,-554178000,-554178000,,,,,,589000,630422000,1184600000,97191000,-13590000,,-568357000,-571058000,52135,WORK
2019-01-31,155938000,,-138062000,9920000,-140683000,345521000,349251000,-152208000,-152208000,,,,,,840000,400552000,552760000,51301000,14146000,,-138902000,-140683000,52135,WORK
2018-01-31,141350000,,-139270000,8139000,-140085000,196681000,194180000,-143851000,-143851000,,,,,,793000,220544000,364395000,26364000,4581000,,-140063000,-180968000,52135,WORK
2017-01-31,96678000,,-146754000,8117000,-146864000,141461000,89636000,-148503000,-148503000,,,,,,155000,105153000,253656000,15517000,1749000,,-146909000,-146864000,52135,WORK
2019-12-31,,,2688000,,2109000,9076000,12126000,3050000,3050000,,-125000,,,,579000,55272000,52222000,43146000,-362000,,2109000,2109000,52136,SVT
2018-12-31,,,4235000,,3498000,7743000,12085000,4342000,4342000,,-107000,,,,737000,47857000,43515000,35772000,-107000,,3498000,3498000,52136,SVT
2017-12-31,,,2075000,,1317000,7845000,9997000,2152000,2152000,,-77000,,,,758000,41444000,39292000,31447000,-67000,,1317000,1317000,52136,SVT
2016-12-31,,,2470000,,1753000,6668000,10023000,2532000,2532000,,-73000,,,,717000,38587000,36055000,28564000,-62000,,1753000,1753000,52136,SVT
2019-12-31,,,25143000,,25143000,9065000,44212000,26930000,26930000,,-1787000,,,,0,144496000,117566000,100284000,-1787000,,25143000,25143000,52138,SHLS
2018-12-31,,,8647000,,8647000,8904000,28168000,11087000,11087000,,-2440000,,,,0,103750000,92663000,75582000,-2440000,,8647000,8647000,52138,SHLS
2019-12-31,,,-23982000,,-23982000,5736000,-19331000,-25067000,-25067000,,,,,,0,9887000,34954000,29218000,1085000,,-23982000,-23982000,52139,STTK
2018-12-31,,,-7388000,,-7388000,3783000,-2365000,-6148000,-6148000,,-2631000.0,,,,0,22442000,28590000,24807000,-1240000,,-7388000,-7388000,52139,STTK
2019-12-31,,,-200776000,,-210977000,368675000,627842000,12068000,12068000,-4826000,-157689000,,,,10201000,974345000,962277000,346503000,-212844000,,-210977000,-210977000,52141,CLVT
2018-12-31,,,-236513000,,-242162000,369377000,571969000,-47254000,-47254000,-1094000,-130805000,,,,5649000,968468000,1015722000,396499000,-189259000,,-242162000,-242162000,52141,CLVT
2017-12-31,,,-285223000,,-263930000,343143000,523419000,-66087000,-66087000,237000,-138196000,,,,-21293000,917634000,983721000,394215000,-219136000,,-263930000,-263930000,52141,CLVT
2019-12-31,,,39432000,,31623000,22888000,81052000,55753000,55753000,,-3626000,,,,7809000,233073000,177320000,152021000,-16321000,,31623000,31623000,52143,SND
2018-12-31,,,23810000,,18688000,22709000,67567000,43015000,43015000,,-2320000,,,,5122000,212470000,169455000,144903000,-19205000,,18688000,18688000,52143,SND
2017-12-31,,,18717000,,21526000,17678000,36908000,18705000,18705000,,-700000,,,,-2809000,137212000,118507000,100304000,12000,,21526000,21526000,52143,SND
2016-12-31,,,19773000,,10379000,11887000,32662000,20391000,20391000,,-14001000,,,,9394000,59231000,38840000,26569000,-618000,,10379000,10379000,52143,SND
2019-12-31,,,46862000,,36186000,76237000,142249000,0,51251000,12918000,,,,,10676000,142249000,90998000,0,-4389000,,36186000,36002000,52145,DCOMP
2018-12-31,,,66715000,,51288000,70523000,153605000,0,68684000,12874000,,,,,15427000,153605000,84921000,0,-1969000,,51288000,51128000,52145,DCOMP
2017-12-31,,,88738000,,51882000,65291000,173724000,0,92976000,13770000,,,,,36856000,173724000,80748000,0,-4238000,,51882000,51751000,52145,DCOMP
2016-12-31,,,133471000,,72514000,56272000,217302000,0,135986000,10393000,,,,,60957000,217302000,81316000,0,-2515000,,72514000,72405000,52145,DCOMP
2019-12-31,,,-30487000,,-30487000,5182000,-25787000,-30969000,-30969000,,,,,,0,215000,31184000,26002000,482000,,-30487000,-30487000,52146,BOLT
2018-12-31,,,-11589000,,-11589000,2209000,-9420000,-11629000,-11629000,,,,,,0,0,11629000,9420000,40000,,-11589000,-11589000,52146,BOLT
2020-07-31,,,-32547000,,-32547000,7041000,68686000,61645000,61645000,,-6135000,,,,0,68686000,7041000,0,-94192000,,-32547000,-34727000,52147,PFN
2019-07-31,,,54517000,,54517000,6663000,60843000,54180000,54180000,,-1615000,,,,0,60843000,6663000,0,337000,,54517000,51249000,52147,PFN
2018-07-31,,,44250000,,44250000,6598000,55776000,49178000,49178000,,-3092000,,,,0,55776000,6598000,0,-4928000,,44250000,41710000,52147,PFN
2017-07-31,,,112170000,,112170000,6355000,54810000,48455000,48455000,,6210000,,,,0,54810000,6355000,0,63715000,,112170000,110335000,52147,PFN
2019-12-31,,,-82201000,4000000,-59854000,12848000,69570000,-68625000,-68625000,-2332000,-15998000,,,,-22347000,317436000,386061000,247866000,-13576000,,-59854000,-58947000,52148,HNRG
2018-12-31,,,3546000,4000000,7621000,11841000,76420000,20559000,20559000,-1332000,-16288000,,,,-4075000,291783000,271224000,215363000,-17013000,,7621000,7436000,52148,HNRG
2017-12-31,,,13882000,4000000,33076000,14978000,79393000,25930000,25930000,-864000,-12413000,,,,-19194000,269543000,243613000,190150000,-12048000,,33076000,32048000,52148,HNRG
2016-12-31,,,8484000,4000000,12510000,10520000,86147000,41322000,41322000,-2933000,-14842000,,,,-4026000,278924000,237602000,192777000,-32838000,,12510000,12205000,52148,HNRG
2019-12-31,,,43399000,,39632000,54068000,31128000,-27091000,-27091000,1537000,-872000,,,,3767000,140990000,168081000,109862000,70490000,,39632000,39632000,52151,NC
2018-12-31,,,42163000,,34785000,48463000,29968000,-22830000,-22830000,1297000,-1998000,,,,7378000,135375000,158205000,105407000,64993000,,34785000,34785000,52151,NC
2017-12-31,,,29102000,,30337000,47491000,16919000,-35267000,-35267000,1590000,-3440000,,,,639000,104778000,140045000,87859000,64369000,1874000.0,28463000,30337000,52151,NC
2016-12-31,,,-4493000,,29607000,45538000,12082000,-53188000,-53188000,-214000,-4318000,,,,-7449000,111081000,164269000,98999000,48695000,26651000.0,2956000,29607000,52151,NC
2019-12-31,7212000,,-14222000,-13000,-13967000,13754000,7488000,-13057000,-13057000,-421000,-1458000,,,,9000,24602000,37659000,17114000,-1165000,,-14231000,-13967000,52155,VJET
2018-12-31,6334000,,-8753000,35000,-8728000,12919000,9145000,-9964000,-9964000,-144000,-1143000,,,,11000,26009000,35973000,16864000,1211000,,-8764000,-8728000,52155,VJET
2017-12-31,5528000,,-8474000,71000,-8538000,11603000,9325000,-7405000,-7405000,-401000,-190000,,,,80000,23178000,30583000,13853000,-1069000,,-8554000,-8538000,52155,VJET
2016-12-31,5683000,,-11311000,87000,-11287000,9875000,6903000,-8840000,-8840000,-71000,-230000,,,,2000,22338000,31178000,15435000,-2471000,,-11313000,-11287000,52155,VJET
2019-12-31,107000000,,-666000000,,-667000000,863000000,391000000,-611000000,-611000000,,,,,,1000000,885000000,1496000000,494000000,-55000000,,-667000000,-668000000,52156,DASH
2018-12-31,51000000,,-204000000,,-204000000,223000000,73000000,-210000000,-210000000,,-1000000.0,,,,0,291000000,501000000,218000000,6000000,,-204000000,-207000000,52156,DASH
2020-12-31,,,73092000,,59313000,109080000,196237000,0,80874000,6283000,,,,,13779000,196237000,115363000,0,-7782000,,59313000,59313000,52157,GSBC
2019-12-31,,,90061000,,73612000,102728000,204834000,0,95450000,6656000,,,,,16449000,204834000,109384000,0,-5389000,,73612000,73612000,52157,GSBC
2018-12-31,,,81950000,,67109000,99393000,189271000,0,84031000,5847000,,,,,14841000,189271000,105240000,0,-2081000,,67109000,67109000,52157,GSBC
2017-12-31,,,70322000,,51564000,97915000,176434000,0,71641000,6878000,,,,,18758000,176434000,104793000,0,-1319000,,51564000,51564000,52157,GSBC
2020-01-31,1850000,,-10409000,,-11287000,19716000,16621000,-9615000,-9615000,,-46000,,,,878000,42675000,52290000,26054000,-794000,,-11287000,-13337000,52160,MINDP
2019-01-31,1159000,,-19588000,,-19840000,20905000,11740000,-13020000,-13020000,,-46000,,,,252000,42942000,55962000,31202000,-6568000,,-19840000,-21548000,52160,MINDP
2018-01-31,1502000,,-20159000,,-21069000,19263000,6634000,-17292000,-17292000,,-46000,,,,910000,48276000,65568000,41642000,-2867000,,-21069000,-21974000,52160,MINDP
2017-01-31,974000,,-31339000,,-33153000,19753000,-7414000,-31290000,-31290000,,-643000,,,,1814000,40999000,72289000,48413000,-49000,,-33153000,-33639000,52160,MINDP
2019-12-31,,,52161582,,52161582,4136808,24077880,19941072,19941072,,-3028212,,,,0,24077880,4136808,0,32220510,,52161582,52161582,52162,BGT
2019-10-31,,,8959718,,8959718,3777167,26435440,22658273,22658273,,-4092128,,,,0,26435440,3777167,0,-13698555,,8959718,8959718,52162,BGT
2018-10-31,,,13094898,,13094898,4129428,25780461,21651033,21651033,,-3685055,,,,0,25780461,4129428,0,-8556135,,13094898,13094898,52162,BGT
2017-10-31,,,20032052,,20032052,4125323,23761221,19635898,19635898,,-2466027,,,,0,23761221,4125323,0,396154,,20032052,20032052,52162,BGT
2020-03-31,,,4704095,,4704095,355040,3730489,3375449,3375449,,,,,,0,3730489,355040,0,1328646,,4704095,4704095,52165,NXC
2019-03-31,,,4386860,,4386860,517136,3720099,3202963,3202963,,,,,,0,3720099,517136,0,1183897,,4386860,4386860,52165,NXC
2018-03-31,,,4194153,,4194153,359676,3949531,3589855,3589855,,,,,,0,3949531,359676,0,604298,,4194153,4194153,52165,NXC
2017-03-31,,,231338,,231338,359369,4158163,3798794,3798794,,,,,,0,4158163,359369,0,-3567456,,231338,231338,52165,NXC
2020-12-31,686000000,,1174000000,17000000,949000000,1212000000,3637000000,1524000000,1524000000,,-233000000,,,,221000000,7414000000,5890000000,3777000000,-350000000,,953000000,949000000,52166,MSI
2019-12-31,687000000,,1001000000,17000000,868000000,1325000000,3948000000,1728000000,1728000000,,-237000000,,,,130000000,7887000000,6159000000,3939000000,-727000000,,871000000,868000000,52166,MSI
2018-12-31,637000000,,1102000000,17000000,966000000,1179000000,3539000000,1535000000,1535000000,,-240000000,,,,133000000,7343000000,5808000000,3804000000,-433000000,,969000000,966000000,52166,MSI
2017-12-31,568000000,,1076000000,15000000,-155000000,979000000,3033000000,1335000000,1335000000,,-215000000,,,,1227000000,6380000000,5045000000,3347000000,-259000000,,-151000000,-155000000,52166,MSI
2019-12-31,2410000,,-276255000,4714000,-271464000,53337000,39754000,-59594000,-59594000,,-22927000,,,,-4626000,75860000,135454000,36106000,-216661000,,-271629000,-271464000,52167,SNDL
2018-12-31,330000,,-67831200,4714000,-67831200,12826800,-9284400,-32437200,-32437200,,-1496400,,,,0,0,32437200,9284400,-35394000,,-67831200,-67831200,52167,SNDL
2018-02-28,413000,,-12995000,4714000,-12995000,4418000,-883000,-10701000,-10701000,,-1496400,,,,0,0,10701000,883000,-2294000,,-12995000,-12995000,52167,SNDL
2017-02-28,413000,,-1545280,4714000,-1545280,1411132,0,-1491340,-1491340,,-37309,,,,0,0,1491340,0,-53940,,-1545280,-1545280,52167,SNDL
2019-12-31,,,210300000,-1200000,154000000,3800000,697900000,334200000,334200000,336400000,-59200000,,,,56700000,2324300000,1990100000,1626400000,-123900000,,153600000,154000000,52169,NOMD
2018-12-31,,,227100000,-800000,171200000,3800000,659200000,302700000,302700000,332700000,-52400000,,,,56600000,2172800000,1870100000,1513600000,-75600000,,170500000,171200000,52169,NOMD
2017-12-31,,,168500000,-800000,136500000,3600000,599400000,276500000,276500000,310200000,-54000000,,,,32000000,1956600000,1680100000,1357200000,-108000000,,136500000,136500000,52169,NOMD
2016-12-31,,,76000000,-800000,36400000,4100000,571000000,268500000,268500000,289400000,-77900000,,,,39600000,1927700000,1659200000,1356700000,-192500000,,36400000,36400000,52169,NOMD
2019-12-31,,,-341,,-341,341,0,-341,-341,,,,,,0,0,341,0,0,,-341,-341,52170,GSAH
2018-12-31,,,-506,,-506,506,0,-506,-506,,,,,,0,0,506,0,0,,-506,-506,52170,GSAH
2019-12-31,,,83200000,,70900000,328400000,441100000,103800000,103800000,,-21000000,,,,13500000,1525400000,1421600000,1084300000,-20600000,-4400000,69700000,70900000,52172,SPXC
2018-12-31,,,79600000,,81200000,294100000,416200000,117900000,117900000,,-21500000,,,,1400000,1538600000,1420700000,1122400000,-38300000,3000000,78200000,81200000,52172,SPXC
2017-12-31,,,36100000,,89300000,282300000,330200000,47300000,47300000,,-14400000,,,,-47900000,1425800000,1378500000,1095600000,-11200000,5300000,84000000,89300000,52172,SPXC
2016-12-31,,,39400000,,-85300000,301000000,375800000,72000000,72000000,,-14800000,,,,9100000,1472300000,1400300000,1096500000,-32600000,-97900000,30300000,-85300000,52172,SPXC
2019-12-31,,,-107900000,,-108500000,129400000,21500000,-107900000,-107900000,,,,,,600000,67300000,175200000,45800000,0,,-108500000,-108500000,52174,LMND
2018-12-31,,,-52600000,,-52900000,59900000,7300000,-52600000,-52600000,,,,,,300000,22500000,75100000,15200000,0,,-52900000,-52900000,52174,LMND
2017-12-31,,,-28000000,,-28100000,28700000,700000,-28000000,-28000000,,,,,,100000,2400000,30400000,1700000,0,,-28100000,-28100000,52174,LMND
2019-12-31,20759000,,-25344000,,-25352000,5878000,0,-26637000,-26637000,,,,,,8000,0,26637000,0,1293000,,-25352000,-25352000,52175,PMVP
2018-12-31,13853000,,-17535000,,-17538000,5039000,0,-18892000,-18892000,,,,,,3000,0,18892000,0,1357000,,-17538000,-17538000,52175,PMVP
2019-12-31,12824402,,-23270514,,-23270514,9756185,0,-22580587,-22580587,,,,,,0,0,22580587,0,-689927,,-23270514,-23270514,52176,ARPO
2018-12-31,17852756,,-10396635,,-10396635,13485918,20157430,-11181244,-11181244,,,,,,0,20157430,31338674,0,784609,,-10396635,-10396635,52176,ARPO
2017-12-31,12147132,,-21400606,,-21400606,9241411,0,-21388543,-21388543,,-105782.0,,,,0,0,21388543,0,-12063,,-21400606,-22343903,52176,ARPO
2016-12-31,11367590,,-16983511,,-16983511,5265995,0,-16633585,-16633585,,-482204.0,,,,0,0,16633585,0,-349926,,-16983511,-20912088,52176,ARPO
2020-06-30,,,1348000,,775000,52427000,55207000,2780000,2780000,,-1432000,,,,573000,235802000,233022000,180595000,-1432000,,775000,713000,52177,EVI
2019-06-30,,,5616000,,3743000,45446000,52698000,7252000,7252000,,-1389000,,,,1873000,228318000,221066000,175620000,-1636000,,3743000,3483000,52177,EVI
2018-06-30,,,6382000,,3966000,29275000,36506000,7231000,7231000,,-552000,,,,2416000,150007000,142776000,113501000,-849000,,3966000,3671000,52177,EVI
2017-06-30,,,5190000,,3167000,14511000,20339000,5828000,5828000,,-160000,,,,2023000,93978000,88150000,73639000,-638000,,3167000,2919000,52177,EVI
2019-12-31,17514000,,-29135000,,-29135000,100684000,89363000,-28835000,-28835000,,-40000,,,,0,106712000,135547000,17349000,-300000,,-29135000,-29135000,52178,AXGN
2018-12-31,11773000,,-22397000,,-22397000,79741000,71014000,-20500000,-20500000,,-1208000,,,,0,83937000,104437000,12923000,-1897000,,-22397000,-22397000,52178,AXGN
2017-12-31,6699000,,-10445000,,-10445000,52367000,51115000,-7951000,-7951000,,-2463000,,,,0,60426000,68377000,9311000,-2494000,,-10445000,-10445000,52178,AXGN
2016-12-31,4212000,,-14411000,,-14411000,38559000,34641000,-8130000,-8130000,,-6261000,,,,0,41108000,49238000,6467000,-6281000,,-14411000,-14411000,52178,AXGN
2019-12-31,283146000,,-398626000,,-400424000,182769000,113080000,-367306000,-367306000,9711000,-19405000,,,,1798000,143006000,510312000,29926000,-31320000,,-400424000,-400424000,52179,CLVS
2018-12-31,231347000,,-367401000,,-368009000,175781000,75944000,-333814000,-333814000,9711000,-13183000,,,,608000,95388000,429202000,19444000,-33587000,,-368009000,-368009000,52179,CLVS
2017-12-31,142498000,,-349975000,,-346397000,138907000,45260000,-237631000,-237631000,9711000,-10428000,,,,-3578000,55511000,293142000,10251000,-112344000,,-346397000,-346397000,52179,CLVS
2016-12-31,251129000,,-381171000,,-349137000,40731000,8000,-291852000,-291852000,9711000,-8491000,,,,-32034000,78000,291930000,70000,-89319000,,-349137000,-349137000,52179,CLVS
2019-12-31,64535000,,-112477000,,-112477000,29972000,-55328000,-85300000,-85300000,,-4280000,,,,0,7143000,92443000,62471000,-27177000,,-112477000,-112477000,52181,BLCM
2018-12-31,64535000,,-98036000,,-98036000,24998000,-70468000,-95466000,-95466000,,-4199000,,,,0,1120000,96586000,71588000,-2580000,,-98036000,-98036000,52181,BLCM
2017-12-31,64535000,,-91779000,,-91779000,21045000,-66342000,-87387000,-87387000,,-3672000,,,,0,185000,87572000,66527000,-4392000,,-91779000,-91779000,52181,BLCM
2016-12-31,64535000,,-69241000,,-69241000,16925000,-51455000,-68380000,-68380000,,-1760000,,,,0,388000,68768000,51843000,-861000,,-69241000,-69241000,52181,BLCM
2020-09-26,,,60612000,,60758000,67027000,322988000,139170000,139170000,,-74727000,,,,-146000,1107897000,968727000,784909000,-78558000,,60758000,60758000,52185,SPH
2019-09-28,,,69489000,,68632000,71034000,342760000,150854000,150854000,,-76663000,,,,857000,1267705000,1116851000,924945000,-81365000,,68632000,68632000,52185,SPH
2018-09-29,,,75928000,,76534000,66246000,354294000,162826000,162826000,,-77383000,,,,-606000,1344413000,1181587000,990119000,-86898000,,76534000,76534000,52185,SPH
2017-09-30,,,38454000,,37995000,63438000,313871000,122495000,122495000,,-75263000,,,,459000,1187886000,1065391000,874015000,-84041000,,37995000,37995000,52185,SPH
2020-12-31,,,8582333,,7953483,,26472767,0,8582333,17890434,,,,,628850,26472767,17890434,0,0,,7953483,7953483,52187,UBCP
2019-12-31,,,7409000,,6810000,13318000.0,23891000,0,7489000,3084000,,,,,599000,23891000,16402000,0,-80000,,6810000,6554000,52187,UBCP
2018-12-31,,,5082000,,4282000,12062000.0,21405000,0,6576000,2767000,,,,,800000,21405000,14829000,0,-1494000,,4282000,4068000,52187,UBCP
2017-12-31,,,5590000,,3546000,10990000.0,19239000,0,5795000,2454000,,,,,2044000,19239000,13444000,0,-205000,,3546000,3431000,52187,UBCP
2020-12-31,,,36782000,,29994000,63193000,137775000,0,48741000,25841000,,,,,6788000,137775000,89034000,0,-11959000,,29994000,29994000,52188,BFST
2019-12-31,,,29852000,,23772000,43869000,88300000,0,30602000,13632000,,,,,6080000,88300000,57698000,0,-750000,,23772000,23772000,52188,BFST
2018-12-31,,,17370000,,14091000,34422000,67216000,0,20536000,12183000,,,,,3279000,67216000,46680000,0,-3166000,,14091000,14091000,52188,BFST
2017-12-31,,,8951000,,4848000,27495000,45753000,0,9080000,9178000,,,,,4103000,45753000,36673000,0,-129000,,4848000,4848000,52188,BFST
2019-12-31,10363253,,-16099055,,-16099055,5696767,17096,-16042924,-16042924,,-126572,,,,0,17096,16060020,0,-56131,,-16099055,-16099055,52191,VNRX
2018-12-31,10906871,,-18008623,,-18008623,6990828,0,-17897699,-17897699,,-110924,,,,0,0,17897699,0,-110924,,-18008623,-18008623,52191,VNRX
2017-12-31,8026206,,-14769207,,-14769207,6669868,0,-14696074,-14696074,,-73133,,,,0,0,14696074,0,276706,,-14769207,-14769207,52191,VNRX
2016-12-31,7904988,,-11905278,,-11905278,4525225,0,-12430213,-12430213,,-20378,,,,0,0,12430213,0,524935,,-11905278,-11905278,52191,VNRX
2020-12-31,,,563864000,25295000,435030000,1019702000,1729801000,0,624006000,86093000,,,,,128793000,1729801000,1105795000,0,-60142000,,435071000,435030000,52192,BOKFL
2019-12-31,,,630868000,8124000,500758000,1002863000,1763249000,0,682099000,78287000,,,,,130183000,1763249000,1081150000,0,-51231000,,500685000,497531000,52192,BOKFL
2018-12-31,,,565485000,10936000,445646000,902699000,1593651000,0,618321000,72631000,,,,,119061000,1593651000,975330000,0,-52836000,,446424000,441909000,52192,BOKFL
2017-12-31,,,518278000,22967000,334644000,902488000,1543795000,0,556397000,84910000,,,,,182593000,1543795000,987398000,0,-38119000,,335685000,331083000,52192,BOKFL
2020-02-01,,,317548000,,242464000,1812123000,2114682000,167578000,167578000,,-16827000,,,,75084000,5323180000,5155602000,3208498000,149970000,,242464000,242464000,52193,BIG
2019-02-02,,,207613000,,156894000,1736475000,2127895000,266450000,266450000,,-10338000,,,,50719000,5238105000,4971655000,3110210000,-58837000,,156894000,156894000,52193,BIG
2018-02-03,,,295354000,,189832000,1726996000,2142442000,298353000,298353000,,-6711000,,,,105522000,5264362000,4966009000,3121920000,-2999000,,189832000,189832000,52193,BIG
2017-01-28,,,244299000,,152828000,1730856000,2099419000,248103000,248103000,,-5091000,,,,91471000,5193995000,4945892000,3094576000,-3804000,,152828000,152828000,52193,BIG
2019-12-31,20950672,,-28059807,,-28059807,8593626,0,-29544298,-29544298,,,,,,0,0,29544298,0,1484491,,-28059807,-28059807,52194,APRE
2018-12-31,14194732,,-15528269,,-15528269,2294671,0,-16489403,-16489403,,-182.0,,,,0,0,16489403,0,961134,,-15528269,-15528269,52194,APRE
2017-12-31,13392631,,-15190250,,-15190250,2459744,0,-15852375,-15852375,,-15.0,,,,0,0,15852375,0,662125,,-15190250,-15190250,52194,APRE
2019-12-31,,,-1982000,,-1982000,20102000,17117000,-2985000,-2985000,,-1919000,,,,0,18370000,21355000,1253000,1003000,,-1982000,-1982000,52195,XOMA
2018-12-31,,,-13441000,,-13343000,18563000,3617000,-14946000,-14946000,,-922000,,,,-98000,5299000,20245000,1682000,1505000,,-13343000,-13343000,52195,XOMA
2017-12-31,,,16258000,,14596000,24337000,44815000,20478000,20478000,,-1238000,,,,1662000,52690000,32212000,7875000,-4220000,,14596000,5714000,52195,XOMA
2016-12-31,42834000.0,,-53530000,,-53530000,18322000,4164000,-56992000,-56992000,,-3946000,,,,0,5564000,62556000,1400000,3462000,,-53530000,-53530000,52195,XOMA
2019-12-31,,,85649000000,39000000,61045000000,8062000000,179332000000,83403000000,83403000000,17826000000,-3045000000,,,,24604000000,233107000000,149704000000,53775000000,2246000000,,61045000000,61045000000,52196,CEO
2018-12-31,,,75157000000,10000000,52675000000,7429000000,169842000000,78154000000,78154000000,20090000000,-2581000000,,,,22482000000,227788000000,149634000000,57946000000,-2997000000,,52675000000,52675000000,52196,CEO
2017-12-31,,,36357000000,10000000,24677000000,6861000000,134471000000,35190000000,35190000000,15431000000,-2881000000,,,,11680000000,186396000000,151206000000,51925000000,1167000000,,24677000000,24677000000,52196,CEO
2016-12-31,,,-5275000000,10000000,637000000,6493000000,103819000000,-5075000000,-5075000000,13928000000,-4036000000,,,,-5912000000,146048000000,151123000000,42229000000,-200000000,,637000000,637000000,52196,CEO
2019-12-31,,,-93037000,6525000,-96460000,62183000,130862000,68679000,68679000,,-47011000,,,,3423000,1372487000,1303808000,1241625000,-161716000,,-96460000,-128003000,52199,SUP
2018-12-31,,,32252000,13849000,25961000,68022000,163527000,95505000,95505000,,-50097000,,,,6291000,1501827000,1406322000,1338300000,-63253000,,25961000,7244000,52199,SUP
2017-12-31,,,866000,51943000,-6203000,45479000,102897000,57418000,57418000,,-40004000,,,,6875000,1108055000,1050637000,1005158000,-56552000,,-6009000,-25115000,52199,SUP
2016-12-25,,,54721000,51943000,41381000,33038000,87662000,54624000,54624000,,-40004000,,,,13340000,732677000,678053000,645015000,97000,,41381000,41381000,52199,SUP
2020-09-30,441324000,,396397000,,307441000,1086244000,1942935000,415367000,415367000,,,,,,88956000,2350822000,1935455000,407887000,-18970000,,307441000,307441000,52200,FFIV
2019-09-30,408058000,,541111000,,427734000,952076000,1885870000,525736000,525736000,,,,,,113377000,2242447000,1716711000,356577000,15375000,,427734000,427734000,52200,FFIV
2018-09-30,366084000,,603760000,,453689000,824517000,1799926000,609325000,609325000,,,,,,150071000,2161407000,1552082000,361481000,-5565000,,453689000,453689000,52200,FFIV
2017-09-30,350365000,,575517000,,420761000,809126000,1736556000,577065000,577065000,,,,,,154756000,2090041000,1512976000,353485000,-1548000,,420761000,420761000,52200,FFIV
2019-12-31,19816000,,-28059000,,-27337000,9063000,0,-28879000,-28879000,,,,,,-722000,0,28879000,0,820000,,-27337000,-27337000,52201,CGEN
2018-12-31,30318000,,-22599000,,-22599000,9675000,16766000,-23227000,-23227000,,,,,,0,17800000,41027000,1034000,628000,,-22599000,-22599000,52201,CGEN
2017-12-31,28583000,,-37066000,,-37066000,8822000,0,-37405000,-37405000,,,,,,0,0,37405000,0,339000,,-37066000,-37066000,52201,CGEN
2016-12-31,24549000,,-31486000,,-31506000,8523000,489000,-32583000,-32583000,,,,,,20000,712000,33295000,223000,1097000,,-31506000,-31506000,52201,CGEN
2020-12-31,,,5382000,,4558000,,21299000,0,5382000,15917000,,,,,824000,21299000,15917000,0,0,,4558000,4558000,52202,LSBK
2019-12-31,,,4742000,,4087000,14416000.0,20662000,0,4815000,1431000,,,,,655000,20662000,15847000,0,-73000,,4087000,4087000,52202,LSBK
2018-12-31,,,4585000,,4000000,13892000.0,20018000,0,4734000,1392000,,,,,585000,20018000,15284000,0,-149000,,4000000,4000000,52202,LSBK
2017-12-31,,,4563000,,3378000,12896000.0,18923000,0,4712000,1315000,,,,,1185000,18923000,14211000,0,-149000,,3378000,3378000,52202,LSBK
2020-03-31,,,398000,,398000,7479000,7406000,362000,362000,-435000,-181000,,,,0,13096000,12734000,5690000,36000,,398000,398000,52203,BNSO
2019-03-31,,,-463000,,-463000,4605000,3957000,-545000,-545000,-103000,-139000,,,,0,9992000,10537000,6035000,82000,,-463000,-463000,52203,BNSO
2018-03-31,,,4000,,4000,4669000,4565000,238000,238000,-342000,-72000,,,,0,11523000,11285000,6958000,-246000,,4000,4000,52203,BNSO
2017-03-31,,,3395000,,2795000,4996000,7678000,3135000,3135000,-453000,-37000,,,,600000,18952000,15817000,11274000,260000,,2795000,2795000,52203,BNSO
2019-12-31,,,176745000,4382000,141803000,476283000,928294000,0,193434000,152328000,,,,,35451000,1028711000,835277000,100417000,-16689000,,141294000,141803000,52205,NNI
2018-12-31,,,286294000,10315000,227913000,436179000,974739000,0,297656000,153008000,,,,,58770000,1051231000,753575000,76492000,-11003000,,227524000,227913000,52205,NNI
2017-12-31,,,226684000,15858000,173166000,301885000,742316000,0,273008000,126982000,,,,,64863000,800944000,527936000,58628000,-46324000,,161821000,173166000,52205,NNI
2016-12-31,,,398814000,9270000,256751000,255924000,785530000,0,390833000,103940000,,,,,141313000,862462000,471629000,76932000,7981000,,257501000,256751000,52205,NNI
2020-05-31,14750000,,72305000,,59475000,114006000,196279000,67523000,67523000,,,,,,12830000,418170000,350647000,221891000,4782000,,59475000,59475000,52207,NEOG
2019-05-31,12805000,,72959000,,60176000,111021000,191920000,68094000,68094000,,,,,,12783000,414186000,346092000,222266000,4865000,,60176000,60176000,52207,NEOG
2018-05-31,10855000,,73465000,,63145000,105223000,186272000,70194000,70194000,,,,,,10250000,397930000,327736000,211658000,3271000,,63215000,63145000,52207,NEOG
2017-05-31,10385000,,66673000,143000.0,43793000,93594000,168924000,64945000,64945000,,,,,,22700000,358277000,293332000,189353000,1728000,,43973000,43793000,52207,NEOG
2019-12-31,,,-38529436,,-38539436,20322939,-3782372,-24105311,-24105311,,-5730648,,,,10000,5775257,29880568,9557629,-14424125,,-38539436,-44726242,52208,JAGX
2018-12-31,,,-32146057,,-32146057,22108798,-3504349,-25613147,-25613147,,-2628685,,,,0,4416145,30029292,7920494,-6532910,,-32146057,-32146057,52208,JAGX
2017-12-31,,,-35149856,,-21968614,10777136,-788674,-11565810,-11565810,,-1209632,,,,-13181242,4361186,15926996,5149860,-23584046,,-21968614,-21968614,52208,JAGX
2016-12-31,,,-14733780,,-14733780,6363253,-7117307,-13480560,-13480560,,-985549,,,,0,141523,13622083,7258830,-1253220,,-14733780,-14733780,52208,JAGX
2020-12-31,,,394500000,,213700000,,584000000,503000000,503000000,,-108500000,,,,99500000,4521400000,4018400000,3937400000,-108500000,-81300000,295000000,213700000,52210,ADS
2019-12-31,,,738400000,,278000000,102000000.0,1257900000,1069100000,1069100000,,-130000000,,,,165800000,5581300000,4512200000,4323400000,-330700000,-294600000,572600000,268400000,52210,ADS
2018-12-31,,,1215000000,,963100000,162500000.0,1626400000,1371400000,1371400000,,-156400000,,,,269500000,5666600000,4295200000,4040200000,-156400000,17600000,945500000,963100000,52210,ADS
2017-12-31,,,1062500000,,788700000,159300000.0,1477100000,1228300000,1228300000,,-173700000,,,,293300000,5474700000,4246400000,3997600000,-165800000,19500000,769200000,788700000,52210,ADS
2020-09-30,,,10961000,,7841000,4961000,16519000,11319000,11319000,,-447000,,,,3120000,33389000,22070000,16870000,-358000,,7841000,7841000,52212,HNNA
2019-09-30,,,15275000,,11031000,5796000,22042000,16021000,16021000,,-1084000,,,,4244000,42715000,26694000,20673000,-746000,,11031000,11031000,52212,HNNA
2018-09-30,,,23393000,,20615000,5864000,30570000,24475000,24475000,,-1227000,,,,2778000,54590000,30115000,24020000,-1082000,,20615000,20615000,52212,HNNA
2017-09-30,,,23249000,,14942000,5882000,30594000,24493000,24493000,,-1256000,,,,8307000,52955000,28462000,22361000,-1244000,,14942000,14942000,52212,HNNA
2020-12-31,,,93387000,,76584000,56286000,156495000,95557000,95557000,,,,,,18222000,427536000,331979000,271041000,-2170000,,75165000,76584000,52217,CNS
2019-12-31,,,187549000,53412000.0,134621000,47632000,212162000,160134000,160134000,,,,,,40565000,410830000,250696000,198668000,27415000,,146984000,134621000,52217,CNS
2018-12-31,,,143779000,114192000.0,113896000,48265000,199776000,147038000,147038000,,,,,,34257000,381111000,234073000,181335000,-3259000,,109522000,113896000,52217,CNS
2017-12-31,,,160400000,47795000.0,91939000,42219000,201282000,154746000,154746000,,,,,,67914000,378696000,223950000,177414000,5654000,,92486000,91939000,52217,CNS
2019-12-31,65021719,,4812811296,18730200769,1686459523,4575992713,25290005123,18750288307,18750288307,1850460284,-10762718101,,,,2434897405,173484800604,154734512297,148194795481,-13937477011,,2377913891,1000537160,52222,HNP
2018-12-31,46219278,,3436354148,18551570005,1438881447,4182111456,18947912523,12796899387,12796899387,1891013803,-10545102773,,,,1028946553,169861164810,157064265423,150913252287,-9360545239,,2407407595,1096532090,52222,HNP
2017-12-31,45122564,,3574358581,17474060544,1742482005,3859529285,17308542792,11898038449,11898038449,1483911161,-9851561501,,,,1581318354,152970195366,141072156917,135661652574,-8323679868,,1993040227,1673882005,52222,HNP
2016-12-31,45122564,,17783637152,18829694057,10382413710,4009249164,30075356648,24093949789,24093949789,1807010258,-8702971678,,,,4508965803,138150296159,114056346370,108074939511,-6310312637,,13274671349,10382413710,52222,HNP
2020-03-31,,,-4807729,,-5024004,6173185,0,-6173185,-6173185,,,,,,216275,0,6173185,0,1365456,,-5024004,-5024004,52223,AVCT
2019-03-31,,,773962,,989799,4507961,0,-4507961,-4507961,,,,,,-215837,0,4507961,0,5281923,,989799,-3851603,52223,AVCT
2018-03-31,,,-2336047,,-2520045,3939349,0,-3939349,-3939349,,,,,,183998,0,3939349,0,1603302,,-2520045,-3906960,52223,AVCT
2017-03-31,,,-59193,,-59193,59193,0,-59193,-59193,,,,,,0,0,59193,0,0,,-59193,-59193,52223,AVCT
2019-12-26,,,54435000,23000,42017000,124842000,329482000,73127000,73127000,62936000,-11791000,,,,12320000,783705000,710578000,454223000,-18692000,,42115000,42017000,52225,MCS
2018-12-27,,,66592000,110000,53391000,107136000,307619000,86911000,86911000,55930000,-13079000,,,,13127000,672835000,585924000,365216000,-20319000,,53465000,53391000,52225,MCS
2017-12-28,,,68110000,100000,64996000,104495000,282149000,75595000,75595000,50340000,-12100000,,,,3625000,622714000,547119000,340565000,-7485000,,64485000,64996000,52225,MCS
2016-12-29,,,60533000,1535000,37902000,91549000,251689000,68691000,68691000,49617000,-9176000,,,,22994000,540564000,471873000,288875000,-8158000,,37539000,37902000,52225,MCS
2019-12-31,3948000,,-4460000,,-4460000,512000,0,-4460000,-4460000,,,,,,0,0,4460000,0,0,,-4460000,-4460000,52226,TSHA
2019-12-31,8955000,,-9938000,,-9938000,3057000,0,-12012000,-12012000,,,,,,0,0,12012000,0,2074000,,-9938000,-9938000,52227,KNTE
2018-12-31,5675000,,-7630000,,-7630000,1955000,0,-7630000,-7630000,,,,,,0,0,7630000,0,0,,-7630000,-7630000,52227,KNTE
2020-12-31,,,617882000,,491723000,,1806567000,0,617882000,1188685000,,,,,126159000,1806567000,1188685000,0,0,,491723000,477661000,52231,FCNCA
2019-12-31,,,592048000,,457371000,936071000.0,1696011000,0,632094000,127846000,,,,,134677000,1696011000,1063917000,0,-40046000,,457371000,457371000,52231,FCNCA
2018-12-31,,,503610000,,400313000,899639000.0,1554028000,0,518976000,135413000,,,,,103297000,1554028000,1035052000,0,-15366000,,400313000,400313000,52231,FCNCA
2017-12-31,,,543698000,,323752000,835653000.0,1408935000,0,442079000,131203000,,,,,219946000,1408935000,966856000,0,101619000,,323752000,323752000,52231,FCNCA
2020-12-31,,,18285000,,13178000,28955000,50215000,0,20069000,1191000,,,,,5107000,50215000,30146000,0,-1784000,,13178000,13178000,52233,OPBK
2019-12-31,,,22076000,,16757000,29139000,53396000,0,22721000,1536000,,,,,5319000,53396000,30675000,0,-645000,,16757000,16374000,52233,OPBK
2018-12-31,,,19457000,,14253000,26123000,49019000,0,21303000,1593000,,,,,5204000,49019000,27716000,0,-1846000,,14253000,13831000,52233,OPBK
2017-12-31,,,17128000,,9236000,23731000,43385000,0,18459000,1195000,,,,,7892000,43385000,24926000,0,-1331000,,9236000,8870000,52233,OPBK
2020-03-31,,,-291132713,,-291132713,33733029,122151901,88418872,88418872,,-15479924,,,,0,122151901,33733029,0,-379551585,,-291132713,-291132713,52234,OXLCP
2019-03-31,,,-20981998,,-20981998,25262087,89398979,64136892,64136892,,-15051475,,,,0,89398979,25262087,0,-85118890,,-20981998,-20981998,52234,OXLCP
2018-03-31,,,38005588,,38005588,21061618,74815772,53754154,53754154,,-13400159,,,,0,74815772,21061618,0,-15748566,,38005588,38005588,52234,OXLCP
2017-03-31,,,105201826,,105201826,16089994,57944128,41854134,41854134,,-11711709,,,,0,57944128,16089994,0,63347692,,105201826,105201826,52234,OXLCP
2019-12-31,,,-3541000,,2325000,21476000,-7345000,-28821000,-28821000,,-2614000,,,,-5866000,144568000,173389000,151913000,25280000,,2325000,2325000,52239,VFF
2018-12-31,,,-9815000,,-7515000,15562000,9317000,-6245000,-6245000,,-2794000,,,,-2300000,150000000,156245000,140683000,-3570000,,-7515000,-7515000,52239,VFF
2017-12-31,,,-5520000,,-4757000,16394000,13973000,-2421000,-2421000,,-2695000,,,,-763000,158406000,160827000,144433000,-3099000,,-4757000,-4757000,52239,VFF
2016-12-31,,,-3087000,,-1983000,13720000,13223000,-497000,-497000,,-2514000,,,,-1104000,155502000,155999000,142279000,-2590000,,-1983000,-1983000,52239,VFF
2020-12-31,90244000,,185936000,,143453000,413916000,743656000,186123000,186123000,,-19000,,,,42483000,841434000,655311000,97778000,-187000,,143453000,143453000,52242,PAYC
2019-12-31,73080000,,226087000,,180576000,306820000,648335000,226224000,226224000,,-2315000,,,,45511000,737671000,511447000,89336000,-137000,,180576000,180495000,52242,PAYC
2018-12-31,46247000,,174711000,,137065000,240486000,490105000,173715000,173715000,,-99000,,,,37646000,566336000,392621000,76231000,996000,,137065000,136906000,52242,PAYC
2017-12-31,30430000,,127732000,,123486000,191074000,370609000,129710000,129710000,,-911000,,,,4246000,433047000,303337000,62438000,-1978000,,123486000,123171000,52242,PAYC
2019-12-31,5310000,,-3239000,,-5512000,15762000,26353000,5281000,5281000,,-1073000,,,,2273000,129558000,124277000,103205000,-8520000,,-5512000,-5512000,52247,KLR
2018-12-31,3368000,,-5676000,,-7098000,16586000,15420000,-4534000,-4534000,,-585000,,,,1424000,77845000,82379000,62425000,-1142000,,-7100000,-7098000,52247,KLR
2017-12-31,1891000,,966000,,494000,4757000,8326000,1678000,1678000,,-178000,,,,472000,43149000,41471000,34823000,-712000,,494000,494000,52247,KLR
2019-12-31,62999000,,-81028000,,-81028000,20005000,0,-83004000,-83004000,,,,,,0,0,83004000,0,1976000,,-81028000,-81028000,52249,YMAB
2018-12-31,34269000,,-43274000,,-43274000,8961000,0,-43230000,-43230000,,,,,,0,0,43230000,0,-44000,,-43274000,-43274000,52249,YMAB
2017-12-31,14307000,,-19161000,,-19161000,4937000,0,-19244000,-19244000,,,,,,0,0,19244000,0,83000,,-19161000,-19161000,52249,YMAB
2016-12-31,13855000,,-17057000,,-17057000,3184000,0,-17039000,-17039000,,-18000.0,,,,0,0,17039000,0,-18000,,-17057000,-17057000,52249,YMAB
2020-02-29,,,6369607,,6369607,380542,2138287,1757745,1757745,,,,,,0,2138287,380542,0,4611862,,6369607,6369607,52250,NCB
2019-02-28,,,1253107,,1253107,393803,2560097,2166294,2166294,,,,,,0,2560097,393803,0,-913187,,1253107,1253107,52250,NCB
2018-02-28,,,1929282,,1929282,413325,2648829,2235504,2235504,,,,,,0,2648829,413325,0,-306222,,1929282,1929282,52250,NCB
2017-02-28,,,131439,,131439,418633,2955870,2537237,2537237,,,,,,0,2955870,418633,0,-2405798,,131439,131439,52250,NCB
2019-12-31,114859000,,-15768000,-1743000,-13614000,41300000,137919000,-18307000,-18307000,,-2325000,,,,416000,671835000,690142000,533916000,2539000,,-16184000,-13614000,52251,HIMX
2018-12-31,123037000,,7020000,-4261000,8569000,42008000,168915000,3580000,3580000,,-1232000,,,,994000,723605000,720025000,554690000,3440000,,6026000,8569000,52251,HIMX
2017-12-31,117662000,,30092000,-1735000,27680000,40849000,167025000,8359000,8359000,,-878000,,,,4554000,685167000,676808000,518142000,21733000,,25538000,27680000,52251,HIMX
2016-12-31,95820000,,59418000,4074000,50912000,38637000,194312000,59235000,59235000,,-633000,,,,10671000,802917000,743682000,608605000,183000,,48747000,50912000,52251,HIMX
2019-12-31,,,21999000,77231000,-4690000,329267000,454727000,87131000,87131000,,-64942000,,,,10533000,1415803000,1328672000,961076000,-65132000,,11466000,-16994000,52252,MDCA
2018-12-31,,,-80345000,116060000,-123733000,350046000,485005000,88763000,88763000,,-67075000,,,,31603000,1476203000,1387440000,991198000,-169108000,,-111948000,-132088000,52252,MDCA
2017-12-31,,,89159000,120916000,241848000,310572000,490303000,136257000,136257000,,-64364000,,,,-168064000,1513779000,1377522000,1023476000,-47098000,,257223000,205594000,52252,MDCA
2016-12-31,,,-50025000,125813000,-45839000,305809000,449652000,97397000,97397000,,-64795000,,,,-9404000,1385785000,1288388000,936133000,-147422000,,-40621000,-45839000,52252,MDCA
2019-12-31,352000000,,4070000000,13191000000,2651000000,11963000000,18634000000,10044000000,10044000000,-3736000000,-5845000000,,,,975000000,154322000000,144278000000,135688000000,-5974000000,,3095000000,2651000000,52254,ZNH
2018-12-31,221000000,,4487000000,13180000000,2983000000,10822000000,14998000000,8002000000,8002000000,-4048000000,-3202000000,,,,1031000000,143623000000,135621000000,128625000000,-3515000000,,3456000000,2983000000,52254,ZNH
2017-12-31,173000000,,8798000000,12571000000,5914000000,10393000000,15692000000,7959000000,7959000000,-2841000000,-2747000000,,,,1965000000,127489000000,119530000000,111797000000,839000000,,6833000000,5914000000,52254,ZNH
2016-12-31,173000000,,7648000000,11523000000,5056000000,9418000000,18391000000,8664000000,8664000000,294000000,-2464000000,,,,1759000000,114803000000,106139000000,96412000000,-1016000000,,5889000000,5056000000,52254,ZNH
2019-12-31,1174000000,,687000000,,4700000000,3953000000,7632000000,1806000000,1806000000,,-473000000,,,,-4013000000,10735000000,8929000000,3103000000,-1119000000,,4700000000,4700000000,52255,BSX
2018-12-31,1113000000,,1422000000,,1671000000,3557000000,6993000000,1724000000,1724000000,,-241000000,,,,-249000000,9823000000,8099000000,2830000000,-302000000,,1671000000,1671000000,52255,BSX
2017-12-31,997000000,,932000000,,104000000,3281000000,6442000000,1599000000,1599000000,,-229000000,,,,828000000,9048000000,7449000000,2606000000,-667000000,,104000000,104000000,52255,BSX
2016-12-31,920000000,,177000000,,347000000,3083000000,5939000000,1391000000,1391000000,,-233000000,,,,-170000000,8386000000,6995000000,2447000000,-1214000000,,347000000,347000000,52255,BSX
2020-12-31,141249000,,661985000,707000,581776000,735267000,1571040000,694524000,694524000,,-32539000,,,,79854000,2706655000,2012131000,1135615000,-32539000,,582131000,581776000,52257,IDXX
2019-12-31,133193000,,522218000,352000,427720000,666110000,1365549000,566246000,566246000,,-31055000,,,,94426000,2406908000,1840662000,1041359000,-44028000,,427792000,427720000,52257,IDXX
2018-12-31,117863000,,457742000,280000,377031000,632344000,1241542000,491335000,491335000,,-34744000,,,,80695000,2213242000,1721907000,971700000,-36222000,,377047000,377031000,52257,IDXX
2017-12-31,109182000,,381057000,264000,263144000,575172000,1097382000,413028000,413028000,,-37225000,,,,117788000,1969058000,1556030000,871676000,-31971000,,263269000,263144000,52257,IDXX
2019-12-31,,,5081560,,4294345,579708,5790058,5210350,5210350,,-128790,,,,787215,59524900,54314550,53734842,-128790,,4294345,4294345,52258,ICCH
2018-12-31,,,999383,,893296,545986,1686246,1140260,1140260,,-140877,,,,106087,51163691,50023431,49477445,-140877,,893296,893296,52258,ICCH
2017-12-31,,,1080136,,707851,555109,1860624,1305515,1305515,,-225379,,,,372285,48178157,46872642,46317533,-225379,,707851,707851,52258,ICCH
2016-12-31,,,3987366,,2810397,464383,4677844,4213461,4213461,,-226095,,,,1176969,44870942,40657481,40193098,-226095,,2810397,2810397,52258,ICCH
2020-12-31,,,29901000,,23287000,54943000,97641000,0,32225000,10473000,,,,,6614000,97641000,65416000,0,-2324000,,23287000,23287000,52259,SONA
2019-12-31,,,39244000,,33167000,42792000,95836000,0,37926000,15118000,,,,,6077000,95836000,57910000,0,1318000,,33167000,33167000,52259,SONA
2018-12-31,,,43305000,,33691000,42693000,96715000,0,44760000,9262000,,,,,9614000,96715000,51955000,0,-1455000,,33691000,33691000,52259,SONA
2017-12-31,,,15572000,,2425000,31682000,64721000,0,26363000,6676000,,,,,13147000,64721000,38358000,0,-10791000,,2425000,2425000,52259,SONA
2020-12-31,,,12479000000,,9459000000,15976000000,35974000000,0,15899000000,2197000000,,,,,3020000000,41462000000,25563000000,5488000000,-3420000000,,9459000000,8915000000,52263,GS
2019-12-31,,,10583000000,1713000000.0,8466000000,15437000000,31062000000,0,11823000000,2098000000,,,,,2117000000,35481000000,23658000000,4419000000,-1240000000,,8466000000,7871000000,52263,GS
2018-12-31,,,12481000000,1568000000.0,10459000000,15091000000,31719000000,0,13325000000,1975000000,,,,,2022000000,35942000000,22617000000,4223000000,-844000000,,10459000000,9841000000,52263,GS
2017-12-31,,,11132000000,553000000.0,4286000000,14139000000,28300000000,0,11320000000,1689000000,,,,,6846000000,32073000000,20753000000,3773000000,-188000000,,4286000000,3661000000,52263,GS
2019-12-31,11241000,,-23605000,,-23605000,127746000,114159000,-24828000,-24828000,,-2497000,,,,0,119872000,144700000,5713000,1223000,,-23605000,-86124000,52265,SKLZ
2018-12-31,7547000,,-27780000,,-27780000,66664000,48666000,-25545000,-25545000,,-2190000,,,,0,50778000,76323000,2112000,-2235000,,-27780000,-46578000,52265,SKLZ
2019-12-31,,,49723000,,49723000,14883000,115677000,75907000,75907000,-468000,-24632000,,,,0,140655000,64748000,24978000,-26184000,,49723000,48726000,52266,GTY
2018-12-31,,,47706000,,47706000,14661000,112461000,69498000,69498000,4196000,-22345000,,,,0,136106000,66608000,23645000,-21792000,-704000.0,47706000,46955000,52266,GTY
2017-12-31,,,47186000,,47186000,13879000,97813000,65755000,65755000,-1115000,-17769000,,,,0,120153000,54398000,22340000,-18569000,2138000.0,47186000,46619000,52266,GTY
2016-12-31,,,39825000,,38411000,14155000,92066000,56535000,56535000,2654000,-16561000,,,,0,115271000,58736000,23205000,-16710000,-1414000.0,39825000,37929000,52266,GTY
2020-12-31,,,2413000000,8416000000,2919000000,-200000000,10707000000,5146000000,5146000000,1709000000,-1950000000,,,,44000000,17997000000,12851000000,7290000000,-2733000000,,2369000000,2919000000,52268,NEE
2019-12-31,,,3836000000,4842000000,3769000000,-185000000,11201000000,5366000000,5366000000,1804000000,-2249000000,,,,448000000,19204000000,13838000000,8003000000,-1530000000,,3388000000,3769000000,52268,NEE
2018-12-31,,,7352000000,3737000000,6638000000,-168000000,9665000000,4371000000,4371000000,1551000000,-1498000000,,,,1576000000,16727000000,12356000000,7062000000,2981000000,,5776000000,6638000000,52268,NEE
2017-12-31,,,4663000000,1295000000,5380000000,-151000000,9644000000,5983000000,5983000000,1455000000,-1558000000,,,,-660000000,17173000000,11190000000,7529000000,-1320000000,,5323000000,5380000000,52268,NEE
2020-12-31,,,451969000,,366738000,659931000,1130902000,470971000,470971000,,-12353000,,,,85231000,3936623000,3465652000,2805721000,-19002000,,366738000,366738000,52269,POOL
2019-12-31,,,317736000,,261575000,583679000,924925000,341246000,341246000,,-22472000,,,,56161000,3199517000,2858271000,2274592000,-23510000,,261575000,261575000,52269,POOL
2018-12-31,,,293235000,,234461000,556284000,870173000,313889000,313889000,,-20296000,,,,58774000,2998097000,2684208000,2127924000,-20654000,,234461000,234461000,52269,POOL
2017-12-31,,,269321000,,191633000,520918000,805289000,284371000,284371000,,-15389000,,,,77982000,2788188000,2503817000,1982899000,-15050000,,191339000,191633000,52269,POOL
2020-05-31,,,-161000000,,-52400000,759900000,1408400000,292600000,292600000,,-62200000,,,,-111800000,7806900000,7514300000,6398500000,-453600000,-3200000,-49200000,-52400000,52270,DRI
2019-05-26,,,782300000,,713400000,660800000,1849000000,851500000,851500000,,-54000000,,,,63700000,8510400000,7658900000,6661400000,-69200000,-5200000,718600000,713400000,52270,DRI
2018-05-27,,,605700000,,596000000,662100000,1745400000,770200000,770200000,,-59700000,,,,1900000,8080100000,7309900000,6334700000,-164500000,-7800000,603800000,596000000,52270,DRI
2017-05-28,,,637300000,,479100000,627400000,1569400000,669100000,669100000,,-41500000,,,,154800000,7170200000,6501100000,5600800000,-31800000,-3400000,482500000,479100000,52270,DRI
2020-12-31,,,80867000,,80867000,16302000,173627000,104565000,104565000,,-23661000,,,,0,178332000,73767000,4705000,-23698000,,80867000,80569000,52271,CTRE
2019-12-31,,,46359000,,46359000,15158000,156379000,89399000,89399000,,-28125000,,,,0,163401000,74002000,7022000,-43040000,,46359000,46063000,52271,CTRE
2018-12-31,,,57923000,,57923000,12555000,142053000,83732000,83732000,,-27860000,,,,0,156941000,73209000,14888000,-25809000,,57923000,57559000,52271,CTRE
2017-12-31,,,25874000,,25874000,11117000,119995000,59305000,59305000,10414000.0,-24196000,,,,0,132982000,73677000,12987000,-55728000,,25874000,25520000,52271,CTRE
2019-08-31,,,14604022,,14604022,6196679,43923422,37726743,37726743,,-6951555,,,,0,43923422,6196679,0,-23122721,,14604022,14604022,52272,FRA
2018-08-31,,,26912250,,26912250,6680143,41694483,35014340,35014340,,-5709193,,,,0,41694483,6680143,0,-8102090,,26912250,26912250,52272,FRA
2017-08-31,,,36008640,,36008640,6763229,38718273,31955044,31955044,,-3682438,,,,0,38718273,6763229,0,4053596,,36008640,36008640,52272,FRA
2016-08-31,,,23134183,,23134183,6156188,36771942,30615754,30615754,,-2178604,,,,0,36771942,6156188,0,-7481571,,23134183,23134183,52272,FRA
2019-12-31,83331000,,-24415000,,-48206000,84826000,162532000,-5625000,-5625000,,-20522000,,,,23791000,282297000,287922000,119765000,-18790000,,-48206000,-48206000,52273,CASA
2018-12-31,70974000,,65938000,,73006000,68026000,217966000,78966000,78966000,,-19763000,,,,-7068000,297127000,218161000,79161000,-13028000,,73006000,73006000,52273,CASA
2017-12-31,60677000,,122818000,,88500000,61165000,258064000,136222000,136222000,,-17466000,,,,34318000,351575000,215353000,93511000,-13404000,,88500000,11849000,52273,CASA
2016-12-31,49210000,,115693000,,88668000,54329000,218311000,114772000,114772000,,-902000,,,,27025000,316128000,201356000,97817000,921000,,88668000,-35119000,52273,CASA
2019-12-31,,,62610000,36137000,55400000,30732000,321643000,135783000,135783000,,-48605000,,,,5367000,1149087000,1013304000,827444000,-73173000,,57243000,54852000,52276,XHR
2018-12-31,,,204525000,28792000,193688000,30460000,315842000,127544000,127544000,,-51402000,,,,5993000,1058207000,930663000,742365000,76981000,,198532000,193005000,52276,XHR
2017-12-31,,,108649000,30181000,98862000,31552000,291419000,106890000,106890000,,-46294000,,,,7833000,945277000,838387000,653858000,1759000,,100816000,98269000,52276,XHR
2016-12-31,,,91807000,21970000,85855000,28183000,305484000,124883000,124883000,,-48113000,,,,5077000,950160000,825277000,644676000,-33076000,,86730000,85382000,52276,XHR
2019-12-31,,,1599000000,,1273000000,1771000000,4057000000,2070000000,2070000000,-11000000,-394000000,,,,326000000,5373000000,3303000000,1316000000,-471000000,,1273000000,1273000000,52277,MAR
2018-12-31,,,2345000000,,1907000000,1587000000,3909000000,2521000000,2521000000,-425000000,-340000000,,,,438000000,5215000000,2694000000,1306000000,-176000000,,1907000000,1907000000,52277,MAR
2017-12-31,,,2982000000,,1459000000,1483000000,3586000000,2663000000,2663000000,-789000000,-288000000,,,,1523000000,4997000000,2334000000,1411000000,319000000,,1459000000,1459000000,52277,MAR
2016-12-31,,,1239000000,,808000000,1152000000,2572000000,1810000000,1810000000,-509000000,-234000000,,,,431000000,3473000000,1663000000,901000000,-571000000,,808000000,808000000,52277,MAR
2019-12-31,15436000,,-28207000,,-28207000,14644000,0,-30080000,-30080000,,,,,,0,0,30080000,0,1873000,,-28207000,-28207000,52278,VRCA
2018-12-31,12826000,,-20648000,,-20648000,9052000,0,-21878000,-21878000,,,,,,0,0,21878000,0,1230000,,-20648000,-20648000,52278,VRCA
2017-12-31,3730000,,-4459000,,-4459000,727000,0,-4457000,-4457000,,-2000.0,,,,0,0,4457000,0,-2000,,-4459000,-9759000,52278,VRCA
2016-12-31,1709000,,-1913000,,-1913000,204000,0,-1913000,-1913000,,-2000.0,,,,0,0,1913000,0,0,,-1913000,-1913000,52278,VRCA
2019-12-31,100327000,,-153042000,,-153587000,64536000,9770000,-151724000,-151724000,-3369000,-1385000,,,,545000,9770000,161494000,0,-1318000,,-153587000,-153587000,52280,DBVT
2018-12-31,104468000,,-166061000,,-166076000,76295000,11186000,-166226000,-166226000,-3351000,-327000,,,,15000,11186000,177412000,0,165000,,-166076000,-166076000,52280,DBVT
2017-12-31,103214000,,-147692000,,-147693000,53690000,9601000,-144995000,-144995000,-2308000,-914000,,,,1000,9601000,154596000,0,-2697000,,-147693000,-147693000,52280,DBVT
2016-12-31,76925000,,-114531000,,-114531000,48200000,7531000,-116041000,-116041000,-1553000,-6000,,,,0,7531000,123572000,0,1510000,,-114531000,-114531000,52280,DBVT
2020-12-31,,,-130400000,,-122300000,932800000,1275500000,185500000,185500000,157200000,-261300000,,,,-18400000,8420100000,8234600000,7144600000,-315900000,-10300000,-112000000,-122800000,52281,R
2019-12-31,,,-42271000,,-24410000,967855000,1593577000,506914000,506914000,118808000,-241381000,,,,-18999000,8925801000,8418887000,7332224000,-549185000,-1138000,-23272000,-24863000,52281,R
2018-12-31,,,389469000,,284613000,856951000,1628627000,678373000,678373000,93303000,-180488000,,,,102547000,8413946000,7735573000,6785319000,-288904000,-2309000,286922000,283575000,52281,R
2017-12-31,,,296436000,,719644000,873176000,1471999000,524880000,524880000,73943000,-141876000,,,,-423665000,7280074000,6755194000,5808075000,-228444000,-457000,720101000,717050000,52281,R
2019-12-31,,,-48909,,-38637,323814,0,-323814,-323814,,,,,,-10272,0,323814,0,274905,,-38637,-122166,52282,GRNV
2020-12-31,,,177530000,,177530000,21080000,199667000,0,177530000,1057000,,,,,0,199667000,22137000,0,0,,177530000,160017000,52283,DX
2019-12-31,,,-152668000,,-152668000,15987000,-136703000,0,-152668000,-22000,,,,,0,-136703000,15965000,0,0,,-152668000,-165635000,52283,DX
2018-12-31,,,7023000,,7023000,15105000,23695000,0,7023000,1567000,,,,,0,23695000,16672000,0,0,,7023000,-4778000,52283,DX
2017-12-31,,,33893000,,33893000,15819000,49913000,0,33893000,201000,,,,,0,49913000,16020000,0,0,,33893000,23099000,52283,DX
2020-04-25,10800000,,115173000,15553000,77469000,565239000,737745000,161706000,161706000,,-1291000,,,,36189000,1703982000,1542276000,966237000,-46533000,,78984000,77352000,52287,LZB
2019-04-27,9100000,,95327000,14468000,68574000,570072000,701270000,122098000,122098000,,-1542000,,,,25186000,1745401000,1623303000,1044131000,-26771000,,70141000,68349000,52287,LZB
2018-04-28,7900000,,128890000,13035000,80866000,488367000,622747000,126480000,126480000,,-538000,,,,47295000,1583947000,1457467000,961200000,2410000,,81595000,80459000,52287,LZB
2017-04-29,8000000,,130740000,11186000,85922000,474326000,609303000,130581000,130581000,-3604000.0,-1073000,,,,43756000,1520060000,1389479000,910757000,159000,,86984000,85500000,52287,LZB
2020-12-31,,,83684000,,58693000,33850000,157379000,99609000,99609000,23920000,-2620000,,,,24991000,259726000,160117000,102347000,-15925000,,58693000,58693000,52289,GBL
2019-12-31,,,108658000,,81917000,44189000,188840000,117984000,117984000,26667000,-2609000,,,,26741000,312368000,194384000,123528000,-9326000,,81917000,81917000,52289,GBL
2018-12-31,,,154659000,,117196000,48208000,257687000,186787000,186787000,22692000,-3525000,,,,37463000,341455000,154668000,83768000,-32128000,,117196000,117196000,52289,GBL
2017-12-31,,,132888000,,77809000,58113000,226354000,148083000,148083000,20158000,-10160000,,,,55079000,360524000,212441000,134170000,-15195000,,77809000,77809000,52289,GBL
2020-12-31,,,103876000,89000,84337000,81301000,195081000,0,105583000,8197000,,,,,19539000,195081000,89498000,0,-1707000,,84337000,84337000,52292,LKFN
2019-12-31,,,107385000,89000,87047000,79672000,196809000,0,108023000,9114000,,,,,20338000,196809000,88786000,0,-638000,,87047000,87047000,52292,LKFN
2018-12-31,,,98944000,89000,80411000,77294000,185173000,0,100645000,7234000,,,,,18533000,185173000,84528000,0,-1701000,,80411000,80411000,52292,LKFN
2017-12-31,,,89634000,89000,57330000,71081000,168932000,0,91432000,6419000,,,,,32304000,168932000,77500000,0,-1798000,,57330000,57330000,52292,LKFN
2020-02-01,,,243969000,,187176000,2042130000,2426781000,369499000,369499000,,-104410000,,,,56212000,13190707000,12821208000,10763926000,-125530000,-581000,187757000,187176000,52293,BJ
2019-02-02,,,138918000,,127261000,2047362000,2360895000,307415000,307415000,,-139130000,,,,11826000,13007347000,12699932000,10646452000,-168497000,169000,127092000,127261000,52293,BJ
2018-02-03,,,23548000,,50301000,2008756000,2241097000,229337000,229337000,,-175663000,,,,-28427000,12754589000,12525252000,10513492000,-205789000,-1674000,51975000,50301000,52293,BJ
2017-01-28,,,72668000,,44224000,1908752000,2127520000,216019000,216019000,,-143460000,,,,27968000,12350537000,12134518000,10223017000,-143351000,-476000,44700000,44224000,52293,BJ
2019-12-31,,,-77052000,,-66160000,175457000,249706000,73344000,73344000,905000,-56651000,,,,-10892000,461067000,387723000,211361000,-150396000,,-66160000,-66160000,52294,VTRU
2018-12-31,,,-50215000,,-45204000,127956000,199288000,70291000,70291000,1041000,-62517000,,,,-5011000,383449000,313158000,184161000,-120506000,,-45204000,-45204000,52294,VTRU
2020-12-31,,,5726695000,27083098000,2002509000,2933132000,8659827000,0,5726695000,,,,,,609097000,8659827000,2933132000,0,0,,5117598000,1945954000,52296,KKR
2019-12-31,,,5168290000,19694884000,2005049000,2908431000,7907306000,0,5168290000,-169415000.0,,,,,528750000,7907306000,2739016000,0,0,,4639540000,1971685000,52296,KKR
2018-12-31,,,2256848000,16732999000,1131063000,2077976000,4199336000,0,2268349000,-146989000.0,,,,,-194098000,4199336000,1930987000,0,-11501000,,2450946000,1100801000,52296,KKR
2017-12-31,,,2784368000,13476864000,1018305000,2336692000,4999133000,0,2784368000,-121927000.0,,,,,224326000,4999133000,2214765000,0,0,,2560042000,984941000,52296,KKR
2020-12-31,,,59488000,2180000,59294000,22733000,156251000,123842000,123842000,243000,-64354000,,,,0,158731000,34889000,2480000,-64354000,,59488000,59294000,52298,SAFE
2019-12-31,,,33728000,1486000,27693000,14435000,90320000,65607000,65607000,899000,-29868000,,,,0,92993000,27386000,2673000,-31879000,,33728000,27693000,52298,SAFE
2018-12-31,,,11936000,2007000,11740000,10662000,48124000,27325000,27325000,995000,-15389000,,,,0,49724000,22399000,1600000,-15389000,,11936000,11740000,52298,SAFE
2017-12-31,,,-1823000,2007000,-1823000,6237000,21763000,7967000,7967000,252000,-9917000,,,,0,23234000,15267000,1471000,-9790000,,-1823000,-3669000,52298,SAFE
2019-12-31,,,5080000,3249000,3476000,15639000,60065000,4122000,4122000,4148000,-3635000,,,,1421000,108972000,104850000,48907000,958000,,3659000,3476000,52300,PNRG
2018-12-31,,,17643000,3994000,14529000,13550000,67394000,17350000,17350000,-1235000,-3413000,,,,2978000,116865000,99515000,49471000,293000,,14665000,14529000,52300,PNRG
2017-12-31,,,39681000,7130000,41998000,9646000,46048000,726000,726000,-392000,-2310000,,,,-7753000,88918000,88192000,42870000,38955000,,47434000,41998000,52300,PNRG
2016-12-31,,,7522000,7335000,3444000,7849000,20271000,-21350000,-21350000,3598000,-3507000,,,,2100000,60364000,81714000,40093000,28872000,,5422000,3444000,52300,PNRG
2020-03-31,41884900000,,-115799800000,8135600000,-120708500000,380528400000,1117557400000,2839900000,2839900000,478049900000,-62336600000,,,,3952500000,2616806200000,2613966300000,1499248800000,-118639700000,,-119752300000,-120708500000,52306,TTM
2019-03-31,42245700000,,-311616500000,5230600000,-288262300000,419735000000,1246528100000,37740300000,37740300000,510900800000,-44579500000,,,,-24374500000,3025597800000,2987857500000,1779069700000,-349356800000,,-287242000000,-288262300000,52306,TTM
2018-03-31,35318700000,,134332900000,5250600000,89889100000,392686800000,1238448500000,117875100000,117875100000,477032000000,-36936100000,,,,43419300000,2921087500000,2803212400000,1682639000000,16457800000,,90913600000,89889100000,52306,TTM
2017-03-31,34135700000,,108077900000,4531700000,74543600000,370315700000,1198977400000,155938000000,155938000000,459538100000,-34845800000,,,,32512300000,2698496600000,2542558600000,1499519200000,-47860100000,,75565600000,74543600000,52306,TTM
2019-12-31,276018000,,817103000,2023649000,625146000,942821000,2341232000,1122393000,1122393000,,-324381000,,,,168459000,5098691000,3976298000,2757459000,-305290000,,648644000,625146000,52308,GRFS
2018-12-31,240661000,,725842000,471050000,596642000,814775000,2049560000,994124000,994124000,,-274162000,,,,131436000,4486724000,3492600000,2437164000,-268282000,,594406000,596642000,52308,GRFS
2017-12-31,224645000,,695722000,4886000,662700000,860348000,2152011000,1067018000,1067018000,,-249533000,,,,34408000,4318073000,3251055000,2166062000,-371296000,,661314000,662700000,52308,GRFS
2016-12-31,197617000,,712752000,6497000,545456000,775266000,1912291000,939408000,939408000,,-228804000,,,,168209000,4049830000,3110422000,2137539000,-226656000,,544543000,545456000,52308,GRFS
2020-12-31,,,-309431000,,-212192000,123698000,117563000,-101665000,-101665000,,-373000,,,,-97239000,598302000,699967000,480739000,-207766000,,-212192000,-212192000,52309,RES
2019-12-31,,,-113101000,,-87111000,168127000,293737000,-44842000,-44842000,43000.0,-334000,,,,-25990000,1222409000,1267251000,928672000,-68259000,,-87111000,-87445000,52309,RES
2018-12-31,,,221280000,,175402000,168151000,537957000,206686000,206686000,43000.0,-489000,,,,45878000,1721005000,1514319000,1183048000,14594000,,175402000,173563000,52309,RES
2017-12-31,,,232816000,,162511000,159194000,544418000,221687000,221687000,43000.0,-426000,,,,70305000,1595227000,1373540000,1050809000,11129000,,162511000,160409000,52309,RES
2019-12-31,,,396705000,,316821000,,357339000,357339000,357339000,,-856000,,,,79884000,2477298000,2119959000,2119959000,39366000,,316821000,316821000,52310,ERIE
2018-12-31,,,371320000,,288224000,-1716000.0,344343000,344343000,344343000,,-2460000,,,,83096000,2382212000,2037869000,2037869000,26977000,,288224000,288224000,52310,ERIE
2017-12-31,,,315695000,,196999000,3482000.0,290252000,290252000,290252000,215740000.0,-1238000,,,,118696000,1691774000,1401522000,1401522000,25443000,,196999000,196999000,52310,ERIE
2016-12-31,,,320091000,,210366000,2412000.0,293517000,291105000,291105000,197111000.0,-101000,,,,109725000,1596631000,1305526000,1303114000,28986000,,210366000,210366000,52310,ERIE
2019-12-31,242799000,,-344681000,,-344681000,317418000,247790000,-312427000,-312427000,,-41144000,,,,0,252002000,564429000,4212000,-32254000,,-344681000,-344681000,52311,ICPT
2018-12-31,207301000,,-309242000,,-309242000,255474000,177285000,-285490000,-285490000,,-30523000,,,,0,179804000,465294000,2519000,-23752000,,-309242000,-309242000,52311,ICPT
2017-12-31,190199000,,-360367000,,-360367000,269798000,129585000,-330412000,-330412000,,-29271000,,,,0,130956000,461368000,1371000,-29955000,,-360367000,-360367000,52311,ICPT
2016-12-31,153893000,,-412830000,,-412830000,228596000,24951000,-357538000,-357538000,,-14196000,,,,0,24951000,382489000,0,-55292000,,-412830000,-412830000,52311,ICPT
2019-12-31,,,55712000,30036000,47821000,931511000,2546759000,425784000,425784000,924634000,-316977000,,,,2957000,4031017000,3605233000,1484258000,-370072000,,52755000,54667000,52312,PPD
2018-12-31,,,146444000,24892000,104186000,813019000,2415159000,402253000,402253000,940913000,-269072000,,,,39579000,3748971000,3346718000,1333812000,-255809000,,106865000,96337000,52312,PPD
2017-12-31,,,16469000,21733000,296027000,800833000,1464493000,340594000,340594000,940913000,-257444000,,,,-284360000,2767476000,2426882000,1302983000,-324125000,,300829000,198891000,52312,PPD
2016-12-31,,,166893000,21733000,183095000,708928000,1292890000,323475000,323475000,940913000,-205803000,,,,-15961000,2467941000,2144466000,1175051000,-156582000,,182854000,183095000,52312,PPD
2020-12-31,,,396300000,72300000,284500000,520000000,1017700000,497700000,497700000,,-67600000,,,,103900000,3513200000,3015500000,2495500000,-101400000,,292400000,284500000,52313,TKR
2019-12-31,,,472400000,86600000,362100000,608400000,1149800000,541400000,541400000,,-72100000,,,,97700000,3789900000,3248500000,2640100000,-69000000,,374700000,362100000,52313,TKR
2018-12-31,,,408100000,63100000,302800000,586900000,1040100000,453200000,453200000,,-51700000,,,,102600000,3580800000,3127600000,2540700000,-45100000,,305500000,302800000,52313,TKR
2017-12-31,,,259900000,32200000,203400000,523300000,812100000,288800000,288800000,,-37100000,,,,57600000,3003800000,2715000000,2191700000,-28900000,,202300000,203400000,52313,TKR
2019-12-31,18176000,,-21877000,,-21877000,5010000,967000,-22219000,-22219000,,-26000,,,,0,967000,23186000,0,342000,,-21877000,-25852000,52314,PAND
2018-12-31,8387000,,-10887000,,-10887000,2662000,0,-11049000,-11049000,,-13000,,,,0,0,11049000,0,162000,,-10887000,-13216000,52314,PAND
2019-12-31,,,12475488,,8697999,4500000,18697785,11056161,11056161,-4246057,-115356,,,,3777489,26690336,15634175,7992551,1419327,,8697999,8697999,52315,EPSN
2018-12-31,,,7404485,,6662060,4935738,21738528,7682572,7682572,1938465,-140615,,,,742425,29684205,22001633,7945677,-278087,,6662060,6662060,52315,EPSN
2017-12-31,,,5369479,,7435905,4418288,19137704,6271344,6271344,-2623687,-955698,,,,-2066426,25757091,19485747,6619387,-901865,,7435905,7435905,52315,EPSN
2016-12-31,,,-10264301,,-7567783,2047804,16344369,-7158260,-7158260,487550,-3084565,,,,-2696518,23700273,30858533,7355904,-3106041,,-7567783,-7567783,52315,EPSN
2019-12-31,,,-270761000,2369000,-267931000,497625000,895221000,18163000,18163000,,-248341000,,,,-2269000,3267039000,3248876000,2371818000,-288924000,,-268492000,-267931000,52317,BKD
2018-12-31,,,-577808000,-490000,-528258000,534679000,1067869000,85735000,85735000,,-280269000,,,,-49456000,3521197000,3435462000,2453328000,-663543000,,-528352000,-528258000,52317,BKD
2017-12-31,,,-588121000,-437000,-571419000,617740000,1253830000,154013000,154013000,,-326154000,,,,-16515000,3855985000,3701972000,2602155000,-742134000,,-571606000,-571419000,52317,BKD
2016-12-31,,,-399258000,-250000,-404397000,636844000,1439981000,282735000,282735000,,-385617000,,,,5378000,4239383000,3956648000,2799402000,-681993000,,-404636000,-404397000,52317,BKD
2019-12-31,,,4625000,,-18630000,19909000,48238000,25746000,25746000,,-19806000,,,,0,99219000,73473000,50981000,-21121000,-23255000,4625000,-18630000,52318,REPH
2018-12-31,39985000.0,,4368000,,-79723000,14437000,29785000,12765000,12765000,,-8756000,,,,17436000,77347000,64582000,47562000,-8397000,-66655000,-13068000,-79723000,52318,REPH
2017-12-31,39985000.0,,600000,,-50082000,14324000,29181000,12274000,12274000,,-12034000,,,,7317000,71834000,59560000,42653000,-11674000,-43365000,-6717000,-50082000,52318,REPH
2016-12-31,39985000.0,,-31312000,,-30205000,12742000,-1093000,-16418000,-16418000,,-5588000,,,,-1107000,69337000,85755000,70430000,-14894000,-43365000,-30205000,-30205000,52318,REPH
2020-12-31,,,243724000,,185754000,289560000,611396000,0,252383000,69453000,,,,,57970000,611396000,359013000,0,-8659000,,185754000,185754000,52320,FHB
2019-12-31,,,381698000,,284392000,282425000,752135000,0,389088000,80622000,,,,,97306000,752135000,363047000,0,-7390000,,284392000,284392000,52320,FHB
2018-12-31,,,358178000,,264394000,266794000,723131000,0,376520000,79817000,,,,,93784000,723131000,346611000,0,-18342000,,264394000,264394000,52320,FHB
2017-12-31,,,368355000,,183682000,255020000,715909000,0,383262000,77627000,,,,,184673000,715909000,332647000,0,-14907000,,183682000,183682000,52320,FHB
2020-10-03,22564000,,200758000,,139713000,240931000,525707000,263079000,263079000,-867000,-28903000,,,,61045000,6960370000,6697291000,6434663000,-62321000,,139713000,139713000,52323,SANM
2019-09-28,27552000,,245619000,,141515000,260032000,591938000,299870000,299870000,4484000,-30763000,,,,104104000,8233859000,7933989000,7641921000,-54251000,,141515000,141515000,52323,SANM
2018-09-29,30754000,,97539000,,-95533000,250924000,463783000,179197000,179197000,2908000,-27734000,,,,193072000,7110130000,6930933000,6646347000,-81658000,,-95533000,-95533000,52323,SANM
2017-09-30,33716000,,213480000,,138833000,251568000,519911000,227806000,227806000,6821000,-21934000,,,,74647000,6868619000,6640813000,6348708000,-14326000,,138833000,138833000,52323,SANM
2019-12-31,,,-609221000,,-451653000,331003000,310151000,-20852000,-20852000,,-482400000,,,,-157568000,3346851000,3367703000,3036700000,-588369000,,-451653000,-451653000,52324,GFL
2018-12-31,,,-624252000,,-483336000,197963000,170800000,-27163000,-27163000,,-262000000,,,,-140916000,1852591000,1879754000,1681791000,-597089000,,-483336000,-483336000,52324,GFL
2017-12-31,,,-139957000,,-100982000,136290000,198701000,62411000,62411000,,-196500000,,,,-38975000,1333067000,1270656000,1134366000,-202368000,,-100982000,-100982000,52324,GFL
2016-12-31,,,-201663000,,-152209000,105325000,125852000,20527000,20527000,,-164500000,,,,-49454000,933661000,913134000,807809000,-222190000,,-152209000,-152209000,52324,GFL
2020-09-30,,,49294000,1804000,41599000,170911000,227959000,57048000,57048000,,-777000,,,,8740000,1190856000,1133808000,962897000,-7754000,,40554000,40830000,52325,IESC
2019-09-30,,,40141000,3294000,33206000,140575000,182103000,41528000,41528000,,-1857000,,,,6663000,1076996000,1035468000,894893000,-1387000,,33478000,32950000,52325,IESC
2018-09-30,,,24348000,3232000,-14157000,123920000,149962000,26042000,26042000,,-1946000,,,,38151000,876828000,850786000,726866000,-1694000,,-13803000,-14113000,52325,IESC
2017-09-30,,,18805000,3271000,13422000,120370000,140498000,20128000,20128000,,-1702000,,,,5211000,810744000,790616000,670246000,-1323000,,13594000,13275000,52325,IESC
2019-12-31,,,165156000,,131616000,,269714000,168456000,168456000,98858000,,,,,33540000,819188000,650732000,549474000,-3300000,,131616000,131616000,52326,NWLI
2018-12-31,,,141507000,,116758000,234000.0,235476000,142507000,142507000,91569000,,,,,24749000,551599000,409092000,316123000,-1000000,,116758000,116758000,52326,NWLI
2017-12-31,,,144555000,,110421000,474000.0,251557000,136355000,136355000,110202000,,,,,34134000,874448000,738093000,622891000,8200000,,110421000,110421000,52326,NWLI
2016-12-31,,,152862000,,100892000,662000.0,247310000,157062000,157062000,82348000,,,,,51970000,682368000,525306000,435058000,-4200000,,100892000,100892000,52326,NWLI
2019-12-31,27843000,,-44568000,1324000,-44568000,17556000,0,-45399000,-45399000,,,,,,0,0,45399000,0,831000,,-44568000,-44568000,52328,MLND
2018-12-31,14425000,,-27177000,2171000,-27192000,8691000,0,-23116000,-23116000,,-134000.0,,,,0,0,23116000,0,-4061000,,-27177000,-27192000,52328,MLND
2017-12-31,14526000,,-84586000,12755000,-84578000,5956000,0,-20482000,-20482000,,-288000.0,,,,0,0,20482000,0,-64104000,,-84586000,-84578000,52328,MLND
2016-12-31,14097000,,-18847000,12755000,-18847000,4543000,0,-18640000,-18640000,,-177000.0,,,,0,0,18640000,0,-207000,,-18847000,-18847000,52328,MLND
2020-12-31,,,6444000,,5054000,82708000,124199000,0,14460000,27031000,,,,,1390000,124199000,109739000,0,-8016000,,5054000,4130000,52329,FRBK
2019-12-31,,,-4850000,,-3500000,84079000,99640000,0,-1513000,17074000,,,,,-1350000,99640000,101153000,0,-3337000,,-3500000,-3500000,52329,FRBK
2018-12-31,,,10205000,,8627000,66670000,93926000,0,13468000,13788000,,,,,1578000,93926000,80458000,0,-3263000,,8627000,8627000,52329,FRBK
2017-12-31,,,5986000,,8905000,58005000,81262000,0,11445000,11812000,,,,,-2919000,81262000,69817000,0,-5459000,,8905000,8905000,52329,FRBK
2020-12-31,,,16677000,,13755000,,53842000,0,16677000,37165000,,,,,2922000,53842000,37165000,0,0,,13755000,13755000,52330,UBOH
2019-12-31,,,12276000,,10661000,23641000.0,41413000,0,10296000,7476000,,,,,1615000,41413000,31117000,0,1980000,,10661000,10661000,52330,UBOH
2018-12-31,,,9749000,,8220000,20844000.0,37185000,0,9749000,6592000,,,,,1529000,37185000,27436000,0,0,,8220000,8220000,52330,UBOH
2017-12-31,,,6725000,,3846000,16017000.0,29103000,0,7996000,5090000,,,,,2879000,29103000,21107000,0,-1271000,,3846000,3846000,52330,UBOH
2019-12-31,,,17631000,,11671000,14687000,42444000,17637000,17637000,9985000,-6000,,,,5960000,55421000,37784000,12977000,-6000,,11671000,11671000,52331,GNOG
2018-12-31,,,11867000,,7159000,12840000,33219000,11875000,11875000,8378000,-8000,,,,4708000,42902000,31027000,9683000,-8000,,7159000,7159000,52331,GNOG
2019-12-31,,,-1192300000,,-1033300000,75400000,2000400000,-903900000,-903900000,90700000,-173100000,,,,-159000000,2877100000,3781000000,876700000,-288400000,,-1033300000,-1033300000,52332,CPG
2018-12-31,,,-3555400000,,-2616900000,97700000,2311000000,-3197400000,-3197400000,83900000,-188400000,,,,-938500000,3320500000,6517900000,1009500000,-358000000,,-2616900000,-2616900000,52332,CPG
2017-12-31,,,-23600000,,-124000000,94300000,1889900000,68600000,68600000,-76400000,-154900000,,,,100400000,2858700000,2790100000,968800000,-92200000,,-124000000,-124000000,52332,CPG
2016-12-31,,,-1313800000,,-932700000,98600000,1362700000,-1159100000,-1159100000,145400000,-155700000,,,,-381100000,2184600000,3343700000,821900000,-154700000,,-932700000,-932700000,52332,CPG
2019-12-31,157505000,,-99352000,,-104420000,988620000,1038570000,-107555000,-107555000,,-3110000,,,,5068000,1478493000,1586048000,439923000,8203000,,-104420000,-104420000,52333,COE
2018-12-31,185000000,,-412814000,,-416694000,954290000,734609000,-404681000,-404681000,,-1944000,,,,3880000,1145517000,1550198000,410908000,-8133000,,-416694000,-416694000,52333,COE
2017-12-31,223202000,,-576469000,,-580811000,881460000,533872000,-570790000,-570790000,,-12542000,,,,4342000,847993000,1418783000,314121000,-5679000,,-580811000,-580811000,52333,COE
2016-12-31,152709000,,-513162000,,-514778000,630547000,271124000,-512132000,-512132000,,-12542000,,,,1616000,418281000,930413000,147157000,-1030000,,-514778000,-603791000,52333,COE
2020-06-30,,,574110,,574110,214075,788185,574110,574110,,,,,,0,788185,214075,0,0,,574110,574110,52336,MARPS
2019-06-30,,,634072,,634072,226471,860543,634072,634072,,,,,,0,860543,226471,0,0,,634072,634072,52336,MARPS
2018-06-30,,,661919,,661919,210723,872642,661919,661919,,,,,,0,872642,210723,0,0,,661919,661919,52336,MARPS
2017-06-30,,,751506,,751506,198032,949538,751506,751506,,,,,,0,949538,198032,0,0,,751506,751506,52336,MARPS
2020-12-31,,,-1419000000,65000000,-1061000000,,934000000,-1235000000,-1235000000,2169000000,-184000000,,,,-363000000,8503000000,9738000000,7569000000,-184000000,,-1056000000,-1105000000,52337,BHFAN
2019-12-31,,,-1052000000,65000000,-740000000,,1405000000,-895000000,-895000000,2279000000,-157000000,,,,-317000000,6520000000,7415000000,5115000000,-157000000,,-735000000,-761000000,52337,BHFAN
2018-12-31,,,989000000,65000000,865000000,,3463000000,1046000000,1046000000,2377000000,-57000000,,,,119000000,8864000000,7818000000,5401000000,-57000000,,870000000,865000000,52337,BHFAN
2017-12-31,,,-615000000,65000000,-378000000,,1865000000,-465000000,-465000000,2330000000,-150000000,,,,-237000000,6839000000,7304000000,4974000000,-150000000,,-378000000,-378000000,52337,BHFAN
2020-01-31,,,14652000,,13953000,224265000,250818000,25096000,25096000,,-9806000,,,,699000,1305171000,1280075000,1054353000,-10444000,,13953000,13732000,52338,TITN
2019-01-31,,,16154000,,12182000,201537000,231588000,30051000,30051000,,-13874000,,,,3972000,1261505000,1231454000,1029917000,-13897000,,12182000,11980000,52338,TITN
2018-01-31,,,-14439000,,-7049000,203203000,215300000,12097000,12097000,,-16999000,,,,-7390000,1192606000,1180509000,977306000,-26536000,,-7049000,-6908000,52338,TITN
2017-01-31,,,-22713000,,-14179000,213369000,213729000,360000,360000,,-21865000,,,,-8178000,1201697000,1201337000,987968000,-23073000,,-14535000,-13936000,52338,TITN
2019-12-31,45199000,,-24604000,,-24753000,165735000,194212000,-16722000,-16722000,,-78000,,,,149000,362305000,379027000,168093000,-7882000,,-24753000,-24753000,52340,TNDM
2018-12-31,29227000,,-122560000,,-122611000,105226000,89822000,-44631000,-44631000,,-7584000,,,,51000,183866000,228497000,94044000,-77929000,,-122611000,-122611000,52340,TNDM
2017-12-31,20661000,,-73025000,,-73033000,86377000,44094000,-62944000,-62944000,,-11341000,,,,8000,107601000,170545000,63507000,-10081000,,-73033000,-73033000,52340,TNDM
2016-12-31,18809000,,-83462000,,-83447000,82834000,23592000,-78051000,-78051000,,-5707000,,,,-15000,84248000,162299000,60656000,-5411000,,-83447000,-83447000,52340,TNDM
2019-12-31,36448000,,-53768000,,-53909000,16601000,0,-53049000,-53049000,,,,,,141000,0,53049000,0,-719000,,-53909000,-53909000,52347,FRLN
2018-12-31,25925000,,-33256000,,-33283000,6790000,0,-32715000,-32715000,,-151000.0,,,,27000,0,32715000,0,-541000,,-33283000,-33283000,52347,FRLN
2017-09-30,8521061,,-14672554,,-12461172,5590113,0,-14722847,-14722847,,-151000.0,,,,585401,0,14722847,0,50293,,-15257955,-12461172,52347,FRLN
2016-09-30,2076303,,-5440382,,-2575263,3420079,0,-5947156,-5947156,,-151000.0,,,,-1422811,0,5947156,0,506774,,-4017571,-2575263,52347,FRLN
2019-12-31,43399000,,-51387000,,-66049000,51549000,46201000,-48747000,-48747000,,-5405000,,,,14662000,190872000,239619000,144671000,-2640000,,-66049000,-66049000,52348,AAOI
2018-12-31,49903000,,-9778000,,-2146000,48638000,87773000,-10768000,-10768000,,-1106000,,,,-7632000,267465000,278233000,179692000,990000,,-2146000,-2146000,52348,AAOI
2017-12-31,35365000,,84526000,,73951000,43964000,166280000,86951000,86951000,,-858000,,,,10575000,382329000,295378000,216049000,-2425000,,73951000,73951000,52348,AAOI
2016-12-31,31780000,,21003000,,31234000,32154000,86954000,23020000,23020000,,-1717000,,,,-10231000,260713000,237693000,173759000,-2017000,,31234000,31234000,52348,AAOI
2020-12-31,,,389781000,,292990000,896362000,1429244000,0,424250000,108632000,,,,,96791000,1429244000,1004994000,0,-34469000,,292990000,271613000,52349,WTFCM
2019-12-31,,,480101000,,355697000,802683000,1408192000,0,504737000,100772000,,,,,124404000,1408192000,903455000,0,-24636000,,355697000,347497000,52349,WTFCM
2018-12-31,,,460133000,,343166000,718618000,1285620000,0,487432000,79570000,,,,,116967000,1285620000,798188000,0,-27299000,,343166000,334966000,52349,WTFCM
2017-12-31,,,389997000,,257682000,635623000,1120586000,0,412994000,71969000,,,,,132315000,1120586000,707592000,0,-22997000,,257682000,247904000,52349,WTFCM
2019-12-31,,,1181000000,994000000,621000000,2807000000,6792000000,1781000000,1781000000,158000000,-892000000,,,,498000000,8825000000,7044000000,2033000000,-600000000,,683000000,621000000,52350,VEON
2018-12-31,,,-248000000,-891000000,582000000,3480000000,6970000000,1439000000,1439000000,217000000,-816000000,,,,369000000,9086000000,7647000000,2116000000,-1687000000,979000000.0,-617000000,582000000,52350,VEON
2017-12-31,,,328000000,-441000000,-505000000,3529000000,7335000000,1559000000,1559000000,219000000,-935000000,,,,472000000,9474000000,7915000000,2139000000,-1231000000,-390000000.0,-144000000,-505000000,52350,VEON
2016-12-31,,,288000000,83000000,2328000000,3424000000,6900000000,1296000000,1296000000,244000000,-830000000,,,,635000000,8885000000,7589000000,1985000000,-1008000000,2767000000.0,-347000000,2328000000,52350,VEON
2020-01-31,820000000,,294800000,,214500000,1716100000,2984400000,374900000,374900000,,-54000000,,,,80300000,3274300000,2899400000,289900000,-80100000,,214500000,214500000,52351,ADSK
2019-01-31,725000000,,-42700000,,-80800000,1508200000,2299400000,32700000,32700000,,-52100000,,,,38100000,2569800000,2537100000,270400000,-75400000,,-80800000,-80800000,52351,ADSK
2018-01-31,755500000,,-557300000,,-566900000,1371100000,1769600000,-393600000,-393600000,,-34500000,,,,9600000,2056600000,2450200000,287000000,-163700000,,-566900000,-566900000,52351,ADSK
2017-01-31,766100000,,-523800000,,-582100000,1311500000,1729100000,-420300000,-420300000,,-29700000,,,,58300000,2031000000,2451300000,301900000,-103500000,,-582100000,-582100000,52351,ADSK
2019-12-31,58043000,,-49894000,,-50714000,158936000,166511000,-50468000,-50468000,,-367000,,,,820000,260352000,310820000,93841000,574000,,-50714000,-50714000,52352,APPN
2018-12-31,44724000,,-49212000,,-49451000,143813000,141818000,-46719000,-46719000,,-198000,,,,239000,226743000,273462000,84925000,-2493000,,-49451000,-49451000,52352,APPN
2017-12-31,34835000,,-30246000,,-31007000,109116000,112140000,-31811000,-31811000,,-473000,,,,761000,176737000,208548000,64597000,1565000,,-31007000,-31364000,52352,APPN
2016-12-31,22994000,,-14144000,,-12461000,71176000,82800000,-11370000,-11370000,,-982000,,,,-1683000,132923000,144293000,50123000,-2774000,,-12461000,-13318000,52352,APPN
2019-12-31,36522000,,-41996000,,-41996000,6610000,0,-43132000,-43132000,,,,,,0,0,43132000,0,1136000,,-41996000,-41996000,52355,ARQT
2018-12-31,17940000,,-19255000,,-19255000,1795000,0,-19735000,-19735000,,,,,,0,0,19735000,0,480000,,-19255000,-19255000,52355,ARQT
2017-12-31,3411000,,-4978000,,-4978000,695000,0,-4106000,-4106000,,,,,,0,0,4106000,0,-872000,,-4978000,-4978000,52355,ARQT
2019-12-31,53365000,,-307865000,,-314925000,327705000,264946000,-180907000,-180907000,,-21516000,,,,7060000,901935000,1082842000,636989000,-126958000,,-314925000,-314925000,52357,OPK
2018-12-31,53332000,,-191766000,,-153040000,353446000,313376000,-161335000,-161335000,,-11890000,,,,-38726000,990266000,1151601000,676890000,-30431000,,-153040000,-153040000,52357,OPK
2017-12-31,53511000,,-286395000,,-305250000,408828000,272952000,-260871000,-260871000,,-6601000,,,,18855000,966006000,1226877000,693054000,-25524000,,-305250000,-305250000,52357,OPK
2016-12-31,40628000,,-104474000,,-48359000,408231000,451569000,-61697000,-61697000,,-7430000,,,,-56115000,1117494000,1179191000,665925000,-42777000,,-48359000,-48359000,52357,OPK
2020-01-31,,,182098000,,143837000,832180000,1117940000,247025000,247025000,,-44407000,,,,38261000,3160464000,2913439000,2042524000,-64927000,,143837000,143837000,52358,GIII
2019-01-31,,,183830000,,138067000,834763000,1107109000,233527000,233527000,,-43924000,,,,45763000,3076208000,2842681000,1969099000,-49697000,,138067000,138067000,52358,GIII
2018-01-31,,,110049000,,62124000,855247000,1054739000,161709000,161709000,,-42363000,,,,47925000,2806938000,2645229000,1752199000,-51660000,,62124000,62124000,52358,GIII
2017-01-31,,,77762000,,51938000,704436000,841328000,104411000,104411000,,-15589000,,,,25824000,2386435000,2282024000,1545107000,-26649000,,51938000,51938000,52358,GIII
2019-10-31,,,293214,1466646,-94598,15218803,15759332,540529,540529,,-254592,,,,29208,86467432,85926903,70708100,-247315,,264006,-94598,52360,JVA
2018-10-31,,,2038938,1108042,1059276,13213329,15614492,2401163,2401163,,-370705,,,,511532,90655294,88254131,75040802,-362225,,1527406,1059276,52360,JVA
2017-10-31,,,976936,639912,467262,10927246,12149963,1222717,1222717,,-264261,,,,244096,77127595,75904878,64977632,-245781,,732840,467262,52360,JVA
2016-10-31,,,3715962,374334,2212288,8019110,11882178,3863068,3863068,,-187310,,,,1365920,78948228,75085160,67066050,-147106,,2350042,2212288,52360,JVA
2020-12-31,,,4468000000,319000000,3617000000,9425000000,15472000000,0,4572000000,1475000000,,,,,842000000,15472000000,10900000000,0,-104000000,,3626000000,3423000000,52361,BK
2019-12-31,,,5587000000,245000000,4441000000,9407000000,16487000000,0,5704000000,1376000000,,,,,1120000000,16487000000,10783000000,0,-117000000,,4467000000,4254000000,52361,BK
2018-12-31,,,5192000000,230000000,4266000000,9399000000,16403000000,0,5372000000,1632000000,,,,,938000000,16403000000,11031000000,0,-180000000,,4254000000,4070000000,52361,BK
2017-12-31,,,4610000000,495000000,4090000000,9093000000,15567000000,0,4819000000,1655000000,,,,,496000000,15567000000,10748000000,0,-209000000,,4114000000,3872000000,52361,BK
2021-01-01,,,96936000,,82552000,12888000,128371000,83249000,83249000,32234000,,,,,14384000,378412000,295163000,250041000,13687000,,82552000,82552000,52365,EXPO
2020-01-03,,,104190000,,82460000,29799000,139193000,85111000,85111000,24283000,,,,,21730000,391390000,306279000,252197000,19079000,,82460000,82460000,52365,EXPO
2018-12-28,,,93317000,,72254000,17532000,139587000,91456000,91456000,30599000,,,,,21063000,354639000,263183000,215052000,1861000,,72254000,72254000,52365,EXPO
2017-12-29,,,82509000,,41305000,17780000,119375000,72051000,72051000,29544000,,,,,41204000,329664000,257613000,210289000,10458000,,41305000,41305000,52365,EXPO
2020-12-31,,,58518000,,44675000,129764000,222317000,0,62479000,30074000,,,,,13843000,222317000,159838000,0,-3961000,,44675000,44675000,52366,ALRS
2019-12-31,,,38896000,,29540000,112832000,181433000,0,42977000,25624000,,,,,9356000,181433000,138456000,0,-4081000,,29540000,28893000,52366,ALRS
2018-12-31,,,33038000,,25866000,108376000,169363000,0,36896000,24091000,,,,,7172000,169363000,132467000,0,-3858000,,25866000,25866000,52366,ALRS
2017-12-31,,,32515000,,15001000,103912000,167435000,0,40208000,23315000,,,,,17514000,167435000,127227000,0,-7693000,,15001000,15001000,52366,ALRS
2020-01-31,,,21362000,,19290000,543962000,621892000,46802000,46802000,-8000,-25987000,,,,2072000,1450201000,1403399000,828309000,-25440000,,19290000,19290000,52367,LE
2019-02-01,,,9631000,,11590000,545590000,616056000,42853000,42853000,55000,-28909000,,,,-1959000,1451592000,1408739000,835536000,-33222000,,11590000,11590000,52367,LE
2018-02-02,,,448000,,28195000,538939000,597203000,29085000,29085000,4269000,-25929000,,,,-27747000,1406677000,1377592000,809474000,-32537000,,28195000,28195000,52367,LE
2017-01-27,,,-178880000,,-109782000,536576000,576408000,20369000,20369000,460000,-24630000,,,,-69098000,1335760000,1315391000,759352000,-199249000,,-109782000,-109782000,52367,LE
2019-12-31,,,63600000,,47500000,294800000,542300000,247500000,247500000,,-119900000,,,,16100000,1999000000,1751500000,1456700000,-183900000,,47500000,47500000,52368,HRI
2018-12-31,,,68800000,,69100000,311300000,522000000,210700000,210700000,,-131600000,,,,-300000,1976700000,1766000000,1454700000,-141900000,,69100000,69100000,52368,HRI
2017-12-31,,,-64400000,,160300000,319100000,425200000,106100000,106100000,,-128600000,,,,-224700000,1754500000,1648400000,1329300000,-170500000,,160300000,160300000,52368,HRI
2016-12-31,,,-4900000,,-19700000,274500000,351400000,76900000,76900000,,-84200000,,,,14800000,1554800000,1477900000,1203400000,-85800000,,-19700000,-19700000,52368,HRI
2019-12-31,,,440500000,94000000,346900000,811600000,1782000000,608300000,608300000,,-173600000,,,,83900000,2656100000,2047800000,874100000,-167800000,-4600000,356600000,346900000,52369,TRU
2018-12-31,,,343500000,92500000,276600000,707300000,1527100000,512900000,512900000,,-137500000,,,,54500000,2317200000,1804300000,790100000,-169400000,-1500000,289000000,276600000,52369,TRU
2017-12-31,,,372500000,95900000,441200000,587000000,1288100000,463100000,463100000,,-87600000,,,,-79100000,1933800000,1470700000,645700000,-90600000,-1500000,451600000,441200000,52369,TRU
2016-12-31,,,205400000,110200000,120600000,540500000,1125800000,320100000,320100000,,-85500000,,,,74000000,1704900000,1384800000,579100000,-114700000,-1500000,131400000,120600000,52369,TRU
2020-12-31,,,-703400000,,-615300000,539900000,1616800000,0,-107300000,1196300000,,,,,-88100000,1616800000,1724100000,0,-596100000,,-615300000,-646400000,52370,CIT
2019-12-31,,,623900000,,529900000,568500000,2228900000,0,670400000,945800000,,,,,94500000,2228900000,1558500000,0,-46500000,500000.0,529400000,511000000,52370,CIT
2018-12-31,,,637000000,,447100000,589100000,2287100000,0,675600000,983600000,,,,,164900000,2287100000,1611500000,0,-38600000,-25000000.0,472100000,428200000,52370,CIT
2017-12-31,,,191600000,,468200000,561400000,2375900000,0,721200000,1051400000,,,,,-67800000,2375900000,1654700000,0,-529600000,208800000.0,259400000,458400000,52370,CIT
2019-12-31,2606420,,-3425307,,-3425307,818887,0,-3425307,-3425307,,,,,,0,0,3425307,0,0,,-3425307,-3425307,52374,GLSI
2018-12-31,1270016,,-1689655,,-1689655,419639,0,-1689655,-1689655,,,,,,0,0,1689655,0,0,,-1689655,-1689655,52374,GLSI
2019-12-31,,,1446000,,1080000,11400000,15310000,0,1520000,2390000,,,,,366000,15310000,13790000,0,-74000,,1080000,1080000,52379,HVBC
2019-06-30,,,1073000,,879000,8784000,11808000,0,1330000,1694000,,,,,194000,11808000,10478000,0,-257000,,879000,879000,52379,HVBC
2018-06-30,,,1014000,,770000,7577000,10443000,0,1135000,1731000,,,,,244000,10443000,9308000,0,-121000,,770000,770000,52379,HVBC
2017-06-30,,,764000,,569000,7315000,9584000,0,920000,1349000,,,,,195000,9584000,8664000,0,-156000,,569000,569000,52379,HVBC
2020-12-31,57800000,,4000000,,-25500000,328700000,622400000,235900000,235900000,,-72100000,,,,29500000,1726000000,1490100000,1103600000,-231900000,,-25500000,-25500000,52381,AIMC
2019-12-31,59100000,,148200000,,127200000,359000000,656300000,238200000,238200000,,-73800000,,,,21000000,1834100000,1595900000,1177800000,-90000000,,127200000,127200000,52381,AIMC
2018-12-31,33100000,,51700000,,35300000,215700000,390300000,141500000,141500000,,-28600000,,,,16400000,1175300000,1033800000,785000000,-89800000,,35300000,35300000,52381,AIMC
2017-12-31,24400000,,71100000,,51400000,164500000,275700000,86800000,86800000,,-7700000,,,,19700000,876700000,789900000,601000000,-15700000,,51400000,51400000,52381,AIMC
2019-12-31,,,-23862000,,-27839000,15840000,51310000,19536000,19536000,,-17496000,,,,3977000,253898000,234362000,202588000,-43398000,,-27839000,-27839000,52384,SALM
2018-12-31,,,-719000,,-3192000,15486000,58477000,24765000,24765000,,-18328000,,,,2473000,262783000,238018000,204306000,-25484000,,-3192000,-3192000,52384,SALM
2017-12-31,,,3774000,,24644000,16155000,60092000,26975000,26975000,,-16349000,,,,-20870000,263736000,236761000,203644000,-23201000,,24644000,24644000,52384,SALM
2016-12-31,,,13445000,,8873000,14494000,66039000,34269000,34269000,,-14653000,,,,4572000,274321000,240052000,208282000,-20824000,,8873000,8873000,52384,SALM
2019-12-31,9013000,,-23086000,,-23086000,14359000,-29000,-23401000,-23401000,,,,,,0,107000,23508000,136000,315000,,-23086000,-23086000,52385,MOTS
2018-12-31,6048000,,-22257000,,-22257000,12859000,-18000,-18925000,-18925000,,,,,,0,36000,18961000,54000,-3332000,,-22257000,-22257000,52385,MOTS
2017-12-31,4262000,,-13200000,,-13200000,8702000,0,-12964000,-12964000,,-6000.0,,,,0,0,12964000,0,-236000,,-13200000,-13200000,52385,MOTS
2016-12-31,3079000,,-7973000,,-8023000,2928000,0,-6007000,-6007000,,-6000.0,,,,50000,0,6007000,0,-1966000,,-8023000,-8023000,52385,MOTS
2019-12-31,,,123724000,,81138000,272411000,466533000,132455000,132455000,,-800000,,,,42586000,997137000,864682000,530604000,-8731000,,81138000,81138000,52386,STRA
2018-12-31,,,-19139000,,-15671000,194035000,262643000,42914000,42914000,,-700000,,,,-3468000,634185000,591271000,371542000,-62053000,,-15671000,-15671000,52386,STRA
2017-12-31,,,52646000,,20612000,129332000,185908000,56576000,56576000,,-600000,,,,32034000,454851000,398275000,268943000,-3930000,,20612000,20612000,52386,STRA
2016-12-31,,,57292000,,34802000,144530000,198989000,54459000,54459000,,-600000,,,,22490000,441088000,386629000,242099000,2833000,,34802000,34802000,52386,STRA
2020-12-31,,,15284000,,13035000,,53603000,0,15784000,37819000,,,,,2249000,53603000,37819000,0,-500000,,13035000,13035000,52387,FDBC
2019-12-31,,,13902000,,11576000,24035000.0,40836000,0,14609000,2192000,,,,,2326000,40836000,26227000,0,-707000,,11576000,11576000,52387,FDBC
2018-12-31,,,13135000,,11006000,22584000.0,38225000,0,13597000,2044000,,,,,2129000,38225000,24628000,0,-462000,,11006000,11006000,52387,FDBC
2017-12-31,,,9922000,,8716000,22325000.0,34922000,0,10553000,2044000,,,,,1206000,34922000,24369000,0,-631000,,8716000,8716000,52387,FDBC
2019-12-31,,,-464000,,-436000,1315000,1526000,-505000,-505000,,-10000,,,,-28000,4911000,5416000,3385000,41000,,-436000,-436000,52388,TGC
2018-12-31,,,425000,,1569000,1245000,2280000,240000,240000,,-5000,,,,-17000,5871000,5631000,3591000,185000,1127000.0,442000,1569000,52388,TGC
2017-12-31,,,-845000,,-574000,1171000,1239000,-794000,-794000,,-53000,,,,-242000,4683000,5477000,3444000,-51000,29000.0,-603000,-574000,52388,TGC
2016-12-31,,,-4199000,,-4199000,1405000,1251000,-1293000,-1293000,,-102000,,,,0,4672000,5965000,3421000,-2906000,29000.0,-4199000,-4199000,52388,TGC
2020-12-31,46072000,,36647000,,27248000,65394000,149816000,38350000,38350000,,,,,,9399000,220774000,182424000,70958000,-1703000,,27248000,27248000,52391,AUDC
2019-12-31,41199000,,-11315000,,3977000,63336000,127136000,22601000,22601000,,-198000.0,,,,-15292000,200287000,177686000,73151000,-33916000,,3977000,3977000,52391,AUDC
2018-12-31,34661000,,16587000,,13493000,59380000,110606000,16565000,16565000,,-266000.0,,,,3094000,176223000,159658000,65617000,22000,,13493000,13493000,52391,AUDC
2017-12-31,30348000,,9640000,,4030000,57847000,97845000,9650000,9650000,,-294000.0,,,,5610000,156739000,147089000,58894000,-10000,,4030000,4030000,52391,AUDC
2020-03-31,12955879,,-22000556,,-22000556,12804493,0,-25760372,-25760372,,-114243,,,,0,0,25760372,0,3759816,,-22000556,-22000556,52393,TYME
2019-03-31,14719481,,-32983115,,-32983115,14586165,0,-29305646,-29305646,,-7415,,,,0,0,29305646,0,-3677469,,-32983115,-32983115,52393,TYME
2018-03-31,8839661,,-18969493,,-18969493,10520217,0,-19359878,-19359878,,-7415,,,,0,0,19359878,0,390385,,-18969493,-18969493,52393,TYME
2017-03-31,6111587,,-15206781,,-15206781,9095194,0,-15206781,-15206781,,-7415,,,,0,0,15206781,0,0,,-15206781,-15206781,52393,TYME
2020-12-26,,,1030000000,140000000,356000000,3607000000,9171000000,5564000000,5564000000,,-1394000000,,,,669000000,26185000000,20621000000,17014000000,-4534000000,,361000000,356000000,52394,KHC
2019-12-28,112000000.0,,2661000000,126000000,1935000000,2515000000,8195000000,5568000000,5568000000,,-1361000000,,,,728000000,24977000000,19409000000,16782000000,-2907000000,,1933000000,1935000000,52394,KHC
2018-12-29,109000000.0,,-11321000000,121000000,-10192000000,2608000000,9119000000,6402000000,6402000000,,-1284000000,,,,-1067000000,26268000000,19866000000,17149000000,-17723000000,,-10254000000,-10192000000,52394,KHC
2017-12-30,93000000.0,,5450000000,213000000,10941000000,2079000000,9497000000,7325000000,7325000000,,-1234000000,,,,-5482000000,26076000000,18751000000,16579000000,-1875000000,,10932000000,10941000000,52394,KHC
2019-12-31,7467000,,-13294000,,-13294000,5971000,0,-13438000,-13438000,,-87000,,,,0,0,13438000,0,144000,,-13294000,-20179000,52398,GALT
2018-12-31,6471000,,-13900000,,-13900000,7131000,0,-13602000,-13602000,,-336000,,,,0,0,13602000,0,-298000,,-13900000,-15047000,52398,GALT
2017-12-31,11721000,,-16235000,,-16235000,4526000,0,-16247000,-16247000,,-12000,,,,0,0,16247000,0,12000,,-16235000,-17467000,52398,GALT
2016-12-31,15325000,,-21436000,,-21436000,6156000,0,-21481000,-21481000,,-12000,,,,0,0,21481000,0,45000,,-21436000,-22350000,52398,GALT
2020-03-31,,,671099,,671099,775230,4144293,3369063,3369063,,-763298,,,,0,4144293,775230,0,-2697964,,671099,671099,52400,VCF
2019-03-31,,,3024338,,3024338,710379,4346638,3636259,3636259,,-812588,,,,0,4346638,710379,0,-611921,,3024338,3024338,52400,VCF
2018-03-31,,,3123853,,3123853,680845,4361620,3680775,3680775,,-651448,,,,0,4361620,680845,0,-556922,,3123853,3123853,52400,VCF
2017-03-31,,,-48815,,-48815,673910,4444002,3770092,3770092,,-529928,,,,0,4444002,673910,0,-3818907,,-48815,-48815,52400,VCF
2020-12-31,,,474715000,,472771000,65498000,886732000,511595000,511595000,-10112000,-91553000,,,,1944000,1230750000,719155000,344018000,-36880000,,472771000,472771000,52401,EURN
2019-12-31,,,112832000,,112230000,66890000,575297000,180799000,180799000,-10094000,-97722000,,,,602000,932377000,751578000,357080000,-67967000,,112230000,112230000,52401,EURN
2018-12-31,,,-109832000,,-110070000,61232000,241702000,-85448000,-85448000,-4775000,-70746000,,,,238000,600024000,685472000,358322000,-24384000,,-110070000,-110070000,52401,EURN
2017-12-31,,,25000,,1383000,46868000,269733000,-2105000,-2105000,-4902000,-38391000,,,,-1358000,513368000,515473000,243635000,2130000,,1383000,1383000,52401,EURN
2019-12-31,,,43943000,,43943000,3351000,21522000,18171000,18171000,,-2286000,,,,0,21522000,3351000,0,25772000,,43943000,40690000,52406,PCK
2018-12-31,,,-886000,,-886000,3437000,22380000,18943000,18943000,,-1564000,,,,0,22380000,3437000,0,-19829000,,-886000,-4411000,52406,PCK
2017-12-31,,,29928000,,29928000,3430000,23158000,19728000,19728000,,-683000,,,,0,23158000,3430000,0,10200000,,29928000,27679000,52406,PCK
2016-12-31,,,2468000,,2468000,3552000,23674000,20122000,20122000,,-427000,,,,0,23674000,3552000,0,-17654000,,2468000,1258000,52406,PCK
2019-12-31,,,-21075835,,-21075835,5246960,-17101570,-22348530,-22348530,,-472819,,,,0,115385,22463915,17216955,1272695,,-21075835,-21075835,52407,NKTX
2018-12-31,,,-274503,,-274503,2654239,2297790,-356449,-356449,,-472819,,,,0,6550000,6906449,4252210,81946,,-274503,-274503,52407,NKTX
2020-12-31,,,151723000,,114887000,665258000,875467000,152753000,152753000,,-9014000,,,,36836000,4735940000,4583187000,3860473000,-1030000,,114887000,114887000,52408,RUSHA
2019-12-31,,,189523000,,141583000,753749000,1025628000,216507000,216507000,,-30487000,,,,47940000,5809847000,5593340000,4784219000,-26984000,,141583000,141583000,52408,RUSHA
2018-12-31,,,183169000,,139062000,705226000,978269000,202554000,202554000,,-21058000,,,,44107000,5506190000,5303636000,4527921000,-19385000,,139062000,139062000,52408,RUSHA
2017-12-31,,,136399000,,172129000,631053000,829936000,148814000,148814000,,-13201000,,,,-35730000,4713882000,4565068000,3883946000,-12415000,,172129000,172129000,52408,RUSHA
2019-12-31,,,-6886740,,-6886740,20651863,78118521,57466658,57466658,,-15558648,,,,0,78118521,20651863,0,-64353398,,-6886740,-6886740,52410,BKCC
2018-12-31,,,-9162162,,-9162162,21208057,83867594,62659537,62659537,,-15228062,,,,0,83867594,21208057,0,-71821699,,-9162162,-9162162,52410,BKCC
2017-12-31,,,20902457,,20902457,24031606,97329210,73297604,73297604,,-18205912,,,,0,97329210,24031606,0,-52395147,,20902457,20902457,52410,BKCC
2016-12-31,,,-84291924,,-84291924,29212148,117410387,88198239,88198239,,-16661674,,,,0,117410387,29212148,0,-172490163,,-84291924,-84291924,52410,BKCC
2019-12-31,,,-1343412,,-1343412,1533102,2077096,-268863,-268863,,-1249154,,,,0,10291524,10560387,8214428,-1074549,,-1343412,-1343412,52411,OLB
2018-12-31,,,-2139706,,-2139706,2493047,2678118,-447572,-447572,,-1715880,,,,0,12194415,12641987,9516297,-1692134,,-2139706,-1393544,52411,OLB
2017-12-31,,,-14483818,,-14483818,4580587,2369236,-2574307,-2574307,,-3863396,,,,0,15091707,17666014,12722471,-11909511,,-14483818,-14483818,52411,OLB
2016-12-31,,,-312952,,-312952,365629,62131,-303498,-303498,,-9454,,,,0,83026,386524,20895,-9454,,-312952,-312952,52411,OLB
2020-02-29,,,129242829,,129242829,10427483,47641276,37213793,37213793,,-7071479,,,,0,47641276,10427483,0,92029036,,129242829,129242829,52412,NKX
2019-02-28,,,25766609,,25766609,10550394,49317676,38767282,38767282,,-7445951,,,,0,49317676,10550394,0,-13000673,,25766609,25766609,52412,NKX
2018-02-28,,,32587275,,32587275,11293043,50996398,39703355,39703355,,-5461648,,,,0,50996398,11293043,0,-7116080,,32587275,32587275,52412,NKX
2017-02-28,,,2286030,,2286030,11245441,50317139,39071698,39071698,,-2883853,,,,0,50317139,11245441,0,-36785668,,2286030,2286030,52412,NKX
2020-12-31,169811000,,586785000,1682000,128561000,791114000,1755436000,745715000,745715000,,-174791000,,,,32874000,2391269000,1645554000,635833000,-158930000,-366070000,553911000,128561000,52413,MTCH
2019-12-31,343485000,,494511000,1014803000,431131000,2476890000,3634182000,640113000,640113000,,-153563000,,,,-49309000,4757055000,4116942000,1122873000,-145602000,-366070000,543820000,431131000,52413,MTCH
2018-12-31,309329000,,761558000,774363000,626961000,2175363000,3351746000,712095000,712095000,,-109327000,,,,3811000,4262892000,3550797000,911146000,49463000,-366070000,757747000,626961000,52413,MTCH
2017-12-31,250879000,,66958000,559662000,304924000,2001277000,2656231000,274667000,274667000,,-105295000,,,,-291050000,3307239000,3032572000,651008000,-207709000,-366070000,358008000,304924000,52413,MTCH
2020-07-25,,,31733000,,24939000,447566000,506475000,27551000,27551000,,-2611000,,,,6794000,1804594000,1777043000,1298119000,4182000,,24939000,24220000,52415,VLGEA
2019-07-27,,,35523000,,25539000,395165000,456716000,34261000,34261000,,-4436000,,,,9984000,1643502000,1609241000,1186786000,1262000,,25539000,24879000,52415,VLGEA
2018-07-28,,,32838000,,25080000,384577000,443029000,33453000,33453000,,-4460000,,,,7758000,1615045000,1581592000,1172016000,-615000,,25080000,24372000,52415,VLGEA
2017-07-29,,,39123000,,22921000,371495000,436711000,40734000,40734000,,-4452000,,,,16202000,1604574000,1563840000,1167863000,-1611000,,22921000,22379000,52415,VLGEA
2020-12-31,,,3289000,,11228000,,93811000,19185000,19185000,1897000,-17972000,,,,-7939000,145521000,126336000,51710000,-15896000,,11228000,11026000,52417,AIRC
2019-12-31,,,73360000,,62358000,26288000.0,476601000,132730000,132730000,16616000,-133146000,,,,199000,732592000,599862000,255991000,-59370000,,73161000,54219000,52417,AIRC
2020-12-31,,,61000000,1000000,10000000,480000000,790000000,141000000,141000000,,-34000000,,,,51000000,2800000000,2659000000,2010000000,-80000000,,10000000,10000000,52422,RFP
2019-12-31,,,11000000,1000000,-47000000,525000000,738000000,46000000,46000000,,-31000000,,,,58000000,2923000000,2877000000,2185000000,-35000000,,-47000000,-47000000,52422,RFP
2018-12-31,,,387000000,1000000,235000000,640000000,1214000000,362000000,362000000,,-47000000,,,,152000000,3756000000,3394000000,2542000000,25000000,,235000000,235000000,52422,RFP
2017-12-31,,,6000000,1000000,-84000000,612000000,925000000,109000000,109000000,,-49000000,,,,84000000,3513000000,3404000000,2588000000,-103000000,,-78000000,-84000000,52422,RFP
2019-12-31,,,43971000,,23796000,29805000,84581000,49937000,49937000,874000,-857000,,,,20175000,257187000,207250000,172606000,-5966000,,23796000,23796000,52423,FSM
2018-12-31,,,67340000,,33990000,26189000,96173000,67726000,67726000,1535000,-1092000,,,,33350000,263296000,195570000,167123000,-386000,,33990000,33990000,52423,FSM
2017-12-31,,,104951000,,66305000,24911000,108575000,101062000,101062000,-272000,-1645000,,,,38646000,268111000,167049000,159536000,3889000,,66305000,66305000,52423,FSM
2016-12-31,,,47110000,,17858000,31117000,80326000,47224000,47224000,665000,-2147000,,,,29252000,210255000,163031000,129929000,-114000,,17858000,17858000,52423,FSM
2019-12-31,21923000,,-80029000,,-80033000,30819000,0,-52742000,-52742000,,,,,,4000,0,52742000,0,-27287000,,-80033000,-80033000,52424,EVFM
2018-12-31,43224000,,-125710000,,-125712000,34418000,0,-77642000,-77642000,,,,,,2000,0,77642000,0,-48068000,,-125712000,-125778000,52424,EVFM
2017-12-31,23539000,,-105302000,,-105305000,12148000,0,-35687000,-35687000,,,,,,3000,0,35687000,0,-69615000,,-105305000,-109322000,52424,EVFM
2016-12-31,14855000,,-68357000,,-66667000,15083000,0,-29938000,-29938000,,,,,,-613000,0,29938000,0,-38419000,1077000.0,-67744000,-67811000,52424,EVFM
2019-12-31,6422000,,-23017000,-1571000,8187000,23550000,9456000,-20675925,-20675925,159925,-1385000,,,,13000,22652000,43327925,13196000,-2341075,30484000,-23030000,8187000,52426,WKEY
2018-12-31,5306000,,-9855000,-883000,-16278000,19844000,15961000,-9489000,-9489000,300000,-394000,,,,53000,34280000,43769000,18319000,-366000,-6357000,-9908000,-16278000,52426,WKEY
2017-12-31,5339000,,-10055000,-883000,-24267000,20003000,15804000,-8012000,-8012000,-1526000,-543000,,,,71000,33674000,41686000,17870000,-2043000,-14624000,-10126000,-24267000,52426,WKEY
2016-12-31,1438000,,-36501000,-1083000,-35926000,39283000,4426000,-36183000,-36183000,-112000,-947000,,,,-16000,10962000,47145000,6536000,-318000,-14624000,-36485000,-35926000,52426,WKEY
2020-03-31,124704000,,-8136236000,-154000,-9936716000,1057716000,-27412000,-985660000,-985660000,-224172000,-116116000,,,,1304000,415444000,1401104000,442856000,-7150576000,-1820708000,-8137540000,-9936716000,52428,UXIN
2019-12-31,140006000,,-1330232000,-4048000,-1988676000,1587037000,898739000,-1097751000,-1097751000,-1925000,-112587000,,,,-2554000,1588031000,2685782000,689292000,-232481000,-662450000,-1327678000,-1988676000,52428,UXIN
2018-12-31,124513000,,-1350117000,-2490000,-1522514000,2559118000,240238000,-2484019000,-2484019000,-1925000,-63880000,,,,1644000,659090000,3143109000,418852000,1133902000,-186524000,-1351761000,-2386238000,52428,UXIN
2017-12-31,124513000,,-1268613000,-10881000,-2722596000,568400000,216398000,-390077000,-390077000,-1925000,-199000,,,,211000,309133000,699210000,92735000,-878536000,-1478974000,-1268824000,-3773205000,52428,UXIN
2019-12-31,3627000,,-5853000,3231000,-4470000,48354000,76291000,24310000,24310000,,-29959000,,,,-652000,143140000,118830000,66849000,-30163000,,-5201000,-4470000,52430,MRVI
2018-12-31,4499000,,-16498000,3611000,-4472000,41194000,63068000,17375000,17375000,,-27399000,,,,417000,123833000,106458000,60765000,-33873000,,-16915000,-4472000,52430,MRVI
2020-12-31,,,270113000,,178831000,609214000,898250000,0,265709000,18619000,,,,,51675000,943276000,677567000,45026000,4404000,,218438000,178831000,52431,MC
2019-12-31,,,147505000,-49000000.0,105095000,527877000,673448000,0,114543000,26063000,,,,,11813000,746534000,631991000,73086000,32962000,,135692000,105095000,52431,MC
2018-12-31,,,238452000,-32608000.0,140680000,558126000,813829000,0,226781000,24297000,,,,,30448000,885840000,659059000,72011000,11671000,,208004000,140680000,52431,MC
2017-12-31,,,350351000,19306000.0,29400000,438439000,628808000,0,164282000,22543000,,,,,223827000,684615000,520333000,55807000,186069000,,126524000,29400000,52431,MC
2019-12-31,,,51867000,,38339000,5200000,235023000,63518000,63518000,158530000,-10596000,,,,13528000,907125000,843607000,672102000,-11651000,,38339000,38339000,52433,JRVR
2018-12-31,,,70838000,,63830000,4000000,285323000,83977000,83977000,190521000,-11553000,,,,7008000,885599000,801622000,600276000,-14439000,,63830000,63830000,52433,JRVR
2017-12-31,,,55145000,,43566000,4200000,262248000,64266000,64266000,185497000,-8974000,,,,11579000,817625000,753359000,555377000,-9121000,,43566000,43566000,52433,JRVR
2016-12-31,,,79343000,,74471000,4200000,260806000,89283000,89283000,165434000,-8448000,,,,4872000,586227000,496944000,325421000,-9940000,,74471000,74471000,52433,JRVR
2019-12-31,1567000,,3056000,,1542000,11079000,16444000,3798000,3798000,,-59000,,,,1514000,37678000,33880000,21234000,-742000,,1542000,1542000,52437,PMD
2018-12-31,1551000,,7653000,,4584000,11457000,20618000,7610000,7610000,,-106000,,,,3069000,42674000,35064000,22056000,43000,,4584000,4584000,52437,PMD
2017-12-31,1357000,,8177000,,6121000,10308000,19822000,8157000,8157000,,-72000,,,,2056000,39701000,31544000,19879000,20000,,6121000,6121000,52437,PMD
2016-12-31,1415000,,9976000,,6678000,9925000,21450000,10110000,10110000,,-134000,,,,3298000,38980000,28870000,17530000,-134000,,6678000,6678000,52437,PMD
2017-12-31,,,-5695000,,-6984000,14008000,51089000,37081000,37081000,,-17853000,,,,1289000,51089000,14008000,0,-42776000,,-6984000,-6984000,52438,CPTAL
2016-12-31,,,9152000,,9152000,19561000,68312000,48751000,48751000,,-19407000,,,,0,68312000,19561000,0,-39599000,,9152000,9152000,52438,CPTAL
2015-12-31,,,13850000,,13850000,19627000,63976000,44349000,44349000,,-18293000,,,,0,63976000,19627000,0,-30499000,,13850000,13850000,52438,CPTAL
2014-12-31,,,-3440000,,-3440000,16187000,49528000,33341000,33341000,,-13300000,,,,0,49528000,16187000,0,-36781000,,-3440000,-3440000,52438,CPTAL
2019-12-31,,,-302844000,7535000,-300353000,62711000,1110083000,565377000,565377000,,-278674000,,,,4262000,1239852000,674475000,129769000,-868221000,,-307106000,-368841000,52439,VER
2018-12-31,,,-86624000,143085000,-85774000,63933000,1132575000,428824000,428824000,,-280487000,,,,5101000,1259036000,830212000,126461000,-515448000,3695000.0,-91725000,-157708000,52439,VER
2017-12-31,,,58377000,158598000,31818000,58603000,1126131000,361326000,361326000,,-286766000,,,,6882000,1254848000,893522000,128717000,-302949000,-19117000.0,51495000,-40565000,52439,VER
2016-12-31,,,-69751000,172172000,-195863000,51927000,1190602000,378837000,378837000,,-317376000,,,,7136000,1335030000,956193000,144428000,-448588000,-123937000.0,-76887000,-268247000,52439,VER
2019-12-31,324284,,-8503948,,-8503948,13512321,5084634,-8751971,-8751971,,-48816,,,,0,13103728,21855699,8019094,248023,,-8503948,-1055069,52441,LSF
2018-12-31,119487,,-8459436,,-8459436,10972969,2662960,-8429496,-8429496,,-48228,,,,0,8291082,16720578,5628122,-29940,,-8459436,-9209434,52441,LSF
2020-12-31,,,72601000,,60351000,272979000,453720000,0,142374000,38367000,,,,,12250000,453720000,311346000,0,-69773000,,60351000,60351000,52442,PPBI
2019-12-31,,,217753000,,159718000,206343000,477430000,0,237190000,33897000,,,,,58035000,477430000,240240000,0,-19437000,,159718000,158068000,52442,PPBI
2018-12-31,,,165580000,,123340000,189345000,415014000,0,200163000,25506000,,,,,42240000,415014000,214851000,0,-34583000,,123340000,123340000,52442,PPBI
2017-12-31,,,102226000,,60100000,120740000,270121000,0,131532000,17849000,,,,,42126000,270121000,138589000,0,-29306000,,60100000,60100000,52442,PPBI
2019-12-31,,,25348000,2255000,12396000,173206000,200327000,27121000,27121000,,,,,,12659000,374448000,347327000,174121000,-1773000,,12689000,12396000,52443,IHC
2018-12-31,,,37541000,4865000,28482000,169028000,206569000,37541000,37541000,,,,,,8488000,350775000,313234000,144206000,0,,29053000,28482000,52443,IHC
2017-12-31,,,28336000,4764000,42042000,157104000,185440000,28336000,28336000,,,,,,-13794000,320494000,292158000,135054000,0,,42130000,42042000,52443,IHC
2016-12-31,,,32065000,2697000,123298000,132174000,165215000,33041000,33041000,,-1534000.0,,,,9555000,310446000,277405000,145231000,-976000,110804000.0,22510000,123298000,52443,IHC
2020-01-25,,,78536000,,57215000,264935000,568152000,115661000,115661000,,-50859000,,,,21321000,3339682000,3224021000,2771530000,-37125000,,57215000,57215000,52444,DY
2019-01-26,,,88038000,,62907000,251983000,565308000,133722000,133722000,,-44525000,,,,25131000,3127700000,2993978000,2562392000,-45684000,,62907000,62907000,52444,DY
2018-01-27,,,177931000,,151339000,245766000,608021000,199547000,199547000,,-38677000,,,,26592000,2977874000,2778327000,2369853000,-21616000,,151339000,151339000,52444,DY
2017-07-29,,,250425000,,157217000,239231000,662146000,275009000,275009000,,-37364000,,,,93208000,3066880000,2791871000,2404734000,-24584000,,157217000,157217000,52444,DY
2019-12-31,412590,,-3930822,,-3933922,2578703,-153774,-3145067,-3145067,,-716337,,,,3100,5111545,8256612,5265319,-785755,,-3933922,-3933922,52445,BEEM
2018-12-31,164118,,-3598780,,-3598780,2154578,-192100,-2510796,-2510796,,-1089223,,,,0,6162402,8673198,6354502,-1084255,,-3598780,-3598780,52445,BEEM
2017-12-31,1772,,-3040630,,-3041430,2225873,-472751,-2700396,-2700396,,-474601,,,,800,1412042,4112438,1884793,-340234,,-3041430,-3041430,52445,BEEM
2016-12-31,3459,,-2631916,,-2633516,2640213,-144721,-2788393,-2788393,,-275776,,,,1600,2781273,5569666,2925994,156477,,-2633516,-2633516,52445,BEEM
2020-12-31,,,41651000,,33244000,71993000,136543000,0,49827000,14723000,,,,,8407000,136543000,86716000,0,-8176000,,33244000,33244000,52446,BHB
2019-12-31,,,26829000,,22620000,65916000,116544000,0,33947000,16681000,,,,,4209000,116544000,82597000,0,-7118000,,22620000,22620000,52446,BHB
2018-12-31,,,40499000,,32937000,59779000,116038000,0,43055000,13204000,,,,,7562000,116038000,72983000,0,-2556000,,32937000,32937000,52446,BHB
2017-12-31,,,42623000,,25993000,57539000,117855000,0,49337000,10979000,,,,,16630000,117855000,68518000,0,-6714000,,25993000,25993000,52446,BHB
2019-12-31,,,-70279000,,-70279000,24748000,-45636000,-70384000,-70384000,,-502000,,,,0,34505000,104889000,80141000,105000,,-70279000,-70279000,52449,MCRB
2018-12-31,,,-98942000,,-98942000,32596000,-67688000,-100284000,-100284000,,-502000,,,,0,28267000,128551000,95955000,1342000,,-98942000,-98942000,52449,MCRB
2017-12-31,,,-89380000,,-89380000,34040000,-57355000,-91395000,-91395000,,-502000,,,,0,32100000,123495000,89455000,2015000,,-89380000,-89380000,52449,MCRB
2016-12-31,,,-91579000,,-91579000,32616000,-60223000,-92839000,-92839000,,-502000,,,,0,21766000,114605000,81989000,1260000,,-91579000,-91579000,52449,MCRB
2019-12-31,,,-7397000,,-6708000,6317000,3604000,-2713000,-2713000,,-1437000,,,,-512000,7305000,10018000,3701000,-4684000,177000,-6885000,-6708000,52450,CGIX
2018-12-31,154000.0,,-4205000,,-20373000,7913000,1842000,-6225000,-6225000,,-319000,,,,0,4932000,11157000,3090000,2020000,-16168000,-4205000,-20373000,52450,CGIX
2017-12-31,4789000.0,,-22959000,,-20880000,24884000,11051000,-18622000,-18622000,,-2128000,,,,-2079000,29121000,47743000,18070000,-4337000,-16168000,-20880000,-20880000,52450,CGIX
2016-12-31,5967000.0,,-15803000,,-15803000,20702000,9945000,-16724000,-16724000,,-454000,,,,0,27049000,43773000,17104000,921000,-16168000,-15803000,-15803000,52450,CGIX
2019-12-31,,,-6049000,,-5125000,33359000,40558000,0,3881000,3318000,,,,,-924000,40558000,36677000,0,-19860000,,-5125000,-5125000,52451,PDLB
2018-12-31,,,3798000,,2677000,31344000,38355000,0,3798000,3213000,,,,,1121000,38355000,34557000,0,-272000,,2677000,2677000,52451,PDLB
2017-12-31,,,-2963000,,-4387000,27433000,33594000,0,3330000,2831000,,,,,1424000,33594000,30264000,0,-6543000,,-4387000,-2864000,52451,PDLB
2016-12-31,,,2430000,,1425000,25227000,30293000,0,2968000,2098000,,,,,1005000,30293000,27325000,0,-538000,,1425000,1425000,52451,PDLB
2019-12-31,,,160449000,621000,160456000,13906000,312343000,220071000,220071000,1550000,-56299000,,,,0,318081000,98010000,5738000,-59622000,,160449000,160456000,52453,NHI
2018-12-31,,,154333000,621000,154333000,12856000,289860000,204489000,204489000,1166000,-49055000,,,,0,294612000,90123000,4752000,-50894000,,154333000,154333000,52453,NHI
2017-12-31,,,159365000,621000,159365000,12711000,278659000,197815000,197815000,960000,-46324000,,,,0,278659000,80844000,0,-38450000,,159365000,159365000,52453,NHI
2016-12-31,,,153465000,621000,151540000,10195000,247246000,167061000,167061000,1009000,-43108000,,,,749000,247246000,80185000,0,-13596000,,152716000,151540000,52453,NHI
2019-12-31,,,-22450000,,-22450000,51962000,30774000,-22327000,-22327000,,-123000,,,,0,63667000,85994000,32893000,-123000,,-22450000,-30994000,52455,RSI
2018-12-31,,,-10735000,,-10735000,17312000,7517000,-10693000,-10693000,,-42000,,,,0,18226000,28919000,10709000,-42000,,-10735000,-10735000,52455,RSI
2019-12-31,,,-85719000,,-53382000,13804000,70613000,-62296000,-62296000,2834000,-34593000,,,,-32337000,329163000,391459000,258550000,-23423000,,-53382000,-53382000,52456,TGB
2018-12-31,,,-35326000,,-35774000,13957000,104090000,18850000,18850000,294000,-32077000,,,,448000,343870000,325020000,239780000,-54176000,,-35774000,-35774000,52456,TGB
2017-12-31,,,63440000,,34262000,12775000,177716000,97121000,97121000,11385000,-30965000,,,,29178000,378299000,281178000,200583000,-33681000,,34262000,34262000,52456,TGB
2016-12-31,,,-46109000,,-31396000,11299000,54715000,-22509000,-22509000,7280000,-27649000,,,,-14713000,263865000,286374000,209150000,-23600000,,-31396000,-31396000,52456,TGB
2020-12-31,,,24693000,,18086000,33328000,66448000,0,25645000,7475000,,,,,6607000,66448000,40803000,0,-952000,,18086000,18086000,52457,FCCY
2019-12-31,,,18674000,,13634000,27468000,54223000,0,20729000,6026000,,,,,5040000,54223000,33494000,0,-2055000,,13634000,13634000,52457,FCCY
2018-12-31,,,16365000,,12048000,25342000,50220000,0,18920000,5958000,,,,,4317000,50220000,31300000,0,-2555000,,12048000,12048000,52457,FCCY
2017-12-31,,,12799000,,6928000,23512000,43805000,0,13466000,6827000,,,,,5871000,43805000,30339000,0,-667000,,6928000,6928000,52457,FCCY
2020-06-30,3630024,,-9125916,,-9125916,4514520,0,-8144544,-8144544,,,,,,0,0,8144544,0,-981372,,-9125916,-9134532,52459,KTRA
2019-06-30,3662056,,-8048221,,-8048221,4736440,0,-8398496,-8398496,,,,,,0,0,8398496,0,350275,,-8048221,-8128652,52459,KTRA
2018-06-30,7132952,,-11138312,,-11138312,4041711,0,-11174663,-11174663,,,,,,0,0,11174663,0,36351,,-11138312,-11314548,52459,KTRA
2017-06-30,5003640,,-8081764,,-8081764,3317189,0,-8405923,-8405923,,,,,,0,0,8405923,0,324159,,-8081764,-8872218,52459,KTRA
2020-03-28,,,727208000,,679449000,4529120000,5817436000,1288316000,1288316000,,-92042000,,,,98062000,10488556000,9200240000,4671120000,-561108000,50303000,629146000,679449000,52463,VFC
2019-03-30,,,1038313000,,1259792000,4302258000,5625161000,1322903000,1322903000,,-107738000,,,,167887000,10266887000,8943984000,4641726000,-284590000,389366000,870426000,1259792000,52463,VFC
2018-03-31,,,1278414000,,658553000,4508093000,5886506000,1378413000,1378413000,,-102384000,,,,641506000,11492383000,10113970000,5605877000,-99999000,21645000,636908000,658553000,52463,VFC
2017-12-30,,,787879000,,614923000,3626301000,4550036000,923735000,923735000,,-101974000,,,,519809000,8394684000,7470949000,3844648000,-135856000,346853000,268070000,614923000,52463,VFC
2019-12-31,,,14406097000,790719000,8808815000,1667561000,16874744000,14110893000,14110893000,1096290000,-3211221000,,,,5745242000,35960784000,21849891000,19086040000,295204000,,8660855000,8808815000,52464,CEPU
2018-12-31,,,36171554000,719438000,26950818000,1430286000,11714476000,9783661000,9783661000,500529000,-2274567000,,,,10159632000,21944761000,12161100000,10230285000,26387893000,424850000.0,26011922000,26950818000,52464,CEPU
2017-12-31,,,5552348000,478704000,5291355000,828262000,4369289000,3351735000,3351735000,189292000,-1110955000,,,,1081177000,9638568000,6286833000,5269279000,2200613000,791274000.0,4471171000,5291355000,52464,CEPU
2016-12-31,,,2048501000,6717000,1768843000,301641000,1454177000,1786297000,1786297000,-633761000,-529999000,,,,717639000,3562721000,1776424000,2108544000,262204000,437974000.0,1330862000,1768843000,52464,CEPU
2020-12-31,,,7476000,,5917000,23895000,37541000,0,8469000,5177000,,,,,1559000,37541000,29072000,0,-993000,,5917000,5917000,52465,RBKB
2019-12-31,,,7492000,,5963000,22513000,35417000,0,8136000,4768000,,,,,1529000,35417000,27281000,0,-644000,,5963000,5963000,52465,RBKB
2018-12-31,,,5371000,,4357000,20583000,31491000,0,6539000,4369000,,,,,1014000,31491000,24952000,0,-1168000,,4357000,4357000,52465,RBKB
2017-12-31,,,6600000,,3002000,19775000,31744000,0,7572000,4397000,,,,,3598000,31744000,24172000,0,-972000,,3002000,3002000,52465,RBKB
2020-06-30,,,-20395000,,-20395000,2782000,39565000,36783000,36783000,,-28754000,,,,0,39565000,2782000,0,-57178000,,-20395000,-20395000,52466,RCS
2019-06-30,,,26409000,,26409000,2947000,35784000,32837000,32837000,,-26468000,,,,0,35784000,2947000,0,-6428000,,26409000,26409000,52466,RCS
2018-06-30,,,17772000,,17772000,3149000,38866000,35717000,35717000,,9098000,,,,0,38866000,3149000,0,-17945000,,17772000,17772000,52466,RCS
2017-06-30,,,32728000,,32728000,3204000,34472000,31268000,31268000,,14013000,,,,0,34472000,3204000,0,1460000,,32728000,32728000,52466,RCS
2020-05-02,,,169455000,,129972000,204394000,370140000,165746000,165746000,,,,,,39483000,1000394000,834648000,630254000,3709000,,129972000,129972000,52467,FIZZ
2019-04-27,,,183877000,,140853000,204415000,384350000,179935000,179935000,,,,,,43024000,1014105000,834170000,629755000,3942000,,140853000,140853000,52467,FIZZ
2018-04-28,,,205489000,,149774000,186947000,391135000,204188000,204188000,,,,,,55715000,975734000,771546000,584599000,1301000,,149774000,149774000,52467,FIZZ
2017-04-29,,,162825000,,107045000,163600000,326077000,162477000,162477000,,-189000.0,,,,55780000,826918000,664441000,500841000,348000,,107045000,107045000,52467,FIZZ
2019-12-31,,,-13734000,64590000,-11122000,244397000,413313000,144661000,144661000,11860000,-122504000,,,,-2191000,1063665000,919004000,650352000,-158395000,,-11543000,-11122000,52469,WSC
2018-12-31,,,-92172000,63982000,-49040000,204814000,289384000,58162000,58162000,13104000,-98433000,,,,-38600000,751412000,693250000,462028000,-150334000,,-53572000,-51175000,52469,WSC
2017-12-31,,,-165398000,48931000,-147702000,138470000,165570000,6310000,6310000,12137000,-119308000,,,,-936000,445942000,439632000,280372000,-171708000,14650000.0,-164462000,-147702000,52469,WSC
2016-12-31,,,-87633000,48931000,-30936000,130674000,168193000,26669000,26669000,1831000,-94671000,,,,-24502000,426612000,399943000,258419000,-114302000,32195000.0,-63131000,-30936000,52469,WSC
2019-12-31,20783000,,-110053000,,-110053000,104155000,29337000,-95601000,-95601000,,-9623000,,,,0,34631000,130232000,5294000,-14452000,,-110053000,-110053000,52471,OPTN
2018-12-31,10099000,,-106658000,,-106658000,95618000,5477000,-100240000,-100240000,,-9229000,,,,0,7065000,107305000,1588000,-6418000,,-106658000,-106658000,52471,OPTN
2017-12-31,16832000,,-48902000,,-48902000,31698000,0,-48530000,-48530000,,-910000,,,,0,0,48530000,0,-372000,,-48902000,-61967000,52471,OPTN
2016-12-31,15311000,,22613000,,22613000,6869000,47500000,25320000,25320000,,-3517000,,,,0,47500000,22180000,0,-2707000,,22613000,1615000,52471,OPTN
2019-12-31,17948000,,-19234000,-1712000,-11709000,18931000,3103000,-33776000,-33776000,,-15000,,,,-7407000,3515000,37291000,412000,14542000,,-11827000,-11709000,52473,LCTX
2018-12-31,20955000,,-47130000,-1594000,-45990000,24726000,4686000,-40995000,-40995000,,-189000,,,,-346000,4988000,45983000,302000,-6135000,,-46784000,-45990000,52473,LCTX
2017-12-31,24024000,,-23289000,1622000,-19976000,19922000,3290000,-40656000,-40656000,,-792000,,,,0,3458000,44114000,168000,17367000,,-23289000,-19976000,52473,LCTX
2016-12-31,36106000,,18621000,12580000,33572000,28426000,5565000,-58967000,-58967000,,-1047000,,,,0,5923000,64890000,358000,77588000,,18621000,33572000,52473,LCTX
2019-12-31,,,6621822,,6621822,459541,798105,338564,338564,,,,,,0,798105,459541,0,6283258,,6621822,6621822,52475,GRF
2018-12-31,,,-1589545,,-1589545,446169,812367,366198,366198,,,,,,0,812367,446169,0,-1955743,,-1589545,-1589545,52475,GRF
2017-12-31,,,5158669,,5158669,429927,430949,1022,1022,,,,,,0,430949,429927,0,5157647,,5158669,5158669,52475,GRF
2016-12-31,,,3271252,,3271252,407525,456963,49438,49438,,,,,,0,456963,407525,0,3221814,,3271252,3271252,52475,GRF
2020-12-31,419000000,,2855000000,326000000,1982000000,2731000000,5129000000,1953000000,1953000000,26000000,-298000000,,,,849000000,17456000000,15503000000,12327000000,902000000,,2006000000,1982000000,52476,CARR
2019-12-31,401000000,,2672000000,333000000,2116000000,2464000000,5455000000,2696000000,2696000000,-106000000,-75000000,,,,517000000,18608000000,15912000000,13153000000,-24000000,,2155000000,2116000000,52476,CARR
2018-12-31,400000000,,3842000000,352000000,2734000000,2477000000,5605000000,2866000000,2866000000,-138000000,-84000000,,,,1073000000,18914000000,16048000000,13309000000,976000000,,2769000000,2734000000,52476,CARR
2017-12-31,364000000,,3054000000,352000000,1227000000,2382000000,5233000000,2644000000,2644000000,-157000000,-219000000,,,,1787000000,17814000000,15170000000,12581000000,410000000,,1267000000,1227000000,52476,CARR
2020-12-31,,,-266000000,,-266000000,56000000,-173000000,0,-266000000,37000000,,,,,0,-173000000,93000000,0,0,,-266000000,-362000000,52477,AGNCP
2019-12-31,,,688000000,,688000000,47000000,771000000,0,688000000,35500000,,,,,0,771000000,83000000,0,0,,688000000,628000000,52477,AGNCP
2018-12-31,,,129000000,,129000000,45000000,229000000,0,156000000,27500000,,,,,0,229000000,73000000,0,-27000000,,129000000,93000000,52477,AGNCP
2017-12-31,,,771000000,,771000000,42000000,844000000,0,771000000,30500000,,,,,0,844000000,73000000,0,0,,771000000,733000000,52477,AGNCP
2019-12-31,,,22588000,,58729000,77009000,663709000,130343000,130343000,110426000,-97847000,,,,-36141000,906971000,776628000,243262000,-107755000,,58729000,58729000,52478,TALO
2018-12-31,,,224462000,,221540000,45532000,679152000,369992000,369992000,-25091000,-90114000,,,,2922000,889299000,519307000,210147000,-145530000,,221540000,221540000,52478,TALO
2017-12-31,,,-62868000,,-62868000,36673000,258880000,17997000,17997000,46858000,-80934000,,,,0,411368000,393371000,152488000,-80865000,,-62868000,-62868000,52478,TALO
2016-12-31,,,-208087000,,-208087000,41787000,107844000,-137859000,-137859000,79227000,-70415000,,,,0,256796000,394655000,148952000,-70228000,,-208087000,-208087000,52478,TALO
2020-06-30,92230000,,279357000,,229671000,187521000,537110000,257359000,257359000,,-11862000,,,,49686000,598717000,341358000,61607000,21998000,,229671000,229671000,52480,AZPN
2019-06-30,83122000,,301527000,,261362000,174605000,538866000,281139000,281139000,,-8733000,,,,40165000,596682000,315543000,57816000,20388000,,261362000,261362000,52480,AZPN
2018-06-30,82076000,,226353000,,281234000,165229000,456922000,209617000,209617000,,-5691000,,,,-54881000,507566000,297949000,50644000,16736000,,281234000,281234000,52480,AZPN
2017-06-30,79530000,,237183000,,179386000,150712000,446961000,216719000,216719000,,-3787000,,,,57797000,494427000,277708000,47466000,20464000,,179386000,179386000,52480,AZPN
2020-03-31,188294000,,1924000,,-2754000,376517000,649628000,20312000,20312000,,-20597000,,,,4678000,891820000,871508000,242192000,-18388000,,-2754000,-2754000,52483,NTCT
2019-03-31,203486000,,-92912000,,-73324000,385442000,655791000,-7442000,-7442000,,-26143000,,,,-19588000,909918000,917360000,254127000,-85470000,,-73324000,-73324000,52483,NTCT
2018-03-31,215076000,,-18659000,,79812000,422015000,715126000,1395000,1395000,,-12633000,,,,-98471000,986787000,985392000,271661000,-20054000,,79812000,79812000,52483,NTCT
2017-03-31,232701000,,52185000,,33291000,447066000,816923000,67015000,67015000,,-9184000,,,,18894000,1162112000,1095097000,345189000,-14830000,,33291000,33291000,52483,NTCT
2019-12-31,,,-71500000,,-72900000,89100000,197700000,-39900000,-39900000,58500000,-30700000,,,,1400000,776600000,816500000,578900000,-31600000,,-72900000,-72900000,52484,FTSI
2018-12-31,,,260400000,,258400000,87900000,510100000,318300000,318300000,19200000,-49300000,,,,2000000,1543300000,1225000000,1033200000,-57900000,,258400000,681600000,52484,FTSI
2017-12-31,,,202300000,,200700000,81000000,456300000,287500000,287500000,1200000,-86700000,,,,1600000,1466100000,1178600000,1009800000,-85200000,,200700000,-25900000,52484,FTSI
2016-12-31,,,-190100000,,-188500000,64400000,21700000,-157800000,-157800000,2500000,-87500000,,,,-1600000,532200000,690000000,510500000,-32300000,,-188500000,-370100000,52484,FTSI
2019-12-31,,,61138000,,48292000,153879000,637966000,50488000,50488000,429713000,-1789000,,,,12846000,942311000,891823000,304345000,10650000,,48292000,48292000,52485,BBSI
2018-12-31,,,44769000,,38062000,145465000,593676000,36989000,36989000,407003000,-1052000,,,,6707000,940698000,903709000,347022000,7780000,,38062000,38062000,52485,BBSI
2017-12-31,,,34378000,,25170000,123138000,563218000,29941000,29941000,404687000,-313000,,,,9208000,920432000,890491000,357214000,4437000,,25170000,25170000,52485,BBSI
2016-12-31,,,25586000,,18799000,113342000,503403000,28941000,28941000,357867000,-807000,,,,6787000,840586000,811645000,337183000,-3355000,,18799000,18799000,52485,BBSI
2019-12-31,,,181226000,12723000,141311000,478302000,686017000,185464000,185464000,,,,,,39504000,1787157000,1601693000,1101140000,-4238000,,141722000,141311000,52486,SHOO
2018-12-31,,,177340000,8868000,129136000,426761000,640163000,191648000,191648000,,,,,,46841000,1677734000,1486086000,1037571000,-14308000,,130499000,129136000,52486,SHOO
2017-12-31,,,172327000,6111000,117948000,413136000,598726000,165185000,165185000,,,,,,53189000,1567083000,1401898000,968357000,7132000,,119138000,117948000,52486,SHOO
2016-12-31,,,171000000,205000,120911000,345152000,521983000,168751000,168751000,-11788000.0,,,,,49726000,1399551000,1230800000,877568000,2246000,,121274000,120911000,52486,SHOO
2020-03-31,,,579434000,,482603000,1040824000,1786248000,664343000,664343000,,-96960000,,,,96831000,7463841000,6799498000,5677593000,-84909000,,482603000,481085000,52488,BAH
2019-03-31,,,515403000,,418529000,935176000,1598907000,595156000,595156000,,-89517000,,,,96874000,6704037000,6108881000,5105130000,-79753000,,418529000,416664000,52488,BAH
2018-03-31,,,430036000,,301692000,862820000,1440020000,512444000,512444000,,-82269000,,,,128344000,6167600000,5655156000,4727580000,-82408000,,301692000,299824000,52488,BAH
2017-03-31,,,425657000,,260825000,818175000,1379699000,501980000,501980000,,-62298000,,,,164832000,5809491000,5307511000,4429792000,-76323000,,260825000,258495000,52488,BAH
2020-12-31,108568000,,-96863000,,-98849000,252395000,289969000,-70994000,-70994000,,-24137000,,,,1986000,411486000,482480000,121517000,-25869000,,-98849000,-98849000,52489,RPD
2019-12-31,79364000,,-53803000,,-53845000,201176000,235801000,-44739000,-44739000,,-13389000,,,,42000,326947000,371686000,91146000,-9064000,,-53845000,-53845000,52489,RPD
2018-12-31,67743000,,-55079000,,-55545000,157383000,173008000,-52118000,-52118000,,-4934000,,,,466000,244091000,296209000,71083000,-2961000,,-55545000,-55545000,52489,RPD
2017-12-31,50938000,,-47706000,,-45470000,141719000,144030000,-48627000,-48627000,,-87000,,,,-2236000,200940000,249567000,56910000,921000,,-45470000,-45470000,52489,RPD
2019-12-31,26332000,,-54813000,,-54813000,14092000,-5683000,-46107000,-46107000,,-3031000,,,,0,2221000,48328000,7904000,-8706000,,-54813000,-54813000,52492,VBIV
2018-12-31,38467000,,-63600000,,-63600000,20509000,-1154000,-60130000,-60130000,,-3254000,,,,0,3355000,63485000,4509000,-3470000,,-63600000,-63600000,52492,VBIV
2017-12-31,20918000,,-39426000,,-38995000,12034000,-4328000,-37280000,-37280000,,-3031000,,,,-431000,865000,38145000,5193000,-2146000,,-38995000,-38995000,52492,VBIV
2016-12-31,9966000,,-24985000,,-23205000,9240000,-3123000,-22329000,-22329000,,-392000,,,,-1780000,548000,22877000,3671000,-2656000,,-23205000,-23205000,52492,VBIV
2020-07-31,,,-65427080,,-65427080,14337093,84821292,70484199,70484199,,-17718871,,,,0,84821292,14337093,0,-135911279,,-65427080,-65427080,52499,JQC
2019-07-31,,,39320990,,39320990,15966943,103389958,87423015,87423015,,-24798526,,,,0,103389958,15966943,0,-48102025,,39320990,39320990,52499,JQC
2018-07-31,,,44382856,,44382856,16555383,96991507,80436124,80436124,,-20608669,,,,0,96991507,16555383,0,-36053268,,44382856,44382856,52499,JQC
2017-07-31,,,95183090,,95183090,16943542,103231535,86287993,86287993,,-15547730,,,,0,103231535,16943542,0,8895097,,95183090,95183090,52499,JQC
2019-12-31,47045000,,208621000,31924000,171585000,401243000,718497000,280306000,280306000,-10097000,-82273000,,,,42066000,3200583000,2920277000,2482086000,-71685000,,166555000,171585000,52500,CSIQ
2018-12-31,44193000,,304400000,47372000,237070000,379810000,775082000,362092000,362092000,-11013000,-106825000,,,,61969000,3744512000,3382420000,2969430000,-57692000,,242431000,237070000,52500,CSIQ
2017-12-31,28777000,,143934000,27549000,99572000,375404000,637598000,239890000,239890000,-6473000,-116316000,,,,40951000,3390393000,3150503000,2752795000,-95956000,,102983000,99572000,52500,CSIQ
2016-12-31,17407000,,83251000,14709000,65249000,326399000,417188000,76116000,76116000,-2734000,-67493000,,,,17976000,2853078000,2776962000,2435890000,7135000,,65275000,65249000,52500,CSIQ
2019-12-31,,,378069000,,320087000,59542000,706609000,395104000,395104000,251963000,-17035000,,,,57982000,3972518000,3577414000,3265909000,-17035000,,320087000,320087000,52501,MCY
2018-12-31,,,-30615000,,-5728000,40900000,271951000,-13579000,-13579000,244630000,-17036000,,,,-24887000,3380004000,3393583000,3108053000,-17036000,,-5728000,-5728000,52501,MCY
2017-12-31,,,167085000,,144877000,37400000,449828000,178953000,178953000,233475000,-15168000,,,,22208000,3412662000,3233709000,2962834000,-11868000,,144877000,144877000,52501,MCY
2016-12-31,,,70724000,,73044000,39600000,349600000,74686000,74686000,235314000,-3962000,,,,-2320000,3227683000,3152997000,2878083000,-3962000,,73044000,73044000,52501,MCY
2020-06-30,41280000,,97497000,4403000,79396000,70352000,190568000,105195000,105195000,-26259000,-306000,,,,18171000,503327000,398132000,312759000,-7698000,,79326000,79313000,52502,HOLI
2019-06-30,36687000,,143723000,1774000,125261000,69965000,211166000,135249000,135249000,-30735000,-575000,,,,18184000,570341000,435092000,359175000,8474000,,125539000,125261000,52502,HOLI
2018-06-30,36090000,,129642000,301000,107161000,73996000,205880000,120244000,120244000,-24450000,-692000,,,,22205000,540768000,420524000,334888000,9398000,,107437000,107161000,52502,HOLI
2017-06-30,30109000,,83355000,21000,68944000,68709000,140471000,71481000,71481000,-29828000,-938000,,,,14386000,431943000,360462000,291472000,11874000,,68969000,68944000,52502,HOLI
2019-12-31,35807000,,-828896000,6739000,-850441000,262376000,275316000,-22867000,-22867000,,,,,,19893000,655606000,678473000,380290000,-806029000,,-848789000,-850441000,52506,KRKR
2018-12-31,22075000,,-64715000,7731000,-80567000,91109000,163880000,45592000,45592000,5104000.0,-97000.0,,,,14827000,299093000,253501000,135213000,-110307000,,-79542000,-80567000,52506,KRKR
2017-12-31,6429000,,8998000,7731000,5089000,42315000,62592000,11014000,11014000,2834000.0,-185000.0,,,,3909000,120507000,109493000,57915000,-2016000,,5089000,2255000,52506,KRKR
2019-12-31,34392000,,-22481000,,-22645000,323623000,333736000,-24279000,-24279000,,-6626000,,,,164000,429755000,454034000,96019000,1798000,,-22645000,-22645000,52508,AMRN
2018-12-31,55900000,,-116349000,,-116445000,226996000,174671000,-108225000,-108225000,,-8872000,,,,96000,229214000,337439000,54543000,-8124000,,-116445000,-116445000,52508,AMRN
2017-12-31,47158000,,-54818000,,-67865000,134549000,136152000,-45555000,-45555000,,-9766000,,,,13047000,181104000,226659000,44952000,-9263000,,-67865000,-67865000,52508,AMRN
2016-12-31,49975000,,-76381000,,-86350000,111372000,95721000,-65626000,-65626000,,-18677000,,,,9969000,130084000,195710000,34363000,-10755000,,-86350000,-86350000,52508,AMRN
2020-12-31,,,142453000,,115928000,341653000,515601000,0,162075000,11873000,,,,,26525000,515601000,353526000,0,-19622000,,115928000,115928000,52511,BANR
2019-12-31,,,183132000,,146278000,318829000,540860000,0,201970000,20061000,,,,,36854000,540860000,338890000,0,-18838000,,146278000,146278000,52511,BANR
2018-12-31,,,165110000,,136515000,292942000,506481000,0,186014000,27525000,,,,,28595000,506481000,320467000,0,-20904000,,136515000,136515000,52511,BANR
2017-12-31,,,151264000,,60776000,283378000,458045000,0,147980000,26687000,,,,,90488000,458045000,310065000,0,3284000,,60776000,60776000,52511,BANR
2019-12-31,,,-32800000,182700000,-42600000,23900000,132300000,42500000,42500000,1400000,-51400000,,,,9800000,281600000,239100000,149300000,-75300000,,-42600000,-42600000,52512,AT
2018-12-31,,,37000000,199300000,36800000,23900000,124200000,19800000,19800000,-3200000,-55900000,,,,200000,282300000,262500000,158100000,17200000,,36800000,36800000,52512,AT
2017-12-31,,,-156700000,215200000,-98600000,23600000,236900000,93400000,93400000,6800000,-78400000,,,,-58100000,431000000,337600000,194100000,-250100000,,-98600000,-98600000,52512,AT
2016-12-31,,,-137000000,221300000,-122400000,22600000,144500000,40200000,40200000,-31800000,-117600000,,,,-14600000,399200000,359000000,254700000,-177200000,,-122400000,-122400000,52512,AT
2019-12-31,65615000,,2193000,,5451000,312274000,432366000,54477000,54477000,,-12413000,,,,-3258000,994852000,940375000,562486000,-52284000,,5451000,5451000,52513,MMSI
2018-12-31,59532000,,49519000,,42017000,261918000,394770000,73320000,73320000,,-10360000,,,,7502000,882753000,809433000,487983000,-23801000,,42017000,42017000,52513,MMSI
2017-12-31,51403000,,35881000,,27523000,209934000,326253000,64916000,64916000,,-7736000,,,,8358000,727852000,662936000,401599000,-29035000,,27523000,27523000,52513,MMSI
2016-12-31,45229000,,25386000,,20121000,182798000,265025000,36998000,36998000,,-8798000,,,,5265000,603838000,566840000,338813000,-11612000,,20121000,20121000,52513,MMSI
2020-02-29,,,-291061,,-291061,1078682,0,-1078682,-1078682,,,,,,0,0,1078682,0,787621,,-291061,-937068,52514,LOAC
2019-02-28,,,-14269,,-14269,439639,0,-439639,-439639,,,,,,0,0,439639,0,425370,,-14269,-383405,52514,LOAC
2019-12-31,,,58264000,49534000,34851000,425122000,565568000,140446000,140446000,,-39538000,,,,12140000,674353000,533907000,108785000,-82182000,,46124000,34851000,52516,BXG
2018-12-31,,,128893000,45611000,87962000,415403000,579005000,163602000,163602000,,-34709000,,,,28541000,675786000,512184000,96781000,-34709000,,100352000,87962000,52516,BXG
2017-12-31,,,136998000,43021000,126583000,421199000,588174000,166975000,166975000,,-29977000,,,,-2345000,670413000,503438000,82239000,-29977000,,139343000,126583000,52516,BXG
2016-12-31,,,129623000,40772000,77877000,419930000,580406000,160476000,160476000,,-30853000,,,,41620000,670384000,509908000,89978000,-30853000,,88003000,77877000,52516,BXG
2019-12-31,,,1334491000,67308000,1145694000,267458000,2973269000,2705811000,2705811000,,-1295020000,,,,167714000,4937340000,2231529000,1964071000,-1371320000,,1166777000,1145694000,52518,AER
2018-12-31,,,1161576000,52566000,1015632000,305226000,2674419000,2369193000,2369193000,-61564000.0,-1174074000,,,,144079000,4799980000,2430787000,2125561000,-1207617000,,1017497000,1015632000,52518,AER
2017-12-31,,,1245071000,59104000,1076151000,348291000,2772445000,2424154000,2424154000,-61564000.0,-1112391000,,,,164718000,5037493000,2613339000,2265048000,-1179083000,,1080353000,1076151000,52518,AER
2016-12-31,,,1213012000,57817000,1046630000,351012000,2669165000,2381353000,2381353000,-63200000.0,-1091861000,,,,173496000,5043031000,2661678000,2373866000,-1168341000,,1039516000,1046630000,52518,AER
2019-12-31,113820000,,-107189000,,-106373000,17745000,-93934000,-111679000,-111679000,,,,,,-816000,19886000,131565000,113820000,4490000,,-106373000,-106373000,52519,CARA
2018-12-31,113820000,,-74402000,,-74013000,15320000,-62062000,-77382000,-77382000,,,,,,-389000,13469000,90851000,75531000,2980000,,-74013000,-74013000,52519,CARA
2017-12-31,113820000,,-58329000,,-58125000,11872000,-47613000,-59485000,-59485000,,,,,,-204000,911000,60396000,48524000,1156000,,-58125000,-58125000,52519,CARA
2016-12-31,113820000,,-57748000,,-57280000,9233000,-49167000,-58400000,-58400000,,,,,,-468000,86000,58486000,49253000,652000,,-57280000,-57280000,52519,CARA
2019-12-31,,,-121351000,252565000,-211956000,52171000,283629000,115458000,115458000,-33000,-118993000,,,,1024000,448750000,333292000,165121000,-236809000,,-122375000,-211956000,52520,GLNG
2018-12-31,,,-166947000,80666000,-231428000,51542000,206228000,47019000,47019000,1278000,-93479000,,,,1267000,430604000,383585000,224376000,-213966000,,-168214000,-231428000,52520,GLNG
2017-12-31,,,-143774000,80988000,-179703000,38031000,13996000,-100557000,-100557000,1278000,-57170000,,,,1505000,143537000,244094000,129541000,-43217000,,-145279000,-179703000,52520,GLNG
2016-12-31,,,-161369000,46564000,-186531000,37302000,-29127000,-139385000,-139385000,-16000,-78940000,,,,-589000,80257000,219642000,109384000,-21984000,,-160780000,-186531000,52520,GLNG
2020-12-30,,,19141000,,15146000,32728000,57138000,0,19663000,4747000,,,,,3995000,57138000,37475000,0,-522000,,15146000,15146000,52525,CCB
2019-12-31,,,16662000,,13201000,27684000,47667000,0,16846000,3137000,,,,,3461000,47667000,30821000,0,-184000,,13201000,13201000,52525,CCB
2018-12-31,,,12242000,,9701000,23325000,38377000,0,12537000,2515000,,,,,2541000,38377000,25840000,0,-295000,,9701000,9701000,52525,CCB
2017-12-31,,,10089000,,5436000,19640000,32300000,0,10420000,2240000,,,,,4653000,32300000,21880000,0,-331000,,5436000,5436000,52525,CCB
2020-03-31,110020000,,-12546000,,-5645000,427915000,553807000,57000,57000,,,,,,-6901000,670885000,670828000,117078000,-12603000,,-5645000,-5645000,52526,CVLT
2019-03-31,92647000,,10427000,,3561000,469634000,593951000,21073000,21073000,,,,,,6866000,710957000,689884000,117006000,-10646000,,3561000,3561000,52526,CVLT
2018-03-31,91030000,,-3500000,,-61900000,501436000,601241000,-946000,-946000,,-1161000.0,,,,58400000,699393000,700339000,98152000,-2554000,,-61900000,-61900000,52526,CVLT
2017-03-31,79558000,,-1994000,,-508000,472862000,559813000,-1242000,-1242000,,-957000.0,,,,-1486000,645005000,646247000,85192000,-752000,,-508000,-508000,52526,CVLT
2019-12-31,,,45937000,,38793000,29290000,76532000,47242000,47242000,,-1305000,,,,7144000,362745000,315503000,286213000,-1305000,,38793000,38540000,52527,MGPI
2018-12-31,,,48980000,,37284000,33451000,83599000,50148000,50148000,,-1168000,,,,11696000,376089000,325941000,292490000,-1168000,,37284000,36576000,52527,MGPI
2017-12-31,,,52758000,,41823000,33107000,76016000,42909000,42909000,,-1184000,,,,10935000,347448000,304539000,271432000,9849000,,41823000,40827000,52527,MGPI
2016-12-31,,,44717000,,31184000,26693000,65283000,38590000,38590000,,-1294000,,,,13533000,318263000,279673000,252980000,6127000,,31184000,30230000,52527,MGPI
2019-12-31,,,-208687000,,-322324000,100844000,-72558000,-173402000,-173402000,,-17666000,,,,-930000,90722000,264124000,163280000,-35285000,-116159000,-207757000,-322324000,52529,PGEN
2018-12-31,404586000.0,,-429742000,15867000.0,-509336000,125751000,-277746000,-403497000,-403497000,,-8473000,,,,-15425000,151178000,554675000,428924000,-26245000,-100389000,-414317000,-509336000,52529,PGEN
2017-12-31,404586000.0,,-78367000,12914000.0,-117018000,130175000,48595000,-81580000,-81580000,,-584000,,,,2072000,219463000,301043000,170868000,3213000,-46381000,-80439000,-117018000,52529,PGEN
2016-12-31,404586000.0,,-194151000,9011000.0,-186612000,138006000,17152000,-120854000,-120854000,,-861000,,,,-3877000,190926000,311780000,173774000,-73297000,-46381000,-190274000,-186612000,52529,PGEN
2020-01-31,95978000,,-111801000,,-112333000,276226000,257274000,-114930000,-114930000,119000,,,,,532000,402463000,517393000,145189000,3129000,,-112333000,-112333000,52531,MDLA
2019-01-31,86272000,,-80455000,,-82234000,187413000,197741000,-75944000,-75944000,119000,,,,,1779000,313642000,389586000,115901000,-4511000,,-82234000,-82234000,52531,MDLA
2018-01-31,86368000,,-68723000,,-70361000,150185000,165418000,-71135000,-71135000,119000,,,,,1638000,261195000,332330000,95777000,2412000,,-70361000,-70361000,52531,MDLA
2019-12-31,,,-9059639,160594,-9527714,92833575,84055491,-8778084,-8778084,,,,,,496981,979937241,988715325,895881750,-281555,,-9556620,-9527714,52533,EXPI
2018-12-31,,,-22352556,160594,-22430356,62816360,40431845,-22384515,-22384515,,,,,,77800,500147681,522532196,459715836,31959,,-22430356,-22430356,52533,EXPI
2017-12-31,,,-22033731,160594,-22130965,38532228,16500574,-22031654,-22031654,,-2077.0,,,,97234,156104544,178136198,139603970,-2077,,-22130965,-22130965,52533,EXPI
2016-12-31,,,-7372188,160594,-7384915,14488614,7116781,-7371833,-7371833,,-370.0,,,,42528,53555725,60927558,46438944,-355,,-7414716,-7384915,52533,EXPI
2019-12-31,,,194353000,,132047000,214493000,486895000,272039000,272039000,363000,-77528000,,,,62306000,1392701000,1120662000,905806000,-77686000,,132047000,132047000,52534,CPAC
2018-12-31,,,116141000,,76699000,212265000,466728000,237191000,237191000,17272000,-86571000,,,,40995000,1262934000,1025743000,796206000,-121050000,,75146000,76699000,52534,CPAC
2017-12-31,,,128417000,148000.0,93782000,234061000,487794000,253534000,253534000,-1533000,-73237000,,,,47032000,1220750000,967216000,732956000,-125117000,-754000.0,81385000,93782000,52534,CPAC
2016-12-31,,,198110000,112589000.0,116174000,227254000,500134000,275908000,275908000,-3028000,-74267000,,,,78627000,1236664000,960756000,736530000,-77798000,-6589000.0,119483000,116174000,52534,CPAC
2020-03-31,,,-7234000,,-7234000,11753000,61924000,39911000,39911000,10260000,-13809000,,,,0,61924000,22013000,0,-47145000,,-7234000,-7234000,52536,GAIN
2019-03-31,,,81590000,,81590000,35618000,59663000,10545000,10545000,13500000,-18191000,,,,0,59663000,49118000,0,71045000,,81590000,81590000,52536,GAIN
2018-03-31,,,60687000,,60687000,21888000,58355000,36467000,36467000,13500000,-14507000,,,,0,58355000,21888000,0,24220000,,60687000,60687000,52536,GAIN
2017-03-31,,,44763000,,44763000,15355000,51875000,36520000,36520000,13500000,-14098000,,,,0,51875000,15355000,0,8243000,,44763000,44763000,52536,GAIN
2020-02-01,,,123742000,26364000,95975000,843651000,1015708000,172057000,172057000,,-16129000,,,,22513000,2678109000,2506052000,1662401000,-48315000,,101229000,95125000,52537,GES
2019-02-02,,,46708000,21271000,14099000,832474000,939604000,107130000,107130000,,-3407000,,,,29542000,2609694000,2502564000,1670090000,-60422000,,17166000,13343000,52537,GES
2018-02-03,,,70271000,22246000,-7894000,743823000,828848000,85025000,85025000,,-2431000,,,,74172000,2363754000,2278729000,1534906000,-14754000,,-3901000,-8658000,52537,GES
2017-01-28,,,53610000,16224000,22761000,682558000,745040000,62482000,62482000,,-1859000,,,,28212000,2190453000,2127971000,1445413000,-8872000,,25398000,22234000,52537,GES
2019-12-31,,,284000000,10000000,283000000,340000000,440000000,95000000,95000000,,-36000000,,,,1000000,6840000000,6745000000,6400000000,189000000,,283000000,283000000,52538,SEB
2018-12-31,,,-16000000,11000000,-17000000,311000000,523000000,205000000,205000000,,-44000000,,,,1000000,6583000000,6378000000,6060000000,-221000000,,-17000000,-17000000,52538,SEB
2017-12-31,,,427000000,11000000,247000000,305000000,549000000,232000000,232000000,,-29000000,,,,181000000,5809000000,5577000000,5260000000,195000000,,246000000,247000000,52538,SEB
2016-12-31,,,384000000,13000000,312000000,263000000,497000000,238000000,238000000,,-29000000,,,,70000000,5379000000,5141000000,4882000000,146000000,,314000000,312000000,52538,SEB
2019-12-31,,,21556000,,15778000,63348000,107337000,42037000,42037000,,-16855000,,,,5778000,901238000,859201000,793901000,-20481000,,15778000,15778000,52539,CVGI
2018-12-31,,,49576000,,41489000,59777000,124920000,63843000,63843000,,-14676000,,,,8087000,897737000,833894000,772817000,-14267000,,41489000,41489000,52539,CVGI
2017-12-31,,,12798000,,-2269000,56554000,92771000,34897000,34897000,,-19149000,,,,15067000,755231000,720334000,662460000,-22099000,,-2269000,-2269000,52539,CVGI
2016-12-31,,,6834000,,6785000,59399000,90103000,29399000,29399000,,-19318000,,,,49000,662112000,632713000,572009000,-22565000,,6785000,6785000,52539,CVGI
2019-12-31,,,65707274,,65707274,3417714,9654509,6097088,6097088,139707,,,,,0,9654509,3557421,0,59610186,,65707274,65707274,52540,SOR
2018-12-31,,,-27767606,,-27767606,3492457,8208466,4716009,4716009,139707,,,,,0,8208466,3492457,0,-32483615,,-27767606,-27767606,52540,SOR
2017-12-31,,,48711297,,48711297,3500194,7848091,4347897,4347897,139707,,,,,0,7848091,3500194,0,44363400,,48711297,48711297,52540,SOR
2016-12-31,,,27867511,,27867511,3640166,7120916,3480750,3480750,139707,,,,,0,7120916,3640166,0,24386761,,27867511,27867511,52540,SOR
2019-12-31,91378000,,-199671000,,-199581000,138402000,42288000,-187492000,-187492000,,-15255000,,,,-90000,69888000,257380000,27600000,-12179000,,-199581000,-199581000,52541,AERI
2018-12-31,86123000,,-232566000,,-232569000,120614000,-3005000,-209742000,-209742000,,-2531000,,,,3000,24181000,233923000,27186000,-22824000,,-232569000,-232569000,52541,AERI
2017-12-31,72078000,,-146863000,,-145105000,56905000,-16710000,-145693000,-145693000,,-2531000,,,,-1758000,0,145693000,16710000,-1170000,,-145105000,-145105000,52541,AERI
2016-12-31,52394000,,-98866000,,-99059000,34706000,-9772000,-96872000,-96872000,,-2537000,,,,193000,0,96872000,9772000,-1994000,,-99059000,-99059000,52541,AERI
2020-12-31,984000000,,1954000000,,1599000000,4759000000,9158000000,2943000000,2943000000,,-315000000,,,,355000000,14351000000,11408000000,5193000000,-989000000,,1599000000,1599000000,52543,SYK
2019-12-31,971000000,,2562000000,,2083000000,4978000000,9801000000,3388000000,3388000000,,-287000000,,,,479000000,14884000000,11496000000,5083000000,-826000000,,2083000000,2083000000,52543,SYK
2018-12-31,862000000,,2356000000,,3553000000,4808000000,8981000000,2894000000,2894000000,,-264000000,,,,-1197000000,13601000000,10707000000,4620000000,-538000000,,3553000000,3553000000,52543,SYK
2017-12-31,787000000,,2063000000,14000000.0,1020000000,4380000000,8259000000,2721000000,2721000000,,-247000000,,,,1043000000,12444000000,9723000000,4185000000,-658000000,,1020000000,1020000000,52543,SYK
2020-10-31,,,50300000,,38496000,89464000,192823000,56130000,56130000,,-5245000,,,,11804000,851573000,795443000,658750000,-5830000,,38496000,38496000,52544,NX
2019-10-31,,,-35954000,,-46730000,100896000,199421000,48939000,48939000,,-9643000,,,,10776000,893841000,844902000,694420000,-84893000,,-46730000,-46730000,52544,NX
2018-10-31,,,25753000,,26553000,102780000,192763000,38161000,38161000,,-11100000,,,,-800000,889785000,851624000,697022000,-12408000,,26553000,26553000,52544,NX
2017-10-31,,,25502000,,18683000,97655000,194067000,45117000,45117000,,-9595000,,,,6819000,866555000,821438000,672488000,-19615000,,18683000,18683000,52544,NX
2020-12-31,,,5091348000,759241000,16546577000,37176817000,64271356000,0,10052939000,17041600000,,,,,-11652328000,65570797000,55517858000,1299441000,-4961591000,,16743676000,16546577000,52546,BBD
2019-12-31,,,16179340000,709791000,22582615000,40404592000,87385813000,0,26071554000,20909667000,,,,,-6554360000,88617409000,62545855000,1231596000,-9892214000,,22733700000,22582615000,52546,BBD
2018-12-31,,,19442015000,400665000,16583915000,38151507000,70798510000,0,20887733000,11759270000,,,,,2693576000,71911018000,51023285000,1112508000,-1445718000,,16748439000,16583915000,52546,BBD
2017-12-31,,,23743559000,289873000,17089364000,40088318000,72761002000,0,24190341000,8482343000,,,,,6428956000,73919842000,49729501000,1158840000,-446782000,,17314603000,17089364000,52546,BBD
2020-12-31,,,201805000,,160025000,317750000,677040000,0,208034000,151256000,,,,,41780000,677040000,469006000,0,-6229000,,160025000,160025000,52549,TRMK
2019-12-31,,,173793000,,150460000,297599000,602795000,0,184143000,121053000,,,,,23333000,602795000,418652000,0,-10350000,,150460000,150460000,52549,TRMK
2018-12-31,,,171853000,,149584000,289566000,587268000,0,183457000,114245000,,,,,22269000,587268000,403811000,0,-11604000,,149584000,149584000,52549,TRMK
2017-12-31,,,154345000,,105630000,279485000,584514000,0,190209000,114820000,,,,,48715000,584514000,394305000,0,-35864000,,105630000,105630000,52549,TRMK
2019-12-31,99991000,,-126189000,,-103931000,44183000,25669000,-118320000,-118320000,-185000,-3796000,,,,-22258000,25669000,143989000,0,-7869000,,-103931000,-103931000,52550,IMCR
2018-12-31,83575000,,-88178000,,-71630000,34156000,23654000,-93455000,-93455000,-622000,-842000,,,,-16548000,23654000,117109000,0,5277000,,-71630000,-71630000,52550,IMCR
2017-12-31,60352000,,-64731000,,-48916000,21736000,14256000,-67526000,-67526000,-306000,-248000,,,,-15815000,14256000,81782000,0,2795000,,-48916000,-48916000,52550,IMCR
2016-12-31,46035000,,-31224000,,-23141000,3749000,16470000,-32490000,-32490000,-824000,-248000,,,,-8083000,16470000,48960000,0,1266000,,-23141000,-23141000,52550,IMCR
2019-12-31,,,-47111000,,-47057000,14289000,-31375000,-45664000,-45664000,,-2563000,,,,-54000,3049000,48713000,34424000,-1447000,,-47057000,-47057000,52551,INFI
2018-12-31,,,-11253000,,-11253000,14248000,2319000,-11929000,-11929000,,-93000,,,,0,22146000,34075000,19827000,676000,,-11253000,-11253000,52551,INFI
2017-12-31,,,-42550000,,-41830000,21615000,-14830000,-36445000,-36445000,,-1010000,,,,-720000,6000000,42445000,20830000,-6105000,,-41830000,-41830000,52551,INFI
2016-12-31,,,-30101000,,-30101000,34619000,-87288000,-121907000,-121907000,,-1225000,,,,0,18723000,140630000,106011000,91806000,,-30101000,-30101000,52551,INFI
2020-12-31,,,529600000,97000000,402500000,5268800000,6196700000,701500000,701500000,,-52800000,,,,106900000,8900100000,8198600000,2703400000,-171900000,,422700000,402500000,52552,JLL
2019-12-31,,,697600000,95200000,535300000,5816100000,6914900000,896400000,896400000,,-56400000,,,,159700000,10030600000,9134200000,3115700000,-198800000,,537900000,534400000,52552,JLL
2018-12-31,,,706000000,43000000,484500000,5209200000,6138600000,743300000,743300000,,-51100000,,,,214300000,9089500000,8346200000,2950900000,-37300000,,491700000,484100000,52552,JLL
2017-12-31,,,535800000,41900000,276400000,4622400000,5366200000,576600000,576600000,,-56200000,,,,256300000,7967400000,7390800000,2601200000,-40800000,,279500000,276000000,52552,JLL
2019-12-31,20473000,,-25741000,,-25741000,3410000,0,-23883000,-23883000,,,,,,0,0,23883000,0,-1858000,,-25741000,-25741000,52554,AKUS
2018-12-31,5644000,,-6013000,,-6013000,1776000,0,-7420000,-7420000,,,,,,0,0,7420000,0,1407000,,-6013000,-6013000,52554,AKUS
2020-12-31,,,841734000,,683451000,1541032000,2474019000,932987000,932987000,,-111937000,,,,158283000,6683760000,5750773000,4209741000,-91253000,,683451000,683451000,52558,DOV
2019-12-31,,,843009000,,677918000,1572388000,2629848000,1057460000,1057460000,,-125818000,,,,165091000,7136397000,6078937000,4506549000,-214451000,,677918000,677918000,52558,DOV
2018-12-31,,,725378000,,570267000,1675135000,2576477000,901342000,901342000,,-130972000,,,,134233000,6992118000,6090776000,4415641000,-175964000,-20878000.0,591145000,570267000,52558,DOV
2017-12-31,,,875815000,,811665000,1682590000,2545705000,863115000,863115000,,-144948000,,,,129152000,6820886000,5957771000,4275181000,12700000,65002000.0,746663000,811665000,52558,DOV
2019-12-31,,,341733971,,341733971,13234251,22944169,9709918,9709918,,,,,,0,22944169,13234251,0,332024053,,341733971,341733971,52562,USA
2018-12-31,,,-58090290,,-58090290,13277942,22847003,9569061,9569061,,,,,,0,22847003,13277942,0,-67659351,,-58090290,-58090290,52562,USA
2017-12-31,,,251264499,,251264499,12577714,20582778,8005064,8005064,,,,,,0,20582778,12577714,0,243259435,,251264499,251264499,52562,USA
2016-12-31,,,86973808,,86973808,11871772,20225233,8353461,8353461,,,,,,0,20225233,11871772,0,78620347,,86973808,86973808,52562,USA
2019-12-31,,,367116000,,301699000,37014000,517736000,383392000,383392000,,-29335000,,,,65417000,1268309000,884917000,750573000,-16276000,,301699000,301699000,52564,HCC
2018-12-31,,,470973000,,696787000,36626000,652990000,521355000,521355000,1800000.0,-37314000,,,,-225814000,1379807000,858452000,726817000,-50382000,,696787000,696787000,52564,HCC
2017-12-31,,,416454000,,455046000,36453000,542740000,436274000,436274000,-5400000.0,-6947000,,,,-38592000,1163692000,727418000,620952000,-19820000,,455046000,455046000,52564,HCC
2016-12-31,,,-111453000,,-111489000,35675000,27932000,-84114000,-84114000,-5400000.0,-18273000,,,,36000,369017000,453131000,341085000,-27339000,,-111489000,-49673000,52564,HCC
2020-12-31,,,-78228,,-78228,76128,0,-78228,-78228,2100,,,,,0,0,78228,0,0,,-78228,-78228,52565,FWAA
2020-12-31,223000000,,-59000000,3000000,-79000000,1002000000,1674000000,449000000,449000000,,-218000000,,,,-53000000,6207000000,5758000000,4533000000,-508000000,-72000000,-6000000,-110000000,52567,NCR
2019-12-31,253000000,,341000000,3000000,564000000,1099000000,1942000000,590000000,590000000,,-197000000,,,,-273000000,6915000000,6325000000,4973000000,-249000000,-50000000,614000000,454000000,52567,NCR
2018-12-31,242000000,,39000000,18000000,-88000000,887000000,1777000000,648000000,648000000,,-168000000,,,,73000000,6405000000,5757000000,4628000000,-609000000,-52000000,-34000000,-137000000,52567,NCR
2017-12-31,237000000,,482000000,18000000,232000000,919000000,1866000000,710000000,710000000,,-163000000,,,,242000000,6516000000,5806000000,4650000000,-228000000,-5000000,240000000,123000000,52567,NCR
2019-12-31,156634000,,-1371858000,10228000,-1462799000,1355408000,604920000,-891232000,-891232000,-15890000,-48208000,,,,85864000,2175378000,3066610000,1570458000,-480626000,,-1457722000,-1462799000,52570,SE
2018-12-31,67529000,,-956946000,3684000,-961241000,940630000,14758000,-983602000,-983602000,-9799000,-31295000,,,,4088000,826968000,1810570000,812210000,26656000,,-961034000,-961241000,52570,SE
2017-12-31,29323000,,-550421000,6106000,-560485000,562920000,87312000,-501434000,-501434000,-3497000,-26501000,,,,10745000,414190000,915624000,326878000,-48987000,,-561166000,-560485000,52570,SE
2016-12-31,20809000,,-216409000,20000,-222867000,294187000,113072000,-199821000,-199821000,-2103000,-23000,,,,8546000,345670000,545491000,232598000,-16588000,,-224955000,-222867000,52570,SE
2020-02-29,,,34503256,,34503256,1218399,10033482,8815083,8815083,,,,,,0,10033482,1218399,0,25688173,,34503256,34503256,52571,VBF
2019-02-28,,,3801892,,3801892,1244803,10593464,9348661,9348661,,,,,,0,10593464,1244803,0,-5546769,,3801892,3801892,52571,VBF
2018-02-28,,,7440782,,7440782,1252104,10549022,9296918,9296918,,,,,,0,10549022,1252104,0,-1856136,,7440782,7440782,52571,VBF
2017-02-28,,,22773969,,22773969,1205783,10668822,9463039,9463039,,,,,,0,10668822,1205783,0,13310930,,22773969,22773969,52571,VBF
2020-10-31,,,4890000000,181000000,3790000000,9585000000,16252000000,0,5566000000,1101000000,,,,,1098000000,16252000000,10686000000,0,-676000000,,3792000000,3668000000,52573,CM
2019-10-31,,,6469000000,186000000,5096000000,9380000000,17325000000,0,6639000000,1303000000,,,,,1348000000,17325000000,10686000000,0,-170000000,,5121000000,4985000000,52573,CM
2018-10-31,,,6706000000,173000000,5267000000,9150000000,16964000000,0,6706000000,1105000000,,,,,1422000000,16964000000,10258000000,0,0,,5284000000,5178000000,52573,CM
2017-10-31,,,5880000000,202000000,4699000000,8478000000,15451000000,0,5880000000,1088000000,,,,,1162000000,15451000000,9571000000,0,0,,4718000000,4647000000,52573,CM
2020-12-31,,,-5112377,,-5302800,,-6220070,-6220070,-6220070,,,,,,190423,0,6220070,6220070,1107693,,-5302800,-5302800,52574,CIIC
2019-12-31,,,194364,,124364,,-367116,-367116,-367116,,,,,,70000,0,367116,367116,561480,,124364,124364,52574,CIIC
2019-12-31,,,6205367,99500,6248890,8404311,16267774,0,6205367,1658096,,,,,-43523,16267774,10062407,0,0,,6248890,2664098,52578,LFT
2018-12-31,,,-3949717,99500,-5471462,8971488,4991579,0,-3949717,-30192,,,,,1521745,4991579,8941296,0,0,,-5471462,-9000050,52578,LFT
2017-12-31,,,4706961,99500,4706961,12002970,18053369,0,4706961,1343438,,,,,0,18053369,13346408,0,0,,4706961,1184925,52578,LFT
2016-12-31,,,-10426645,99500,-10426645,13284931,5166491,0,-10426645,2308205,,,,,0,5166491,15593136,0,0,,-10426645,-13948681,52578,LFT
2020-12-31,,,-620184000,,-428700000,85059000,-178353000,-808259000,-808259000,355186000,-118525000,,,,-191484000,1810022000,2618281000,1988375000,188075000,,-428700000,-428700000,52579,SAVE
2019-12-31,,,436426000,,335255000,153770000,1326216000,519114000,519114000,491432000,-88879000,,,,101171000,3830536000,3311422000,2504320000,-82688000,,335255000,335255000,52579,SAVE
2018-12-31,,,204976000,,155749000,137001000,1101393000,449415000,449415000,379536000,-73936000,,,,49227000,3323034000,2873619000,2221641000,-244439000,,155749000,155749000,52579,SAVE
2017-12-31,,,349686000,,415522000,113472000,949211000,401622000,401622000,347820000,-43509000,,,,-65836000,2643552000,2241930000,1694341000,-51936000,,415522000,415522000,52579,SAVE
2020-12-31,,,-217000000,58500000,-111500000,557800000,1192500000,97800000,97800000,,-271100000,,,,-110500000,1738100000,1640300000,545600000,-314800000,,-106500000,-175600000,52580,DNB
2019-12-31,,,-671700000,57800000,-560000000,647200000,965400000,-164200000,-164200000,,-303500000,,,,-118200000,1413900000,1578100000,448500000,-507500000,,-553500000,-598400000,52580,DNB
2018-12-31,,,375900000,15900000,288100000,612400000,1153000000,451900000,451900000,,-54400000,,,,81600000,1716400000,1264500000,563400000,-76000000,,294300000,288100000,52580,DNB
2017-12-31,,,325500000,16100000,140900000,670400000,1169200000,419100000,419100000,,-59700000,,,,179700000,1742500000,1323400000,573300000,-93600000,-800000.0,145800000,140900000,52580,DNB
2019-12-28,,,3575000,,5742000,1192204000,1243830000,51626000,51626000,,-34548000,,,,-2342000,8536065000,8484439000,7292235000,-48051000,-175000,5917000,5742000,52581,SPTN
2018-12-29,,,40698000,,33572000,997570000,1110406000,112836000,112836000,,-30483000,,,,6907000,8064552000,7951716000,6954146000,-72138000,-219000,33791000,33572000,52581,SPTN
2017-12-30,,,-131644000,,-52845000,1014665000,1144909000,130244000,130244000,,-25343000,,,,-79027000,7963799000,7833555000,6818890000,-261888000,-228000,-52617000,-52845000,52581,SPTN
2016-12-31,,,89963000,,56828000,963570000,1111494000,147924000,147924000,,-19082000,,,,32907000,7561084000,7413160000,6449590000,-57961000,-228000,57056000,56828000,52581,SPTN
2020-12-31,,,6051000000,630000000,4959000000,11360000000,19420000000,0,6227000000,1833000000,,,,,1066000000,19420000000,13193000000,0,-176000000,,4985000000,4621000000,52583,USB
2019-12-31,,,8594000000,630000000,6914000000,10999000000,21140000000,0,8762000000,1379000000,,,,,1648000000,21140000000,12378000000,0,-168000000,,6946000000,6583000000,52583,USB
2018-12-31,,,8678000000,628000000,7096000000,10594000000,20813000000,0,8839000000,1380000000,,,,,1554000000,20813000000,11974000000,0,-161000000,,7124000000,6784000000,52583,USB
2017-12-31,,,7517000000,626000000,6218000000,10086000000,19883000000,0,7692000000,2105000000,,,,,1264000000,19883000000,12191000000,0,-175000000,,6253000000,5913000000,52583,USB
2020-12-31,997000000,,-4267000000,1035000000,-3990000000,3671000000,7726000000,3055000000,3055000000,3000000,-963000000,,,,-168000000,16659000000,13604000000,8933000000,-7322000000,,-4099000000,-3990000000,52584,TEVA
2019-12-31,1010000000,,-1279000000,1091000000,-999000000,3806000000,7536000000,2716000000,2716000000,4000000,-881000000,,,,-278000000,16887000000,14171000000,9351000000,-3995000000,,-1001000000,-999000000,52584,TEVA
2018-12-31,1213000000,,-2667000000,1087000000,-2150000000,4214000000,8296000000,2947000000,2947000000,-78000000,-920000000,,,,-195000000,18271000000,15324000000,9975000000,-5614000000,,-2472000000,-2399000000,52584,TEVA
2017-12-31,1778000000,,-18382000000,1386000000,-16265000000,4846000000,10683000000,3979000000,3979000000,80000000,-875000000,,,,-1933000000,21853000000,17874000000,11170000000,-22361000000,,-16449000000,-16525000000,52584,TEVA
2019-12-31,,,3909000,,7016000,9077000,12516000,3439000,3439000,,,,,,-3107000,31897000,28458000,19381000,470000,,7016000,7016000,52586,LGL
2018-12-31,,,1570000,,1405000,8229000,9659000,1430000,1430000,,,,,,165000,24870000,23440000,15211000,140000,,1405000,1405000,52586,LGL
2017-12-31,,,219000,,117000,7465000,7741000,276000,276000,,-11000.0,,,,102000,22402000,22126000,14661000,-57000,,117000,117000,52586,LGL
2016-12-31,,,-17000,,148000,7156000,7033000,-123000,-123000,,-22000.0,,,,-165000,20891000,21014000,13858000,106000,,148000,148000,52586,LGL
2020-12-31,,,241416000,71068000,228284000,61180000,570962000,356311000,356311000,-1660000,-102771000,,,,0,1095618000,739307000,524656000,-114895000,,241416000,228268000,52587,ELS
2019-12-31,,,295922000,72078000,279139000,55663000,558548000,351994000,351994000,-1219000,-104223000,,,,0,1046011000,694017000,487463000,-56072000,,295922000,279123000,52587,ELS
2018-12-31,,,226386000,71792000,212612000,54321000,524650000,333933000,333933000,-813000,-104993000,,,,0,991592000,657659000,466942000,-107547000,,226386000,212596000,52587,ELS
2017-12-31,,,210377000,68088000,197589000,46637000,485573000,315604000,315604000,-354000,-100570000,,,,0,929077000,613473000,443504000,-105227000,,210377000,189904000,52587,ELS
2019-12-31,81664000,,368485000,6139000,253610000,1808664000,2080975000,258608000,258608000,-67961000,-50610000,,,,105243000,3320937000,3062329000,1239962000,109877000,,263242000,253610000,52588,WEI
2018-12-31,139318000,,764259000,8526000,601619000,2358467000,3225350000,798543000,798543000,-70978000,-161735000,,,,159629000,3976922000,3178379000,751572000,-34284000,,604630000,556789000,52588,WEI
2017-12-31,100966000,,668024000,8526000,474821000,2375524000,2897729000,623933000,623933000,-202694000,-44005000,,,,193203000,3381792000,2757859000,484063000,44091000,,474821000,350662000,52588,WEI
2016-12-31,56142000,,396159000,2000000,291029000,1181766000,1467532000,381294000,381294000,-151670000,-2439000,,,,105130000,1612149000,1230855000,144617000,14865000,,291029000,125740000,52588,WEI
2020-02-01,,,1098700000,,827000000,7367600000,8951900000,1584300000,1584300000,,-161800000,,,,271700000,23610800000,22026500000,14658900000,-485600000,,827000000,827000000,52589,DLTR
2019-02-02,,,-1309000000,,-1590800000,5104500000,6947500000,1843000000,1843000000,,-213000000,,,,281800000,22823300000,20980300000,15875800000,-3152000000,,-1590800000,-1590800000,52589,DLTR
2018-02-03,,,1704000000,,1714300000,4998700000,7021900000,2004700000,2004700000,,-301800000,,,,-10300000,22245500000,20240800000,15223600000,-300700000,,1714300000,1714300000,52589,DLTR
2017-01-28,,,1329400000,,896200000,5969100000,7677600000,1708500000,1708500000,,-372900000,,,,433200000,20719200000,19010700000,13041600000,-379100000,,896200000,896200000,52589,DLTR
2020-12-31,,,6980000000,,5349000000,,11433000000,7878000000,7878000000,1345000000,-1141000000,,,,1631000000,19533000000,11655000000,8100000000,-898000000,,5349000000,5349000000,52591,UNP
2019-12-31,,,7747000000,,5919000000,,11867000000,8591000000,8591000000,1060000000,-1050000000,,,,1828000000,21708000000,13117000000,9841000000,-844000000,,5919000000,5919000000,52591,UNP
2018-12-31,,,7741000000,,5966000000,-13000000.0,11743000000,8530000000,8530000000,1022000000,-870000000,,,,1775000000,22832000000,14302000000,11089000000,-789000000,,5966000000,5966000000,52591,UNP
2017-12-31,,,7632000000,,10712000000,-24000000.0,11200000000,8147000000,8147000000,948000000,-719000000,,,,-3080000000,21240000000,13093000000,10040000000,-515000000,,10712000000,10712000000,52591,UNP
2020-03-31,8597000,,-5450000,,-5610000,43694000,47761000,-5287000,-5287000,,,,,,160000,114117000,119404000,66356000,-163000,,-5610000,-5610000,52592,ITI
2019-03-31,7819000,,-7780000,,-7816000,38471000,38606000,-7959000,-7959000,,,,,,36000,99123000,107082000,60517000,179000,,-7816000,-7816000,52592,ITI
2018-03-31,7945000,,-5586000,,-3526000,37400000,39831000,-5602000,-5602000,,,,,,-1818000,103729000,109331000,63898000,16000,242000.0,-3768000,-3526000,52592,ITI
2017-03-31,6877000,,-5231000,,-4826000,33313000,37402000,-3069000,-3069000,,,,,,-44000,95982000,99051000,58580000,-2162000,361000.0,-5187000,-4826000,52592,ITI
2019-12-31,,,-411818000,118077000,-280601000,283863000,400825000,-174724000,-174724000,171492000,-51583000,,,,-41541000,1615222000,1789946000,1214397000,-237094000,84637000,-370277000,-280601000,52593,GSM
2018-12-31,,,35568000,116145000,43661000,337087000,795325000,107587000,107587000,236814000,-42761000,,,,20459000,2242002000,2134415000,1446677000,-72019000,9464000,15109000,43661000,52593,GSM
2017-12-31,,,-14997000,121734000,-678000,300035000,689001000,72260000,72260000,216304000,-52361000,,,,-14225000,1732276000,1660016000,1043275000,-87257000,-5050000,-772000,-678000,52593,GSM
2016-12-31,,,-405308000,125556000,-338427000,275399000,532625000,-86222000,-86222000,217771000,-25844000,,,,-46695000,1576037000,1662259000,1043412000,-319086000,-5050000,-358613000,-338427000,52593,GSM
2020-12-31,,,632700000,,461000000,537300000,1386300000,798300000,798300000,50700000,-93500000,,,,171700000,6658200000,5859900000,5271900000,-165600000,,461000000,457400000,52594,PKG
2019-12-31,,,917000000,,696400000,565500000,1644000000,1071800000,1071800000,6700000,-110600000,,,,220600000,6964300000,5892500000,5320300000,-154800000,,696400000,691200000,52594,PKG
2018-12-31,,,970500000,,738000000,538500000,1660300000,1115100000,1115100000,6700000,-89800000,,,,232500000,7014600000,5899500000,5354300000,-144600000,,738000000,732300000,52594,PKG
2017-12-31,,,828600000,,668600000,521200000,1470800000,945700000,945700000,3900000,-96900000,,,,160000000,6444900000,5499200000,4974100000,-117100000,,668600000,663000000,52594,PKG
2020-06-30,,,133529000,,119554000,58190000,222691000,162699000,162699000,1802000,-25248000,,,,13975000,548988000,386289000,326297000,-29170000,,119554000,119554000,52595,LND
2019-06-30,,,199798000,,177079000,49348000,234660000,183929000,183929000,1383000,-18171000,,,,22719000,500722000,316793000,266062000,15869000,,177079000,177079000,52595,LND
2018-06-30,,,152257000,,126338000,45032000,155503000,110182000,110182000,289000,-28768000,,,,25919000,284095000,173913000,128592000,42075000,,126338000,126338000,52595,LND
2017-06-30,,,33259000,,27310000,37617000,51444000,13138000,13138000,689000,-8963000,,,,5949000,173627000,160489000,122183000,20121000,,27310000,27310000,52595,LND
2019-12-31,,,542000000,8000000,385000000,791000000,1733000000,837000000,837000000,-11000000,-114000000,,,,156000000,3456000000,2619000000,1723000000,-295000000,,386000000,385000000,52596,IHG
2018-12-31,,,482000000,8000000,349000000,738000000,1573000000,734000000,734000000,-14000000,-95000000,,,,132000000,3166000000,2432000000,1593000000,-252000000,,350000000,349000000,52596,IHG
2017-12-31,,,653000000,7000000,534000000,709000000,1556000000,746000000,746000000,-11000000,-91000000,,,,118000000,2972000000,2226000000,1416000000,-93000000,,535000000,534000000,52596,IHG
2016-12-31,,,632000000,8000000,456000000,345000000,1154000000,743000000,743000000,-9000000,-86000000,,,,173000000,2866000000,2123000000,1712000000,-111000000,,459000000,456000000,52596,IHG
2019-12-31,,,-105152000,,-106157000,119876000,417624000,5598000,5598000,,-21856000,,,,1005000,1821556000,1815958000,1403932000,-110750000,,-106157000,-106157000,52599,NEX
2018-12-31,,,63601000,,59331000,113810000,476460000,103505000,103505000,,-33504000,,,,4270000,2137006000,2033501000,1660546000,-39904000,,59331000,59331000,52599,NEX
2017-12-31,,,-28073000,,-28223000,84853000,259520000,15387000,15387000,,-59223000,,,,150000,1542081000,1526694000,1282561000,-43460000,,-28223000,-28223000,52599,NEX
2016-12-31,,,-187087000,,-187087000,31755000,18128000,-114606000,-114606000,,-38299000,,,,0,420570000,535176000,402442000,-72481000,,-187087000,-187087000,52599,NEX
2019-12-31,,,67031000,,53711000,49325000,119425000,68485000,68485000,,,,,,13320000,469333000,400848000,349908000,-1454000,,53711000,53711000,52600,AAON
2018-12-31,,,55500000,,42329000,46137000,103533000,56272000,56272000,,,,,,13171000,433947000,377675000,330414000,-772000,,42329000,42329000,52600,AAON
2017-12-31,,,74624000,,53830000,47748000,123651000,75004000,75004000,,,,,,20794000,405232000,330228000,281581000,-380000,,53830000,53830000,52600,AAON
2016-12-31,,,79991000,,53376000,37385000,118080000,79944000,79944000,,,,,,26615000,383977000,304033000,265897000,47000,,53376000,53376000,52600,AAON
2019-12-31,,,4393000000,203000000,2925000000,170000000,16984000000,0,4593000000,11848000000,,,,,1387000000,17171000000,12578000000,187000000,-200000000,,3006000000,2459000000,52601,LYG
2018-12-31,,,5960000000,274000000,4408000000,197000000,17360000000,0,6070000000,10650000000,,,,,1454000000,17550000000,11480000000,190000000,-110000000,,4506000000,3975000000,52601,LYG
2017-12-31,,,5275000000,237000000,3559000000,208000000,17510000000,0,5077000000,11788000000,,,,,1626000000,17741000000,12664000000,231000000,198000000,,3649000000,3144000000,52601,LYG
2016-12-31,,,3888000000,440000000,2063000000,198000000,16411000000,0,4212000000,11559000000,,,,,1724000000,16598000000,12386000000,187000000,-324000000,,2164000000,1742000000,52601,LYG
2020-06-30,,,33278000,,22737000,34638000,73671000,0,33697000,5336000,,,,,10541000,73671000,39974000,0,-419000,,22737000,22737000,52602,NBN
2019-06-30,,,19615000,,13884000,32724000,67128000,0,29063000,5341000,,,,,5731000,67128000,38065000,0,-9448000,,13884000,13884000,52602,NBN
2018-06-30,,,23197000,,16166000,30818000,58927000,0,23947000,4162000,,,,,7031000,58927000,34980000,0,-750000,,16166000,16166000,52602,NBN
2017-06-30,,,20138000,,12339000,30510000,55927000,0,20873000,4544000,,,,,7799000,55927000,35054000,0,-735000,,12339000,12339000,52602,NBN
2019-12-31,75356000,,-17079000,,-21826000,71137000,180611000,27127000,27127000,6991000,-22627000,,,,4747000,792195000,765068000,611584000,-44206000,,-21826000,-21826000,52604,MX
2018-12-31,78039000,,749000,,-3900000,72639000,198096000,47418000,47418000,6991000,-22282000,,,,4649000,750898000,703480000,552802000,-46669000,,-3900000,-3900000,52604,MX
2017-12-31,70523000,,86091000,,84936000,81775000,187893000,35595000,35595000,6991000,-21559000,,,,1155000,679672000,644077000,491779000,50496000,,84936000,84936000,52604,MX
2016-12-31,72180000,,-25871000,,-29615000,83549000,156226000,497000,497000,6991000,-16238000,,,,3744000,687969000,687472000,531743000,-26368000,,-29615000,-29615000,52604,MX
2020-01-31,89675000,,-118344000,,-118589000,152681000,122725000,-119631000,-119631000,,-78000,,,,245000,142606000,262237000,19881000,1287000,,-118589000,-118589000,52608,ASAN
2019-01-31,42585000,,-50900000,,-50928000,72366000,62938000,-52013000,-52013000,,-78000,,,,28000,76770000,128783000,13832000,1113000,,-50928000,-50928000,52608,ASAN
2019-12-31,129651820,,-51998954,,-52929508,143875963,212676734,-60851049,-60851049,,,,,,930554,758887906,819738955,546211172,8852095,,-52929508,-683935071,52609,BLCT
2018-12-31,93985275,,-144560198,,-144560198,168082672,112907077,-149160870,-149160870,,,,,,0,501291812,650452682,388384735,4600672,,-144560198,-382710208,52609,BLCT
2019-12-31,,,334763000,197538000,324042000,98609000,285874000,115886000,115886000,13120000,-183919000,,,,438000,494445000,378559000,208571000,218877000,,334325000,291547000,52613,STAR
2018-12-31,,,-17511000,201137000,-32262000,86835000,302808000,151234000,151234000,6040000,-183751000,,,,815000,809215000,657981000,506407000,-168745000,,-18326000,-64757000,52613,STAR
2017-12-31,,,50903000,34546000,175682000,98882000,246112000,78213000,78213000,19984000,-194686000,,,,-948000,568817000,490604000,322705000,-27310000,128357000.0,51851000,110924000,52613,STAR
2016-12-31,,,71746000,48151000,95306000,84027000,312321000,169636000,169636000,6998000,-221398000,,,,-10166000,499336000,329700000,187015000,-97890000,18270000.0,81912000,43972000,52613,STAR
2019-12-31,54619000,,-78326000,,-78326000,20553000,18000,-75154000,-75154000,,-187000,,,,0,18000,75172000,0,-3172000,,-78326000,-91040000,52614,BEAM
2018-12-31,33873000,,-116738000,,-115257000,11868000,0,-45741000,-45741000,,-187000,,,,0,0,45741000,0,-70997000,,-116738000,-117325000,52614,BEAM
2017-12-31,6391636,,-8729454,,-8729454,2204727,0,-8596363,-8596363,,-187000,,,,0,0,8596363,0,-133091,,-8729454,-10567635,52614,BEAM
2019-12-31,,,34832000,115890000,14350000,14308000,64201000,37156000,37156000,,-2489000,,,,3918000,68463000,31307000,4262000,-2324000,,30914000,14235000,52616,FLMN
2018-12-31,,,102260000,127029000,90125000,11912000,93512000,63182000,63182000,1456000.0,-2350000,,,,3292000,98655000,35473000,5143000,39078000,2139000.0,98968000,9166000,52616,FLMN
2017-12-31,,,72695000,629000,75518000,14718000,90730000,43966000,43966000,-1791000.0,-2746000,,,,0,95972000,52006000,5242000,28729000,2978000.0,72695000,75518000,52616,FLMN
2016-12-31,,,14758000,636000,14711000,12719000,66433000,17031000,17031000,843000.0,-3096000,,,,0,70964000,53933000,4531000,-2273000,22000.0,14758000,14711000,52616,FLMN
2019-12-31,154000000,,768000000,,604000000,343000000,1394000000,905000000,905000000,-8000000,-134000000,,,,164000000,2698000000,1793000000,1304000000,-126000000,,604000000,604000000,52617,ALSN
2018-12-31,131000000,,805000000,,639000000,352000000,1422000000,939000000,939000000,-8000000,-121000000,,,,166000000,2713000000,1774000000,1291000000,-134000000,,639000000,639000000,52617,ALSN
2017-12-31,105000000,,527000000,,504000000,342000000,1131000000,684000000,684000000,-8000000,-103000000,,,,23000000,2262000000,1578000000,1131000000,-157000000,,504000000,504000000,52617,ALSN
2016-12-31,88000000,,341000000,,215000000,324000000,864000000,452000000,452000000,-8000000,-101000000,,,,126000000,1840000000,1388000000,976000000,-111000000,,215000000,215000000,52617,ALSN
2019-12-31,,,2294000000,2075000000,2069000000,2762000000,7392000000,3283000000,3283000000,,-720000000,,,,81000000,11144000000,7861000000,3752000000,-989000000,,2213000000,1845000000,52621,DISCK
2018-12-31,,,1022000000,2131000000,594000000,2510000000,6643000000,2735000000,2735000000,,-743000000,,,,341000000,10553000000,7818000000,3910000000,-1713000000,,681000000,529000000,52621,DISCK
2017-12-31,,,-137000000,413000000,-337000000,1689000000,4249000000,2230000000,2230000000,7000000.0,-458000000,,,,176000000,6873000000,4643000000,2624000000,-2367000000,,-313000000,-296000000,52621,DISCK
2016-12-31,,,1671000000,243000000,1194000000,1690000000,4130000000,2122000000,2122000000,-4000000.0,-353000000,,,,453000000,6497000000,4375000000,2367000000,-451000000,,1218000000,1055000000,52621,DISCK
2019-12-31,2922279,,-5539790,,-5539790,9055452,7384053,-4593678,-4593678,,-955166,,,,0,11216937,15810615,3832884,-946112,,-5539790,-5539790,52622,CLPT
2018-12-31,2310139,,-6163469,,-6163469,7857826,4920197,-5247768,-5247768,,-980383,,,,0,7353266,12601034,2433069,-915701,,-6163469,-6163469,52622,CLPT
2017-12-31,2813733,,-7167353,,-7167353,8002821,4480717,-6335837,-6335837,,-872926,,,,0,7379525,13715362,2898808,-831516,,-7167353,-7167353,52622,CLPT
2016-12-31,2628179,,-8069895,,-8069895,7967250,3106691,-7488738,-7488738,,-1051258,,,,0,5749454,13238192,2642763,-581157,,-8069895,-8069895,52622,CLPT
2019-12-31,,,11686000,-22000000,3567000,19042000,35154000,13456000,13456000,,-2387000,,,,1304000,76869000,63413000,41715000,-1770000,,10382000,3567000,52623,GSHD
2018-12-31,,,-18218000,-16703000,-8903000,13060000,1470000,-14352000,-14352000,,-4266000,,,,449000,59726000,74078000,58256000,-3866000,,-18667000,-8903000,52623,GSHD
2017-12-31,,,8678000,-16703000,0,8597000,17924000,7368000,7368000,,-2474000,,,,0,42468000,35100000,24544000,1310000,,-18667000,-8903000,52623,GSHD
2016-12-31,,,4722527,-16703000,4722527,5731599,11915066,5036143,5036143,,-413042,,,,0,31384522,26348379,19469456,-313616,,4722527,4722527,52623,GSHD
2019-12-31,31342000,,-40333000,854000,-38085000,8965000,0,-40307000,-40307000,,-206000,,,,0,0,40307000,0,-26000,,-40333000,-38085000,52626,BYSI
2018-12-31,51618000,,-57474000,-1616000,-54869000,5927000,0,-57545000,-57545000,,-206000,,,,0,0,57545000,0,71000,,-57474000,-54869000,52626,BYSI
2017-12-31,88928000,,-96388000,960000,-91763000,9053000,0,-97981000,-97981000,,-206000,,,,0,0,97981000,0,1593000,,-96388000,-91763000,52626,BYSI
2016-12-31,10437000,,-12545000,147000,-12010000,1931000,0,-12368000,-12368000,,-206000,,,,0,0,12368000,0,-177000,,-12545000,-12010000,52626,BYSI
2020-12-31,,,130372000,,97061000,244776000,459017000,173373000,173373000,,-43001000,,,,33311000,2486597000,2313224000,2027580000,-43001000,,97061000,97061000,52627,PATK
2019-12-31,,,117826000,,89566000,234921000,422871000,152042000,152042000,,-36616000,,,,28260000,2337082000,2185040000,1914211000,-34216000,,89566000,89566000,52627,PATK
2018-12-31,,,151979000,,119832000,203238000,415866000,178415000,178415000,,-26436000,,,,32147000,2263061000,2084646000,1847195000,-26436000,,119832000,119832000,52627,PATK
2017-12-31,,,113110000,,85718000,137641000,278915000,121900000,121900000,,-8790000,,,,27392000,1635653000,1513753000,1356738000,-8790000,,85718000,85718000,52627,PATK
2020-12-31,,,2172000000,,1592000000,13000000,5857000000,3226000000,3226000000,,-831000000,,,,580000000,13916000000,10690000000,8059000000,-1054000000,,1592000000,1592000000,52629,RCI
2019-12-31,,,2755000000,,2043000000,11000000,6212000000,3713000000,3713000000,,-788000000,,,,712000000,15073000000,11360000000,8861000000,-958000000,,2043000000,2043000000,52629,RCI
2019-01-01,,,2817000000,,2059000000,14000000,5983000000,3758000000,3758000000,,-689000000,,,,758000000,15096000000,11338000000,9113000000,-941000000,,2059000000,2059000000,52629,RCI
2017-12-31,,,2530000000,,1845000000,12000000,5502000000,3348000000,3348000000,,-722000000,,,,685000000,14369000000,11021000000,8867000000,-818000000,,1845000000,1845000000,52629,RCI
2020-06-30,8502000,,-10594000,,-10738000,20771000,27155000,-4155000,-4155000,,-239000,,,,144000,59878000,64033000,32723000,-6439000,,-10738000,-10738000,52630,LTRX
2019-06-30,8168000,,-267000,,-408000,16762000,26273000,1343000,1343000,,-239000,,,,141000,46890000,45547000,20617000,-1610000,,-408000,-408000,52630,LTRX
2018-06-30,6933000,,778000,,680000,17163000,25406000,1310000,1310000,,-18000,,,,98000,45580000,44270000,20174000,-532000,,680000,680000,52630,LTRX
2017-06-30,7151000,,-209000,,-277000,16366000,23580000,63000,63000,,-23000,,,,68000,44730000,44667000,21150000,-272000,,-277000,-277000,52630,LTRX
2019-12-31,,,235350,,6469049,22171598,22185812,9214,9214,22176598,-38440,,,,-15269,50906179,50896965,28720367,452272,6218430,250619,6469049,52635,JCS
2018-12-31,,,-4526619,,-6791735,22360765,17622117,-4750648,-4750648,27501367,-38355,,,,404386,42369232,47119880,24747115,395679,-1860730,-4931005,-6791735,52635,JCS
2017-12-31,,,-11860135,,-11825632,28669138,20836239,-7862899,-7862899,27501367,-71428,,,,-34503,82322618,90185517,61486379,-3997236,-1860730,-11825632,-11825632,52635,JCS
2016-12-31,,,-7856598,,-8113548,35111924,26581541,-8604383,-8604383,27501367,-119627,,,,256950,99352934,107957317,72771393,747785,-1860730,-8113548,-8113548,52635,JCS
2019-12-31,55037000,,125899000,713000,103129000,150324000,330749000,125388000,125388000,,-11649000,,,,22798000,1858745000,1733357000,1527996000,511000,,103101000,103129000,52637,SCL
2018-12-31,54263000,,137769000,760000,111117000,135648000,339349000,149438000,149438000,,-12600000,,,,26664000,1993857000,1844419000,1654508000,-11669000,,111105000,111117000,52637,SCL
2017-12-31,53696000,,146882000,818000,100774000,130697000,347457000,163064000,163064000,,-13519000,,,,46139000,1925007000,1761943000,1577550000,-16182000,,100743000,100774000,52637,SCL
2016-12-31,55776000,,113816000,1312000,86191000,149536000,343740000,138428000,138428000,,-14452000,,,,27618000,1766166000,1627738000,1422426000,-24612000,,86198000,86191000,52637,SCL
2019-12-31,,,-90315000,,-60708000,461019000,542634000,82454000,82454000,-5136000,-133507000,,,,-29607000,989683000,907229000,447049000,-172769000,,-60708000,-60708000,52639,VSTA
2018-12-31,,,14760000,,-4160000,544196000,705832000,163976000,163976000,-11472000,-129712000,,,,18920000,985444000,821468000,279612000,-149216000,,-4160000,-4160000,52639,VSTA
2019-12-31,,,49233492,,49233492,3324123,6511409,3185978,3185978,1308,-352,,,,0,6511409,3325431,0,46047514,,49233492,45413067,52640,GGT
2018-12-31,,,-30801528,,-30801528,3306134,4145187,839053,839053,1308,-227,,,,0,4145187,3306134,0,-31640581,,-30801528,-34558668,52640,GGT
2017-12-31,,,51689317,,51689317,3211014,3500623,289862,289862,-253,-2786,,,,0,3500623,3210761,0,51399455,,51689317,49728988,52640,GGT
2016-12-31,,,15819400,,15819400,2641853,4038279,1396426,1396426,-253,-570,,,,0,4038279,2641853,0,14422974,,15819400,14525087,52640,GGT
2020-12-31,,,-10538000,,-2985000,42581000,96608000,30585000,30585000,,-19342000,,,,-7553000,186419000,155834000,89811000,-41123000,,-2985000,-2985000,52643,LGND
2019-12-31,,,796639000,,629302000,41884000,53027000,-3021000,-3021000,,-35745000,,,,167337000,120282000,123303000,67255000,799660000,,629302000,629302000,52643,LGND
2018-12-31,,,173330000,,143321000,37734000,217253000,163727000,163727000,,-48276000,,,,30009000,251453000,87726000,34200000,9603000,,143321000,143321000,52643,LGND
2017-12-31,,,57231000,,12556000,28653000,108849000,68076000,68076000,,-13460000,,,,44675000,141102000,73026000,32253000,-10845000,,12556000,12556000,52643,LGND
2020-11-30,,,-4499596,,-4499596,1076402,3488996,2412594,2412594,,-432849,,,,0,3488996,1076402,0,-6912190,,-4499596,-4499596,52644,DDF
2019-11-30,,,7629259,,7629259,1499679,5031513,3531834,3531834,,-1126431,,,,0,5031513,1499679,0,4097425,,7629259,7629259,52644,DDF
2018-11-30,,,2244455,,2244455,1117965,4332259,3214294,3214294,,-1097000,,,,0,4332259,1117965,0,-969839,,2244455,2244455,52644,DDF
2017-11-30,,,12603481,,12603481,1139198,4591487,3452289,3452289,,-766622,,,,0,4591487,1139198,0,9151192,,12603481,12603481,52644,DDF
2020-02-01,,,682000000,,496000000,4776000000,5592000000,816000000,816000000,,-112000000,,,,186000000,15524000000,14708000000,9932000000,-134000000,,496000000,496000000,52646,JWN
2019-02-02,,,733000000,,564000000,4796000000,5705000000,909000000,909000000,,-119000000,,,,169000000,15860000000,14951000000,10155000000,-176000000,,564000000,564000000,52646,JWN
2018-02-03,,,790000000,,437000000,4662000000,5588000000,926000000,926000000,,-141000000,,,,353000000,15478000000,14552000000,9890000000,-136000000,,437000000,437000000,52646,JWN
2017-01-28,,,684000000,,354000000,4315000000,5317000000,1002000000,1002000000,,-122000000,,,,330000000,14757000000,13755000000,9440000000,-318000000,,354000000,354000000,52646,JWN
2019-12-31,,,301188,,249933,618919,731399,110730,110730,,,,,,51255,811271,700541,79872,190458,,249933,249933,52647,CKX
2018-12-31,,,1465853,,1115060,573532,1062256,486697,486697,,,,,,350793,1194763,708066,132507,979156,,1115060,1115060,52647,CKX
2017-12-31,,,586087,,522863,495040,1002649,506418,506418,,,,,,63224,1144585,638167,141936,79669,,522863,522863,52647,CKX
2016-12-31,,,222311,,170674,508422,696249,187360,187360,,,,,,51637,863402,676042,167153,34951,,170674,170674,52647,CKX
2019-12-31,,,26557000,,21136000,52303000,89601000,0,30609000,6689000,,,,,5421000,89601000,58992000,0,-4052000,,21136000,21136000,52651,STXB
2018-12-31,,,11980000,,9978000,38361000,55344000,0,13991000,2992000,,,,,2002000,55344000,41353000,0,-2011000,,9978000,9978000,52651,STXB
2017-12-31,,,8340000,,4753000,33111000,45742000,0,9967000,2664000,,,,,3587000,45742000,35775000,0,-1627000,,4753000,4730000,52651,STXB
2016-12-31,,,5324000,,3715000,30636000,40205000,0,6737000,2832000,,,,,1609000,40205000,33468000,0,-1413000,,3715000,3628000,52651,STXB
2019-12-31,,,572287000,3539000,402044000,955991000,1600252000,582170000,582170000,,-66890000,,,,165472000,12112153000,11529983000,10511901000,-9883000,,406815000,402044000,52652,PWR
2018-12-31,,,457666000,1294000,293346000,856274000,1479964000,579696000,579696000,,-36945000,,,,161659000,11171423000,10591727000,9691459000,-122030000,,296007000,293346000,52652,PWR
2017-12-31,,,353757000,4058000,314978000,777920000,1241860000,431735000,431735000,,-20946000,,,,35532000,9466478000,9034743000,8224618000,-77978000,,318225000,314978000,52652,PWR
2016-12-31,,,307686000,3275000,198383000,649038000,1013800000,333077000,333077000,,-14887000,,,,107246000,7651319000,7318242000,6637519000,-25391000,-342000.0,200440000,198383000,52652,PWR
2020-12-31,,,224161000,499777000,346894000,5684987000,6997898000,0,340158000,972753000,,,,,-109977000,7415184000,7075026000,417286000,-115997000,,334138000,346894000,52653,BAP
2019-12-31,,,5975408000,508350000,4265304000,5744879000,12323154000,0,6002680000,575595000,,,,,1623077000,12641869000,6639189000,318715000,-49908000,,4352331000,4265304000,52653,BAP
2018-12-31,,,5592214000,426833000,3983865000,5391597000,11537731000,0,5672639000,473495000,,,,,1520909000,11839624000,6166985000,301893000,-80425000,,4071305000,3983865000,52653,BAP
2017-12-31,,,5574934000,497136000,4091753000,5119214000,11191985000,0,5603957000,468814000,,,,,1393286000,11463066000,5859109000,271081000,-29023000,,4181648000,4091753000,52653,BAP
2019-12-31,22563000,,-51255000,,-51255000,5559000,375000,-27747000,-27747000,,-29000,,,,0,375000,28122000,0,-23508000,,-51255000,-51255000,52656,SEEL
2018-12-31,553000,,-3475000,,-3475000,2631000,0,-3184000,-3184000,,-131000,,,,0,0,3184000,0,-68000,-24000.0,-3475000,-3475000,52656,SEEL
2017-12-31,3463000,,-11749000,,321000,7210000,0,-10673000,-10673000,,-83000,,,,0,0,10673000,0,-1076000,12070000.0,-11749000,321000,52656,SEEL
2016-12-31,42857,,-437143,,-437143,394286,0,-437143,-437143,,-83000,,,,0,0,437143,0,0,12070000.0,-437143,-437143,52656,SEEL
2020-12-31,117620000,,-164199000,34438000,-128080000,323219000,309367000,-134850000,-134850000,3378000,-29322000,,,,-108000,391865000,526715000,82498000,-29349000,,-164091000,-128080000,52657,PS
2019-12-31,102902000,,-162756000,63175000,-112658000,291410000,245580000,-148755000,-148755000,23000,-23565000,,,,823000,316910000,465665000,71330000,-14001000,,-163579000,-112658000,52657,PS
2018-12-31,69289000,,-146109000,107167000,-97113000,236827000,169430000,-136702000,-136702000,16000,-6826000,,,,664000,232029000,368731000,62599000,-9407000,,-146773000,-45330000,52657,PS
2017-12-31,49293000,,-96212000,107167000,-96536000,150449000,116996000,-82746000,-82746000,16000,-11665000,,,,324000,166824000,249570000,49828000,-13466000,,-96536000,-160336000,52657,PS
2019-12-31,32858000,,-30218000,,-30218000,6337000,10358000,-29216000,-29216000,379000,-3000,,,,0,11291000,40507000,933000,-1002000,,-30218000,-30218000,52658,IVA
2018-12-31,30824000,,-33014000,,-33014000,6270000,6412000,-32904000,-32904000,2222000,-4000,,,,0,7379000,40283000,967000,-110000,,-33014000,-33014000,52658,IVA
2017-12-31,25730000,,-22361000,,-19083000,5415000,8948000,-22894000,-22894000,697000,-5000,,,,-3278000,9951000,32845000,1003000,533000,,-19083000,-19083000,52658,IVA
2016-12-31,21101518,,-12558676,,-7045045,4255799,13289967,-12058761,-12058761,-8589,-7548,,,,-5513631,14333135,26391896,1043168,-499915,,-7045045,-7045045,52658,IVA
2020-12-31,,,143699000,,106579000,673089000,911139000,195945000,195945000,,-29344000,,,,37120000,1631284000,1435339000,720145000,-52246000,,106579000,106579000,52661,FCFS
2019-12-31,,,224611000,,164618000,717873000,1018347000,258570000,258570000,,-34035000,,,,59993000,1864439000,1605869000,846092000,-33959000,,164618000,164618000,52661,FCFS
2018-12-31,,,205309000,,153206000,683363000,966767000,240443000,240443000,,-29173000,,,,52103000,1780858000,1540415000,814091000,-35134000,,153206000,153206000,52661,FCFS
2017-12-31,,,172312000,,143892000,674664000,947506000,217609000,217609000,,-24035000,,,,28420000,1779822000,1562213000,832316000,-45297000,,143892000,143892000,52661,FCFS
2020-01-31,209895000,,313697000,,301118000,303298000,800712000,287519000,287519000,,,,,,12579000,1104081000,816562000,303369000,26178000,,301118000,301118000,52664,VEEV
2019-01-31,158783000,,238643000,,229832000,235280000,616929000,222866000,222866000,,,,,,8811000,862210000,639344000,245281000,15777000,,229832000,229832000,52664,VEEV
2018-01-31,132017000,,165771000,,151177000,189191000,479137000,157929000,157929000,,,,,,14594000,690559000,532630000,211422000,7842000,,151177000,151177000,52664,VEEV
2017-01-31,96743000,,122355000,,77572000,159430000,376861000,120688000,120688000,,,,,,44783000,550542000,429854000,173681000,1667000,,77572000,77569000,52664,VEEV
2020-10-31,,,585006,,585006,551212,1604655,1053443,1053443,,,,,,0,1604655,551212,0,-468437,,585006,585006,52665,MFV
2019-10-31,,,5094069,,5094069,554363,1687964,1133601,1133601,,,,,,0,1687964,554363,0,3960468,,5094069,5094069,52665,MFV
2018-10-31,,,-95318,,-95318,573618,1710431,1136813,1136813,,,,,,0,1710431,573618,0,-1232131,,-95318,-95318,52665,MFV
2017-10-31,,,5101157,,5101157,525877,1953403,1427526,1427526,,,,,,0,1953403,525877,0,3673631,,5101157,5101157,52665,MFV
2019-12-31,,,328142000,67947000,267377000,991664000,2429269000,779404000,779404000,,-425857000,,,,59931000,4262584000,3483180000,1833315000,-451262000,104000,268211000,267377000,52666,IRM
2018-12-31,,,410311000,71941000,353933000,1006983000,2431807000,785310000,785310000,,-416201000,,,,42753000,4225761000,3440451000,1793954000,-374999000,-12427000,367558000,353933000,52666,IRM
2017-12-31,,,200977000,92822000,170113000,937180000,2180753000,721197000,721197000,,-361304000,,,,22962000,3845578000,3124381000,1664825000,-520220000,-6291000,178015000,170113000,52666,IRM
2016-12-31,,,148824000,54821000,104824000,868351000,1955639000,634962000,634962000,,-318220000,,,,44944000,3511453000,2876491000,1555814000,-486138000,3353000,103880000,104824000,52666,IRM
2019-12-29,,,66348000,11980000,44602000,290039000,477683000,159444000,159444000,,-46489000,,,,17309000,2176683000,2017239000,1699000000,-93096000,,49039000,44602000,52667,DOOR
2018-12-30,,,120357000,11865000,92710000,236711000,435306000,170895000,170895000,,-39008000,,,,23813000,2170103000,1999208000,1734797000,-50538000,,96544000,92710000,52667,DOOR
2017-12-31,,,129421000,13273000,151739000,222399000,406983000,160384000,160384000,,-30153000,,,,-27560000,2032925000,1872541000,1625942000,-30963000,,156981000,151739000,52667,DOOR
2017-01-01,,,125929000,12892000,98622000,236863500,409645000,148781500,148781500,,-28178000,,,,21787000,1973964000,1825182500,1564319000,-22852500,,104142000,98622000,52667,DOOR
2019-12-31,,,9493707,,7318433,8448907,20115690,0,9493707,2173076,,,,,2175274,20115690,10621983,0,0,,7318433,7318433,52668,BKSC
2018-12-31,,,8031916,,6922934,8081375,18757262,0,8089529,2586358,,,,,1108982,18757262,10667733,0,-57613,,6922934,6922934,52668,BKSC
2017-12-31,,,7716459,,4901825,7642751,17958755,0,7809111,2506893,,,,,2814634,17958755,10149644,0,-92652,,4901825,4901825,52668,BKSC
2016-12-31,,,6935496,,5247063,7632136,17207940,0,6952187,2623617,,,,,1688433,17207940,10255753,0,-16691,,5247063,5247063,52668,BKSC
2020-06-27,,,-624200000,,-652100000,2920400000,3357300000,436900000,436900000,,-71500000,,,,27900000,4961400000,4524500000,1604100000,-1061100000,,-652100000,-652100000,52670,TPR
2019-06-29,,,766200000,,643400000,3167400000,4081500000,914100000,914100000,,-66900000,,,,122800000,6027100000,5113000000,1945600000,-147900000,,643400000,643400000,52670,TPR
2018-06-30,,,596800000,,397500000,2971800000,3964900000,993100000,993100000,,-86300000,,,,199300000,5880000000,4886900000,1915100000,-396300000,,397500000,397500000,52670,TPR
2017-07-01,,,759000000,,591000000,2271400000,3084000000,812600000,812600000,,-26800000,,,,168000000,4488300000,3675700000,1404300000,-53600000,,591000000,591000000,52670,TPR
2020-04-30,,,46325000,,23381000,779767000,1063789000,167489000,167489000,,-69049000,,,,22944000,3241307000,3073818000,2177518000,-121164000,,23381000,23307000,52671,GMS
2019-04-30,,,70041000,,56002000,726602000,1008295000,164234000,164234000,,-73677000,,,,14039000,3116032000,2951798000,2107737000,-94193000,,56002000,54620000,52671,GMS
2018-04-30,,,83854000,,62971000,633877000,818900000,119493000,119493000,,-31469000,,,,20883000,2511469000,2391976000,1692569000,-35639000,,62971000,62971000,52671,GMS
2017-04-30,,,71540000,,48886000,585078000,759517000,105199000,105199000,,-36463000,,,,22654000,2319146000,2213947000,1559629000,-33659000,,48886000,48886000,52671,GMS
2019-12-31,,,21068000,,16452000,24666000,53752000,0,23090000,5996000,,,,,4616000,53752000,30662000,0,-2022000,,16452000,15980000,52672,ICBK
2018-12-31,,,19310000,,14251000,21530000,47593000,0,20397000,5666000,,,,,5059000,47593000,27196000,0,-1087000,,14251000,13838000,52672,ICBK
2017-12-31,,,18216000,,10425000,16091000,44208000,0,19121000,8996000,,,,,7791000,44208000,25087000,0,-905000,,10425000,10072000,52672,ICBK
2016-12-31,,,17177000,,10694000,13613000,41323000,0,20257000,7453000,,,,,6483000,41323000,21066000,0,-3080000,,10694000,10352000,52672,ICBK
2019-12-31,,,415057000,,415057000,517617000,1300900000,622227000,622227000,34434000,-164131000,,,,0,1300900000,678673000,0,-207170000,,415057000,415057000,52674,UWMC
2018-12-31,,,91373000,,91316000,328658000,502167000,85830000,85830000,24817000,-85587000,,,,57000,502167000,416337000,0,5543000,,91316000,91316000,52674,UWMC
2017-12-31,,,114964000,,114601000,257467000,455615000,128406000,128406000,18200000,-53137000,,,,363000,455615000,327209000,0,-13442000,,114601000,114601000,52674,UWMC
2019-12-31,12836000,,-18218000,,-18218000,13691000,-8083000,-21774000,-21774000,,,,,,0,4753000,26527000,12836000,3556000,,-18218000,-18218000,52675,ARAV
2018-12-31,12836000,,-76333000,,-76333000,25695000,-7204000,-32899000,-32899000,,-2429000.0,,,,0,1371000,34270000,8575000,-43434000,,-76333000,-76333000,52675,ARAV
2017-12-31,12836000,,-85226000,,-84979000,29170000,-51912000,-81082000,-81082000,,-528000.0,,,,-247000,40000000,121082000,91912000,-4144000,,-84979000,-84979000,52675,ARAV
2016-12-31,71984000,,-95570000,,-95817000,24336000,0,-96320000,-96320000,,-528000.0,,,,247000,0,96320000,0,750000,,-95817000,-95817000,52675,ARAV
2020-12-31,,,18366000,,15080000,24788000,52806000,0,20981000,7037000,,,,,3286000,52806000,31825000,0,-2615000,,15080000,15080000,52676,NWFL
2019-12-31,,,16823000,,14215000,22457000,44134000,0,17122000,4555000,,,,,2608000,44134000,27012000,0,-299000,,14215000,14215000,52676,NWFL
2018-12-31,,,16204000,,13651000,21097000,42179000,0,16849000,4233000,,,,,2553000,42179000,25330000,0,-645000,,13651000,13651000,52676,NWFL
2017-12-31,,,14749000,,8198000,19445000,39619000,0,16440000,3734000,,,,,6551000,39619000,23179000,0,-1691000,,8198000,8198000,52676,NWFL
2019-12-31,,,3289884000,36455000,3246487000,2308334000,8047592000,5127796000,5127796000,272605000,-864492000,,,,785630000,25137135000,20009339000,17089543000,-1837912000,772436000,2504254000,3246487000,52677,TKC
2018-12-31,,,2672816000,131810000,2021065000,2273217000,7157229000,4440847000,4440847000,96775000,-552101000,,,,495481000,21292475000,16851628000,14135246000,-1768031000,772436000,2177335000,2021065000,52677,TKC
2017-12-31,,,2609517000,55927000,1979129000,2626274000,6299255000,3525838000,3525838000,147143000,-193311000,,,,571758000,17632064000,14106226000,11332809000,-916321000,772436000,2037759000,1979129000,52677,TKC
2016-12-31,,,2032230000,56632000,1511736000,2612481000,5092592000,2467940000,2467940000,12171000,-397623000,,,,426615000,14285561000,11817621000,9192969000,-435710000,-42164000,1605615000,1511736000,52677,TKC
2020-12-31,,,5430000000,2320000000,3754000000,,19290000000,7262000000,7262000000,9307000000,-1584000000,,,,1043000000,51533000000,44271000000,32243000000,-1832000000,,4387000000,3754000000,52680,HCA
2019-12-31,,,5244000000,2243000000,3505000000,855000000.0,19295000000,7218000000,7218000000,8626000000,-1824000000,,,,1099000000,51336000000,44118000000,32041000000,-1974000000,,4145000000,3505000000,52680,HCA
2018-12-31,,,5335000000,2032000000,3787000000,855000000.0,17528000000,6642000000,6642000000,8608000000,-1755000000,,,,946000000,46677000000,40035000000,29149000000,-1307000000,,4389000000,3787000000,52680,HCA
2017-12-31,,,4381000000,1811000000,2216000000,855000000.0,16239000000,6055000000,6055000000,8053000000,-1690000000,,,,1638000000,43614000000,37559000000,27375000000,-1674000000,,2743000000,2216000000,52680,HCA
2019-12-31,,,156000000,,128000000,578000000,899000000,290000000,290000000,2000000,-87000000,,,,27000000,2077000000,1787000000,1178000000,-134000000,-1000000,129000000,128000000,52681,TMX
2018-12-31,,,-126000000,,-41000000,555000000,859000000,286000000,286000000,2000000,-133000000,,,,37000000,1900000000,1614000000,1041000000,-412000000,122000000,-163000000,-41000000,52681,TMX
2017-12-31,,,99000000,,510000000,500000000,793000000,275000000,275000000,2000000,-150000000,,,,-242000000,1755000000,1480000000,962000000,-176000000,169000000,341000000,510000000,52681,TMX
2016-12-31,,,-3000000,,155000000,462000000,805000000,316000000,316000000,2000000,-153000000,,,,-5000000,1726000000,1410000000,921000000,-319000000,153000000,2000000,155000000,52681,TMX
2020-03-31,6355000,,3433000,,1349000,49337000,73435000,17743000,17743000,,-5504000,,,,2084000,117687000,99944000,44252000,-14310000,,1349000,1349000,52682,MLAB
2019-03-31,3506000,,8623000,,7484000,39555000,60916000,17855000,17855000,,-1749000,,,,1139000,103135000,85280000,42219000,-9232000,,7484000,7484000,52682,MLAB
2018-03-31,3539000,,301000,,-2962000,35078000,54619000,16002000,16002000,,-1853000,,,,3263000,96179000,80177000,41560000,-15701000,,-2962000,-2962000,52682,MLAB
2017-03-31,4157000,,14296000,,11183000,32769000,53919000,16993000,16993000,,-1853000,,,,3113000,93665000,76672000,39746000,-2697000,,11183000,11183000,52682,MLAB
2019-12-31,8199074,,-37162827,,-37162827,10199534,-5468329,-11672137,-11672137,-12194800,-6596143,,,,0,376562,12048699,5844891,-25490690,,-37162827,-37249034,52688,WKHS
2018-12-31,7391693,,-36502316,,-36502316,11485482,-15190392,-34067567,-34067567,-12194800,-2868419,,,,0,763173,34830740,15953565,-2434749,,-36502316,-37267495,52688,WKHS
2017-12-31,17737737,,-41216788,,-41216788,8820211,-14478403,-41036351,-41036351,-12194800,-180437,,,,0,10038460,51074811,24516863,-180437,,-41216788,-41216788,52688,WKHS
2016-12-31,6145801,,-19555868,,-19555868,6202569,-7163462,-19511832,-19511832,-12194800,-44036,,,,0,6414800,25926632,13578262,-44036,,-19555868,-19555868,52688,WKHS
2019-12-31,40961000,,43511000,9826000,6038000,179131000,308816000,81486000,81486000,,-24302000,,,,8119000,1018366000,936880000,709550000,-37975000,-27977000,35392000,6038000,52689,FOE
2018-12-31,40097000,,71050000,9218000,80093000,186637000,339735000,106246000,106246000,,-23659000,,,,14130000,1082223000,975977000,742488000,-35196000,24026000,56920000,80093000,52689,FOE
2017-12-31,36251000,,83315000,11866000,57054000,158240000,326719000,124103000,124103000,-1000.0,-20647000,,,,46413000,996382000,872279000,669663000,-40788000,20866000,36902000,57054000,52689,FOE
2016-12-31,27327000,,62445000,7919000,-20817000,210054000,356378000,111415000,111415000,-1000.0,-21547000,,,,17868000,1145292000,1033877000,788914000,-48970000,-64464000,44577000,-20817000,52689,FOE
2020-09-30,1123555,,-2265218,309794,-825614,4698623,3942802,-1879376,-1879376,,-1000554,,,,-1428202,86846791,88726167,82903989,-385842,,-837016,-825614,52691,ZKIN
2019-09-30,1452061,,8441922,299666,8106866,5545424,15644042,8646557,8646557,,-1151045,,,,248228,63883520,55236963,48239478,-204635,,8193694,8106866,52691,ZKIN
2018-09-30,1652633,,8501267,225747,7018114,7020320,18290589,9617636,9617636,,-1239170,,,,1398210,54884381,45266745,36593792,-1116369,,7103057,7018114,52691,ZKIN
2017-09-30,1331111,,6928693,150028,5874276,3697445,13108403,8079847,8079847,,-1245385,,,,995005,44951740,36871893,31843337,-1151154,,5933688,5874276,52691,ZKIN
2020-12-31,,,139523000,,108013000,1098948000,1223889000,137049000,137049000,-12108000,,,,,31510000,2501554000,2364505000,1277665000,2474000,,108013000,108013000,52693,COLM
2019-12-31,,,405429000,,330489000,1076986000,1515670000,394971000,394971000,-15487000,,,,,74940000,3042478000,2647507000,1526808000,10458000,,330489000,330489000,52693,COLM
2018-12-31,,,360717000,16456000.0,268256000,993652000,1386348000,350982000,350982000,-15786000,,,,,85769000,2802326000,2451344000,1415978000,11963000,,274948000,268256000,52693,COLM
2017-12-31,,,266734000,30308000.0,105123000,910894000,1159962000,262969000,262969000,-13901000,-429000.0,,,,154419000,2466105000,2203136000,1306143000,2364000,,112315000,105123000,52693,COLM
2019-12-31,,,99438000,3295000,99140000,16378000,100373000,14909000,14909000,,-37385000,,,,0,181066000,166157000,80693000,84529000,,99438000,99140000,52694,NXRT
2018-12-31,,,-1614000,2567000,-1609000,13942000,78204000,16792000,16792000,,-28572000,,,,0,146597000,129805000,68393000,-18406000,,-1614000,-1609000,52694,NXRT
2017-12-31,,,56359000,2135000,53374000,12434000,74475000,13289000,13289000,,-29576000,,,,0,144235000,130946000,69760000,43070000,,56359000,53374000,52694,NXRT
2016-12-31,,,25888000,24558000,21882000,9891000,67379000,21845000,21845000,,-20167000,,,,0,132848000,111003000,65469000,4043000,,25888000,21882000,52694,NXRT
2020-12-31,252771000,,-204409000,,-207303000,482025000,606557000,-128239000,-128239000,,-46728000,,,,2894000,940584000,1068823000,334027000,-76170000,,-207303000,-208353000,52699,FEYE
2019-12-31,271326000,,-251719000,,-257409000,508103000,580260000,-199169000,-199169000,,-61927000,,,,5690000,889152000,1088321000,308892000,-52550000,,-257409000,-257409000,52699,FEYE
2018-12-31,254142000,,-237599000,,-243123000,486735000,558475000,-182402000,-182402000,,-56426000,,,,5524000,830950000,1013352000,272475000,-55197000,,-243123000,-243123000,52699,FEYE
2017-12-31,243273000,,-280552000,,-285184000,504827000,508001000,-240099000,-240099000,,-49766000,,,,4632000,779648000,1019747000,271647000,-40453000,,-285184000,-285184000,52699,FEYE
2020-03-28,,,-12227000,,-12779000,65867000,64477000,-6235000,-6235000,,-5183000,,,,0,169420000,175655000,104943000,-5992000,-552000,-12227000,-12779000,52700,BGI
2019-03-30,,,-18305000,,-18686000,67106000,58577000,-12388000,-12388000,,-4389000,,,,0,151049000,163437000,92472000,-5917000,-381000,-18305000,-18686000,52700,BGI
2018-03-31,,,-21995000,,14095000,66754000,55693000,-14325000,-14325000,,-4088000,,,,0,146608000,160933000,90915000,-7670000,36090000,-21995000,14095000,52700,BGI
2017-03-25,,,-8859000,,7075000,61599000,61532000,-3495000,-3495000,,-4567000,,,,0,152992000,156487000,91460000,-5364000,15934000,-8859000,7075000,52700,BGI
2020-12-31,,,49033000,48000,37273000,133562000,203212000,0,52232000,17418000,,,,,11760000,203212000,150980000,0,-3199000,,37273000,37273000,52704,CPF
2019-12-31,,,77927000,48000,58322000,125320000,218877000,0,78178000,15379000,,,,,19605000,218877000,140699000,0,-251000,,58322000,58322000,52704,CPF
2018-12-31,,,78244000,48000,59486000,116610000,211421000,0,80324000,14487000,,,,,18758000,211421000,131097000,0,-2080000,,59486000,59486000,52704,CPF
2017-12-31,,,75800000,24000,41204000,112625000,205029000,0,77525000,14879000,,,,,34596000,205029000,127504000,0,-1725000,,41204000,41204000,52704,CPF
2019-12-31,45302000,,90791000,49331000,96720000,176550000,375450000,139130000,139130000,,-42332000,,,,220000,580615000,441485000,205165000,-48339000,,90571000,96720000,52710,EBIX
2018-12-31,39078000,,125582000,66242000,93139000,127453000,329411000,151588000,151588000,,-27101000,,,,32501000,497826000,346238000,168415000,-26006000,,93081000,93139000,52710,EBIX
2017-12-31,33854000,,103360000,42249000,100618000,76279000,234477000,113221000,113221000,,-13383000,,,,777000,363971000,250750000,129494000,-9861000,,102583000,100618000,52710,EBIX
2016-12-31,32981000,,95931000,11740000,93847000,70502000,213166000,98937000,98937000,,-7376000,,,,1637000,298294000,199357000,85128000,-3006000,,94294000,93847000,52710,EBIX
2020-12-31,,,11755000,,8245000,25354000,39278000,0,12320000,1285000,,,,,3510000,39278000,26958000,0,-565000,,8245000,8245000,52711,CWBC
2019-12-31,,,11374000,,7963000,24375000,38129000,0,11801000,1571000,,,,,3411000,38129000,26328000,0,-427000,,7963000,7963000,52711,CWBC
2018-12-31,,,10218000,,7409000,23118000,36257000,0,10988000,1673000,,,,,2809000,36257000,25269000,0,-770000,,7409000,7409000,52711,CWBC
2017-12-31,,,10463000,,4915000,21430000,35008000,0,11127000,1914000,,,,,5548000,35008000,23881000,0,-664000,,4915000,4915000,52711,CWBC
2019-12-31,,,-1009000,,-2170000,72634000,74221000,887000,887000,,-1896000,,,,1161000,240995000,240108000,166774000,-1896000,,-2170000,-2170000,52713,PFSW
2018-12-31,,,3998000,,1228000,77200000,85297000,6497000,6497000,,-2499000,,,,2770000,264834000,258337000,179537000,-2499000,,1228000,1228000,52713,PFSW
2017-12-31,,,-2140000,,-3964000,76581000,80579000,598000,598000,,-2738000,,,,1824000,274243000,273645000,193664000,-2738000,,-3964000,-3964000,52713,PFSW
2016-12-31,,,-5163000,,-7530000,68804000,73464000,660000,660000,,-2323000,,,,2367000,274860000,274200000,201396000,-5823000,,-7530000,-7530000,52713,PFSW
2020-12-31,,,163898000,,79957000,,259587000,144319000,144319000,80481000,-97331000,,,,43935000,603896000,459577000,344309000,19579000,,119963000,79957000,52714,VRTS
2019-12-31,,,140685000,74403000.0,95649000,5100000.0,240626000,127012000,127012000,73278000,-111478000,,,,35177000,563246000,436234000,322620000,13673000,,105508000,87312000,52714,VRTS
2018-12-31,,,109041000,71439000.0,75529000,6900000.0,221293000,113186000,113186000,71468000,-84233000,,,,32961000,552235000,439049000,330942000,-4145000,,76080000,67192000,52714,VRTS
2017-12-31,,,80429000,20845000.0,37012000,6100000.0,162226000,68615000,68615000,71841000,-47250000,,,,40490000,425607000,356992000,263381000,11814000,,39939000,28676000,52714,VRTS
2020-06-30,3600000,,11693000,,9592000,65183000,74614000,5831000,5831000,,-873000,,,,2101000,305558000,299727000,230944000,5862000,,9592000,9592000,52717,LYTS
2019-06-30,5300000,,-22268000,,-16339000,67170000,75231000,2761000,2761000,,-2278000,,,,-5929000,328852000,326091000,253621000,-25029000,,-16339000,-16339000,52717,LYTS
2018-06-30,5952000,,-23332000,,-19541000,73798000,89234000,9484000,9484000,,-1719000,,,,-3791000,342023000,332539000,252789000,-32816000,,-19541000,-19541000,52717,LYTS
2017-06-30,5700000,,3080000,,3000000,71572000,83865000,6593000,6593000,,-620000,,,,80000,331392000,324799000,247527000,-3513000,,3000000,3000000,52717,LYTS
2019-12-31,,,2155000000,,1746000000,-316000000,4357000000,3161000000,3161000000,313000000,-994000000,,,,409000000,7769000000,4608000000,3412000000,-1006000000,,1746000000,1745000000,52719,PPL
2018-12-31,,,2285000000,,1827000000,-257000000,4271000000,3122000000,3122000000,312000000,-963000000,,,,458000000,7785000000,4663000000,3514000000,-837000000,,1827000000,1825000000,52719,PPL
2017-12-31,,,1912000000,,1128000000,-167000000,4201000000,3068000000,3068000000,292000000,-901000000,,,,784000000,7447000000,4379000000,3246000000,-1320000000,,1128000000,1126000000,52719,PPL
2016-12-31,,,2550000000,,1902000000,-112000000,4163000000,3048000000,3048000000,301000000,-888000000,,,,648000000,7517000000,4469000000,3354000000,-498000000,,1902000000,1896000000,52719,PPL
2020-02-29,,,-16180444,,-16180444,3441693,6553134,3111441,3111441,,,,,,0,6553134,3441693,0,-19291885,,-16180444,-16180444,52720,JOF
2019-02-28,,,-60538877,,-60538877,3976709,6328503,2351794,2351794,,,,,,0,6328503,3976709,0,-62890671,,-60538877,-60538877,52720,JOF
2018-02-28,,,107742509,,107742509,4003187,6499391,2496204,2496204,,,,,,0,6499391,4003187,0,105246305,,107742509,107742509,52720,JOF
2017-02-28,,,71486625,,71486625,3568380,6819031,3250651,3250651,,,,,,0,6819031,3568380,0,68235974,,71486625,71486625,52720,JOF
2020-05-31,,,3909655,,3909655,1471227,7852691,6381464,6381464,,-1575172,,,,0,7852691,1471227,0,-2471809,,3909655,3909655,52721,NMT
2019-05-31,,,8809098,,8809098,1517260,8106114,6588854,6588854,,-1713702,,,,0,8106114,1517260,0,2220244,,8809098,8809098,52721,NMT
2018-05-31,,,1679613,,1679613,1526079,8368412,6842333,6842333,,-1360033,,,,0,8368412,1526079,0,-5162720,,1679613,1679613,52721,NMT
2017-05-31,,,548307,,548307,1502336,8620356,7118020,7118020,,-1156582,,,,0,8620356,1502336,0,-6569713,,548307,548307,52721,NMT
2019-12-31,,,-142810000,,-142978000,184988000,57859000,-133148000,-133148000,,-14596000,,,,168000,1191821000,1324969000,1133962000,-9662000,,-142978000,-275728000,52722,VRM
2018-12-31,,,-84949000,,-85178000,133842000,60807000,-79892000,-79892000,,-8513000,,,,229000,855429000,935321000,794622000,-5057000,,-85178000,-98214000,52722,VRM
2019-12-31,5607000,,-12775000,,-12775000,7402000,0,-13009000,-13009000,,-64000,,,,0,0,13009000,0,234000,,-12775000,-12775000,52723,FENC
2018-12-31,5008000,,-9888000,,-9888000,5401000,0,-10409000,-10409000,,-64000,,,,0,0,10409000,0,521000,,-9888000,-9888000,52723,FENC
2017-12-31,1936000,,-7046000,,-7046000,5015000,0,-6951000,-6951000,,-64000,,,,0,0,6951000,0,-95000,,-7046000,-7046000,52723,FENC
2016-12-31,472000,,-2789000,,-2789000,2399000,0,-2871000,-2871000,,-64000,,,,0,0,2871000,0,82000,,-2789000,-2789000,52723,FENC
2019-12-31,,,-17620000,180000,-20675000,43100000,159082000,39319000,39319000,,-53375000,,,,3353000,476581000,437262000,317499000,-56939000,,-20973000,-20675000,52725,CCLP
2018-12-31,,,-34363000,505000,-36371000,39600000,130266000,20166000,20166000,,-52585000,,,,2615000,438663000,418497000,308397000,-54529000,,-36978000,-36371000,52725,CCLP
2017-12-31,,,-37675000,1618000,-39650000,33438000,102068000,-510000,-510000,,-43135000,,,,2784000,295566000,296076000,193498000,-37165000,,-40459000,-39650000,52725,CCLP
2016-12-31,,,-136273000,3061000,-135375000,36222000,120103000,11758000,11758000,,-38055000,,,,1865000,311363000,299605000,191260000,-148031000,,-138138000,-135375000,52725,CCLP
2020-12-31,,,12933000,,9990000,216569000,268085000,21954000,21954000,,-5340000,,,,2943000,448984000,427030000,180899000,-9021000,,9990000,9990000,52729,FORR
2019-12-31,,,-9599000,,-9570000,225907000,264971000,7873000,7873000,,-8054000,,,,-29000,461697000,453824000,196726000,-17472000,,-9570000,-9570000,52729,FORR
2018-12-31,,,23525000,,15380000,175744000,211073000,26212000,26212000,,-8054000,,,,8145000,357575000,331363000,146502000,-2687000,,15380000,15380000,52729,FORR
2017-12-31,,,27371000,,15140000,165823000,200801000,27549000,27549000,,-8054000,,,,12231000,337673000,310124000,136872000,-178000,,15140000,15140000,52729,FORR
2020-01-31,,,30055752,,30055752,1860516,31990874,30130358,30130358,,,,,,0,31990874,1860516,0,-74606,,30055752,30055752,52730,MSB
2019-01-31,,,45559044,,45559044,1662222,47293765,45631543,45631543,,,,,,0,47293765,1662222,0,-72499,,45559044,45559044,52730,MSB
2018-01-31,,,33423425,,33423425,1004657,34495415,33490758,33490758,,,,,,0,34495415,1004657,0,-67333,,33423425,33423425,52730,MSB
2017-01-31,,,9763771,,9763771,1064787,10887193,9822406,9822406,,,,,,0,10887193,1064787,0,-58635,,9763771,9763771,52730,MSB
2020-03-31,80790000,,159000,,-2200000,231024000,317581000,5767000,5767000,,-4507000,,,,2359000,426963000,421196000,109382000,-5608000,,-2200000,-2200000,52731,MIME
2019-03-31,57939000,,-5000000,,-7001000,189941000,249503000,1623000,1623000,,-5940000,,,,2001000,340377000,338754000,90874000,-6623000,,-7001000,-7001000,52731,MIME
2018-03-31,38373000,,-9681000,,-12386000,158235000,192198000,-4410000,-4410000,,-598000,,,,2705000,261897000,266307000,69699000,-5271000,,-12386000,-12386000,52731,MIME
2017-03-31,22593000,,-3239000,,-5441000,124029000,136249000,-10373000,-10373000,,-268000,,,,2202000,186563000,196936000,50314000,7134000,,-5441000,-5441000,52731,MIME
2019-12-31,1314000,,4465000,,4465000,2480000,8301000,4507000,4507000,,-46000,,,,0,13643000,9136000,5342000,-42000,,4465000,4326000,52732,INTZ
2018-12-31,1237000,,2287000,,2287000,2716000,6429000,2476000,2476000,,-189000,,,,0,10276000,7800000,3847000,-189000,,2287000,2148000,52732,INTZ
2017-12-31,2162000,,-30000,,-30000,2625000,4038000,-749000,-749000,,-209000,,,,0,6862000,7611000,2824000,719000,,-30000,-169000,52732,INTZ
2016-12-31,2499000,,-1552000,,-1552000,2827000,3919000,-1407000,-1407000,,-145000,,,,0,6102000,7509000,2183000,-145000,,-1552000,-1691000,52732,INTZ
2020-12-31,,,453500000,15400000,351200000,679100000,1228600000,549500000,549500000,,-60300000,,,,97500000,4186000000,3636500000,2957400000,-96000000,,356000000,349900000,52734,HUBB
2019-12-31,,,520500000,13400000,400900000,754900000,1375000000,620100000,620100000,,-69400000,,,,113100000,4591000000,3970900000,3216000000,-99600000,,407400000,399400000,52734,HUBB
2018-12-31,,,467000000,18300000,360200000,730200000,1308600000,578400000,578400000,,-72400000,,,,100900000,4481700000,3903300000,3173100000,-111400000,,366100000,358900000,52734,HUBB
2017-12-31,,,443100000,13700000,243100000,623000000,1168800000,545800000,545800000,,-44900000,,,,193200000,3668800000,3123000000,2500000000,-102700000,,249900000,242300000,52734,HUBB
2020-03-29,,,38956000,,28367000,59246000,101517000,42271000,42271000,,-2511000,,,,10589000,540198000,497927000,438681000,-3315000,,28367000,28367000,52736,HWKN
2019-03-31,,,33530000,,24433000,59118000,95936000,36818000,36818000,,-3361000,,,,9097000,556326000,519508000,460390000,-3288000,,24433000,24433000,52736,HWKN
2018-04-01,,,-15076000,,-9177000,59403000,86760000,27357000,27357000,,-3408000,,,,-5899000,504169000,476812000,417409000,-42433000,,-9177000,-9177000,52736,HWKN
2017-04-02,,,36048000,,22555000,59381000,98073000,38692000,38692000,,-2644000,,,,13493000,483593000,444901000,385520000,-2644000,,22555000,22555000,52736,HWKN
2019-12-31,,,1045000,,960000,5634000,7762000,0,1467000,661000,,,,,85000,7762000,6295000,0,-422000,,960000,960000,52737,MSVB
2018-12-31,,,1708000,,1413000,5131000,7556000,0,1779000,646000,,,,,295000,7556000,5777000,0,-102000,,1413000,1413000,52737,MSVB
2017-12-31,,,2155000,,1173000,4517000,7407000,0,2292000,598000,,,,,982000,7407000,5115000,0,-137000,,1173000,1173000,52737,MSVB
2016-12-31,,,1645000,,1138000,4174000,7016000,0,2112000,730000,,,,,507000,7016000,4904000,0,-467000,,1138000,1138000,52737,MSVB
2019-12-31,,,464432000,-58000,369596000,124328000,760580000,636252000,636252000,,-185843000,,,,94661000,3230785000,2594533000,2470205000,-171820000,,369771000,369596000,52738,SCI
2018-12-31,,,441732000,-88000,447208000,145392000,760322000,614930000,614930000,,-181556000,,,,-5826000,3190174000,2575244000,2429852000,-173198000,,447558000,447208000,52738,SCI
2017-12-31,,,400258000,47000,546663000,160597000,722779000,562182000,562182000,,-169125000,,,,-146589000,3095031000,2532849000,2372252000,-161924000,,546847000,546663000,52738,SCI
2016-12-31,,,326658000,2534000,177038000,115046000,676850000,561804000,561804000,,-162093000,,,,149353000,3031137000,2469333000,2354287000,-235146000,,177305000,177038000,52738,SCI
2020-12-31,,,445196000,1656000,455359000,77419000,1172878000,592271000,592271000,44315000,-209981000,,,,-20759000,1226846000,634575000,53968000,-147075000,,465955000,455359000,52740,WPC
2019-12-31,,,332755000,6244000,305243000,82872000,1128150000,560048000,560048000,19308000,-233443000,,,,26211000,1205710000,645662000,77560000,-227293000,,306544000,305166000,52740,WPC
2018-12-31,,,438752000,5777000,411566000,77577000,880419000,471961000,471961000,21147000,-178395000,,,,14411000,923342000,451381000,42923000,-33209000,,424341000,411226000,52740,WPC
2017-12-31,,,287794000,220089000,277289000,84491000,813278000,439556000,439556000,16980000,-165757000,,,,2711000,860578000,421022000,47300000,-151762000,,285083000,276505000,52740,WPC
2020-03-31,,,2825759000000,677064000000,2076183000000,2973166000000,5407628000000,2434462000000,2434462000000,,-32217000000,,,,683430000000,29929992000000,27495530000000,24522364000000,391297000000,,2142329000000,2058899000000,52741,TM
2019-03-31,,,2645531000000,718985000000,1882873000000,2986695000000,5443896000000,2457201000000,2457201000000,,-28078000000,,,,659944000000,30225681000000,27768480000000,24781785000000,188330000000,,1985587000000,1868085000000,52741,TM
2018-03-31,,,3090512000000,694120000000,2493983000000,3090495000000,5490357000000,2399862000000,2399862000000,,-27586000000,,,,504406000000,29379510000000,26979648000000,23889153000000,690650000000,,2586106000000,2481692000000,52741,TM
2017-03-31,,,2555885000000,668264000000,1831109000000,2868485000000,4862857000000,1994372000000,1994372000000,,-29353000000,,,,628900000000,27597193000000,25602821000000,22734336000000,561513000000,,1926985000000,1821314000000,52741,TM
2019-12-31,,,-2968000,,-31461000,3193000,-270000,-4504000,-4504000,104000,-64000,,,,-633000,31746000,36250000,32016000,1536000,-29126000,-2335000,-31461000,52742,ASM
2018-12-31,,,2064000,,1626000,3610000,6266000,1904000,1904000,122000,-109000,,,,407000,34116000,32212000,27850000,160000,-31000,1657000,1626000,52742,ASM
2017-12-31,,,5436000,,2522000,3327000,11253000,5815000,5815000,93000,-103000,,,,2771000,33359000,27544000,22106000,-379000,-143000,2665000,2522000,52742,ASM
2017-01-01,,,6455000,,2016000,3789000,11731000,6509000,6509000,215000,-126000,,,,4439000,34692000,28183000,22961000,-54000,-143000,2016000,2016000,52742,ASM
2020-12-31,,,932000000,406000000,579000000,593000000,2393000000,1319000000,1319000000,,-300000000,,,,244000000,11575000000,10256000000,9182000000,-387000000,,688000000,579000000,52743,CCK
2019-12-31,,,791000000,379000000,510000000,644000000,2316000000,1180000000,1180000000,2000000.0,-378000000,,,,166000000,11665000000,10485000000,9349000000,-389000000,,625000000,510000000,52743,CCK
2018-12-31,,,744000000,349000000,439000000,533000000,2123000000,1161000000,1161000000,4000000.0,-384000000,,,,216000000,11151000000,9990000000,9028000000,-417000000,,528000000,439000000,52743,CCK
2017-12-31,,,829000000,322000000,323000000,314000000,1692000000,1131000000,1131000000,6000000.0,-252000000,,,,401000000,8698000000,7567000000,7006000000,-302000000,,428000000,323000000,52743,CCK
2020-02-29,,,44963061,,44963061,6939677,54823313,47883636,47883636,,-797893,,,,0,54823313,6939677,0,-2920575,,44963061,32505285,52746,NCV
2019-02-28,,,-7348783,,-7348783,7519402,58168842,50649440,50649440,,-917690,,,,0,58168842,7519402,0,-57998223,,-7348783,-17934028,52746,NCV
2018-02-28,,,46507952,,46507952,7585971,68529139,60943168,60943168,,-917690,,,,0,68529139,7585971,0,-14435216,,46507952,40500355,52746,NCV
2017-02-28,,,190838813,,190663497,7531155,71983811,64452656,64452656,,-917690,,,,175316,71983811,7531155,0,126386157,,190663497,188305535,52746,NCV
2020-10-03,,,-1743000000,13929000000,-2864000000,11799000000,21508000000,4364000000,4364000000,,-2217000000,,,,699000000,65388000000,61024000000,43880000000,-6107000000,-32000000,-2442000000,-2864000000,52747,DIS
2019-09-28,,,13923000000,13975000000,11054000000,10588000000,27546000000,12791000000,12791000000,,-1907000000,,,,3026000000,69607000000,56816000000,42061000000,1132000000,629000000,10897000000,11054000000,52747,DIS
2018-09-29,,,14729000000,5182000000,12598000000,8281000000,26708000000,15416000000,15416000000,,-1261000000,,,,1663000000,59434000000,44018000000,32726000000,-687000000,629000000,13066000000,12598000000,52747,DIS
2017-09-30,,,13788000000,4837000000,8980000000,8176000000,24831000000,13873000000,13873000000,,-507000000,,,,4422000000,55137000000,41264000000,30306000000,-85000000,629000000,9366000000,8980000000,52747,DIS
2019-12-31,2874000,,-14901000,,-14901000,9835000,-860000,-13569000,-13569000,,-2151000,,,,0,7215000,20784000,8075000,-1332000,,-14901000,-14901000,52748,XL
2018-12-31,1893000,,-12903000,,-12903000,9333000,-1469000,-12695000,-12695000,,-208000,,,,0,9545000,22240000,11014000,-208000,,-12903000,-12903000,52748,XL
2020-12-31,,,9750000,,8349000,24008000,39538000,0,10684000,4846000,,,,,1401000,39538000,28854000,0,-934000,,8349000,8349000,52750,MBCN
2019-12-31,,,15303000,,12711000,24351000,45336000,0,16512000,4473000,,,,,2592000,45336000,28824000,0,-1209000,,12711000,12711000,52750,MBCN
2018-12-31,,,14593000,,12431000,22860000,43336000,0,16100000,4376000,,,,,2162000,43336000,27236000,0,-1507000,,12431000,12431000,52750,MBCN
2017-12-31,,,13677000,,9455000,21019000,41162000,0,16058000,4085000,,,,,4222000,41162000,25104000,0,-2381000,,9455000,9455000,52750,MBCN
2019-12-31,,,214368000,,214368000,63253000,384745000,235272000,235272000,-23761000,-21435000,,,,0,462943000,227671000,78198000,-20904000,,214368000,193368000,52751,BSM
2018-12-31,,,295560000,,295536000,76512000,475742000,318578000,318578000,-49944000,-20756000,,,,0,558521000,239943000,82779000,-23018000,,295560000,274511000,52751,BSM
2017-12-31,,,157153000,867000.0,157187000,74577000,295941000,174150000,174150000,-67938000,-15694000,,,,0,360695000,186545000,64754000,-16997000,,157153000,152145000,52751,BSM
2016-12-31,,,20188000,1021000.0,20200000,73139000,210999000,22676000,22676000,5277000,-7547000,,,,0,265218000,242542000,54219000,-2488000,,20188000,14437000,52751,BSM
2020-07-31,,,-31159376,,-31159376,5179158,39619358,34440200,34440200,,-6843158,,,,0,39619358,5179158,0,-65599576,,-31159376,-31159376,52752,HPF
2019-07-31,,,35092305,,35092305,5461324,41428645,35967321,35967321,,-9721623,,,,0,41428645,5461324,0,-875016,,35092305,35092305,52752,HPF
2018-07-31,,,19403746,,19403746,5572676,42993394,37420718,37420718,,-3709317,,,,0,42993394,5572676,0,-18016972,,19403746,19403746,52752,HPF
2017-07-31,,,21081505,,21081505,5747901,43409833,37661932,37661932,,-3565741,,,,0,43409833,5747901,0,-16580427,,21081505,21081505,52752,HPF
2019-12-31,,,-280600000,870100000,-80100000,801300000,2977800000,591700000,591700000,712900000,-499200000,,,,-98200000,3867000000,3275300000,889200000,-872300000,,-182400000,-80100000,52755,LILA
2018-12-31,,,-584700000,1010800000,-345200000,758400000,2815900000,556500000,556500000,670600000,-443700000,,,,51100000,3705700000,3149200000,889800000,-1141200000,,-635800000,-345200000,52755,LILA
2017-12-31,,,-651200000,1361000000,-778100000,696200000,2713800000,549800000,549800000,673600000,-381800000,,,,147500000,3590000000,3040200000,876200000,-1201000000,,-798700000,-778100000,52755,LILA
2016-12-31,,,-98100000,1480800000,-432300000,517600000,2046600000,472700000,472700000,467600000,-314400000,,,,305900000,2723800000,2251100000,677200000,-570800000,,-404000000,-432300000,52755,LILA
2019-12-31,48819000,,68393000,,60291000,125092000,221358000,47447000,47447000,,-4324000,,,,8102000,834289000,786842000,612931000,20946000,,60291000,60291000,52756,SRI
2018-12-31,50918000,,65058000,,53848000,135176000,257517000,71423000,71423000,,-4720000,,,,11210000,866199000,794776000,608682000,-6365000,,53848000,53848000,52756,SRI
2017-12-31,48876000,,52582000,,45179000,133532000,250013000,67605000,67605000,,-5783000,,,,7533000,824444000,756839000,574431000,-15023000,,45049000,45179000,52756,SRI
2016-12-31,39112000,,39185000,13762000.0,77461000,108296000,195876000,48468000,48468000,,-6277000,,,,-36389000,695977000,647509000,500101000,-9283000,,75574000,77461000,52756,SRI
2020-01-03,31789000,,108569000,15719000,93033000,91793000,242735000,112809000,112809000,,-3173000,,,,14099000,751020000,638211000,508285000,-4240000,,94470000,93033000,52757,FOXF
2018-12-28,25847000,,90890000,14282000,84040000,76952000,205496000,96632000,96632000,,-3059000,,,,5523000,619225000,522593000,413729000,-5742000,,85367000,84040000,52757,FOXF
2017-12-29,20178000,,64285000,12955000,43128000,61938000,154490000,69388000,69388000,,-2396000,,,,21102000,475633000,406245000,321143000,-5103000,,43183000,43128000,52757,FOXF
2016-12-30,18459000,,43090000,12955000,35675000,53489000,126600000,51664000,51664000,,-2088000,,,,7415000,403077000,351413000,276477000,-8574000,,35675000,35675000,52757,FOXF
2019-12-31,,,-36351000,,-36351000,1954000,2939000,-3776000,-3776000,,-4037000,,,,0,15623000,19399000,12684000,-32575000,,-36351000,-36351000,52758,GLBS
2018-12-31,,,-3568000,,-3568000,1884000,5075000,-1450000,-1450000,,-2027000,,,,0,17354000,18804000,12279000,-2118000,,-3568000,-3568000,52758,GLBS
2017-12-31,,,-6475000,,-6475000,1738000,2534000,-4098000,-4098000,,-1862000,,,,0,13883000,17981000,11349000,-2377000,,-6475000,-6475000,52758,GLBS
2016-12-31,,,-9825000,,-9825000,2445000,-1946000,-9455000,-9455000,,-2558000,,,,0,8701000,18156000,10647000,-370000,,-9825000,-9825000,52758,GLBS
2020-07-03,973000000,,1032000000,,1004000000,473000000,2845000000,1385000000,1385000000,,-201000000,,,,28000000,10509000000,9124000000,7664000000,-353000000,,1004000000,1004000000,52759,STX
2019-06-28,991000000,,1372000000,,2012000000,453000000,2932000000,1465000000,1465000000,,-224000000,,,,-640000000,10390000000,8925000000,7458000000,-93000000,,2012000000,2012000000,52759,STX
2018-06-29,1022000000,,1418000000,,1182000000,560000000,3365000000,1730000000,1730000000,,-236000000,,,,236000000,11184000000,9454000000,7819000000,-312000000,,1182000000,1182000000,52759,STX
2017-06-30,1232000000,,815000000,,772000000,606000000,3174000000,1232000000,1232000000,,-222000000,,,,43000000,10771000000,9539000000,7597000000,-417000000,,772000000,772000000,52759,STX
2019-12-31,,,22944000,,22944000,6732000,40091000,33359000,33359000,,-10738000,,,,0,40091000,6732000,0,-10415000,,22944000,22944000,52761,SUNS
2018-12-31,,,13813000,,13813000,9381000,39809000,30428000,30428000,,-7808000,,,,0,39809000,9381000,0,-16615000,,13813000,13813000,52761,SUNS
2017-12-31,,,23386000,,23386000,5715000,32167000,26452000,26452000,,-3848000,,,,0,32167000,5715000,0,-3066000,,23386000,23386000,52761,SUNS
2016-12-31,,,24252000,,24252000,5599000,27196000,21597000,21597000,,-3281000,,,,0,27196000,5599000,0,2655000,,24252000,24252000,52761,SUNS
2019-12-31,,,400736,-178806,453106,5345120,5679977,358560,358560,,,,,,101372,5679977,5321417,0,42176,,299364,453106,52762,MDJH
2018-12-31,,,-537814,-22666,-515971,3106426,2408448,-564379,-564379,,,,,,0,2408448,2972827,0,26565,,-537814,-515971,52762,MDJH
2017-12-31,,,1563554,-22666,1167002,3741180,5532244,1589683,1589683,,,,,,396552,5532244,3942561,0,-27342,,1167002,1167002,52762,MDJH
2016-12-31,,,1328780,-22666,996550,4423133,5302030,873307,873307,,,,,,332230,5302030,4428723,0,455473,,996550,996550,52762,MDJH
2019-12-31,,,714000000,447000000,343000000,,953000000,953000000,953000000,,-239000000,,,,195000000,8096000000,7143000000,7143000000,-239000000,-112000000,519000000,343000000,52766,GNW
2018-12-31,,,137000000,1739000000,119000000,,393000000,393000000,393000000,,-256000000,,,,70000000,7901000000,7508000000,7508000000,-256000000,122000000,67000000,119000000,52766,GNW
2017-12-31,,,127000000,1910000000,817000000,,393000000,393000000,393000000,,-266000000,,,,-406000000,7513000000,7120000000,7120000000,-266000000,204000000,533000000,817000000,52766,GNW
2016-12-31,,,320000000,1823000000,-277000000,,775000000,743000000,743000000,,-337000000,,,,358000000,8369000000,7626000000,7594000000,-423000000,-29000000,-38000000,-277000000,52766,GNW
2020-10-31,,,-11091699,,-11091699,11017587,77969174,66951587,66951587,,-74031,,,,0,77969174,11017587,0,-78043286,,-11091699,-11091699,52767,AOD
2019-10-31,,,95484190,,95484190,11611564,80067435,68455871,68455871,,-350746,,,,0,80067435,11611564,0,27028319,,95484190,95484190,52767,AOD
2018-10-31,,,7089723,,7089723,12372121,81241892,68869771,68869771,,-445982,,,,0,81241892,12372121,0,-61780048,,7089723,7089723,52767,AOD
2017-10-31,,,209911622,,209911622,11765125,83533363,71768238,71768238,,-390783,,,,0,83533363,11765125,0,138143384,,209911622,209911622,52767,AOD
2019-12-28,,,150960000,3722000,119616000,493791000,788107000,294316000,294316000,,-135267000,,,,31513000,1413337000,1119021000,625230000,-143356000,,119447000,119616000,52769,WW
2018-12-29,,,244061000,3913000,223749000,477425000,866410000,388985000,388985000,,-142346000,,,,20493000,1514121000,1125136000,647711000,-144924000,,223568000,223749000,52769,WW
2017-12-30,,,145080000,4467000,163514000,412021000,692649000,280628000,280628000,,-112784000,,,,-18237000,1306911000,1026283000,614262000,-135548000,,163317000,163514000,52769,WW
2016-12-31,,,84127000,4699000,67699000,384690000,585501000,200811000,200811000,,-115160000,,,,16634000,1164902000,964091000,579401000,-116684000,,67493000,67699000,52769,WW
2019-12-31,,,6744000,,6475000,14473000,148883000,43501000,43501000,,-36757000,,,,269000,269065000,225564000,120182000,-36757000,,6475000,6475000,52770,FSP
2018-12-31,,,13429000,,13069000,13070000,152310000,45010000,45010000,,-38374000,,,,360000,268870000,223860000,116560000,-31581000,,13069000,13069000,52770,FSP
2017-12-31,,,-15544000,,-15944000,13471000,155535000,40806000,40806000,,-32387000,,,,400000,272588000,231782000,117053000,-56350000,,-15944000,-15944000,52770,FSP
2016-12-31,,,8796000,,8378000,14126000,143582000,36404000,36404000,,-26548000,,,,418000,249057000,212653000,105475000,-27608000,,8378000,8378000,52770,FSP
2020-06-30,,,-9805000,,-6509000,38791000,41880000,0,-1741000,4830000,,,,,-3296000,41880000,43621000,0,-8064000,,-6509000,-6509000,52771,PBFS
2019-06-30,,,23846000,,19016000,32807000,61736000,0,24522000,4407000,,,,,4830000,61736000,37214000,0,-676000,,19016000,19016000,52771,PBFS
2018-06-30,,,17809000,,11499000,30802000,54134000,0,18650000,4682000,,,,,6310000,54134000,35484000,0,-841000,,11499000,11499000,52771,PBFS
2017-06-30,,,8346000,,5631000,30416000,43712000,0,8978000,4318000,,,,,2715000,43712000,34734000,0,-632000,,5631000,5631000,52771,PBFS
2020-12-31,,,-1140000000,181000000,-1254000000,2302000000,2089000000,-233000000,-233000000,20000000,-324000000,,,,110000000,12321000000,12554000000,10232000000,-907000000,,-1250000000,-1254000000,52772,GT
2019-12-31,,,177000000,194000000,-311000000,2441000000,3147000000,703000000,703000000,3000000,-340000000,,,,474000000,14745000000,14042000000,11598000000,-526000000,,-297000000,-311000000,52772,GT
2018-12-31,,,1011000000,206000000,693000000,2433000000,3518000000,1049000000,1049000000,36000000,-321000000,,,,303000000,15475000000,14426000000,11957000000,-38000000,,708000000,693000000,52772,GT
2017-12-31,,,878000000,247000000,346000000,2341000000,3737000000,1393000000,1393000000,3000000,-335000000,,,,513000000,15377000000,13984000000,11640000000,-515000000,,365000000,346000000,52772,GT
2019-12-31,60438000,,-126038000,,-125580000,63061000,1119000,-122380000,-122380000,,-7163000,,,,-458000,2722000,125102000,1603000,-3658000,,-125580000,-125580000,52773,XERS
2018-12-31,40654000,,-60080000,,-60080000,21113000,2423000,-59344000,-59344000,,-2545000,,,,0,2423000,61767000,0,-736000,,-60080000,-60080000,52773,XERS
2017-12-31,20166000,,-26554000,,-26554000,8015000,1552000,-26629000,-26629000,,-2000,,,,0,1556000,28185000,4000,75000,,-26554000,-26554000,52773,XERS
2016-12-31,10238000,,-13209000,,-13209000,4060000,1067000,-13231000,-13231000,,-2000,,,,0,1075000,14306000,8000,22000,,-13209000,-13209000,52773,XERS
2019-12-31,,,-45980000,4695000,-39530000,38162000,3102000,-36540000,-36540000,,-2684000,,,,0,7834000,44374000,4732000,-9440000,,-45980000,-39530000,52774,CLVR
2018-12-31,,,6405000,12896000,7361000,5309000,0,-5408000,-5408000,,-390000,,,,-126000,0,5408000,0,11813000,,6531000,7361000,52774,CLVR
2019-12-31,2810000,,-26667000,,-26727000,25662000,8191000,-23933000,-23933000,,-440000,,,,-28000,24079000,48012000,15888000,-2734000,-88000,-26639000,-27156000,52775,IDXG
2018-12-31,2124000,,-12187000,,-12189000,16920000,11699000,-10597000,-10597000,,-331000,,,,18000,21896000,32493000,10197000,-1590000,16000,-12205000,-12189000,52775,IDXG
2017-12-31,1461000,,-13132000,,-12216000,17220000,8539000,-13395000,-13395000,,-433000,,,,-395000,15897000,29292000,7358000,263000,521000,-12737000,-12216000,52775,IDXG
2016-12-31,1647000,,-8572000,,-8332000,15966000,6444000,-14939000,-14939000,,-2144000,,,,-162000,13085000,28024000,6641000,6367000,78000,-8410000,-8332000,52775,IDXG
2019-12-31,,,-29681000,,-29681000,6026000,-23061000,-29087000,-29087000,,,,,,0,1022000,30109000,24083000,-594000,,-29681000,-29681000,52776,ARDS
2018-12-31,,,-22105000,,-22105000,3874000,-20243000,-24117000,-24117000,,,,,,0,2757000,26874000,23000000,2012000,,-22105000,-23462000,52776,ARDS
2017-12-31,,,-24656000,,-24656000,3160000,-16578000,-19738000,-19738000,,,,,,0,860000,20598000,17438000,-4918000,,-24656000,-27449000,52776,ARDS
2016-12-31,,,-8422000,,-8422000,1965000,-5919000,-7884000,-7884000,,-366000.0,,,,0,2269000,10153000,8188000,-538000,,-8422000,-8887000,52776,ARDS
2019-12-31,,,342069000,336000,242202000,450690000,1041334000,396092000,396092000,,-35489000,,,,99842000,2859732000,2463640000,1818398000,-54023000,,242227000,242202000,52779,ATR
2018-12-31,,,266020000,315000,194745000,420357000,951800000,359696000,359696000,,-32626000,,,,71254000,2764761000,2405065000,1812961000,-93676000,,194766000,194745000,52779,ATR
2017-12-31,,,294825000,310000,220030000,387424000,866213000,325695000,325695000,,-40597000,,,,74796000,2469283000,2143588000,1603070000,-30870000,,220029000,220030000,52779,ATR
2016-12-31,,,280497000,292000,205590000,363858000,834760000,316100000,316100000,,-35237000,,,,74893000,2330934000,2014834000,1496174000,-35603000,,205604000,205590000,52779,ATR
2019-12-31,,,-4450994,,-4450994,3429078,-360286,-3802375,-3802375,,,,,,0,383458,4185833,743744,-648619,,-4450994,-4450994,52781,LLIT
2018-12-31,,,-8910002,,-8910002,5758294,-198515,-5979038,-5979038,,-200799.0,,,,0,559386,6538424,757901,-2930964,,-8910002,-8910002,52781,LLIT
2017-12-31,,,-5136434,,-5136434,4362408,-773959,-5058018,-5058018,-54741.0,-6246.0,,,,0,882011,5940029,1655970,-78416,,-5136434,-5136434,52781,LLIT
2016-12-31,,,-9704761,,-9731868,5111018,-4116687,-9083968,-9083968,6543.0,-128537.0,,,,-95026,13062373,22146341,17179060,-620793,-251153.0,-9609735,-9731868,52781,LLIT
2020-02-01,,,-181000000,4000000,-366000000,4306000000,5547000000,1241000000,1241000000,,-378000000,,,,185000000,12914000000,11673000000,7367000000,-1422000000,,-366000000,-366000000,52782,LB
2019-02-02,,,857000000,4000000,644000000,4289000000,5749000000,1460000000,1460000000,,-385000000,,,,213000000,13237000000,11777000000,7488000000,-603000000,,644000000,644000000,52782,LB
2018-02-03,,,1312000000,2000000,983000000,3940000000,5668000000,1728000000,1728000000,,-406000000,,,,329000000,12632000000,10904000000,6964000000,-416000000,,983000000,983000000,52782,LB
2017-01-28,,,1696000000,2000000,1158000000,3776000000,5814000000,2038000000,2038000000,,-394000000,,,,538000000,12574000000,10536000000,6760000000,-342000000,,1158000000,1158000000,52782,LB
2019-12-31,710000,,-6352000,,-12085000,16625000,20298000,200000,200000,,-1045000,,,,5733000,82975000,82775000,62677000,-6552000,,-12085000,-12085000,52786,GVP
2018-12-31,899000,,777000,,-354000,16929000,23130000,3175000,3175000,,-371000,,,,1131000,92249000,89074000,69119000,-2398000,,-354000,-354000,52786,GVP
2017-12-31,1391000,,404000,,6557000,15023000,18544000,1453000,1453000,,-371000,,,,-6153000,70880000,69427000,52336000,-1049000,,6557000,6557000,52786,GVP
2016-12-31,1261000,,1772000,,1422000,12467000,16258000,1858000,1858000,,-371000,,,,350000,53101000,51243000,36843000,-86000,,1422000,1422000,52786,GVP
2019-12-31,,,-36100000,13400000,-93200000,759000000,1190900000,241900000,241900000,20800000,-153300000,,,,56600000,6276200000,6034300000,5085300000,-278000000,,-92700000,-93200000,52788,RRD
2018-12-31,,,28300000,14700000,-11000000,812800000,1255400000,261400000,261400000,-200000,-172500000,,,,37900000,6800200000,6538800000,5544800000,-211200000,,-9600000,-11000000,52788,RRD
2017-12-31,,,75500000,14700000,-34400000,845300000,1316200000,279500000,279500000,-200000,-182400000,,,,108700000,6939600000,6660100000,5623400000,-155300000,,-33200000,-34400000,52788,RRD
2016-12-31,,,-497200000,13500000,-495900000,894300000,1348700000,250200000,250200000,-200000,-203300000,,,,-12300000,6833000000,6582800000,5484300000,-747400000,-9700000.0,-484900000,-495900000,52788,RRD
2019-12-31,,,-528000,-3417000,-1602000,21120000,21043000,-77000,-77000,,-51000,,,,1091000,55858000,55935000,34815000,-451000,,-1619000,-1602000,52791,INOD
2018-12-31,,,1562000,-3400000,-253000,18414000,20684000,2270000,2270000,,-33000,,,,1808000,57418000,55148000,36734000,-708000,,-246000,-253000,52791,INOD
2017-12-31,,,-5074000,-3938000,-5055000,22900000,17803000,-5097000,-5097000,,-33000,,,,285000,60929000,66026000,43126000,23000,,-5359000,-5055000,52791,INOD
2016-12-31,,,-4785000,-3634000,-5524000,22239000,18555000,-3684000,-3684000,,-63000,,,,1126000,63074000,66758000,44519000,-1101000,,-5911000,-5524000,52791,INOD
2020-12-31,,,-266000000,,-266000000,56000000,-173000000,0,-266000000,37000000,,,,,0,-173000000,93000000,0,0,,-266000000,-362000000,52792,AGNCM
2019-12-31,,,688000000,,688000000,47000000,771000000,0,688000000,35500000,,,,,0,771000000,83000000,0,0,,688000000,628000000,52792,AGNCM
2018-12-31,,,129000000,,129000000,45000000,229000000,0,156000000,27500000,,,,,0,229000000,73000000,0,-27000000,,129000000,93000000,52792,AGNCM
2017-12-31,,,771000000,,771000000,42000000,844000000,0,771000000,30500000,,,,,0,844000000,73000000,0,0,,771000000,733000000,52792,AGNCM
2020-12-31,,,37132000,,32192000,,107797000,0,37132000,70665000,,,,,4940000,107797000,70665000,0,0,,32192000,32192000,52793,CIVB
2019-12-31,,,39561000,,33878000,52846000.0,106508000,0,40644000,13018000,,,,,5683000,106508000,65864000,0,-1083000,,33878000,33231000,52793,CIVB
2018-12-31,,,16779000,,14139000,43487000.0,83458000,0,30417000,9554000,,,,,2640000,83458000,53041000,0,-13638000,,14139000,13180000,52793,CIVB
2017-12-31,,,22232000,,15872000,39235000.0,70836000,0,23320000,8281000,,,,,6360000,70836000,47516000,0,-1088000,,15872000,14628000,52793,CIVB
2020-12-31,,,-266000000,,-266000000,56000000,-173000000,0,-266000000,37000000,,,,,0,-173000000,93000000,0,0,,-266000000,-362000000,52794,AGNC
2019-12-31,,,688000000,,688000000,47000000,771000000,0,688000000,35500000,,,,,0,771000000,83000000,0,0,,688000000,628000000,52794,AGNC
2018-12-31,,,129000000,,129000000,45000000,229000000,0,156000000,27500000,,,,,0,229000000,73000000,0,-27000000,,129000000,93000000,52794,AGNC
2017-12-31,,,771000000,,771000000,42000000,844000000,0,771000000,30500000,,,,,0,844000000,73000000,0,0,,771000000,733000000,52794,AGNC
2019-12-28,,,8934000,,7258000,31616000,42360000,9275000,9275000,,-356000,,,,1676000,180541000,171266000,138181000,-341000,,7258000,7258000,52795,ESCA
2018-12-29,,,26442000,,20442000,29807000,45030000,13817000,13817000,,-427000,,,,6000000,175780000,161963000,130750000,12625000,,20442000,20442000,52795,ESCA
2017-12-30,,,15517000,,14061000,28548000,44727000,14600000,14600000,,-804000,,,,1456000,177333000,162733000,132606000,917000,,14061000,14061000,52795,ESCA
2016-12-31,,,15542000,,11493000,27357000,44267000,14583000,14583000,,-834000,,,,4049000,171662000,157079000,127395000,959000,,11493000,11493000,52795,ESCA
2020-12-31,,,-24294000,,-19047000,19752000,-2656000,-22408000,-22408000,,-3009000,,,,-5247000,179731000,202139000,182387000,-1886000,,-19047000,-19047000,52797,USAP
2019-12-31,,,3773000,,4275000,19747000,27638000,7291000,7291000,,-3992000,,,,-502000,243007000,235716000,215369000,-3518000,,4275000,4275000,52797,USAP
2018-12-31,,,12597000,,10662000,21246000,37816000,16070000,16070000,,-4302000,,,,1935000,255927000,239857000,218111000,-3473000,,10662000,10662000,52797,USAP
2017-12-31,,,9000,,7610000,18497000,23034000,4237000,4237000,,-4277000,,,,-7601000,202643000,198406000,179609000,-4228000,,7610000,7610000,52797,USAP
2020-06-30,3437000,,-8311000,,-8311000,4716000,39000,-8114000,-8114000,,-197000,,,,0,488000,8602000,449000,-197000,,-8311000,-8311000,52799,ASTC
2019-06-30,3578000,,-8392000,,-7534000,4876000,37000,-8417000,-8417000,,-197000,,,,-858000,127000,8544000,90000,25000,,-7534000,-7534000,52799,ASTC
2018-06-30,6065000,,-13251000,,-13251000,5629000,50000,-11644000,-11644000,,-197000,,,,0,86000,11730000,36000,-1607000,,-13251000,-13251000,52799,ASTC
2017-06-30,5587000,,-11754000,,-11582000,7508000,1035000,-12060000,-12060000,,-197000,,,,2000,2328000,14388000,1293000,306000,,-11756000,-11582000,52799,ASTC
2020-12-31,,,91947000,,74384000,105745000,259106000,0,96121000,57240000,,,,,17563000,259106000,162985000,0,-4174000,,74384000,74384000,52801,EFSC
2019-12-31,,,116036000,,92739000,105685000,281521000,0,134005000,41831000,,,,,23297000,281521000,147516000,0,-17969000,,92739000,92739000,52801,EFSC
2018-12-31,,,104577000,,89217000,85044000,223369000,0,105848000,32477000,,,,,15360000,223369000,117521000,0,-1271000,,89217000,89217000,52801,EFSC
2017-12-31,,,86517000,,48190000,80530000,201179000,0,92979000,27670000,,,,,38327000,201179000,108200000,0,-6462000,,48190000,48190000,52801,EFSC
2019-12-31,,,204000000,,153000000,392000000,678000000,262000000,262000000,,-62000000,,,,51000000,1365000000,1103000000,687000000,-58000000,,153000000,153000000,52803,FTDR
2018-12-31,,,167000000,,125000000,338000000,571000000,212000000,212000000,,-23000000,,,,42000000,1258000000,1046000000,687000000,-45000000,,125000000,125000000,52803,FTDR
2017-12-31,,,220000000,,160000000,312000000,566000000,237000000,237000000,,-1000000,,,,60000000,1157000000,920000000,591000000,-17000000,,160000000,160000000,52803,FTDR
2016-12-31,,,195000000,,124000000,286000000,492000000,192000000,192000000,,-1000000,,,,71000000,1020000000,828000000,528000000,3000000,,124000000,124000000,52803,FTDR
2019-12-31,,,-49306000,,-49306000,13895000,-31732000,-45627000,-45627000,,,,,,0,6986000,52613000,38718000,-3679000,,-49306000,-49306000,52804,FDMT
2018-12-31,,,-9551000,,-9551000,6167000,-4232000,-10399000,-10399000,,,,,,0,14130000,24529000,18362000,848000,,-9551000,-9551000,52804,FDMT
2017-12-31,,,-11223000,,-11223000,3489000,-7783000,-11272000,-11272000,,,,,,0,5790000,17062000,13573000,49000,,-11223000,-11223000,52804,FDMT
2019-12-31,,,43843,,4903,327130,0,-327130,-327130,,,,,,38940,0,327130,0,370973,,4903,4903,52805,AMHC
2019-12-31,8082000,,-8353000,,-8353000,8739000,2758000,-14835000,-14835000,,-2118000,,,,0,7070000,21905000,4312000,6482000,,-8353000,-8353000,52806,NNDM
2018-12-31,8623000,,-15488000,,-15488000,7261000,1506000,-15150000,-15150000,,-2118000,,,,0,5100000,20250000,3594000,-338000,,-15488000,-15488000,52806,NNDM
2017-12-31,10819000,,-17503000,,-17503000,5546000,420000,-16688000,-16688000,,-2118000,,,,0,829000,17517000,409000,-815000,,-17503000,-17503000,52806,NNDM
2016-12-31,4043000,,-8976000,,-8976000,4824000,27000,-9014000,-9014000,,-2118000,,,,0,46000,9060000,19000,38000,,-8976000,-8976000,52806,NNDM
2020-12-31,,,45182000,,34674000,110534000,183113000,0,55944000,16635000,,,,,10508000,183113000,127169000,0,-10762000,,34674000,34674000,52807,FFIC
2019-12-31,,,53331000,,41279000,99259000,168600000,0,54404000,14937000,,,,,12052000,168600000,114196000,0,-1073000,,41279000,41279000,52807,FFIC
2018-12-31,,,65485000,,55090000,94454000,177168000,0,67479000,15235000,,,,,10395000,177168000,109689000,0,-1994000,,55090000,55090000,52807,FFIC
2017-12-31,,,66134000,,41121000,90066000,173608000,0,68303000,15239000,,,,,25013000,173608000,105305000,0,-2169000,,41121000,41121000,52807,FFIC
2019-12-31,23385000,,-28119000,,-28138000,8416000,995000,-30806000,-30806000,,,,,,19000,995000,31801000,0,2687000,,-28138000,-28138000,52811,ACET
2018-12-31,14717000,,-9888000,,-9299000,8428000,8181000,-14964000,-14964000,,,,,,-589000,8181000,23145000,0,5076000,,-9299000,-9299000,52811,ACET
2019-12-31,,,-3249890,,-3115703,4067852,3662045,-3249890,-3249890,2844083,,,,,-134187,31372814,34622704,27710769,0,,-3115703,-3115703,52812,UNAM
2018-12-31,,,-3926792,,-3169559,4592841,3969521,-3926792,-3926792,3303472,,,,,-757233,33612796,37539588,29643275,0,,-3169559,-3169559,52812,UNAM
2017-12-31,,,-9880221,,-8724984,5843714,-329342,-9880221,-9880221,3707165,,,,,-1155237,36791482,46671703,37120824,0,,-8724984,-8724984,52812,UNAM
2016-12-31,,,-2114238,,-1404277,4926652,5384152,-2114238,-2114238,2571738,,,,,-709961,35267724,37381962,29883572,0,,-1404277,-1404277,52812,UNAM
2019-12-31,,,77400000,,57700000,821600000,924200000,92600000,92600000,,-14900000,,,,19700000,13329200000,13236600000,12405000000,-15200000,,57700000,57700000,52815,CORE
2018-12-31,,,59900000,,45500000,783000000,867500000,74500000,74500000,,-14000000,,,,14400000,12903900000,12829400000,12036400000,-14600000,,45500000,45500000,52815,CORE
2017-12-31,,,28400000,,33500000,726600000,791700000,56600000,56600000,,-11300000,,,,-5100000,12225000000,12168400000,11433300000,-28200000,,33500000,33500000,52815,CORE
2016-12-31,,,85500000,,54200000,641300000,736900000,90300000,90300000,,-5300000,,,,31300000,11507400000,11417100000,10770500000,-4800000,,54200000,54200000,52815,CORE
2019-12-31,,,16672963,,16672963,1024676,2194838,1170162,1170162,,,,,,0,2194838,1024676,0,15502801,,16672963,16672963,52817,EEA
2018-12-31,,,-14835040,,-14835040,1079667,1713261,633594,633594,,,,,,0,1713261,1079667,0,-15468634,,-14835040,-14835040,52817,EEA
2017-12-31,,,18318583,,18318583,1158992,1669253,510261,510261,,,,,,0,1669253,1158992,0,17808322,,18318583,18318583,52817,EEA
2016-12-31,,,-1684584,,-1684584,1141706,2037409,895703,895703,,,,,,0,2037409,1141706,0,-2580287,,-1684584,-1684584,52817,EEA
2019-12-31,,,177950000,,165664000,591896000,779851000,0,187955000,,,,,,12286000,972317000,784362000,192466000,-10005000,,165664000,143159000,52821,FUTU
2018-12-31,,,200800000,,138512000,352990000,561749000,0,208759000,,,,,,62288000,715719000,506960000,153970000,-7959000,,138512000,36938000,52821,FUTU
2017-12-31,,,3378000,,-8102000,194265000,202561000,0,8296000,,,,,,11480000,291784000,283488000,89223000,-4918000,,-8102000,-55817000,52821,FUTU
2016-12-31,,,-111747000,,-98471000,152608000,41946000,0,-110662000,,,,,,-13276000,83556000,194218000,41610000,-1085000,,-98471000,-116400000,52821,FUTU
2019-12-31,,,4494718,,3498714,10986700,15600060,4613360,4613360,,-118642,,,,996004,42259487,37646127,26659427,-118642,,3498714,3498714,52824,OBCI
2018-12-31,,,3586279,,2795249,10689016,14397189,3708173,3708173,,-121894,,,,791030,41799545,38091372,27402356,-121894,,2795249,2795249,52824,OBCI
2017-12-31,,,3677495,,2603534,9956416,13631846,3675430,3675430,,-121894,,,,1073961,37940978,34265548,24309132,2065,,2603534,2603534,52824,OBCI
2016-12-31,,,3078322,,2095171,9631541,13873683,4242142,4242142,,-17820,,,,983151,36205444,31963302,22331761,-1163820,,2095171,2095171,52824,OBCI
2019-12-31,154180000,,-172871000,,-172871000,15027000,152000,-169055000,-169055000,,-5287000,,,,0,152000,169207000,0,-3816000,,-172871000,-172871000,52826,TGTX
2018-12-31,159391000,,-173482000,,-173482000,15161000,152000,-174400000,-174400000,,-877000,,,,0,152000,174552000,0,918000,,-173482000,-173482000,52826,TGTX
2017-12-31,102533000,,-118476000,,-118476000,16331000,152000,-118712000,-118712000,,-845000,,,,0,152000,118864000,0,236000,,-118476000,-118476000,52826,TGTX
2016-12-31,69232000,,-78253000,,-78253000,9889000,152000,-78969000,-78969000,,-845000,,,,0,152000,79121000,0,716000,,-78253000,-78253000,52826,TGTX
2019-12-31,52885000,,-66894000,,-66894000,74588000,5497000,-69091000,-69091000,,-335000,,,,0,59288000,128379000,53791000,2197000,,-66894000,-66894000,52831,RIGL
2018-12-31,46903000,,-70480000,,-70480000,70002000,-2681000,-72683000,-72683000,,-335000,,,,0,44509000,117192000,47190000,2203000,,-70480000,-70480000,52831,RIGL
2017-12-31,46903000,,-77992000,,-77992000,37831000,-41785000,-79616000,-79616000,,-335000,,,,0,4484000,84100000,46269000,1624000,,-77992000,-77992000,52831,RIGL
2016-12-31,46903000,,-69216000,,-69216000,20908000,-43063000,-63971000,-63971000,,-335000,,,,0,20383000,84354000,63446000,-5245000,,-69216000,-69216000,52831,RIGL
2019-12-31,270100000,,78200000,,67900000,760200000,1600700000,370000000,370000000,,-78900000,,,,10300000,3071000000,2701000000,1470300000,-291800000,,67900000,67900000,52832,ELAN
2018-12-31,246600000,,114100000,,86500000,735200000,1531600000,352400000,352400000,,-29600000,,,,27600000,3066800000,2714400000,1535200000,-238300000,,86500000,86500000,52832,ELAN
2017-12-31,251700000,,-232600000,,-310700000,779800000,1437800000,185100000,185100000,,-29600000,,,,78100000,2889000000,2703900000,1451200000,-417700000,,-310700000,-310700000,52832,ELAN
2016-12-31,265800000,,-22400000,,-47900000,784800000,1504500000,283200000,283200000,,-29600000,,,,25500000,2913500000,2630300000,1409000000,-305600000,,-47900000,-47900000,52832,ELAN
2019-12-31,,,241000000,,214000000,295000000,1186000000,348000000,348000000,134000000,-133000000,,,,27000000,2123000000,1775000000,937000000,-107000000,,214000000,214000000,52836,POR
2018-12-31,,,229000000,,212000000,292000000,1128000000,325000000,325000000,129000000,-130000000,,,,17000000,1991000000,1666000000,863000000,-96000000,,212000000,212000000,52836,POR
2017-12-31,,,273000000,,187000000,267000000,1108000000,373000000,373000000,123000000,-126000000,,,,86000000,2009000000,1636000000,901000000,-100000000,,187000000,187000000,52836,POR
2016-12-31,,,243000000,,193000000,252000000,1020000000,328000000,328000000,119000000,-123000000,,,,50000000,1923000000,1595000000,903000000,-85000000,,193000000,193000000,52836,POR
2020-12-31,,,532000000,14000000,412000000,,569000000,0,547000000,,,,,,120000000,1533000000,986000000,964000000,-15000000,,412000000,412000000,52837,NAVI
2019-12-31,,,763000000,13000000,597000000,488000000.0,1738000000,0,724000000,496000000.0,,,,,166000000,1738000000,1014000000,1014000000,39000000,,597000000,597000000,52837,NAVI
2018-12-31,,,528000000,28000000,395000000,507000000.0,1553000000,0,538000000,477000000.0,,,,,133000000,1553000000,1015000000,0,-10000000,,395000000,395000000,52837,NAVI
2017-12-31,,,764000000,31000000,292000000,519000000.0,1785000000,0,796000000,447000000.0,,,,,472000000,1785000000,989000000,0,-35000000,,292000000,292000000,52837,NAVI
2019-12-31,,,-174529000,,-174683000,37598000,-134981000,-172579000,-172579000,,,,,,154000,8091000,180670000,143072000,-1950000,,-174683000,-174683000,52838,VIR
2018-12-31,,,-116364000,,-115884000,28231000,-89561000,-117792000,-117792000,,,,,,-480000,10668000,128460000,100229000,1428000,,-115884000,-115884000,52838,VIR
2017-12-31,,,-80776000,,-69852000,21693000,-59804000,-81497000,-81497000,,,,,,-10924000,2708000,84205000,62512000,721000,,-69852000,-69852000,52838,VIR
2019-12-31,457000000,,1801000000,,1500000000,1564000000,4369000000,2193000000,2193000000,,-223000000,,,,301000000,6260000000,4067000000,1891000000,-392000000,,1500000000,1500000000,52840,ZTS
2018-12-31,432000000,,1690000000,,1428000000,1450000000,3949000000,1950000000,1950000000,,-206000000,,,,266000000,5825000000,3875000000,1876000000,-260000000,,1424000000,1428000000,52840,ZTS
2017-12-31,382000000,,1525000000,16000000.0,864000000,1325000000,3546000000,1748000000,1748000000,,-175000000,,,,663000000,5307000000,3559000000,1761000000,-223000000,,862000000,864000000,52840,ZTS
2016-12-31,376000000,,1228000000,12000000.0,821000000,1316000000,3241000000,1464000000,1464000000,,-166000000,,,,409000000,4888000000,3424000000,1647000000,-236000000,,819000000,821000000,52840,ZTS
2019-12-31,,,1466000,,893000,1870000,4145000,2275000,2275000,,-474000,,,,2000,25317000,23042000,21172000,-809000,-571000,1464000,893000,52841,CHCI
2018-12-31,,,345000,15706000.0,-4385000,830000,1123000,293000,293000,,-90000,,,,-1062000,16447000,16154000,15324000,52000,-5792000,1407000,-4385000,52841,CHCI
2017-12-31,,,-4740000,16986000.0,-5025000,6787000,2548000,-4239000,-4239000,,-41000,,,,38000,45430000,49669000,42882000,-501000,-5792000,-4778000,-4092000,52841,CHCI
2016-12-31,,,-6707000,18252000.0,-8993000,7192000,2917000,-4280000,-4280000,5000.0,-881000,,,,55000,41580000,45860000,38663000,-2427000,-5792000,-6762000,-9341000,52841,CHCI
2020-12-31,,,74396000,,59486000,81112000,174379000,0,76910000,16357000,,,,,14910000,174379000,97469000,0,-2514000,,59486000,59486000,52844,CAC
2019-12-31,,,71579000,,57203000,76123000,166883000,0,74026000,16734000,,,,,14376000,166883000,92857000,0,-2447000,,57203000,57083000,52844,CAC
2018-12-31,,,65777000,,53071000,72500000,157716000,0,69368000,15848000,,,,,12706000,157716000,88348000,0,-3591000,,53071000,52923000,52844,CAC
2017-12-31,,,62354000,,28476000,69005000,150641000,0,67077000,14559000,,,,,33878000,150641000,83564000,0,-4723000,,28476000,28358000,52844,CAC
2020-09-30,,,232603000,120986000,-186370000,188235000,709560000,521325000,521325000,,-159914000,,,,45753000,13239976000,12718651000,12530416000,-288722000,-356822000,186850000,-186370000,52845,ACM
2019-09-30,,,249170000,208774000,-261050000,148323000,611655000,463332000,463332000,,-161482000,,,,13498000,13642455000,13179123000,13030800000,-214162000,-472012000,235672000,-261050000,52845,ACM
2018-09-30,,,212208000,185594000,136468000,135587000,479033000,343446000,343446000,,-201023000,,,,-3494000,13878316000,13534870000,13399283000,-131238000,-59037000,215702000,136468000,52845,ACM
2017-09-30,,,429182000,218560000,339390000,125409000,683720000,558311000,558311000,,-231310000,,,,7706000,18203402000,17645091000,17519682000,-129129000,-59037000,421476000,339390000,52845,ACM
2020-12-31,,,18698000,4000,15206000,30316000,57766000,0,20842000,6608000,,,,,3474000,57766000,36924000,0,-2144000,,15224000,15206000,52847,PWOD
2019-12-31,,,18824000,22000,15672000,30688000,58532000,0,21486000,6358000,,,,,3138000,58532000,37046000,0,-2662000,,15686000,15672000,52847,PWOD
2018-12-31,,,17529000,8000,14704000,29750000,55536000,0,19431000,6355000,,,,,2819000,55536000,36105000,0,-1902000,,14710000,14704000,52847,PWOD
2017-12-31,,,17232000,2000,9773000,27672000,54094000,0,19212000,7210000,,,,,7459000,54094000,34882000,0,-1980000,,9773000,9773000,52847,PWOD
2019-12-31,,,377321122000,262585666000,296153605000,139343582000,1170135082000,691751117000,691751117000,102412996000,-88800080000,,,,61227904000,2624576323000,1932825206000,1454441241000,-314429995000,,316093218000,296153605000,52848,ENIC
2018-12-31,,,566330276000,252935262000,361709937000,132095787000,1093064897000,650754141000,650754141000,95027669000,-77260497000,,,,153482519000,2410360459000,1759606318000,1317295562000,-84423865000,,412847757000,361709937000,52848,ENIC
2017-12-31,,,666760212000,803577647000,349382642000,126683104000,965797385000,607696532000,607696532000,78733643000,-39453547000,,,,143342301000,2484101582000,1876405050000,1518304197000,59063680000,,523417911000,349382642000,52848,ENIC
2016-12-31,,,681047828400,699602354000,381073345200,135619308000,1038703251600,626751693600,626751693600,108861762000,-44436586800,,,,119716557600,2535470152800,1908718459200,1496766901200,54296134800,,561331270800,381073345200,52848,ENIC
2019-12-31,14183000,,-14669000,,-14669000,17778000,18331000,-13630000,-13630000,,-747000,,,,0,37503000,51133000,19172000,-1039000,,-14669000,-14669000,52850,MRAM
2018-12-31,23637000,,-17754000,,-17754000,19018000,25334000,-17321000,-17321000,,-890000,,,,0,49417000,66738000,24083000,-433000,,-17754000,-17754000,52850,MRAM
2017-12-31,25437000,,-21100000,,-21100000,16256000,21485000,-20208000,-20208000,,-764000,,,,0,35936000,56144000,14451000,-892000,,-21100000,-21100000,52850,MRAM
2016-12-31,19233000,,-16708000,,-16708000,10987000,14699000,-15521000,-15521000,,-2347000,,,,0,27094000,42615000,12395000,-1187000,,-16708000,-16708000,52850,MRAM
2020-01-31,67079000,,26362000,,25305000,427487000,507262000,12696000,12696000,,,,,,1057000,622658000,609962000,115396000,13666000,,25305000,21750000,52856,ZM
2019-01-31,33014000,,8349000,,7584000,230335000,269516000,6167000,6167000,,-200000.0,,,,765000,330517000,324350000,61001000,2527000,,25305000,21750000,52856,ZM
2018-01-31,15733000,,-3518000,,-3822000,109798000,120698000,-4833000,-4833000,,-200000.0,,,,304000,151478000,156311000,30780000,1389000,,-3822000,-8227000,52856,ZM
2017-01-31,9218000,,158000,,-14000,39127000,48345000,0,-4833000,,-200000.0,,,,172000,60817000,60817000,12472000,158000,,-14000,-14380000,52856,ZM
2020-12-31,4450000000,,7219000000,211000000,5143000000,8077000000,19705000000,7002000000,7002000000,176000000,-179000000,,,,1938000000,27338000000,20336000000,7633000000,217000000,,5281000000,5143000000,52857,SAP
2019-12-31,4292000000,,4597000000,76000000,3321000000,9322000000,19198000000,5602000000,5602000000,-18000000,-362000000,,,,1226000000,27553000000,21951000000,8355000000,-1005000000,,3371000000,3321000000,52857,SAP
2018-12-31,3624000000,,5600000000,45000000,4083000000,7879000000,17245000000,5722000000,5722000000,20000000,-312000000,,,,1511000000,24707000000,18985000000,7462000000,-122000000,,4089000000,4083000000,52857,SAP
2017-12-31,3352000000,,5029000000,31000000,4008000000,7999000000,16409000000,5059000000,5059000000,-1000000,-205000000,,,,983000000,23461000000,18402000000,7052000000,-30000000,,4046000000,4008000000,52857,SAP
2019-12-31,,,202126000,,157636000,662445000,1981929000,472568000,472568000,570347000,-237465000,,,,44490000,3326119000,2853551000,1344190000,-270442000,,157636000,157636000,52858,BYD
2018-12-31,,,155032000,,115048000,494196000,1495824000,356277000,356277000,415372000,-204188000,,,,40331000,2626730000,2270453000,1130906000,-201245000,347000.0,114701000,115048000,52858,BYD
2017-12-31,,,171113000,,189390000,450185000,1351936000,343375000,343375000,340854000,-173108000,,,,3115000,2400819000,2057444000,1048883000,-172262000,21392000.0,167998000,189390000,52858,BYD
2016-12-31,,,7768000,50000.0,420231000,394927000,1233954000,298710000,298710000,344091000,-212692000,,,,-199933000,2199259000,1900549000,965305000,-290942000,212530000.0,207701000,420231000,52858,BYD
2019-12-31,,,440000,,449000,12291000,16404000,0,366000,3747000,,,,,-9000,16404000,16038000,0,74000,,449000,449000,52861,BCOW
2018-12-31,,,-196000,,-19000,12016000,15339000,0,72000,3251000,,,,,-177000,15339000,15267000,0,-268000,,-19000,-19000,52861,BCOW
2017-12-31,,,-1803000,,1659000,10616000,14787000,0,425000,3746000,,,,,-3462000,14787000,14362000,0,-2228000,,1659000,1659000,52861,BCOW
2016-12-31,,,1254000,,1254000,10714000,15267000,0,1443000,3110000,,,,,0,15267000,13824000,0,-189000,,1254000,1254000,52861,BCOW
2020-12-31,,,1831000000,,1534000000,3120000000,5816000000,2696000000,2696000000,,-865000000,,,,297000000,11958000000,9262000000,6142000000,-865000000,,1534000000,1534000000,52866,AMP
2019-12-31,,,2232000000,,1893000000,3287000000,6325000000,3038000000,3038000000,,-1019000000,,,,339000000,12890000000,9852000000,6565000000,-806000000,,1893000000,1893000000,52866,AMP
2018-12-31,,,2484000000,,2098000000,3171000000,6663000000,3492000000,3492000000,,-1008000000,,,,386000000,12924000000,9432000000,6261000000,-1008000000,,2098000000,2098000000,52866,AMP
2017-12-31,,,2214000000,,1480000000,3158000000,6283000000,3125000000,3125000000,,-911000000,,,,734000000,12180000000,9055000000,5897000000,-911000000,,1480000000,1480000000,52866,AMP
2020-09-30,20623175,,-26257806,,-26280470,6090032,0,-26713207,-26713207,,,,,,22664,0,26713207,0,455401,,-26280470,-26280470,52868,AVXL
2019-09-30,19604242,,-26212798,,-26294979,7037015,0,-26641257,-26641257,,,,,,82181,0,26641257,0,428459,,-26294979,-26294979,52868,AVXL
2018-09-30,11362830,,-17179990,,-17252736,6140575,0,-17503405,-17503405,,,,,,72746,0,17503405,0,323415,,-17252736,-17252736,52868,AVXL
2017-09-30,8649184,,-13400798,,-13460405,5008275,0,-13657459,-13657459,,,,,,59607,0,13657459,0,256661,,-13460405,-13460405,52868,AVXL
2020-03-31,,,13428955,,13428955,696749,10247210,9550461,9550461,,,,,,0,10247210,696749,0,3878494,,13428955,13428955,52869,NXP
2019-03-31,,,15433202,,15433202,659997,10102119,9442122,9442122,,,,,,0,10102119,659997,0,5991080,,15433202,15433202,52869,NXP
2018-03-31,,,11221911,,11221911,689569,9953720,9264151,9264151,,,,,,0,9953720,689569,0,1957760,,11221911,11221911,52869,NXP
2017-03-31,,,1408481,,1408481,716082,10018688,9302606,9302606,,262937.0,,,,0,10018688,716082,0,-7894125,,1408481,1408481,52869,NXP
2020-07-31,97879000,,-112728000,,-115116000,331411000,335536000,-93754000,-93754000,,-5025000,,,,2388000,431269000,525023000,95733000,-18974000,,-115116000,-115116000,52870,ZS
2019-07-31,61969000,,-27912000,,-28655000,203132000,243167000,-21934000,-21934000,,-5025000,,,,743000,302836000,324770000,59669000,-5978000,,-28655000,-28655000,52870,ZS
2018-07-31,39379000,,-38641000,,-39978000,139505000,152299000,-26585000,-26585000,,-6332000,,,,1337000,190174000,216759000,37875000,-12056000,,-39978000,-39978000,52870,ZS
2017-07-31,29161000,,-44153000,,-45030000,93930000,98245000,-24846000,-24846000,,-9570000,,,,877000,125717000,150563000,27472000,-19307000,,-45030000,-45030000,52870,ZS
2019-12-31,15108000,,5264000,,5207000,44591000,64918000,7063000,7063000,-1844000,-438000,,,,57000,158381000,151318000,93463000,-1799000,,5207000,2371000,52871,UCL
2018-12-31,20401000,,-26557000,,-26557000,49577000,46155000,-23164000,-23164000,-659000,-3385000,,,,0,126399000,149563000,80244000,-3393000,,-26557000,-28766000,52871,UCL
2017-12-31,13255000,,-19260000,,-19260000,33859000,29532000,-17362000,-17362000,-220000,-3299000,,,,0,85845000,103207000,56313000,-1898000,,-19260000,-20950000,52871,UCL
2020-09-30,,,-65813013,,-65813013,15406964,21521576,6114612,6114612,,-14938000,,,,0,21521576,15406964,0,-71927625,,-65813013,-65813013,52872,PFX
2019-09-30,,,-96575067,,-96575067,43116693,46298751,3182058,3182058,,-24052000,,,,0,46298751,43116693,0,-99757125,,-96575067,-96575067,52872,PFX
2018-09-30,,,-110766080,,-110924002,26340046,66820598,40480552,40480552,,-26262000,,,,157922,66820598,26340046,0,-151246632,,-110924002,-110924002,52872,PFX
2017-09-30,,,-14809463,,-15076646,28216176,96256078,68039902,68039902,,-28908000,,,,267183,96256078,28216176,0,-82849365,,-15076646,-15076646,52872,PFX
2019-12-31,820906,,-2440343,,-2440343,1669160,0,-2490066,-2490066,,,,,,0,0,2490066,0,49723,,-2440343,-2440343,52873,LIXT
2018-12-31,40703,,-2133128,,-2133128,2097348,0,-2138051,-2138051,,,,,,0,0,2138051,0,4923,,-2133128,-2133128,52873,LIXT
2017-12-31,467258,,-1808414,,-1808414,1342531,0,-1809789,-1809789,,,,,,0,0,1809789,0,1375,,-1808414,-1808414,52873,LIXT
2016-12-31,870006,,-2134732,,-2134732,1264909,0,-2134915,-2134915,,,,,,0,0,2134915,0,183,,-2134732,-2134732,52873,LIXT
2019-12-31,,,106000000,115000000,70000000,206000000,326000000,115000000,115000000,,-13000000,,,,24000000,2945000000,2830000000,2619000000,-9000000,-1000000,82000000,70000000,52875,VC
2018-12-31,,,216000000,117000000,164000000,188000000,411000000,221000000,221000000,,-14000000,,,,43000000,2984000000,2763000000,2573000000,-5000000,1000000,173000000,164000000,52875,VC
2017-12-31,,,223000000,124000000,176000000,211000000,491000000,277000000,277000000,,-21000000,,,,48000000,3146000000,2869000000,2655000000,-54000000,17000000,175000000,176000000,52875,VC
2016-12-31,,,161000000,138000000,75000000,210000000,456000000,244000000,244000000,,-18000000,,,,30000000,3161000000,2917000000,2705000000,-83000000,-40000000,131000000,75000000,52875,VC
2019-12-31,,,80787000,,63116000,114385000,353839000,109924000,109924000,40310000,-44891000,,,,17671000,714557000,604633000,360718000,-29137000,,63116000,63116000,52878,CWT
2018-12-31,,,81456000,,65584000,110224000,355651000,119686000,119686000,41960000,-39917000,,,,15872000,698196000,578510000,342545000,-38230000,,65584000,65584000,52878,CWT
2017-12-31,,,109767000,,72940000,103096000,351192000,132592000,132592000,38721000,-36288000,,,,36827000,676113000,543521000,324921000,-22825000,,72940000,72940000,52878,CWT
2016-12-31,,,75491000,,48675000,98678000,300821000,104015000,104015000,34529000,-33466000,,,,26816000,609370000,505355000,308549000,-28524000,,48675000,48675000,52878,CWT
2020-12-31,,,102633000,,83246000,160664000,288090000,0,105797000,21629000,,,,,19387000,288090000,182293000,0,-3164000,,83246000,83246000,52880,RBCAA
2019-12-31,,,113193000,,91699000,148758000,277291000,0,106433000,22100000,,,,,21494000,277291000,170858000,0,6760000,,91699000,91699000,52880,RBCAA
2018-12-31,,,94263000,,77852000,139805000,257633000,0,95851000,21977000,,,,,16411000,257633000,161782000,0,-1588000,,77852000,77852000,52880,RBCAA
2017-12-31,,,78386000,,45632000,127903000,228055000,0,80152000,20000000,,,,,32754000,228055000,147903000,0,-1766000,,45632000,45632000,52880,RBCAA
2019-12-31,,,130811000,,129569000,25666000,243373000,207624000,207624000,,-50258000,,,,1242000,243373000,35749000,0,-78052000,,129569000,129569000,52881,MAIN
2018-12-31,,,174365000,,168213000,24066000,233355000,200138000,200138000,,-43493000,,,,6152000,233355000,33217000,0,-25773000,,168213000,168213000,52881,MAIN
2017-12-31,,,195093000,,170622000,23864000,205741000,171850000,171850000,,-36479000,,,,24471000,205741000,33891000,0,23243000,,170622000,170622000,52881,MAIN
2016-12-31,,,137672000,,138899000,20603000,178339000,149432000,149432000,,-33630000,,,,-1227000,178339000,28907000,0,-11760000,,138899000,138899000,52881,MAIN
2019-12-31,,,29669000,81454000,14756000,106495000,260982000,73880000,73880000,,-48044000,,,,6229000,1154179000,1080299000,893197000,-44211000,,23440000,14756000,52883,RDNT
2018-12-31,,,38527000,73069000,32243000,89852000,197451000,34700000,34700000,,-43456000,,,,394000,975146000,940446000,777695000,3827000,,38133000,32243000,52883,RDNT
2017-12-31,,,26385000,8365000,53000,89852000,119809000,53013000,53013000,,-40623000,,,,24310000,922186000,869173000,802377000,-26628000,,2075000,53000,52883,RDNT
2016-12-31,,,12436000,3567000,7230000,74214000,182948000,42124000,42124000,,-43455000,,,,4432000,884535000,842411000,701587000,-29688000,,8004000,7230000,52883,RDNT
2020-09-30,,,746796000,,601443000,3189000,1532682000,820910000,820910000,278755000,-84474000,,,,145353000,2821137000,2000227000,1288455000,-74114000,,601443000,600999000,52884,ATO
2019-09-30,,,650309000,,511406000,-3016000,1412703000,749074000,749074000,275189000,-103153000,,,,138903000,2901848000,2152774000,1489145000,-98765000,,511406000,510990000,52884,ATO
2018-09-30,,,611144000,,603064000,5770000,1352903000,722164000,722164000,263886000,-106646000,,,,8080000,3115546000,2393382000,1762643000,-111020000,,603064000,602484000,52884,ATO
2017-09-30,,,604094000,,396421000,8469000,1295483000,727159000,727159000,240407000,-120182000,,,,221383000,2759735000,2032576000,1464252000,-123065000,13710000.0,382711000,395934000,52884,ATO
2019-12-31,,,32081000,,23403000,69459000,224208000,70089000,70089000,19068000,-31796000,,,,8454000,420482000,350393000,196274000,-38008000,,23627000,23403000,52885,SJW
2018-12-31,,,48832000,,38767000,51289000,210559000,89694000,89694000,14975000,-24332000,,,,10065000,397699000,308005000,187140000,-40862000,,38767000,38767000,52885,SJW
2017-12-31,,,96493000,,59204000,52712000,212725000,98079000,98079000,13642000,-22929000,,,,35393000,389225000,291146000,176500000,-1586000,,61100000,59204000,52885,SJW
2016-12-31,,,86381000,,52839000,45850000,195714000,93116000,93116000,12123000,-21838000,,,,33542000,339706000,246590000,143992000,-6735000,,52839000,52839000,52885,SJW
2020-07-31,4448000,,-28520000,,-28520000,49689000,23770000,-30367000,-30367000,,,,,,0,76021000,106388000,52251000,1847000,,-28520000,-28520000,52886,ENZ
2019-07-31,3175000,,2489000,,2489000,47265000,23248000,-27192000,-27192000,,,,,,0,81170000,108362000,57922000,29681000,,2489000,2489000,52886,ENZ
2018-07-31,3210000,,-11418000,,-10321000,49582000,40628000,-12164000,-12164000,,,,,,-1097000,101013000,113177000,60385000,746000,,-10321000,-10321000,52886,ENZ
2017-07-31,2928000,,-2504000,,-2504000,45828000,45608000,-3148000,-3148000,,,,,,82000,105086000,108234000,59478000,644000,,-2504000,-2504000,52886,ENZ
2019-12-28,,,56127000,,43688000,166212000,260368000,84756000,84756000,,-26756000,,,,12439000,744956000,660200000,484588000,-28629000,,43688000,43688000,52887,PGTI
2018-12-29,,,65205000,,53933000,143610000,243468000,96258000,96258000,,-26918000,,,,11272000,698493000,602235000,455025000,-31053000,,53933000,53933000,52887,PGTI
2017-12-30,,,39902000,,39839000,98803000,158984000,60181000,60181000,,-20515000,,,,63000,511081000,450900000,352097000,-20279000,,39839000,39839000,52887,PGTI
2016-12-31,,,35547000,,23747000,83095000,141698000,58603000,58603000,,-20230000,,,,11800000,458550000,399947000,316852000,-23056000,,23747000,23747000,52887,PGTI
2020-12-31,,,69360000,,23733000,34912000,266238000,73924000,73924000,120277000,-4561000,,,,16593000,1269573000,1195649000,1003335000,-4564000,-29034000,52767000,23733000,52888,FWRD
2019-12-31,,,116111000,,87099000,45440000,329994000,119911000,119911000,122534000,-2711000,,,,29012000,1410395000,1290484000,1080401000,-3800000,-29034000,87099000,86154000,52888,FWRD
2018-12-31,,,120246000,,92051000,35180000,309222000,122405000,122405000,109454000,-1783000,,,,28195000,1320886000,1198481000,1011664000,-2159000,-29034000,92051000,91170000,52888,FWRD
2017-12-31,,,107537000,,87255000,29578000,278072000,110038000,110038000,97401000,-1209000,,,,20282000,1169346000,1059308000,891274000,-2501000,-29034000,87255000,86555000,52888,FWRD
2017-12-31,,,,,0,,32354000,6640000,6640000,,,,,,0,485299000,0,0,216000,,,,52889,GBLIL
2016-12-31,,,47618000.0,,49868000,17338000.0,67228000,49890000,49890000,,-8905000.0,,,,-2250000,527881000,477991000,460653000,-2272000,,49868000.0,49868000.0,52889,GBLIL
2015-12-31,,,32746000.0,,41469000,16148000.0,62200000,46052000,46052000,,-4913000.0,,,,-8723000,538871000,492819000,476671000,-13306000,,41469000.0,41469000.0,52889,GBLIL
2014-12-31,,,71194000.0,,62856000,11259000.0,86640000,75381000,75381000,,-822000.0,,,,8338000,333820000,258439000,247180000,-4187000,,62856000.0,62856000.0,52889,GBLIL
2020-12-31,,,2752200000,51200000,1570400000,126200000,4055100000,3120700000,3120700000,,-366600000,,,,1174400000,7984900000,4864200000,3929800000,-368500000,,1577800000,1570400000,52890,SCCO
2019-12-31,,,2437200000,47900000,1485800000,246400000,3793600000,2753000000,2753000000,,-340700000,,,,945300000,7285600000,4532600000,3492000000,-315800000,,1491900000,1485800000,52890,SCCO
2018-12-31,,,2601700000,45400000,1543000000,102600000,3687700000,2881200000,2881200000,,-277100000,,,,1053500000,7096700000,4215500000,3409000000,-279500000,,1548200000,1543000000,52890,SCCO
2017-12-31,,,2325800000,41700000,728500000,93100000,3401700000,2618900000,2618900000,-10200000.0,-306000000,,,,1593400000,6654500000,4035600000,3252800000,-294100000,,732400000,728500000,52890,SCCO
2019-12-31,42991000,,-52532000,,-52553000,11752000,0,-54743000,-54743000,,,,,,21000,0,54743000,0,2211000,,-52553000,-52553000,52892,MIRM
2018-12-31,3496500,,-26022000,,-26022000,877500,0,-4374000,-4374000,,-21000.0,,,,0,0,4374000,0,-21648000,,-26022000,-26022000,52892,MIRM
2019-12-31,,,312100000,,292800000,113500000,575700000,435200000,435200000,27000000,-101200000,,,,17600000,1989900000,1554700000,1414200000,-123100000,-1700000,294500000,292800000,52899,CLF
2018-12-31,,,564700000,,1128100000,99500000,809600000,687200000,687200000,22900000,-118900000,,,,-475200000,2332400000,1645200000,1522800000,-122500000,88200000,1039900000,1128100000,52899,CLF
2017-12-31,,,108200000,200000.0,367000000,102900000,467600000,390200000,390200000,-25500000,-126800000,,,,-252400000,1866000000,1475800000,1398400000,-282000000,2500000,360600000,367000000,52899,CLF
2016-12-31,,,110400000,133800000.0,174100000,109000000,280100000,172600000,172600000,-1500000,-193900000,,,,-12200000,1554500000,1381900000,1274400000,-62200000,76700000,122600000,174100000,52899,CLF
2020-02-29,,,21945420,,21945420,1841915,10461643,8619728,8619728,,-2155387,,,,0,10461643,1841915,0,13325692,,21945420,21945420,52900,NAZ
2019-02-28,,,6533852,,6533852,1983999,10332383,8348384,8348384,,-2266639,,,,0,10332383,1983999,0,-1814532,,6533852,6533852,52900,NAZ
2018-02-28,,,5779678,,5779678,1813315,10758721,8945406,8945406,,-1602962,,,,0,10758721,1813315,0,-3165728,,5779678,5779678,52900,NAZ
2017-02-28,,,-56880,,-56880,1795854,11143233,9347379,9347379,,-1499146,,,,0,11143233,1795854,0,-9404259,,-56880,-56880,52900,NAZ
2019-12-31,,,-514716000,,-514021000,109620000,-436100000,-545720000,-545720000,,-6612000,,,,-695000,60209000,605929000,496309000,31004000,,-514021000,-514021000,52902,MRNA
2018-12-31,,,-384408000,,-384734000,94252000,-319014000,-413266000,-413266000,,-3096000,,,,326000,135068000,548334000,454082000,28858000,,-384734000,-401857000,52902,MRNA
2017-12-31,,,-255996000,,-255916000,64722000,-204634000,-269356000,-269356000,,-132000,,,,-80000,205825000,475181000,410459000,13360000,,-255916000,-269841000,52902,MRNA
2016-12-31,,,-215168000,,-216211000,57450000,-166321000,-223771000,-223771000,,-139000,,,,1043000,108396000,332167000,274717000,8603000,,-216211000,-230314000,52902,MRNA
2020-02-01,,,728000000,,564000000,8967000000,10160000000,1193000000,1193000000,,-205000000,,,,164000000,25331000000,24138000000,15171000000,-465000000,,564000000,564000000,52904,M
2019-02-02,,,1420000000,,1108000000,9000000000,10524000000,1532000000,1532000000,-8000000.0,-261000000,,,,322000000,25739000000,24207000000,15215000000,-112000000,,1098000000,1108000000,52904,M
2018-02-03,,,1516000000,-12000000.0,1566000000,8897000000,10460000000,1572000000,1572000000,-9000000.0,-321000000,,,,-39000000,25641000000,24069000000,15181000000,-56000000,,1555000000,1566000000,52904,M
2017-01-28,,,965000000,-1000000.0,627000000,9202000000,10898000000,1650000000,1650000000,46000000.0,-367000000,,,,346000000,26564000000,24914000000,15666000000,-685000000,,619000000,627000000,52904,M
2020-08-31,,,-146628000,,-136157000,44524000,-50395000,-99644000,-99644000,,-5177000,,,,-10471000,86795000,186439000,137190000,-46984000,,-136157000,-136157000,52907,OGI
2019-08-31,,,-5875000,,-9542000,33218000,48469000,6100000,6100000,,-9668000,,,,3629000,80413000,74313000,31944000,-11975000,-38000.0,-9504000,-9542000,52907,OGI
2018-08-31,,,27777000,,20513000,10989000,51633000,36416000,36416000,,-10094000,,,,5653000,12429000,-23987000,-39204000,-8639000,-1611000.0,22124000,20513000,52907,OGI
2017-08-31,,,-10813000,,-10889000,6101000,-3297000,-11101000,-11101000,,-264000,,,,0,5389000,16490000,8686000,288000,-76000.0,-10813000,-10889000,52907,OGI
2019-12-31,,,-17372651,,-17372651,7776300,-11144736,-18921036,-18921036,,-12000,,,,0,89812,19010848,11234548,1548385,,-17372651,-18296811,52908,MTNB
2018-12-31,,,-14589993,,-14083073,7978821,-6667724,-14646545,-14646545,,-13000,,,,-506920,119750,14766295,6787474,56552,,-14083073,-14988116,52908,MTNB
2017-12-31,,,-15843445,,-15486489,7641592,-8860812,-16502404,-16502404,,-6000,,,,-356956,149687,16652091,9010499,658959,,-15486489,-32836188,52908,MTNB
2016-12-31,,,-7598737,,-7598737,4309489,-3947644,-8257133,-8257133,,-6000,,,,0,0,8257133,3947644,658396,,-7598737,-11992546,52908,MTNB
2020-09-30,,,-106337000,626000,-87155000,407829000,510169000,55226000,55226000,,-34885000,,,,-18685000,1498306000,1443080000,988137000,-161563000,,-87652000,-87155000,52909,MATW
2019-09-30,,,-38083000,1130000,-37988000,412637000,544866000,86473000,86473000,,-40962000,,,,806000,1537276000,1450803000,992410000,-124556000,,-38889000,-37988000,52909,MATW
2018-09-30,,,97993000,363000,107371000,419825000,584221000,132834000,132834000,,-37427000,,,,-9118000,1602580000,1469746000,1018359000,-34841000,,107111000,107371000,52909,MATW
2017-09-30,,,96287000,552000,74368000,431872000,569788000,114603000,114603000,,-26371000,,,,22354000,1515608000,1401005000,945820000,-18316000,,73933000,74368000,52909,MATW
2019-12-31,20214000,,-7117000,,-7117000,219516000,232908000,-6822000,-6822000,,,,,,0,248811000,255633000,15903000,-295000,,-7117000,-7117000,52910,EVER
2018-12-31,14173000,,-13791000,,-13791000,151410000,151671000,-13912000,-13912000,,-200000.0,,,,0,163349000,177261000,11678000,121000,,-13791000,-51206000,52910,EVER
2017-12-31,9194000,,-5071000,,-5071000,113992000,118497000,-4689000,-4689000,,-382000.0,,,,0,126242000,130931000,7745000,-382000,,-5071000,-19164000,52910,EVER
2016-12-31,6585000,,-915000,,-933000,110714000,116890000,-409000,-409000,,-506000.0,,,,18000,122778000,123187000,5888000,-506000,,-933000,-1589000,52910,EVER
2019-12-31,,,-3672891,,-3672891,1429773,-816251,-3745107,-3745107,88347,-78344,,,,0,8268005,12013112,9084256,72216,,-3672891,-3721540,52911,UAMY
2018-12-31,,,540893,,873225,1535431,1543,-1652964,-1652964,119076,-99970,,,,-332332,9034403,10687367,9032860,2193857,,873225,824576,52911,UAMY
2017-12-31,,,-1134394,,-1134394,1235159,275460,-959699,-959699,119076,-106975,,,,0,10229978,11189677,9954518,-174695,,-1134394,-1183043,52911,UAMY
2016-12-31,,,-1011062,,-1309200,1473502,536651,-936851,-936851,119076,-160795,,,,298138,11890135,12826986,11353484,-74211,,-1309200,-1357849,52911,UAMY
2019-12-31,,,16829329000,28000,12805105000,2269336000,24951234000,19914732000,19914732000,2767166000,-2063620000,,,,4024211000,48561494000,28646762000,23610260000,-3085403000,,12805118000,12805105000,52912,TGS
2018-12-31,,,17581516000,15000,17561249000,2128960000,28119092000,22080166000,22080166000,3909966000,-2577365000,,,,20261000,52399423000,30319257000,24280331000,-4498650000,,17561255000,17561249000,52912,TGS
2017-12-31,,,8765549000,12000,8847196000,1148084000,12998876000,9245525000,9245525000,2605267000,-1301985000,,,,-81650000,30694588000,21449063000,17695712000,-479976000,,8847199000,8847196000,52912,TGS
2016-12-31,,,1419982000,9000,930675000,396505000,3049315000,2273869000,2273869000,378941000,-430927000,,,,489304000,7402172000,5128303000,4352857000,-853887000,,930678000,930675000,52912,TGS
2019-12-31,18842752,,33409033,,31875337,36881187,87547198,31823259,31823259,,,,,,1533696,102306337,70483078,14759139,1585774,,31875337,31875337,52913,CPRX
2018-12-31,19919204,,-34003514,,-34003514,15875961,500000,-35295165,-35295165,,,,,,0,500000,35795165,0,1291651,,-34003514,-34003514,52913,CPRX
2017-12-31,11375237,,-18412377,,-18412377,7304399,0,-18679636,-18679636,,,,,,0,0,18679636,0,267259,,-18412377,-18412377,52913,CPRX
2016-12-31,11369941,,-18072452,,-18072452,7310260,0,-18680201,-18680201,,,,,,0,0,18680201,0,607749,,-18072452,-18072452,52913,CPRX
2020-12-31,,,59724000,23271000,54157000,124338000,499109000,223910000,223910000,,-93453000,,,,4386000,1905485000,1681575000,1406376000,-164186000,,55338000,54157000,52914,CXW
2019-12-31,,,196725000,23271000,188886000,125946000,557920000,287402000,287402000,,-86701000,,,,7839000,1980689000,1693287000,1422769000,-90677000,,188886000,188886000,52914,CXW
2018-12-31,,,167560000,23271000,159207000,103769000,520516000,260246000,260246000,,-82153000,,,,8353000,1835766000,1575520000,1315250000,-92686000,,159207000,159207000,52914,CXW
2017-12-31,,,191951000,23271000,178040000,105292000,515961000,263540000,263540000,,-68535000,,,,13911000,1765498000,1501958000,1249537000,-71589000,,178040000,178040000,52914,CXW
2019-12-31,57634000,,-15443000,,-17076000,45847000,88813000,-14787000,-14787000,,-1919000,,,,1633000,356804000,371591000,267991000,-656000,,-17076000,-17076000,52915,NPTN
2018-12-31,53818000,,-42308000,,-43637000,47131000,66373000,-35051000,-35051000,,-2493000,,,,1329000,322540000,357591000,256167000,-7257000,,-43637000,-43637000,52915,NPTN
2017-12-31,58287000,,-52424000,,-53333000,52213000,64279000,-46693000,-46693000,,-1362000,,,,909000,292894000,339587000,228615000,-5731000,,-53333000,-53333000,52915,NPTN
2016-12-31,57376000,,3392000,,-205000,53004000,117133000,5144000,5144000,,-402000,,,,3597000,411423000,406279000,294290000,-1752000,,-205000,-205000,52915,NPTN
2020-03-31,11310000,,77156000,,59672000,169031000,285762000,92479000,92479000,,-14234000,,,,17484000,809162000,716683000,523400000,-15323000,,59672000,59672000,52917,CMCO
2019-03-31,13491000,,52898000,,42577000,181203000,305986000,96392000,96392000,,-17144000,,,,10321000,876282000,779890000,570296000,-43494000,,42577000,42577000,52917,CMCO
2018-03-31,13617000,,49685000,,22065000,185671000,282699000,67859000,67859000,,-19733000,,,,27620000,839419000,771560000,556720000,-18174000,,22065000,22065000,52917,CMCO
2017-03-31,10482000,,13027000,,8984000,138233000,201737000,44917000,44917000,,-10966000,,,,4043000,637123000,592206000,435386000,-31890000,,8984000,8984000,52917,CMCO
2019-12-31,23853000,,-39574000,-120000,-40125000,56181000,63971000,-19484000,-19484000,,-20343000,,,,536000,219496000,238980000,155525000,-20090000,,-40110000,-40486000,52918,INSG
2018-12-31,20593000,,-7328000,-135000,-8058000,48352000,70952000,-1617000,-1617000,,-20238000,,,,815000,202463000,204080000,131511000,-5711000,,-8143000,-8058000,52918,INSG
2017-12-31,21362000,,-45626000,-50000,-45735000,59434000,67066000,-17331000,-17331000,,-17394000,,,,214000,219297000,236628000,152231000,-28295000,,-45840000,-45735000,52918,INSG
2016-12-31,30655000,,-60187000,36000,-60573000,71456000,89697000,-16341000,-16341000,,-15047000,,,,381000,243555000,259896000,153858000,-43846000,,-60568000,-60573000,52918,INSG
2019-12-31,,,-3289000,,-3289000,1368000,408000,-3200000,-3200000,,,,,,0,408000,3200000,0,-89000,,-3289000,-3289000,52919,XPL
2018-12-31,,,-3598000,,-3598000,1954000,0,-3233000,-3233000,,,,,,0,0,3233000,0,-365000,,-3598000,-3598000,52919,XPL
2017-12-31,,,-942000,,-942000,1202000,0,-1914000,-1914000,,-1000.0,,,,0,0,1914000,0,972000,,-942000,-942000,52919,XPL
2016-12-31,,,-2063000,,-1710000,2163000,0,-2799000,-2799000,,-1000.0,,,,-353000,0,2799000,0,736000,,-1710000,-1710000,52919,XPL
2019-12-31,,,-83573000,,-102377000,164314000,363222000,59151000,59151000,,-38620000,,,,25290000,1317440000,1258289000,954218000,-142724000,6486000,-108863000,-102377000,52921,EXTN
2018-12-31,,,39825000,,24854000,178401000,383428000,81105000,81105000,,-29217000,,,,39433000,1360856000,1279751000,977428000,-41280000,24462000,392000,24213000,52921,EXTN
2017-12-31,,,16839000,,33880000,176318000,347140000,62998000,62998000,,-34826000,,,,22695000,1215294000,1152296000,868154000,-46159000,39736000,-5856000,33880000,52921,EXTN
2016-12-31,,,-47524000,,-227937000,157485000,308991000,18620000,18620000,,-34181000,,,,124242000,905397000,886777000,596406000,-66144000,-56171000,-171766000,-227937000,52921,EXTN
2019-12-31,83097000,,-31033000,,-31251000,130834000,214060000,129000,129000,,-3079000,,,,218000,245893000,245764000,31833000,-31162000,,-31251000,-31251000,52922,TXG
2018-12-31,47537000,,-112398000,,-112485000,87936000,125052000,-10421000,-10421000,,-2409000,,,,87000,146313000,156734000,21261000,-101977000,,-112485000,-112485000,52922,TXG
2017-12-31,32164000,,-18741000,,-18762000,46736000,60525000,-18375000,-18375000,,-811000,,,,21000,71085000,89460000,10560000,-366000,,-18762000,-18762000,52922,TXG
2019-12-31,,,116592000,29591000,81611000,14485000,132630000,0,118145000,,,,,,34644000,569763000,451618000,437133000,-1553000,,81948000,81347000,52923,RILYP
2018-12-31,,,21303000,602000,15509000,14479000,34976000,0,20497000,,,,,,4903000,366559000,346062000,331583000,806000,,16400000,15509000,52923,RILYP
2017-12-31,,,20445000,-184000,11556000,8911000,35747000,0,26836000,,,,,,8510000,301743000,274907000,265996000,-6391000,,11935000,11556000,52923,RILYP
2016-12-31,,,47047000,1045000,21526000,4661000,55277000,0,50616000,,,,,,14321000,188355000,137739000,133078000,-3569000,,32726000,21526000,52923,RILYP
2019-12-31,,,542040000,122540000,538320000,-22989000,1487356000,694949000,694949000,224467000,-235251000,,,,-15773000,3471209000,2776260000,1983853000,-152909000,,557813000,538320000,52927,PNW
2018-12-31,,,664442000,125790000,511047000,-49791000,1578387000,823478000,823478000,222346000,-243465000,,,,133902000,3691247000,2867769000,2112860000,-159036000,,530540000,511047000,52927,PNW
2017-12-31,,,766221000,129040000,488456000,-24664000,1634888000,934427000,934427000,191007000,-219796000,,,,258272000,3565296000,2630869000,1930408000,-168206000,,507949000,488456000,52927,PNW
2016-12-31,,,697938000,132290000,442034000,-20373000,1491480000,855984000,855984000,170040000,-205720000,,,,236411000,3498682000,2642698000,2007202000,-158046000,,461527000,442034000,52927,PNW
2019-12-31,,,-21166300,,-16658500,6993900,42592000,20987700,20987700,114300,-11302900,,,,-4507800,43442800,22455100,850800,-42154000,,-16658500,-16658500,52930,ACY
2018-12-31,,,-9054000,,-8081200,7317600,29889100,9844200,9844200,90200,-9506000,,,,-972800,30525100,20680900,636000,-21425200,,-8081200,-8081200,52930,ACY
2017-12-31,,,3432700,,7399200,7706200,31540600,11718500,11718500,90300,-7753200,,,,-3966500,34464900,22746400,2924300,-8285800,,7399200,7399200,52930,ACY
2016-12-31,,,1972000,,1221700,7193200,22064300,5172200,5172200,-276600,-5339700,,,,750300,25350000,20177800,3285700,-3200200,,1221700,1221700,52930,ACY
2019-12-31,,,-9839396,,-9839396,3273697,294938,-7376360,-7376360,4441,-968292,,,,0,746263,8122623,451325,-2463036,,-9839396,-9839396,52932,TRCH
2018-12-31,,,-5806612,,-5806612,4053062,476204,-4750610,-4750610,4441,-547710,,,,0,1282362,6032972,806158,-1056002,,-5806612,-5806612,52932,TRCH
2017-12-31,,,-919910,,-919910,3652970,397312,-3355814,-3355814,4441,-346050,,,,0,570499,3926313,173187,2435904,,-919910,-919910,52932,TRCH
2016-12-31,,,-7684346,,-7684346,6447706,25952,-7058221,-7058221,41,-272796,,,,0,354390,7412611,328438,-626125,,-7684346,-7684346,52932,TRCH
2019-12-31,,,-194819,,-153906,384851,0,-384851,-384851,,,,,,-40913,0,384851,0,190032,,-153906,-153906,52933,DFNS
2020-09-30,163918,,-23346143,,-23346143,14427719,2120852,-15143116,-15143116,,-10449946,,,,0,10028701,25171817,7907849,-8203027,,-23346143,-23346143,52936,CLSK
2019-09-30,1453635,,-26116932,,-26116932,7013739,671696,-9698659,-9698659,,-9483662,,,,0,4532782,14231441,3861086,-16418273,,-26116932,-26116932,52936,CLSK
2018-09-30,1382840,,-47006165,,-47006165,3129881,187861,-5179841,-5179841,,-924454,,,,0,578635,5758476,390774,-41826324,,-47006165,-47006165,52936,CLSK
2017-09-30,1068147,,-13498526,,-13498526,1646816,151668,-4814079,-4814079,,-2895,,,,0,447963,5262042,296295,-8684447,,-13498526,-13498526,52936,CLSK
2020-12-31,,,1042000000,,776000000,967000000,2416000000,1087000000,1087000000,79000000,-48000000,,,,266000000,5850000000,4763000000,3434000000,-45000000,,776000000,776000000,52937,WFG
2019-12-31,,,-219000000,,-150000000,932000000,1225000000,-134000000,-134000000,162000000,-48000000,,,,-69000000,4877000000,5011000000,3652000000,-85000000,,-150000000,-150000000,52937,WFG
2018-12-31,,,1072000000,,810000000,972000000,2501000000,1063000000,1063000000,202000000,-35000000,,,,262000000,6118000000,5055000000,3617000000,9000000,,810000000,810000000,52937,WFG
2017-12-31,,,846000000,,596000000,850000000,2010000000,870000000,870000000,48000000,-25000000,,,,250000000,5134000000,4264000000,3124000000,-24000000,,596000000,596000000,52937,WFG
2019-12-31,1833000,,-5649000,,-5482000,3981000,0,-5814000,-5814000,,-7000,,,,-167000,0,5814000,0,165000,,-5482000,-5482000,52938,ABIO
2018-12-31,4239000,,-7964000,,-7933000,3879000,0,-8118000,-8118000,,-8000,,,,-31000,0,8118000,0,316000,,-7933000,-7933000,52938,ABIO
2017-12-31,14076000,,-18551000,,-18490000,4636000,0,-18712000,-18712000,,-6000,,,,-61000,0,18712000,0,161000,,-18490000,-18490000,52938,ABIO
2016-12-31,12348000,,-16444000,,-16444000,4265000,0,-16613000,-16613000,,-6000,,,,0,0,16613000,0,169000,,-16444000,-16444000,52938,ABIO
2020-12-31,967503000,,-982177000,425405000,-981517000,145769000,101928000,-1011344000,-1011344000,,-17051000,,,,1132000,101928000,1113272000,0,29167000,,-983309000,-981517000,52940,TLC
2019-12-31,860419000,,-803402000,425405000,-807522000,166377000,209140000,-817656000,-817656000,,-23656000,,,,4120000,209140000,1026796000,0,14254000,,-807522000,-807522000,52940,TLC
2018-12-31,832575000,,-900707000,425405000,-901574000,147743000,62324000,-917994000,-917994000,,-9886000,,,,867000,62324000,980318000,0,17287000,,-901574000,-901574000,52940,TLC
2017-12-31,813252000,,-873011000,425405000,-873962000,134869000,49635000,-898486000,-898486000,,-3385000,,,,951000,49635000,948121000,0,25475000,,-873962000,-873962000,52940,TLC
2019-12-31,33831000,,15025000,,14902000,323058000,363788000,1639000,1639000,5260000,-190000,,,,57000,993319000,991680000,629531000,13386000,,14968000,-25383000,52941,HUIZ
2018-12-31,24944000,,3206000,542000.0,3152000,138654000,192431000,24792000,24792000,4041000,-27111000,,,,278000,508828000,484036000,316397000,-21586000,,2928000,-27524000,52941,HUIZ
2017-12-31,50107000,,-96639000,734000.0,-97173000,145811000,98582000,-100301000,-100301000,2965000,-27111000,,,,406000,263332000,363633000,164750000,3662000,,-97045000,-75713000,52941,HUIZ
2019-12-31,,,336370000,113182000,188932000,753192000,1222555000,469363000,469363000,,,,,,143816000,3706003000,3236640000,2483448000,-132993000,,192554000,188932000,52944,FANH
2018-12-31,,,841681000,113543000,609915000,699505000,1125248000,425743000,425743000,,,,,,224586000,3471263000,3045520000,2346015000,415938000,,617095000,609915000,52944,FANH
2017-12-31,,,614039000,111342000,449228000,755930000,1029066000,273136000,273136000,,,,,,167803000,4088473000,3815337000,3059407000,340903000,5480000.0,446236000,449228000,52944,FANH
2016-12-31,,,172344000,117242000,157047000,984749000,976283000,-8466000,-8466000,,,,,,27249000,4082884000,4091350000,3106601000,180810000,22543000.0,145095000,157047000,52944,FANH
2020-04-30,,,64351000,500000,51343000,117762000,353836000,72289000,72289000,-2300000,-8052000,,,,13008000,742311000,670022000,388475000,-7938000,,51343000,51303000,52946,CRMT
2019-04-30,,,59851000,500000,47625000,107249000,323324000,67643000,67643000,-1900000,-7883000,,,,12226000,667222000,599579000,343898000,-7792000,,47625000,47585000,52946,CRMT
2018-04-30,,,38906000,500000,36509000,99023000,295028000,44596000,44596000,-1900000,-5599000,,,,2397000,610301000,565705000,315273000,-5690000,,36509000,36469000,52946,CRMT
2017-04-30,,,32242000,500000,20205000,91940000,282824000,37515000,37515000,-1900000,-4069000,,,,12037000,587751000,550236000,304927000,-5273000,,20205000,20165000,52946,CRMT
2019-12-31,25345000,,-84416000,,-84305000,51886000,4400000,-72831000,-72831000,,-14256000,,,,-111000,9297000,82128000,4897000,-11585000,,-84305000,-84305000,52950,AXDX
2018-12-31,27638000,,-88115000,,-88326000,55214000,2483000,-80369000,-80369000,,-10113000,,,,211000,5670000,86039000,3187000,-7746000,,-88326000,-88326000,52950,AXDX
2017-12-31,22301000,,-63535000,,-64028000,45058000,3175000,-64184000,-64184000,,-10113000,,,,493000,4177000,68361000,1002000,649000,,-64028000,-64028000,52950,AXDX
2016-12-31,29564000,,-66107000,,-66374000,37183000,246000,-66501000,-66501000,,-10113000,,,,267000,246000,66747000,0,394000,,-66374000,-66374000,52950,AXDX
2019-12-31,1371433,,-6195557,,-6195557,4558949,102543,-5893741,-5893741,,-106437,,,,0,214974,6108715,112431,-301816,,-6195557,-6195557,52960,CODX
2018-12-31,1361154,,-6271723,,-6271723,4736417,30520,-6117816,-6117816,,-134947,,,,0,39911,6157727,9391,-153907,,-6271723,-6271723,52960,CODX
2017-12-31,1003167,,-6959232,,-6959232,3522502,7360,-4564067,-4564067,,-310233,,,,0,7662,4571729,302,-2395165,,-6959232,-6959232,52960,CODX
2016-12-31,731474,,-1928686,,-1928686,919001,0,-1687966,-1687966,,-240720,,,,0,0,1687966,0,-240720,,-1928686,-1928686,52960,CODX
2019-12-31,,,-59118859,,-59268859,4321857,0,-58765368,-58765368,,-58028,,,,150000,0,58765368,0,-353491,,-59268859,-59268859,52961,SILV
2018-12-31,,,-19825314,,-19825314,3688012,0,-21072523,-21072523,,-58028,,,,0,0,21072523,0,1247209,,-19825314,-19825314,52961,SILV
2017-12-31,,,-4875261,,-4875261,1735030,0,-4380871,-4380871,,-58028,,,,0,0,4380871,0,-570777,,-4875261,-4875261,52961,SILV
2016-12-31,,,-1741825,,-1741825,1099024,0,-1530284,-1530284,,-58028,,,,0,0,1530284,0,-211541,,-1741825,-1741825,52961,SILV
2019-12-31,,,262543000,,259750000,54639000,903426000,411982000,411982000,8357000,-225126000,,,,2793000,2316148000,1904166000,1412722000,-149439000,,259750000,259750000,52962,SVC
2018-12-31,,,186929000,,185734000,104862000,907471000,394242000,394242000,5290000,-195213000,,,,1195000,2294536000,1900294000,1387065000,-207313000,,185734000,185734000,52962,SVC
2017-12-31,,,211859000,,215143000,125402000,897293000,380327000,380327000,4905000,-181579000,,,,-3284000,2171935000,1791608000,1274642000,-168468000,,215143000,203815000,52962,SVC
2016-12-31,,,227130000,,223110000,99105000,843306000,386859000,386859000,4905000,-161913000,,,,4020000,2047211000,1660352000,1203905000,-159729000,,223110000,202446000,52962,SVC
2020-04-30,,,-7171962,,-7171962,4438649,31260369,26821720,26821720,,-6388459,,,,0,31260369,4438649,0,-33993682,,-7171962,-7171962,52963,MQY
2019-04-30,,,35629501,,35629501,4357641,32826207,28468566,28468566,,-7220983,,,,0,32826207,4357641,0,7160935,,35629501,35629501,52963,MQY
2018-04-30,,,14653603,,14653603,4375449,33580494,29205045,29205045,,-5527707,,,,0,33580494,4375449,0,-14551442,,14653603,14653603,52963,MQY
2017-04-30,,,-1147468,,-1147468,4402744,34685020,30282276,30282276,,-4211039,,,,0,34685020,4402744,0,-31429744,,-1147468,-1147468,52963,MQY
2019-12-31,647994,,-6320849,,-6320849,3711613,-171855,-5699585,-5699585,158706,-8685,,,,0,402446,6102031,574301,-621264,,-6320849,-6320849,52967,SGLB
2018-12-31,493410,,-5574163,,-5574163,3088095,118467,-4935769,-4935769,134827,-3966,,,,0,388574,5324343,270107,-638394,,-5574163,-5589288,52967,SGLB
2017-12-31,302043,,-4424503,,-4424503,2397892,368677,-3343987,-3343987,95990,-520132,,,,0,641049,3985036,272372,-1080516,,-4424503,-4424503,52967,SGLB
2016-12-31,120638,,-2196834,,-2196834,1816594,737520,-1852331,-1852331,132220,-129798,,,,0,966422,2818753,228902,-344503,,-2196834,-2196834,52967,SGLB
2019-12-31,,,21162000,40614000,-772000,108456000,281230000,116277000,116277000,56497000,-69658000,,,,20820000,887138000,770861000,605908000,-95115000,,342000,-772000,52969,AGRO
2018-12-31,,,-24257000,44509000,-24622000,100964000,186498000,94920000,94920000,-9386000,-51577000,,,,-1024000,793239000,698319000,606741000,-119177000,,-23233000,-24622000,52969,AGRO
2017-12-31,,,9983000,9139000,13198000,113382000,238936000,126272000,126272000,-718000,-52308000,,,,-4992000,933178000,806906000,694242000,-116289000,,14975000,13198000,52969,AGRO
2016-12-31,,,27175000,11970000,11568000,100066000,299491000,163315000,163315000,36110000,-48198000,,,,12899000,869235000,705920000,569744000,-136140000,,14276000,11568000,52969,AGRO
2019-12-31,1555000,,-44793000,,-44795000,19314000,-19925000,-40794000,-40794000,,-3477000,,,,2000,4874000,45668000,24799000,-3999000,,-44795000,-44795000,52970,AQMS
2018-12-31,4502000,,-40252000,,-40254000,12414000,-18312000,-35228000,-35228000,,-3447000,,,,2000,4449000,39677000,22761000,-5024000,,-40254000,-40254000,52970,AQMS
2017-12-31,8103000,,-26578000,,-26580000,6891000,-7453000,-22447000,-22447000,,-1761000,,,,2000,2088000,24535000,9541000,-4131000,,-26580000,-26580000,52970,AQMS
2016-12-31,6348000,,-13556000,,-13557000,6610000,0,-12958000,-12958000,,-639000,,,,1000,0,12958000,0,-598000,,-13557000,-13557000,52970,AQMS
2020-10-31,,,-1735429,,-1735429,1837543,3569320,1731777,1731777,,-3399,,,,0,3569320,1837543,0,-3467206,,-1735429,-1735429,52971,IAF
2019-10-31,,,19128561,,19128561,1911807,5837073,3925266,3925266,,-3399,,,,0,5837073,1911807,0,15203295,,19128561,19128561,52971,IAF
2018-10-31,,,-5489772,,-5489772,2093934,5638422,3544488,3544488,,-3399,,,,0,5638422,2093934,0,-9034260,,-5489772,-5489772,52971,IAF
2017-10-31,,,21405891,,21405891,2147059,6033002,3885943,3885943,,-3399,,,,0,6033002,2147059,0,17519948,,21405891,21405891,52971,IAF
2020-06-30,8461000,,-42026000,,-42030000,32948000,11290000,-42679000,-42679000,-3926000,-33000,,,,4000,14263000,56942000,2973000,653000,,-42030000,-42030000,52972,RCEL
2019-06-30,7872000,,-25223000,,-25102000,25834000,4203000,-25528000,-25528000,-5921000,-27000,,,,-121000,5474000,31002000,1271000,305000,,-25102000,-25102000,52972,RCEL
2018-06-30,6257000,,-13809000,,-12735000,14278000,383000,-13841000,-13841000,-7734000,-21000,,,,-1074000,929000,14770000,546000,32000,,-12735000,-12735000,52972,RCEL
2017-06-30,6271194,,-12559261,,-11511024,12314780,674996,-12670216,-12670216,-6828005,-12754,,,,-1048237,1180632,13850848,505636,110955,,-11511024,-11511024,52972,RCEL
2020-12-31,75700000,,432100000,,358600000,520500000,1057600000,461400000,461400000,,-23900000,,,,75000000,3017800000,2556400000,1960200000,-29300000,1500000,357100000,358600000,52973,PNR
2019-12-31,78900000,,407500000,,355700000,525400000,1051500000,447200000,447200000,,-30100000,,,,45800000,2957200000,2510000000,1905700000,-39700000,-6000000,361700000,355700000,52973,PNR
2018-12-31,76700000,,379800000,,347400000,502800000,1047700000,468200000,468200000,,-32600000,,,,58100000,2965100000,2496900000,1917400000,-88400000,25700000,321700000,347400000,52973,PNR
2017-12-31,73200000,,172800000,,666500000,512900000,987500000,401400000,401400000,,-87300000,,,,58700000,2845700000,2444300000,1858200000,-228600000,552400000,114100000,666500000,52973,PNR
2020-12-31,,,1798500000,66500000,1342400000,117900000,2449600000,1788300000,1788300000,137100000,-89600000,,,,439800000,4213400000,2425100000,1763800000,10200000,,1358700000,1342400000,52977,KGC
2019-12-31,,,963800000,14100000,718600000,135800000,1718400000,857700000,857700000,139500000,-76900000,,,,246700000,3497300000,2639600000,1778900000,106100000,,717100000,718600000,52977,KGC
2018-12-31,,,113200000,20600000,-23600000,133000000,1352100000,174800000,174800000,162700000,-72100000,,,,138800000,3212600000,3037800000,1860500000,-61600000,,-25600000,-23600000,52977,KGC
2017-12-31,,,419000000,35600000,445400000,132600000,1545600000,67900000,67900000,137300000,-86500000,,,,-23200000,3303000000,3235100000,1757400000,351100000,,442200000,445400000,52977,KGC
2020-08-31,,,427134000,,372938000,359005000,798665000,439660000,439660000,,-10929000,,,,54196000,1494111000,1054451000,695446000,-12526000,,372938000,372938000,52978,FDS
2019-08-31,,,421965000,,352790000,333870000,771905000,438035000,438035000,,-18124000,,,,69175000,1435351000,997316000,663446000,-16070000,,352790000,352790000,52978,FDS
2018-08-31,,,351838000,,267085000,319745000,690849000,371104000,371104000,,-17586000,,,,84753000,1350145000,979041000,659296000,-19266000,,267085000,267085000,52978,FDS
2017-08-31,,,344312000,,258259000,298564000,654599000,356035000,356035000,,-8200000,,,,86053000,1221179000,865144000,566580000,-11723000,,258259000,258259000,52978,FDS
2020-05-31,1910209,,-2331664,,-2339054,2274415,1781776,-2402848,-2402848,,-9,,,,7390,6692711,9095559,4910935,71184,,-2339054,-2339054,52979,BMRA
2019-05-31,1679098,,-2368823,,-2393060,2025706,1292014,-2412790,-2412790,,-47,,,,24237,5200682,7613472,3908668,43967,,-2393060,-2393060,52979,BMRA
2018-05-31,1398368,,-1434028,,-1465828,1837787,1754400,-1481755,-1481755,,-37,,,,31800,5564185,7045940,3809785,47727,,-1465828,-1465828,52979,BMRA
2017-05-31,1130635,,-908561,,-908561,1845789,2021791,-954633,-954633,,-282,,,,0,5791670,6746303,3769879,46072,,-908561,-908561,52979,BMRA
2020-06-30,,,-37282000,,-37087000,152680000,138122000,-14558000,-14558000,,-10483000,,,,-195000,501320000,515878000,363198000,-22724000,,-37087000,-37641000,52980,FARM
2019-06-30,,,-33484000,,-73595000,182291000,179102000,-3189000,-3189000,,-12000000,,,,40111000,595942000,599131000,416840000,-30295000,,-73595000,-74130000,52980,FARM
2018-06-30,,,-968000,,-18280000,196169000,207389000,11220000,11220000,,-9757000,,,,17312000,606544000,595324000,399155000,-12188000,,-18280000,-18669000,52980,FARM
2017-06-30,,,37366000,,22551000,169519000,186851000,17332000,17332000,,-8601000,,,,14815000,541500000,524168000,354649000,20034000,,22551000,22551000,52980,FARM
2020-06-30,,,-2122427,5659589,-2106600,2813636,357243,-2456393,-2456393,,,,,,0,865705,3322098,508462,333966,,-2122427,-2106600,52981,MYT
2019-06-30,,,-932863,5659589,27555442,2202161,165153,-2037008,-2037008,,,,,,0,401814,2438822,236661,1104145,28488305.0,-932863,27555442,52981,MYT
2018-06-30,,,-683295,5659589,-82889335,889107,1963332,-889107,-889107,,-1388102.0,,,,0,38452206,889107,36488874,205812,-82206040.0,-683295,-82889335,52981,MYT
2017-06-30,,,-2200106,5659589,-28427244,2814205,3924675,-2814205,-2814205,,-3254991.0,,,,0,56292093,2814205,52367418,-2640388,-26227138.0,-2200106,-28427244,52981,MYT
2019-11-30,,,-21460000,,-21699000,8326000,-13910000,-22236000,-22236000,,,,,,239000,31115000,53351000,45025000,776000,,-21699000,-21699000,52982,NRIX
2018-11-30,,,-8921000,,-9428000,6674000,-3065000,-9739000,-9739000,,,,,,507000,37449000,47188000,40514000,818000,,-9428000,-9428000,52982,NRIX
2019-12-31,,,3121000,,311000,2476000,5597000,3121000,3121000,,,,,,738000,5597000,2476000,0,0,-2072000,2383000,-1089000,52983,FGFPP
2018-12-31,,,-1582000,,804000,1145000,1208000,63000,63000,,-33000.0,,,,-308000,1208000,1145000,42726000,-1645000,2078000,-1274000,-304000,52983,FGFPP
2017-12-31,,,1492000,,294000,9304000,11168000,1864000,1864000,,-372000.0,,,,1198000,38148000,36284000,26980000,-372000,2078000,294000,294000,52983,FGFPP
2016-12-31,,,119000,,11000,6918000,7392000,474000,474000,,-355000.0,,,,108000,32256000,31782000,24864000,-355000,2078000,11000,11000,52983,FGFPP
2019-12-31,,,-24714000,,-24714000,7233000,-17617000,-24850000,-24850000,,,,,,0,1708000,26558000,19325000,136000,,-24714000,-24714000,52984,CKPT
2018-12-31,,,-36367000,,-36367000,6592000,-30148000,-36740000,-36740000,,,,,,0,3506000,40246000,33654000,373000,,-36367000,-36367000,52984,CKPT
2017-12-31,,,-22677000,,-22677000,5419000,-17356000,-22775000,-22775000,,,,,,0,1725000,24500000,19081000,98000,,-22677000,-22677000,52984,CKPT
2016-12-31,,,-22461000,,-22461000,4467000,-17697000,-22164000,-22164000,,-344000.0,,,,0,2570000,24734000,20267000,-297000,,-22461000,-22461000,52984,CKPT
2020-05-31,,,30400000,,4400000,220600000,283200000,57200000,57200000,,-9300000,,,,5600000,2072000000,2014800000,1788800000,-26800000,-20400000,24800000,4300000,52985,AIR
2019-05-31,,,89000000,,7500000,215400000,329800000,98600000,98600000,,-9500000,,,,4900000,2051800000,1953200000,1722000000,-9600000,-76600000,84100000,7100000,52985,AIR
2018-05-31,,,77200000,,15600000,208100000,294100000,85500000,85500000,,-8000000,,,,3500000,1748300000,1662800000,1454200000,-8300000,-58100000,73700000,15000000,52985,AIR
2017-05-31,,,77100000,,56500000,179000000,263400000,82300000,82300000,,-5300000,,,,25100000,1590800000,1508500000,1327400000,-5200000,4500000,52000000,56000000,52985,AIR
2019-12-31,,,-7782544,,-5966353,165368,932681,-6654364,-6654364,3374354,-1826180,,,,-1816191,145563020,152217384,144630339,-1128180,,-5966353,-5966353,52988,KINS
2018-12-31,,,3007063,,3093246,165368,9356582,4828660,4828660,1872754,-1821597,,,,-86183,113771898,108943238,104415316,-1821597,,3093246,3093246,52988,KINS
2017-12-31,,,14309715,,9986485,165368,19451273,14370050,14370050,3242696,-60335,,,,4323230,92769310,78399260,73318037,-60335,,9986485,9986485,52988,KINS
2016-12-31,,,13418467,,8899766,119720,16572887,13418467,13418467,1802897,-60335,,,,4518701,77436664,64018197,60863777,0,,8899766,8899766,52988,KINS
2019-12-31,,,-41092000,,-41092000,16238000,-25486000,-41724000,-41724000,,,,,,0,20915000,62639000,46401000,632000,,-41092000,-41092000,52990,CDTX
2018-12-31,,,-59016000,,-59016000,14143000,-49142000,-63285000,-63285000,,,,,,0,0,63285000,49142000,4269000,,-59016000,-69345000,52990,CDTX
2017-12-31,,,-55728000,,-55728000,12898000,-42823000,-55721000,-55721000,,-7000.0,,,,0,0,55721000,42823000,-7000,,-55728000,-55728000,52990,CDTX
2016-12-31,35699000.0,,-48165000,,-48165000,12737000,0,-48436000,-48436000,,-7000.0,,,,0,0,48436000,0,271000,,-48165000,-48165000,52990,CDTX
2019-12-31,,,109672000,63108000,96404000,290825000,473599000,182774000,182774000,,-31189000,,,,11355000,2752639000,2569865000,2279040000,-73102000,,98317000,96404000,52992,CTB
2018-12-31,,,114058000,60400000,76586000,272027000,455254000,183227000,183227000,,-32181000,,,,33495000,2808062000,2624835000,2352808000,-69169000,,80563000,76586000,52992,CTB
2017-12-31,,,243925000,58660000,95400000,279671000,582948000,303277000,303277000,,-32048000,,,,147180000,2854656000,2551379000,2271708000,-59352000,,96745000,95400000,52992,CTB
2016-12-31,,,367093000,54222000,248381000,305696000,755531000,449835000,449835000,,-26604000,,,,115799000,2924869000,2475034000,2169338000,-82742000,,251294000,248381000,52992,CTB
2020-12-31,,,3116798000,,2711647000,770456000,3639846000,2869390000,2869390000,,-58151000,,,,405151000,6205683000,3336293000,2565837000,247408000,,2711647000,2711647000,52993,VRTX
2019-12-31,,,1394919000,,1176810000,658498000,1860523000,1202025000,1202025000,,-58502000,,,,218109000,4162821000,2960796000,2302298000,192894000,,1176810000,1176810000,52993,VRTX
2018-12-31,,,600241000,,2096896000,557616000,1221582000,663966000,663966000,,-72471000,,,,-1486862000,3047597000,2383631000,1826015000,-63725000,,2087103000,2096395000,52993,VRTX
2017-12-31,,,-15689000,13727000.0,263484000,496079000,888908000,392829000,392829000,,-69298000,,,,-107324000,2488652000,2095823000,1599744000,-408518000,,91635000,263191000,52993,VRTX
2020-02-29,,,34677663,,34677663,5332694,41707522,36374828,36374828,,,,,,0,41707522,5332694,0,-1697165,,34677663,23702998,52995,NCZ
2019-02-28,,,-5713044,,-5713044,5726798,44086599,38359801,38359801,,-342944.0,,,,0,44086599,5726798,0,-44072845,,-5713044,-14567084,52995,NCZ
2018-02-28,,,36303552,,36303552,5874930,51942725,46067795,46067795,,-342944.0,,,,0,51942725,5874930,0,-9764243,,36303552,31692706,52995,NCZ
2017-02-28,,,145898937,,145898937,5873985,54887528,49013543,49013543,,-342944.0,,,,0,54887528,5873985,0,96885394,,145898937,144089184,52995,NCZ
2019-12-31,,,-269608,,-269608,414340,0,-414340,-414340,,,,,,0,0,414340,0,144732,,-269608,-406208,52996,LIVK
2019-12-31,,,-10200000,,-21300000,160000000,162000000,-2800000,-2800000,,-6600000,,,,11100000,812000000,814800000,650000000,-7400000,,-21300000,-21300000,52998,HBP
2018-12-31,,,-7400000,,-6400000,160000000,166500000,2300000,2300000,,-6500000,,,,-1400000,839600000,837300000,673100000,-9700000,-400000.0,-6000000,-6400000,52998,HBP
2017-12-31,,,-3000000,,-7100000,152000000,155800000,100000,100000,,-3100000,,,,3200000,753200000,753100000,597400000,-3100000,-900000.0,-6200000,-7100000,52998,HBP
2016-12-31,,,20500000,,16300000,125500000,151200000,22700000,22700000,,-2200000,,,,7200000,713900000,691200000,562700000,-2200000,3000000.0,13300000,15800000,52998,HBP
2020-02-02,433662000,,-194666000,,-200987000,891175000,1133554000,-191283000,-191283000,,-27897000,,,,6321000,1643440000,1834723000,509886000,-3383000,,-200987000,-200987000,53001,PSTG
2019-01-31,349936000,,-177273000,,-178362000,721617000,902296000,-169257000,-169257000,,-21615000,,,,1089000,1359824000,1529081000,457528000,-8016000,,-178362000,-178362000,53001,PSTG
2018-01-31,279196000,,-155989000,,-159878000,559219000,670981000,-167434000,-167434000,,-19000,,,,3889000,1024762000,1192196000,353781000,11445000,,-159878000,-159878000,53001,PSTG
2017-01-31,245817000,,-219645000,,-221532000,432347000,486892000,-191272000,-191272000,,-44000,,,,1887000,739171000,930443000,252279000,-28373000,,-221532000,-221532000,53001,PSTG
2019-12-31,,,19662801,,15499138,58613607,85048759,26435152,26435152,,-3006663,,,,4163663,304201203,277766051,219152444,-6772351,,15499138,-19133698,53002,ASLEW
2018-12-31,,,23498388,,8853211,46611982,72168805,25556823,25556823,,-2374881,,,,-3227061,290732049,265175226,218563244,-2058435,21260340.0,26725449,-24724325,53002,ASLEW
2017-12-31,,,-16974799,-39132578.0,-10851134,46064938,35922435,-10142503,-10142503,,-7949461,,,,-1451422,174716210,184858713,138793775,-6832296,-9725633.0,-15523377,-41648640,53002,ASLEW
2019-12-31,,,1912539000,22384000,1365597000,992536000,788207000,-206238000,-206238000,1909000,-38138000,,,,545514000,3550294000,3756532000,2762087000,2118777000,,1367025000,1365597000,53003,PAGS
2018-12-31,,,1217623000,23806000,909267000,933107000,497016000,-444145000,-444145000,8054000,-31209000,,,,307215000,2641715000,3085860000,2144699000,1660292000,,910408000,909267000,53003,PAGS
2017-12-31,,,683504000,3496000,478781000,398936000,371805000,-39103000,-39103000,11972000,-104544000,,,,204710000,1696185000,1735288000,1324380000,722607000,,478794000,478781000,53003,PAGS
2016-12-31,,,155359000,3496000,127186000,284398000,116952000,-174106000,-174106000,6660000,-68301000,,,,27580000,740619000,914725000,623667000,329465000,,127779000,127186000,53003,PAGS
2020-06-30,34065000,,-46015000,,-46016000,16717000,26242000,-24540000,-24540000,,,,,,1000,28913000,53453000,2671000,-21475000,,-46016000,-46016000,53007,MEIP
2019-06-30,32300000,,-16818000,,-16819000,14597000,652000,-46245000,-46245000,,,,,,1000,4915000,51160000,4263000,29427000,,-16819000,-16819000,53007,MEIP
2018-06-30,17038000,,-40067000,,-40068000,9787000,-1761000,-28586000,-28586000,,,,,,1000,1622000,30208000,3383000,-11481000,,-40068000,-40068000,53007,MEIP
2017-06-30,7237000,,2671000,,2670000,8628000,18249000,2384000,2384000,,,,,,1000,23249000,20865000,5000000,287000,,2670000,2670000,53007,MEIP
2020-03-31,,,60711000,,47377000,65210000,125921000,60711000,60711000,,,,,,13334000,592225000,531514000,466304000,0,,47377000,47377000,53008,CRVL
2019-03-31,,,61513000,,46703000,63296000,124809000,61513000,61513000,,,,,,14810000,595740000,534227000,470931000,0,,46703000,46703000,53008,CRVL
2018-03-31,,,47903000,,35695000,59350000,107253000,47903000,47903000,,,,,,12208000,558350000,510447000,451097000,0,,35695000,35695000,53008,CRVL
2017-03-31,,,47549000,,29479000,57243000,104792000,47549000,47549000,,,,,,18070000,518686000,471137000,413894000,0,,29479000,29479000,53008,CRVL
2019-12-31,114063000,,-137202000,,-137202000,42347000,-92976000,-135323000,-135323000,,,,,,0,14874000,150197000,107850000,-1879000,,-137202000,-137202000,53012,FPRX
2018-12-31,114063000,,-140447000,,-140447000,39671000,-106484000,-146155000,-146155000,,,,,,0,49868000,196023000,156352000,5708000,,-140447000,-140447000,53012,FPRX
2017-12-31,150908000,,-148518000,,-150222000,40002000,-111400000,-151402000,-151402000,,,,,,1704000,39508000,190910000,150908000,2884000,,-150222000,-150222000,53012,FPRX
2016-12-31,150908000,,-96745000,,-65697000,35831000,-63381000,-99212000,-99212000,,,,,,-31048000,30691000,129903000,94072000,2467000,,-65697000,-65697000,53012,FPRX
2019-12-31,15125000,,-38920000,,-39276000,117302000,101104000,-34492000,-34492000,,,,,,356000,159083000,193575000,57979000,-4428000,,-39276000,-39276000,53013,SPNE
2018-12-31,12058000,,-33395000,,-33524000,107189000,87474000,-34941000,-34941000,,,,,,129000,143443000,178384000,55969000,1546000,,-33524000,-33524000,53013,SPNE
2017-12-31,12180000,,-32233000,,-32115000,99678000,79988000,-35038000,-35038000,,,,,,-118000,131814000,166852000,51826000,2805000,,-32115000,-32115000,53013,SPNE
2016-12-31,11434000,,-43764000,,-43212000,98036000,75020000,-38759000,-38759000,,,,,,-552000,128860000,167619000,53840000,-5005000,,-43212000,-43212000,53013,SPNE
2019-12-31,,,146800000,,113300000,179500000,332400000,152900000,152900000,,-6800000,,,,33500000,1736900000,1584000000,1404500000,-6100000,,113300000,112200000,53014,ACA
2018-12-31,,,95000000,,75700000,153900000,272000000,118100000,118100000,,-900000,,,,19300000,1460400000,1342300000,1188400000,-23100000,,75700000,75500000,53014,ACA
2017-12-31,,,130100000,,89700000,163000000,294700000,131700000,131700000,,-900000,,,,40400000,1462400000,1330700000,1167700000,-1600000,,89700000,89700000,53014,ACA
2016-12-31,,,197200000,,123000000,147300000,348100000,200800000,200800000,,-900000,,,,74200000,1704000000,1503200000,1355900000,-3600000,,123000000,123000000,53014,ACA
2019-12-31,4045000,,-12132000,,-12132000,19358000,6764000,-16639000,-16639000,,-384000,,,,0,13917000,30556000,7153000,4507000,,-12132000,-12132000,53018,EKSO
2018-12-31,5128000,,-26992000,,-26992000,26211000,4309000,-27030000,-27030000,,-600000,,,,0,11332000,38362000,7023000,38000,,-26992000,-26992000,53018,EKSO
2017-12-31,8997000,,-29122000,,-29122000,24357000,2069000,-31285000,-31285000,,-648000,,,,0,7353000,38638000,5284000,2163000,,-29122000,-29122000,53018,EKSO
2016-12-31,8479000,,-23470000,,-23470000,21150000,3858000,-25771000,-25771000,,-16000,,,,0,14221000,39992000,10363000,2301000,,-23470000,-33815000,53018,EKSO
2019-12-31,,,58565441,,58565441,4379734,10521858,6142124,6142124,,-97,,,,0,10521858,4379734,0,52423317,,58565441,53428304,53019,GUT
2018-12-31,,,-5611856,,-5611856,3954823,10154933,6200110,6200110,,-283,,,,0,10154933,3954823,0,-11811966,,-5611856,-10696036,53019,GUT
2017-12-31,,,25458046,,25458046,4320165,9227049,4906884,4906884,,-212,,,,0,9227049,4320165,0,20551162,,25458046,20575986,53019,GUT
2016-12-31,,,44851478,,44851478,4024519,8785926,4761407,4761407,,-57,,,,0,8785926,4024519,0,40090071,,44851478,41199540,53019,GUT
2019-12-31,,,49669591,,49669591,5663142,52162110,46498968,46498968,,-8027004,,,,0,52162110,5663142,0,3170623,,49669591,49669591,53020,DSU
2019-02-28,,,18114730,,18114730,6357811,57223482,50865671,50865671,,-8407818,,,,0,57223482,6357811,0,-32750941,,18114730,18114730,53020,DSU
2018-02-28,,,42329373,,42311538,7154208,60853027,53698819,53698819,,-6932948,,,,17835,60853027,7154208,0,-11369446,,42311538,42311538,53020,DSU
2017-02-28,,,128083303,,127547634,6614400,55943561,49329161,49329161,,-3090441,,,,535669,55943561,6614400,0,78754142,,127547634,127547634,53020,DSU
2019-12-31,,,-8625427,-8,-8625419,4622272,-1522880,-6145152,-6145152,,-1378755,,,,0,12648255,18793407,14171135,-2480275,,-8625427,-8625419,53021,PETZ
2018-12-31,1062582.0,,-14219265,-347,-14219225,7328803,-4052796,-12444181,-12444181,,-233101,,,,0,23674037,36118218,27726833,-1775084,,-14219265,-14219225,53021,PETZ
2017-12-31,1051665.0,,60009,-347,115111,6978043,8297013,267305,267305,,-82946,,,,-55102,28979511,28712206,20682498,-207296,,115111,115111,53021,PETZ
2016-12-31,1076568.0,,1098972,-347,1009171,4847630,7075487,1151289,1151289,,-102274,,,,89801,24443736,23292447,17368249,-52317,,1009171,1009171,53021,PETZ
2019-12-31,,,86719000,,84290000,61063000,393005000,156706000,156706000,-4352000,-79246000,,,,2429000,726991000,570285000,333986000,-69987000,,84290000,81662000,53022,OGCP
2018-12-31,,,121895000,,117253000,52674000,391192000,190857000,190857000,-20847000,-79623000,,,,4642000,710664000,519807000,319472000,-68962000,,117253000,115466000,53022,OGCP
2017-12-31,,,124926000,,118253000,50315000,390377000,192903000,192903000,-13551000,-68762000,,,,6673000,695975000,503072000,305598000,-67977000,,118253000,116557000,53022,OGCP
2016-12-31,,,113396000,,107250000,49078000,380509000,183896000,183896000,-7676000,-70595000,,,,6146000,669677000,485781000,289168000,-70500000,,107250000,105567000,53022,OGCP
2020-09-30,,,-5293831000,179288000,-3408716000,2729432000,5188229000,2067735000,2067735000,,-158522000,,,,-1894273000,189893926000,187826191000,184705697000,-7361566000,,-3399558000,-3408716000,53024,ABC
2019-09-30,,,967106000,114289000,855365000,2663508000,4992440000,1866525000,1866525000,,-195474000,,,,112971000,179589121000,177722596000,174596681000,-899419000,,854135000,855365000,53024,ABC
2018-09-30,,,1177423000,117137000,1658405000,2460301000,4576379000,1650951000,1650951000,,-189640000,,,,-438469000,167939635000,166288684000,163363256000,-473528000,,1615892000,1658405000,53024,ABC
2017-09-30,,,917887000,117137000,364484000,2128730000,4544607000,2018274000,2018274000,,-149042000,,,,553403000,153143826000,151125552000,148599219000,-1100387000,,364484000,364484000,53024,ABC
2020-02-29,,,599200000,,466400000,16556700000,17594200000,1037500000,1037500000,,-719000000,,,,132800000,62455100000,61417600000,44860900000,-438300000,,466400000,466400000,53025,ACI
2019-02-23,,,52200000,,131100000,15983700000,16894600000,910900000,910900000,,-843100000,,,,-78900000,60534500000,59623600000,43639900000,-858700000,,131100000,131100000,53025,ACI
2018-02-24,,,-917500000,,46300000,15991000000,16361100000,370100000,370100000,,-874800000,,,,-963800000,59924600000,59554500000,43563500000,-1287600000,,46300000,46300000,53025,ACI
2017-02-25,,,-463600000,,-373300000,16196200000,17142900000,946700000,946700000,,-1003800000,,,,-90300000,59678200000,58731500000,42535300000,-1410300000,,-373300000,-373300000,53025,ACI
2019-12-31,,,30758000,72635000,30154000,41360000,480093000,148349000,148349000,,-96632000,,,,0,693922000,545573000,213829000,-117591000,,30758000,30154000,53030,HTA
2018-12-31,,,217626000,85434000,213463000,35196000,476541000,161715000,161715000,,-101849000,,,,0,698161000,536446000,221620000,55911000,,217626000,213463000,53030,HTA
2017-12-31,,,65577000,91403000,63916000,33403000,416740000,138351000,138351000,,-85491000,,,,0,614772000,476421000,198032000,-72774000,,65577000,63916000,53030,HTA
2016-12-31,,,47345000,97796000,45912000,28773000,310639000,105000000,105000000,,-60802000,,,,0,460928000,355928000,150289000,-57655000,,47345000,45912000,53030,HTA
2019-12-31,,,83369114,,83369114,3610711,7028491,3417780,3417780,,,,,,0,7028491,3610711,0,79951334,,83369114,83369114,53031,FFA
2018-12-31,,,-29622112,,-29622112,3682412,7342895,3660483,3660483,,,,,,0,7342895,3682412,0,-33282595,,-29622112,-29622112,53031,FFA
2017-12-31,,,47790623,,47790623,3640289,7556946,3916657,3916657,,,,,,0,7556946,3640289,0,43873966,,47790623,47790623,53031,FFA
2016-12-31,,,23899923,,23899923,3348303,7093208,3744905,3744905,,,,,,0,7093208,3348303,0,20155018,,23899923,23899923,53031,FFA
2020-12-31,,,173991000,,137938000,301039000,536052000,0,191382000,43631000,,,,,36053000,536052000,344670000,0,-17391000,,137938000,133487000,53033,HTLFP
2019-12-31,,,184119000,,149129000,298141000,542997000,0,198678000,46178000,,,,,34990000,542997000,344319000,0,-14559000,,149129000,149129000,53033,HTLFP
2018-12-31,,,145213000,,116998000,287050000,492660000,0,160170000,45440000,,,,,28215000,492660000,332490000,0,-14957000,,116998000,116959000,53033,HTLFP
2017-12-31,,,119092000,,75272000,248415000,411152000,0,126350000,36387000,,,,,43820000,411152000,284802000,0,-7258000,,75272000,75226000,53033,HTLFP
2020-03-31,,,2624000,7085000,7656000,39617000,52570000,7272000,7272000,,-4695000,,,,-544000,236785000,229513000,184215000,-4648000,8065000,3168000,7656000,53035,AIRT
2019-03-31,,,5968000,4475000,1340000,33607000,50192000,9346000,9346000,,-3485000,,,,1761000,215502000,206156000,165310000,-3378000,-1006000,4207000,1340000,53035,AIRT
2018-03-31,195653.0,,2651607,1118172,2277109,29138534,36288800,4525881,4525881,,-1852632,,,,195000,194519345,189993464,158230545,-1874274,-1006000,2456607,2277109,53035,AIRT
2017-03-31,1042496.0,,-4219186,640763,-3213539,22205947,23329515,-1715773,-1715773,,-571651,,,,725000,148471659,150187432,125142144,-2503413,-1006000,-4944186,-3213539,53035,AIRT
2019-12-31,,,78442793,14178824,54959024,19145140,67080558,47935418,47935418,,,,,,18688474,136624380,88688962,69543822,30507375,,59754319,54959024,53036,DHIL
2018-12-31,,,64983729,62679687,47375829,16891773,88148180,71256407,71256407,,,,,,18669341,145627748,74371341,57479568,-6272678,,46314388,47375829,53036,DHIL
2017-12-31,,,81018959,20076806,49988957,19031206,86032572,67001366,67001366,,,,,,29417290,145201729,78200363,59169157,14017593,,51601669,49988957,53036,DHIL
2016-12-31,,,73261767,13840688,46051923,16884974,79953577,63068603,63068603,,,,,,26667635,136103075,73034472,56149498,10193164,,46594132,46051923,53036,DHIL
2019-12-31,,,-15615773,21650175,-15531911,12335289,0,-25569682,-25569682,-30305,-12029896,,,,932283,0,25569682,0,9953909,,-16548056,-15531911,53037,NXE
2018-12-31,,,1182308,16631820,2269689,10677436,0,-25947369,-25947369,-30305,-11954146,,,,-309298,0,25947369,0,27129677,,1491606,2269689,53037,NXE
2017-12-31,,,-56863922,12017852,-56038329,7861745,0,-17891224,-17891224,-30305,-11504993,,,,-33312,0,17891224,0,-38972698,,-56830610,-56038329,53037,NXE
2016-12-31,,,-17455889,9008702,-16893468,5749732,0,-15536635,-15536635,94868,-7539399,,,,75776,0,15536635,0,-1919254,,-17531665,-16893468,53037,NXE
2020-12-31,,,6012000000,248000000,4779000000,3814000000,10468000000,6654000000,6654000000,,-359000000,,,,1147000000,32637000000,25983000000,22169000000,-642000000,,4865000000,4779000000,53038,HON
2019-12-31,,,7559000000,219000000,6143000000,4866000000,12370000000,7504000000,7504000000,,-357000000,,,,1329000000,36709000000,29205000000,24339000000,55000000,,6230000000,6143000000,53038,HON
2018-12-31,,,7487000000,185000000,6765000000,4854000000,12756000000,7902000000,7902000000,,-367000000,,,,659000000,41802000000,33900000000,29046000000,-415000000,,6828000000,6765000000,53038,HON
2017-12-31,,,6950000000,168000000,1545000000,5191000000,12390000000,7199000000,7199000000,,-316000000,,,,5362000000,40534000000,33335000000,28144000000,-249000000,,1588000000,1545000000,53038,HON
2019-12-31,,,123681000,,99601000,,123771000,123771000,123771000,,-90000,,,,24080000,877753000,753982000,753982000,-90000,,99601000,99078000,53039,SAFT
2018-12-31,,,104251000,,83195000,,104341000,104341000,104341000,,-90000,,,,21056000,836497000,732156000,732156000,-90000,,83195000,82699000,53039,SAFT
2017-12-31,,,86700000,,62387000,,86790000,86790000,86790000,,-90000,,,,24313000,839113000,752323000,752323000,-90000,,62387000,61995000,53039,SAFT
2016-12-31,,,93282000,,64585000,,93372000,93372000,93372000,,-90000,,,,28697000,819822000,726450000,726450000,-90000,,64585000,64149000,53039,SAFT
2020-12-31,,,723200000,,553100000,1275700000,2174800000,857100000,857100000,,-83900000,,,,168800000,6090300000,5233200000,3915500000,-133900000,,554400000,553100000,53040,FBHS
2019-12-31,,,575300000,1200000.0,431900000,1284800000,2066800000,740600000,740600000,,-94200000,,,,144000000,5764600000,5024000000,3697800000,-165300000,,431300000,431900000,53040,FBHS
2018-12-31,,,537000000,1800000.0,389600000,1235700000,1971500000,699700000,699700000,,-74500000,,,,147000000,5485100000,4785400000,3513600000,-162700000,-200000.0,390000000,389600000,53040,FBHS
2017-12-31,,,634800000,1600000.0,472600000,1179200000,1932200000,721300000,721300000,,-49400000,,,,159500000,5283300000,4562000000,3351100000,-86500000,-2600000.0,475300000,472600000,53040,FBHS
2020-01-31,8084000,,1370000,,1759000,38241000,48758000,2433000,2433000,,-826000,,,,-389000,133446000,131013000,84688000,-1063000,,1759000,1759000,53042,ALOT
2019-01-31,7813000,,7308000,,5730000,37466000,53999000,8720000,8720000,,-876000,,,,1578000,136657000,127937000,82658000,-1412000,,5730000,5730000,53042,ALOT
2018-01-31,7453000,,5157000,,3286000,31137000,44002000,5412000,5412000,,-402000,,,,1871000,113401000,107989000,69399000,783000,,3286000,3286000,53042,ALOT
2017-01-31,6314000,,6605000,,4228000,26294000,39489000,6881000,6881000,,-402000,,,,2377000,98448000,91567000,58959000,-276000,,4228000,4228000,53042,ALOT
2019-12-31,,,10115000,,7900000,35622000,117620000,13130000,13130000,13761000,-8654000,,,,2215000,514177000,501047000,396557000,-3015000,,7900000,7900000,53044,PTSI
2018-12-31,,,31341000,,23994000,17191000,118857000,40296000,40296000,11983000,-6245000,,,,7347000,533261000,492965000,414404000,-8955000,,23994000,23994000,53044,PTSI
2017-12-31,,,14631000,,38899000,17484000,81629000,12622000,12622000,9249000,-3902000,,,,-24268000,437838000,425216000,356209000,2009000,,38899000,38899000,53044,PTSI
2016-12-31,,,17772000,,11101000,16632000,79326000,16528000,16528000,8352000,-3641000,,,,6671000,432852000,416324000,353526000,1244000,,11101000,11101000,53044,PTSI
2019-12-31,,,131253000,,131253000,26837000,324416000,201074000,201074000,11593000,-75691000,,,,0,447244000,246170000,122828000,-69821000,,131253000,131253000,53046,DAC
2018-12-31,,,-32936000,,-32936000,26334000,332684000,198593000,198593000,12207000,-90843000,,,,0,458732000,260139000,126048000,-231529000,,-32936000,-32936000,53046,DAC
2017-12-31,,,83905000,,83905000,22672000,325397000,187497000,187497000,12207000,-90250000,,,,0,451731000,264234000,126334000,-103592000,,83905000,83905000,53046,DAC
2016-12-31,,,-366195000,,-366195000,22105000,369495000,202511000,202511000,12207000,-95448000,,,,0,498332000,295821000,128837000,-568706000,,-366195000,-366195000,53046,DAC
2019-12-31,,,-72068000,2740000,-67763000,28599000,128391000,73956000,73956000,,-34976000,,,,-14564000,431408000,357452000,303017000,-146024000,-8150000,-57504000,-67763000,53047,TSQ
2018-12-31,,,-17120000,1287000,-98658000,27062000,120110000,73464000,73464000,,-34552000,,,,30839000,407869000,334405000,287759000,-90584000,-49344000,-47959000,-98658000,53047,TSQ
2017-12-31,,,14282000,1121000,-13748000,25828000,115117000,70927000,70927000,,-32759000,,,,-7546000,389583000,318656000,274466000,-56645000,-34700000,21828000,-13748000,53047,TSQ
2016-12-31,,,36964000,705000,23023000,25370000,121384000,78963000,78963000,,-34072000,,,,16134000,421581000,342618000,300197000,-41999000,2463000,20830000,23023000,53047,TSQ
2019-12-31,,,20590000,32771000,8646000,21987000,42114000,20127000,20127000,,-481000,,,,5178000,102152000,82025000,60038000,463000,,15412000,8646000,53048,SAMG
2018-12-31,,,22826000,26352000,9630000,19477000,40735000,21258000,21258000,,-62000,,,,5458000,98673000,77415000,57938000,1568000,,17368000,9630000,53048,SAMG
2017-12-31,,,26265000,23024000,5337000,16884000,37215000,20331000,20331000,,-112000,,,,13734000,91358000,71027000,54143000,5934000,,12531000,5337000,53048,SAMG
2016-12-31,,,14668000,18779000,5015000,16465000,31253000,14788000,14788000,,-228000,,,,4686000,80262000,65474000,49009000,-120000,,9982000,5015000,53048,SAMG
2020-12-31,,,52646000,,45234000,100043000,175749000,0,64270000,11436000,,,,,7412000,175749000,111479000,0,-11624000,,45234000,37361000,53050,TSC
2019-12-31,,,68658000,,60193000,89670000,180807000,0,77116000,14021000,,,,,8465000,180807000,103691000,0,-8458000,,60193000,54440000,53050,TSC
2018-12-31,,,60369000,,54424000,81491000,161526000,0,67701000,12334000,,,,,5945000,161526000,93825000,0,-7332000,,54424000,52304000,53050,TSC
2017-12-31,,,47470000,,37988000,72946000,138942000,0,54616000,11380000,,,,,9482000,138942000,84326000,0,-7146000,,37988000,37988000,53050,TSC
2020-12-31,,,217606000,150000,170478000,142517000,420243000,223155000,223155000,,-9362000,,,,46242000,2402596000,2179441000,1982353000,-5549000,,171364000,170478000,53052,ENSG
2019-12-31,,,116167000,1947000,110534000,123067000,303301000,129180000,129180000,,-15662000,,,,23954000,2036524000,1907344000,1733223000,-13013000,18844000.0,92213000,110534000,53052,ENSG
2018-12-31,,,71747000,11405000,92364000,90563000,218676000,83249000,83249000,,-15182000,,,,12685000,1754601000,1671352000,1535925000,-11502000,32871000.0,59062000,92364000,53052,ENSG
2017-12-31,,,31179000,7662000,40475000,74120000,172895000,56507000,56507000,,-13616000,,,,14206000,1598326000,1541819000,1425431000,-25328000,23700000.0,16973000,40475000,53052,ENSG
2020-09-30,41800000,,155400000,8300000,97800000,954100000,1384200000,388300000,388300000,,-144500000,,,,70900000,3964200000,3575900000,2580000000,-232900000,14000000,84500000,97800000,53054,SPB
2019-09-30,43500000,,-193800000,8000000,494500000,955300000,1309700000,310900000,310900000,,-222100000,,,,-7100000,3802100000,3491200000,2492400000,-504700000,682500000,-186700000,494500000,53054,SPB
2018-09-30,44600000,,-35700000,8300000,768300000,897300000,1337900000,396000000,396000000,,-264000000,,,,-462700000,3808700000,3412700000,2470800000,-431700000,445000000,427000000,768300000,53054,SPB
2017-09-30,44600000,,-27900000,1188900000,106000000,927800000,1336900000,364500000,364500000,,-310400000,,,,-11800000,3706500000,3342000000,2369600000,-392400000,289300000,-16100000,106000000,53054,SPB
2019-12-31,,,9087872,,9087872,3140465,12119558,8979093,8979093,,,,,,0,13449435,4470342,1329877,108779,,9087872,9087872,53055,OCG
2018-12-31,,,2624138,,2624138,2185177,4852325,2667148,2667148,,,,,,0,5352700,2685552,500375,-43010,,2624138,2624138,53055,OCG
2020-12-31,,,56659000,,39912000,57808000,130593000,0,69007000,3778000,,,,,16747000,130593000,61586000,0,-12348000,,39912000,39912000,53056,LBC
2019-12-31,,,69464000,,48861000,56309000,131448000,0,70745000,4394000,,,,,20603000,131448000,60703000,0,-1281000,,48861000,48861000,53056,LBC
2018-12-31,,,62931000,,45060000,53571000,125618000,0,67123000,4924000,,,,,17871000,125618000,58495000,0,-4192000,,45060000,45060000,53056,LBC
2017-12-31,,,65231000,,69384000,50718000,121775000,0,67043000,4014000,,,,,-4153000,121775000,54732000,0,-1812000,,69384000,69384000,53056,LBC
2019-12-31,2700000,,92363000,,77916000,443119000,536858000,91039000,91039000,,,,,,14447000,713672000,622633000,176814000,1324000,,77916000,77916000,53057,MED
2018-12-31,2200000,,70548000,,55789000,308636000,379899000,69063000,69063000,,,,,,14759000,501003000,431940000,121104000,1485000,,55789000,55789000,53057,MED
2017-12-31,2200000,,40326000,,27721000,188180000,227812000,39632000,39632000,,,,,,12605000,301563000,261931000,73751000,694000,,27721000,27721000,53057,MED
2016-12-31,2000000,,27122000,,17835000,169556000,205664000,34108000,34108000,,,,,,9287000,274534000,240426000,68870000,-6986000,,17835000,17835000,53057,MED
2019-12-31,81326000,,-101660000,46317000,-39960000,55590000,26097000,-110819000,-110819000,,-11849000,,,,0,36629000,147448000,10532000,9159000,,-101660000,-39960000,53058,FBIO
2018-12-31,87383000,,-130800000,17891000,-84147000,53371000,20757000,-119997000,-119997000,,-10340000,,,,0,26882000,146879000,6125000,-10803000,-11136000.0,-130800000,-84147000,53058,FBIO
2017-12-31,52486000,,-97513000,67929000,-66876000,48697000,13587000,-87596000,-87596000,,-7687000,,,,1513000,17245000,104841000,3658000,-9917000,-2323000.0,-97513000,-66876000,53058,FBIO
2016-12-31,35134000,,-71290000,44473000,-55095000,32915000,4985000,-63609000,-63609000,,-3691000,,,,0,16480000,80089000,11495000,-7681000,-2323000.0,-71290000,-55095000,53058,FBIO
2020-03-29,,,163700000,,151700000,349800000,593300000,193800000,193800000,,-21000000,,,,12000000,958100000,764300000,364800000,-30100000,,151700000,151700000,53059,GOOS
2019-03-31,,,182500000,,143600000,300800000,516800000,198000000,198000000,,-14100000,,,,38900000,830500000,632500000,313700000,-15500000,,143600000,143600000,53059,GOOS
2018-03-31,,,125200000,,96100000,200100000,347600000,138100000,138100000,,-12700000,,,,29100000,591200000,453100000,243600000,-12900000,,96100000,96100000,53059,GOOS
2017-03-31,,,30500000,,21600000,165000000,212100000,40500000,40500000,,-11800000,,,,8900000,403800000,363300000,191700000,-10000000,,21600000,21600000,53059,GOOS
2020-06-30,,,-9641000,32803000,17234000,383790000,291518000,-197171000,-197171000,,-2300000,,,,5046000,762936000,960107000,471418000,187530000,,-14687000,17234000,53064,MSGE
2019-06-30,,,-29695000,81417000,-17894000,321128000,378268000,-52203000,-52203000,,-15262000,,,,443000,1048909000,1101112000,670641000,22508000,,-30138000,-17894000,53064,MSGE
2018-06-30,,,-28943000,88189000,6898000,276394000,353772000,-34680000,-34680000,,-12150000,,,,-30830000,988990000,1023670000,635218000,5737000,,1887000,6898000,53064,MSGE
2017-06-30,,,-120422000,88189000,-108545000,187128000,202649000,-82548000,-82548000,,-1926000,,,,-7811000,711022000,793570000,508373000,-37874000,,-112611000,-108545000,53064,MSGE
2020-12-31,,,238114000,28404000,237278000,27034000,497585000,180323000,180323000,1580000,-60605000,,,,0,748435000,568112000,250850000,57791000,,238114000,237278000,53068,CUZ
2019-12-31,,,152683000,68561000,150418000,37007000,448050000,149890000,149890000,4004000,-53963000,,,,0,670196000,520306000,222146000,2793000,,152683000,150418000,53068,CUZ
2018-12-31,,,80765000,55291000,79164000,22040000,322510000,115306000,115306000,3782000,-39430000,,,,0,487436000,372130000,164926000,-34541000,,80765000,79164000,53068,CUZ
2017-12-31,,,219959000,53138000,216275000,27523000,349418000,121623000,121623000,3527000,-33524000,,,,0,513300000,391677000,163882000,98336000,,219959000,216275000,53068,CUZ
2020-02-01,1080391000,,798382000,,1584391000,453580000,1412767000,-121204000,-121204000,,-85631000,,,,-786009000,2699161000,2820365000,1286394000,919586000,,1584391000,1584391000,53070,MRVL
2019-02-02,914009000,,-4647000,,-179094000,370660000,1681764000,397095000,397095000,,-60362000,,,,174447000,2865791000,2468696000,1184027000,-401742000,,-179094000,-179094000,53070,MRVL
2018-02-03,714444000,,451204000,,520831000,238166000,1461940000,509330000,509330000,,-685000,,,,18062000,2409170000,1899840000,947230000,-58126000,87689000.0,433142000,520831000,53070,MRVL
2017-01-28,805029000,,147429000,,21151000,251191000,1283428000,227208000,227208000,,-368000,,,,72608000,2300992000,2073784000,1017564000,-79779000,-53670000.0,74821000,21151000,53070,MRVL
2020-12-31,88788000,,70803000,,58293000,209002000,372152000,74362000,74362000,,,,,,12510000,1255202000,1180840000,883050000,-3559000,,58293000,58293000,53072,NTGR
2019-12-31,77982000,,29571000,,25791000,187582000,294228000,28664000,28664000,,,,,,3780000,998763000,970099000,704535000,907000,,25791000,25791000,53072,NTGR
2018-12-31,82416000,,43204000,,-9162000,217426000,341698000,41856000,41856000,,,,,,25878000,1058816000,1016960000,717118000,1348000,-26488000.0,17326000,-9162000,53072,NTGR
2017-12-31,71893000,,46224000,,19436000,193025000,307716000,42798000,42798000,,,,,,57357000,1039169000,996371000,731453000,3426000,30569000.0,-11133000,19436000,53072,NTGR
2020-12-31,1902530,,-616878,,1369001,19727971,23574410,1943909,1943909,,,,,,-1985879,31717372,29773463,8142962,-2560787,,1369001,1369001,53073,IRMD
2019-12-31,1403858,,9043317,,9630959,19649717,29700980,8647405,8647405,,,,,,-587642,38517141,29869736,8816161,395912,,9630959,9630959,53073,IRMD
2018-12-31,1517112,,6197307,,6303450,15706468,23227350,6003770,6003770,,,,,,-106143,30438983,24435213,7211633,193537,,6303450,6303450,53073,IRMD
2017-12-31,1722564,,1396386,,499764,14298679,17511696,1285009,1285009,,,,,,896622,23081592,21796583,5569896,111377,,499764,499764,53073,IRMD
2019-12-31,,,9979000,-402000,20831000,11472000,24793000,7598000,7598000,-246000,-1954000,,,,-11154000,120681000,113083000,95888000,2381000,,21133000,20831000,53074,STKS
2018-12-31,,,4620000,-452000,3274000,11119000,20917000,5659000,5659000,-50000,-1193000,,,,713000,85601000,79942000,64684000,-1039000,,3907000,3274000,53074,STKS
2017-12-31,,,-3825000,-922000,-4216000,11893000,17640000,1065000,1065000,36000,-1167000,,,,600000,79660000,78595000,62020000,-4890000,397000.0,-4425000,-4216000,53074,STKS
2016-12-31,,,-5993000,-701000,-16688000,11172000,15286000,-4481000,-4481000,-46000,-464000,,,,10370000,72414000,76895000,57128000,-1512000,-92000.0,-16363000,-16688000,53074,STKS
2019-12-31,13913000,,20001000,6584000,6889000,67944000,130518000,48808000,48808000,-147000,-2610000,,,,12234000,279332000,230524000,148814000,-28807000,,7767000,6889000,53076,ITRN
2018-12-31,6223000,,80452000,6507000,60675000,59033000,127328000,62378000,62378000,-306000,-528000,,,,17273000,253335000,190957000,126007000,18074000,,63179000,60675000,53076,ITRN
2017-12-31,3160000,,64066000,7439000,43794000,59836000,119384000,56535000,56535000,-147000,-528000,,,,17705000,234636000,178101000,115252000,7531000,,46361000,43794000,53076,ITRN
2016-12-31,2895000,,49605000,5942000,32139000,50302000,102031000,49198000,49198000,-364000,-528000,,,,14877000,199574000,150376000,97543000,407000,,34728000,32139000,53076,ITRN
2020-03-31,,,-7234000,,-7234000,11753000,61924000,39911000,39911000,10260000,-13809000,,,,0,61924000,22013000,0,-47145000,,-7234000,-7234000,53077,GAINM
2019-03-31,,,81590000,,81590000,35618000,59663000,10545000,10545000,13500000,-18191000,,,,0,59663000,49118000,0,71045000,,81590000,81590000,53077,GAINM
2018-03-31,,,60687000,,60687000,21888000,58355000,36467000,36467000,13500000,-14507000,,,,0,58355000,21888000,0,24220000,,60687000,60687000,53077,GAINM
2017-03-31,,,44763000,,44763000,15355000,51875000,36520000,36520000,13500000,-14098000,,,,0,51875000,15355000,0,8243000,,44763000,44763000,53077,GAINM
2020-12-31,,,530066000,,390606000,503236000,1162879000,0,587768000,71875000,,,,,139460000,1162879000,575111000,0,-57702000,,390606000,377918000,53078,VLYPO
2019-12-31,,,456795000,,309793000,454807000,1070886000,0,553016000,63063000,,,,,147002000,1070886000,517870000,0,-96221000,,309793000,297105000,53078,VLYPO
2018-12-31,,,329693000,,261428000,462483000,934554000,0,408314000,63757000,,,,,68265000,934554000,526240000,0,-78621000,,261428000,248740000,53078,VLYPO
2017-12-31,,,252738000,,161907000,391335000,720064000,0,282575000,46154000,,,,,90831000,720064000,437489000,0,-29837000,,161907000,152458000,53078,VLYPO
2019-12-31,,,1064000000,3001000000,850000000,533000000,4699000000,2432000000,2432000000,20000000,-1186000000,,,,335000000,8201000000,5769000000,3502000000,-1368000000,-15000000,729000000,847000000,53081,WMB
2018-12-31,,,331000000,1337000000,-155000000,574000000,4335000000,1932000000,1932000000,104000000,-1112000000,,,,138000000,8686000000,6754000000,4351000000,-1601000000,-15000000,193000000,-156000000,53081,WMB
2017-12-31,,,535000000,6519000000,2174000000,656000000,4155000000,1680000000,1680000000,83000000,-1083000000,,,,-1974000000,8031000000,6351000000,3876000000,-1145000000,-15000000,2509000000,2174000000,53081,WMB
2016-12-31,,,-375000000,9403000000,-424000000,716000000,4182000000,1623000000,1623000000,80000000,-1179000000,,,,-25000000,7499000000,5876000000,3317000000,-1998000000,-15000000,-350000000,-424000000,53081,WMB
2019-12-31,5239000,,-5764000,-2546000,-5298000,6454000,5963000,-5730000,-5730000,,-34000,,,,38000,6646000,12376000,683000,-34000,,-5802000,-5298000,53084,NEON
2018-12-31,5278000,,-3929000,-2042000,-3060000,6216000,7617000,-3877000,-3877000,,-49000,,,,13000,8538000,12415000,921000,-52000,,-3942000,-3060000,53084,NEON
2017-12-31,6078000,,-5551000,-1160000,-4705000,7296000,7898000,-5476000,-5476000,,-75000,,,,-56000,10241000,15717000,2343000,-75000,,-5495000,-4705000,53084,NEON
2016-12-31,6269000,,-5282000,-370000,-5291000,6950000,8875000,-4344000,-4344000,,-47000,,,,367000,10213000,14557000,1338000,-938000,,-5649000,-5291000,53084,NEON
2019-12-31,36359000,,-43285000,,-43285000,8013000,0,-44372000,-44372000,,,,,,0,0,44372000,0,1087000,,-43285000,-43285000,53085,PRVB
2018-12-31,22649000,,-26665000,,-26478000,4165000,0,-26814000,-26814000,,,,,,-187000,0,26814000,0,149000,,-26478000,-26754000,53085,PRVB
2017-12-31,7684000,,-9133000,,-9133000,1456000,0,-9140000,-9140000,,,,,,0,0,9140000,0,7000,,-9133000,-9476000,53085,PRVB
2016-12-31,7684000,,-660000,,-660000,660000,0,-660000,-660000,,,,,,0,0,660000,0,0,,-660000,-660000,53085,PRVB
2019-12-31,,,178368499,,178368499,12047837,25887621,13839784,13839784,,,,,,0,25887621,12047837,0,164528715,,178368499,178368499,53086,ETW
2018-12-31,,,-87526960,,-87526960,12936212,28064683,15128471,15128471,,,,,,0,28064683,12936212,0,-102655431,,-87526960,-87526960,53086,ETW
2017-12-31,,,211965926,,211965926,13177484,27594193,14416709,14416709,,,,,,0,27594193,13177484,0,197549217,,211965926,211965926,53086,ETW
2016-12-31,,,33414577,,33414577,12838715,30227763,17389048,17389048,,,,,,0,30227763,12838715,0,16025529,,33414577,33414577,53086,ETW
2020-12-31,,,-283000000,,-274000000,435000000,431000000,-4000000,-4000000,,-28000000,,,,-9000000,2560000000,2564000000,2129000000,-279000000,,-274000000,-298000000,53091,MRC
2019-12-31,,,66000000,,39000000,533000000,653000000,115000000,115000000,,-40000000,,,,27000000,3662000000,3547000000,3009000000,-49000000,,39000000,15000000,53091,MRC
2018-12-31,,,95000000,,74000000,558000000,689000000,131000000,131000000,,-39000000,,,,21000000,4172000000,4041000000,3483000000,-36000000,,74000000,50000000,53091,MRC
2017-12-31,,,7000000,,50000000,536000000,582000000,46000000,46000000,,-39000000,,,,-43000000,3646000000,3600000000,3064000000,-59000000,,50000000,26000000,53091,MRC
2019-12-31,,,-19939000,,-19995000,228789000,527759000,-15555000,-15555000,297885000,-2615000,,,,56000,1101352000,1116907000,573593000,-4384000,,-19995000,-19995000,53092,FVE
2018-12-31,,,-73836000,,-74083000,285669000,546286000,-76561000,-76561000,301239000,-3018000,,,,247000,1109549000,1186110000,563263000,2725000,,-74083000,-74083000,53092,FVE
2017-12-31,,,-25438000,,-20902000,281743000,585160000,-29000000,-29000000,294225000,-4308000,,,,-4536000,1136256000,1165256000,551096000,3562000,,-20902000,-20902000,53092,FVE
2016-12-31,,,-19656000,,-21813000,275183000,582298000,-15470000,-15470000,284533000,-4912000,,,,2351000,1135608000,1151078000,553310000,-4186000,194000.0,-22007000,-21813000,53092,FVE
2019-12-31,,,1295800000,2700000,1073300000,1182000000,4081000000,1776600000,1776600000,81900000,-383900000,,,,222000000,10299400000,8522800000,6218400000,-480800000,,1073800000,1073300000,53096,RSG
2018-12-31,,,1320900000,2400000,1036900000,1059500000,3850900000,1677300000,1677300000,80700000,-389200000,,,,283300000,10040900000,8363600000,6190000000,-356400000,,1037600000,1036900000,53096,RSG
2017-12-31,,,1282100000,2300000,1278400000,1057400000,3826900000,1653400000,1653400000,79800000,-366100000,,,,3100000,10041500000,8388100000,6214600000,-371300000,,1279000000,1278400000,53096,RSG
2016-12-31,,,965900000,2400000,612600000,969800000,3623700000,1583700000,1583700000,79100000,-375700000,,,,352700000,9387700000,7804000000,5764000000,-617800000,,613200000,612600000,53096,RSG
2019-12-31,749000,,26594000,475000,26323000,6288000,33876000,26839000,26839000,,-295000,,,,191000,65777000,38938000,31901000,-245000,,26403000,26323000,53097,GSMG
2018-12-31,502000,,13287000,388000,12903000,6464000,20449000,13483000,13483000,,-497000,,,,241000,57801000,44318000,37352000,-196000,,13046000,12903000,53097,GSMG
2017-12-31,166000,,10229000,388000,11018000,3354000,13794000,10274000,10274000,,-45000,,,,-789000,33237000,22963000,19443000,-45000,,11018000,11018000,53097,GSMG
2020-02-29,29436000,,-58850000,,-79304000,117003000,143303000,-15457000,-15457000,,-20096000,,,,20454000,366107000,381564000,222804000,-43393000,,-79304000,-79304000,53098,CAMP
2019-02-28,27656000,,17068000,,18398000,80027000,147764000,28645000,28645000,,-16726000,,,,-1330000,363800000,335155000,216036000,-11577000,,18398000,18398000,53098,CAMP
2018-02-28,25761000,,27298000,,16617000,102185000,150890000,7955000,7955000,,-10280000,,,,10681000,365912000,357957000,215022000,19343000,,16617000,16617000,53098,CAMP
2017-02-28,22005000,,-9467000,,-7904000,106163000,143352000,123000,123000,,-9896000,,,,-1563000,351102000,350979000,207750000,-9590000,,-7904000,-7904000,53098,CAMP
2019-12-31,,,52669000,,52498000,17189000,198867000,102108000,102108000,17643000,-50848000,,,,171000,229234000,127126000,30367000,-49439000,,52498000,52498000,53099,ILPT
2018-12-31,,,74420000,,74388000,11307000,143188000,90301000,90301000,13005000,-16081000,,,,32000,162530000,72229000,19342000,-15881000,,74388000,74388000,53099,ILPT
2017-12-31,,,80147000,,80103000,16799000,137613000,82586000,82586000,10913000,-2439000,,,,44000,156506000,73920000,18893000,-2439000,,80103000,80103000,53099,ILPT
2016-12-31,,,86942000,,86898000,9200000,136071000,89204000,89204000,10593000,-2262000,,,,44000,153310000,64106000,17239000,-2262000,,86898000,86898000,53099,ILPT
2019-12-31,17903000,,-8092000,,-9021000,36783000,60089000,-4462000,-4462000,,-268000,,,,929000,121845000,126307000,61756000,-3630000,,-9021000,-9021000,53100,SYNC
2018-12-31,23455000,,-6939000,,-7555000,42051000,70575000,-4572000,-4572000,,-338000,,,,616000,143879000,148451000,73304000,-2367000,,-7555000,-7555000,53100,SYNC
2017-12-31,27642000,,-8677000,,-9777000,42485000,69974000,-9973000,-9973000,,-433000,,,,1100000,140027000,150000000,70053000,1296000,,-9777000,-9777000,53100,SYNC
2016-12-31,25612000,,-9521000,,-10740000,42207000,68227000,-8827000,-8827000,,-318000,,,,1219000,127373000,136200000,59146000,-694000,,-10740000,-10740000,53100,SYNC
2020-12-31,267359000,,209567000,785345000,269726000,2061927000,2232950000,-307203000,-307203000,,-16166000,,,,-59019000,3047681000,3354884000,814731000,516770000,,268586000,269726000,53104,IAC
2019-12-31,191564000,,-28306000,513939000,22895000,1833779000,2106191000,-58969000,-58969000,,-11904000,,,,-60489000,2705801000,2764770000,599610000,30663000,,32183000,22895000,53104,IAC
2018-12-31,177298000,,305571000,466045000,246772000,1659753000,2031896000,73071000,73071000,,-13059000,,,,13200000,2533048000,2459977000,501152000,232500000,,292371000,246772000,53104,IAC
2017-12-31,148015000,,-130794000,293192000,37006000,1526083000,1589980000,-164084000,-164084000,,-2181000,,,,-155402000,1952607000,2116691000,362627000,33290000,,24608000,37006000,53104,IAC
2020-12-31,,,672000000,,539000000,1415000000,2405000000,0,698000000,292000000,,,,,133000000,2405000000,1707000000,0,-26000000,,539000000,505000000,53108,ZIONP
2019-12-31,,,1053000000,,816000000,1450000000,2797000000,0,1113000000,234000000,,,,,237000000,2797000000,1684000000,0,-60000000,,816000000,777000000,53108,ZIONP
2018-12-31,,,1143000000,,884000000,1403000000,2821000000,0,1197000000,221000000,,,,,259000000,2821000000,1624000000,0,-54000000,,884000000,845000000,53108,ZIONP
2017-12-31,,,936000000,,592000000,1344000000,2585000000,0,1000000000,241000000,,,,,344000000,2585000000,1585000000,0,-64000000,,592000000,546000000,53108,ZIONP
2020-12-31,,,835538000,443196000,721470000,615041000,2227950000,1585909000,1585909000,,-153198000,,,,-490000,20139658000,18553749000,17911708000,-750371000,,836028000,721470000,53110,NUE
2019-12-31,,,1782807000,433310000,1271143000,732523000,2700360000,1932837000,1932837000,,-157358000,,,,411897000,22588858000,20656021000,19888498000,-150030000,,1370910000,1264108000,53110,NUE
2018-12-31,,,3229391000,409890000,2360767000,881222000,4295408000,3304186000,3304186000,,-161256000,,,,748307000,25067279000,21763093000,20771871000,-74795000,,2481084000,2351423000,53110,NUE
2017-12-31,,,1749957000,345752000,1318688000,687531000,2569407000,1881876000,1881876000,,-187282000,,,,369386000,20252393000,18370517000,17682986000,-164219000,,1380571000,1314139000,53110,NUE
2019-12-31,46491000,,-56614000,-496000,-56480000,12887000,1933000,-57445000,-57445000,,-1083000,,,,132000,1933000,59378000,0,831000,,-56746000,-56480000,53111,PRQR
2018-12-31,29514000,,-37085000,-230000,-36894000,12540000,5587000,-36293000,-36293000,-174000.0,-810000,,,,1000,5587000,41880000,0,-831000,,-37086000,-36894000,53111,PRQR
2017-12-31,31153000,,-43673000,-38000,-43637000,10840000,870000,-40498000,-40498000,-625000.0,-596000,,,,2000,870000,41368000,0,-3175000,,-43675000,-43637000,53111,PRQR
2016-12-31,31923000,,-39103000,-38000,-39103000,9478000,1632000,-39573000,-39573000,-196000.0,-538000,,,,0,1632000,41205000,0,470000,,-39103000,-39103000,53111,PRQR
2019-12-31,1429000,,-14365000,,-15884000,16040000,10262000,-7207000,-7207000,,-4098000,,,,47000,19320000,26527000,9058000,-7158000,-1472000,-14412000,-17096000,53112,REKR
2018-12-31,131000,,-5680000,,-5703000,15068000,10076000,-5123000,-5123000,,-492000,,,,29000,20054000,25177000,9978000,-557000,6000,-5709000,-6818000,53112,REKR
2017-12-31,131000,,-5335800,,-5041134,12981744,8343345,-4638399,-4638399,,-213492,,,,-294666,22135818,26774217,13792473,-697401,6000,-5041134,-5953920,53112,REKR
2016-12-31,131000,,-258955,,-38984,5262768,5168892,-93876,-93876,,-165079,,,,-219971,12128406,12222282,6959514,-165079,6000,-38984,-44270,53112,REKR
2020-12-31,115935047,,411812929,,347563621,89952381,605443520,399556092,399556092,,,,,,64249308,1688189405,1288633313,1082745885,12256837,,347563621,347563621,53114,GNTX
2019-12-31,114687309,,500415334,,424683939,85083056,688307969,488537604,488537604,,,,,,75731395,1858897406,1370359802,1170589437,11877730,,424683939,419655126,53114,GNTX
2018-12-31,107134862,,522046947,,437883097,75206283,690466692,508125547,508125547,,123142.0,,,,84163850,1834063697,1325938150,1143597005,13921400,,437883097,437883097,53114,GNTX
2017-12-31,99726438,,531796704,,406791922,71443476,694528266,523358352,523358352,,-1340329.0,,,,125004782,1794872578,1271514226,1100344312,8438352,,406791922,406791922,53114,GNTX
2019-12-31,,,-8350573,,-8350573,10223810,6626209,-5428027,-5428027,,-704230,,,,0,24189803,29617830,17563594,-2922546,,-8350573,-8350573,53116,UGRO
2018-12-31,,,-3895873,,-3895873,8713509,6158751,-3800584,-3800584,,-119961,,,,0,20050776,23851360,13892025,-95289,,-3895873,-3895873,53116,UGRO
2017-12-31,,,-2577395,,-2577395,5331990,3053686,-2363143,-2363143,,-216576,,,,0,12298015,14661158,9244329,-214252,,-2577395,-2577395,53116,UGRO
2016-12-31,,,-1808861,,-1808861,3020352,1410900,-1609452,-1609452,,-218430,,,,0,7033273,8642725,5622373,-199409,,-1808861,-1808861,53116,UGRO
2020-12-31,,,896684000,,731773000,,1284426000,983388000,983388000,301038000,-86704000,,,,164911000,4737921000,3754533000,3453495000,-86704000,,731773000,731773000,53120,GL
2019-12-31,,,931279000,,760790000,9500000.0,1320410000,1023943000,1023943000,242124000,-84306000,,,,170397000,4527532000,3503589000,3207122000,-92664000,-92000.0,760882000,760790000,53120,GL
2018-12-31,,,863671000,,701466000,9000000.0,1233332000,953747000,953747000,230793000,-90076000,,,,162161000,4303751000,3350004000,3070419000,-91076000,-44000.0,701510000,701466000,53120,GL
2017-12-31,,,830648000,,1454494000,9300000.0,1172435000,915180000,915180000,210921000,-84532000,,,,-627615000,4155573000,3240393000,2983138000,-85532000,-3769000.0,1458263000,1454494000,53120,GL
2020-12-31,207790000,,-22222000,,-24547000,271821000,473456000,-13773000,-13773000,7618000,-30434000,,,,2325000,603466000,617239000,130010000,-8449000,,-24547000,-24547000,53122,DDOG
2019-12-31,111425000,,-15976000,,-16710000,182546000,273831000,-20140000,-20140000,7618000,-30434000,,,,734000,362780000,382920000,88949000,4164000,,-16710000,-16710000,53122,DDOG
2018-12-31,55176000,,-10240000,,-10762000,107405000,151548000,-11033000,-11033000,7618000,-30434000,,,,522000,198077000,209110000,46529000,793000,,-10762000,-10762000,53122,DDOG
2017-12-31,24734000,,-2113000,,-2570000,55569000,77347000,-2956000,-2956000,7618000,-30434000,,,,457000,100761000,103717000,23414000,843000,,-2570000,-2570000,53122,DDOG
2019-12-31,,,22119613,,22081046,2583342,12534354,9951012,9951012,,-1639015,,,,38567,12534354,2583342,0,12168601,,22081046,22081046,53125,FAM
2018-12-31,,,-13261878,,-13261749,2704330,13313971,10609641,10609641,,-1529610,,,,-129,13313971,2704330,0,-23871519,,-13261749,-13261749,53125,FAM
2017-12-31,,,27032122,,26969475,3518213,15925357,12407144,12407144,,-1298016,,,,62647,15925357,3518213,0,14624978,,26969475,26969475,53125,FAM
2016-12-31,,,22781551,,22760693,3632350,17277582,13645232,13645232,,-1027888,,,,20858,17277582,3632350,0,9136319,,22760693,22760693,53125,FAM
2020-09-30,6946008,,-17384520,,-17384520,10123298,0,-17069306,-17069306,,-7686,,,,0,0,17069306,0,-315214,,-17384520,-17384520,53127,NBSE
2019-09-30,16414616,,-26132130,,-26132130,9095674,0,-25510290,-25510290,,-128951,,,,0,0,25510290,0,-13589255,,-26132130,-26132130,53127,NBSE
2018-09-30,153828,,-503424,,-503424,340716,0,-494544,-494544,,-8880,,,,0,0,494544,0,-8880,,-503424,-503424,53127,NBSE
2020-12-31,,,64981000,,49343000,103238000,168249000,65011000,65011000,,-30000,,,,15638000,425544000,360533000,257295000,-30000,,49343000,49343000,53128,BMI
2019-12-31,,,61607000,,47177000,101668000,163528000,61860000,61860000,,-253000,,,,14430000,424625000,362765000,261097000,-253000,,47177000,47177000,53128,BMI
2018-12-31,,,35852000,,27790000,125340000,162349000,37009000,37009000,,-1157000,,,,8062000,433732000,396723000,271383000,-1157000,,27790000,27790000,53128,BMI
2017-12-31,,,54833000,,34571000,100124000,155746000,55622000,55622000,,-789000,,,,20262000,402440000,346818000,246694000,-789000,,34571000,34571000,53128,BMI
2020-09-30,3312000,,-3116000,,-15723000,21397000,24441000,-268000,-268000,,,,,,791000,65463000,65731000,41022000,-2848000,-11816000,-3907000,-15723000,53130,ASYS
2019-09-30,3068000,,5768000,,-5162000,24263000,33357000,6026000,6026000,,,,,,2633000,85035000,79009000,51678000,-258000,-8297000,3135000,-5162000,53130,ASYS
2018-09-30,2856000,,9927000,,5305000,25743000,36918000,8319000,8319000,,,,,,3296000,100053000,91734000,63135000,1608000,-1326000,6631000,5305000,53130,ASYS
2017-09-30,2738000,,3603000,,9131000,24727000,31106000,3641000,3641000,,,,,,1409000,83073000,79432000,51967000,-38000,6937000,2194000,9131000,53130,ASYS
2019-12-31,,,7432760,,7432760,1595514,8336139,6547152,6547152,193473,-50739,,,,0,8336139,1788987,0,885608,,7432760,7432760,53131,EIC
2018-12-31,,,-19647288,,-19647288,-75944,6074328,6074328,6074328,75944,-50739,,,,0,6074328,0,0,-25721616,,-19647288,-20608332,53131,EIC
2020-12-31,,,189270000,,138237000,520831000,806854000,194689000,194689000,,-8016000,,,,51033000,4287004000,4092315000,3480150000,-5419000,,138237000,137455000,53134,NSP
2019-12-31,,,189643000,,151099000,493585000,732934000,186633000,186633000,,-7647000,,,,38544000,4314804000,4128171000,3581870000,3010000,,151099000,149340000,53134,NSP
2018-12-31,,,182360000,,135413000,450300000,681909000,188342000,188342000,,-4668000,,,,46947000,3828549000,3640207000,3146640000,-5982000,,135413000,133538000,53134,NSP
2017-12-31,,,130141000,,84402000,398263000,572731000,131941000,131941000,,-3213000,,,,45739000,3300223000,3168282000,2727492000,-1800000,,84402000,82885000,53134,NSP
2020-04-30,64548000,,-68998000,,-69378000,124828000,117879000,-71497000,-71497000,,,,,,380000,156666000,228163000,38787000,2499000,,-69378000,-69378000,53136,AI
2019-04-30,37318000,,-33080000,,-33346000,59943000,61219000,-36042000,-36042000,,,,,,266000,91605000,127647000,30386000,2962000,,-33346000,-33346000,53136,AI
2020-12-31,,,111312000,,89595000,92944000,226602000,0,112441000,21217000,,,,,21717000,226602000,114161000,0,-1129000,,89595000,88708000,53137,CHCO
2019-12-31,,,113487000,,89352000,93842000,231101000,0,115556000,21703000,,,,,24135000,231101000,115545000,0,-2069000,,89352000,88546000,53137,CHCO
2018-12-31,,,88017000,,70002000,81484000,201083000,0,103370000,16229000,,,,,18015000,201083000,97713000,0,-15353000,,70002000,69348000,53137,CHCO
2017-12-31,,,90745000,,54310000,78735000,186726000,0,92828000,15163000,,,,,36435000,186726000,93898000,0,-2083000,,54310000,53719000,53137,CHCO
2020-03-31,,,-947000,,-1320000,10026000,11864000,1889000,1889000,-51000,,,,,373000,65368000,63479000,53504000,-2836000,,-1320000,-1320000,53140,DSWL
2019-03-31,,,4417000,,4273000,9459000,10270000,637000,637000,174000,,,,,144000,66581000,65944000,56311000,3780000,,4273000,4273000,53140,DSWL
2018-03-31,,,6197000,,6190000,8806000,9714000,1919000,1919000,-1011000,,,,,7000,60667000,58748000,50953000,4278000,,6190000,6190000,53140,DSWL
2017-03-31,,,1585000,,1376000,8856000,7449000,-1580000,-1580000,173000,,,,,209000,44522000,46102000,37073000,3165000,,1376000,1376000,53140,DSWL
2019-12-31,39508000,,4823000,,36282000,85715000,154370000,6752000,6752000,,-2254000,,,,-31459000,256012000,249260000,101642000,-1929000,,36282000,36282000,53142,APPF
2018-12-31,24111000,,20387000,,19967000,57939000,117622000,20996000,20996000,,-213000,,,,420000,190071000,169075000,72449000,-609000,,19967000,19967000,53142,APPF
2017-12-31,16578000,,9774000,,9716000,49908000,88520000,9335000,9335000,,-165000,,,,58000,143803000,134468000,55283000,439000,,9716000,9716000,53142,APPF
2016-12-31,12638000,,-8214000,,-8281000,46806000,60956000,-8423000,-8423000,,-254000,,,,67000,105586000,114009000,44630000,209000,,-8281000,-8281000,53142,APPF
2020-02-29,,,39204908,,39204908,3569353,15727495,12158142,12158142,,-3739673,,,,0,15727495,3569353,0,27046766,,39204908,39204908,53145,NUO
2019-02-28,,,12791772,,12791772,3147084,17135237,13988153,13988153,,-3798602,,,,0,17135237,3147084,0,-1196381,,12791772,12791772,53145,NUO
2018-02-28,,,9100351,,9100351,3191728,18530824,15339096,15339096,,-2765732,,,,0,18530824,3191728,0,-6238745,,9100351,9100351,53145,NUO
2017-02-28,,,-1233587,,-1233587,4307209,19429716,15122507,15122507,,-1351025,,,,0,19429716,4307209,0,-16356094,,-1233587,-1233587,53145,NUO
2019-12-31,,,-13685014,4361361,-25228932,5414605,463618,-10185192,-10185192,,-523676,,,,0,955172,11140364,491554,-3499822,-11707494,-13685014,-25228932,53147,FTFT
2018-12-31,,,-189752121,4601121,-169997054,12133503,-2286372,-14419875,-14419875,,-1624683,,,,237,888670,15308545,3175042,-175332246,4013367,-189752358,-169997054,53147,FTFT
2017-12-31,,,-102035434,20343058,-102583700,11135696,1734381,-9401315,-9401315,,-3076051,,,,266120,10463135,19864450,8728754,-92634119,-14662946,-102301554,-102583700,53147,FTFT
2016-12-31,,,968131,35164104,-5292575,6942370,9173472,2231102,2231102,,-1659300,,,,1601967,34407422,32176320,25233950,-1262971,-4785187,-633836,-5292575,53147,FTFT
2020-12-31,,,3228000000,2843000000,2339000000,1277000000,5350000000,3867000000,3867000000,,-141000000,,,,694000000,7442000000,3575000000,2092000000,-639000000,,2534000000,2339000000,53148,SPGI
2019-12-31,,,2930000000,2325000000,2123000000,1360000000,4723000000,3159000000,3159000000,,-141000000,,,,627000000,6699000000,3540000000,1976000000,-229000000,,2303000000,2123000000,53148,SPGI
2018-12-31,,,2681000000,1676000000,1958000000,1253000000,4420000000,2961000000,2961000000,,-134000000,,,,560000000,6258000000,3297000000,1838000000,-250000000,,2121000000,1958000000,53148,SPGI
2017-12-31,,,2461000000,1409000000,1496000000,1438000000,4369000000,2751000000,2751000000,,-149000000,,,,823000000,6063000000,3312000000,1694000000,-290000000,,1638000000,1496000000,53148,SPGI
2019-12-31,,,-18668007,,-16851533,8000164,-12565309,-20565473,-20565473,,-1393400,,,,-1816474,500000,21065473,13065309,1897466,,-16851533,-16851533,53149,CLSN
2018-12-31,,,-22302474,,-11883359,9699521,-10565523,-20265044,-20265044,,-712025,,,,-10419115,500000,20765044,11065523,-2037430,,-11883359,-11883359,53149,CLSN
2017-12-31,,,-20402176,,-20402176,5889722,-12578710,-18468432,-18468432,,-91756,,,,0,500000,18968432,13078710,-1933744,,-20402176,-20747861,53149,CLSN
2016-12-31,14623068.0,,-22053726,,-22053726,6526752,500000,-20649820,-20649820,,-722993,,,,0,500000,21149820,0,-1403906,,-22053726,-22053726,53149,CLSN
2019-12-31,,,819000000,349000000,700000000,79000000,2532000000,961000000,961000000,591000000,-306000000,,,,143000000,6338000000,5377000000,3806000000,-142000000,,676000000,700000000,53150,AGR
2018-12-31,,,768000000,299000000,595000000,128000000,2580000000,1021000000,1021000000,579000000,-303000000,,,,170000000,6478000000,5457000000,3898000000,-253000000,,598000000,595000000,53150,AGR
2017-12-31,,,123000000,19000000,381000000,120000000,2553000000,1047000000,1047000000,563000000,-280000000,,,,-259000000,5963000000,4916000000,3410000000,-924000000,,382000000,381000000,53150,AGR
2016-12-31,,,1009000000,13000000,632000000,120000000,2526000000,1194000000,1194000000,528000000,-268000000,,,,377000000,6018000000,4824000000,3492000000,-185000000,,632000000,632000000,53150,AGR
2019-12-31,,,8505000,,6984000,139716000,164074000,19658000,19658000,,-17220000,,,,1521000,610373000,590715000,446299000,-11153000,,6984000,6984000,53155,SIC
2018-12-31,,,-1486000,,-2475000,117257000,133454000,13297000,13297000,,-11426000,,,,989000,489757000,476460000,356303000,-14783000,,-2475000,-2475000,53155,SIC
2017-12-31,,,-8026000,,-11346000,92127000,103889000,9962000,9962000,,-12761000,,,,3320000,352952000,342990000,249063000,-17988000,,-11346000,-5689000,53155,SIC
2016-12-31,,,9689000,,7055000,51905000,66830000,14925000,14925000,,-4735000,,,,2634000,233868000,218943000,167038000,-5236000,,7055000,7055000,53155,SIC
2020-12-31,580000000,,-11298000000,418000000,-10518000000,365000000,2601000000,1656000000,1656000000,,-563000000,,,,-812000000,23601000000,21945000000,21000000000,-12954000000,,-10486000000,-10518000000,53157,SLB
2019-12-31,717000000,,-10418000000,416000000,-10137000000,511000000,4197000000,2969000000,2969000000,,-609000000,,,,-311000000,32917000000,29948000000,28720000000,-13387000000,,-10107000000,-10137000000,53157,SLB
2018-12-31,702000000,,2624000000,424000000,2138000000,444000000,4337000000,3191000000,3191000000,,-575000000,,,,447000000,32815000000,29624000000,28478000000,-567000000,,2177000000,2138000000,53157,SLB
2017-12-31,787000000,,-1183000000,419000000,-1505000000,432000000,4142000000,2923000000,2923000000,,-566000000,,,,330000000,30440000000,27517000000,26298000000,-4106000000,,-1513000000,-1505000000,53157,SLB
2020-12-31,,,-622323000,,-598606000,142372000,183874000,-460931000,-460931000,,-73045000,,,,-23717000,801003000,1261934000,617129000,-161392000,,-598606000,-598606000,53159,CPA
2019-12-31,,,293439000,,247002000,328713000,1046290000,435497000,435497000,,-51286000,,,,46437000,2707408000,2271911000,1661118000,-142058000,,247002000,247002000,53159,CPA
2018-12-31,,,122728000,,88198000,333895000,958644000,348186000,348186000,,-50029000,,,,34530000,2677627000,2329441000,1718983000,-225458000,,88198000,88198000,53159,CPA
2017-12-31,,,411909000,,362599000,314671000,1030578000,438384000,438384000,,-50330000,,,,49310000,2521786000,2083402000,1491208000,-26475000,,362599000,362599000,53159,CPA
2019-12-31,3687609,,-1267413,,-1295587,4006019,6739720,-953908,-953908,,-431788,,,,28174,13722872,14676780,6983152,-627505,,-1295587,-1295587,53161,ICCC
2018-12-31,3516619,,-1860051,,-2321671,3823856,5193905,-2146570,-2146570,,-427782,,,,461620,10986297,13132867,5792392,286519,,-2321671,-2321671,53161,ICCC
2017-12-31,2046564,,-438480,,-168147,3417638,5221357,-242845,-242845,,-218571,,,,-270333,10431091,10673936,5209734,-195635,,-168147,-168147,53161,ICCC
2016-12-31,1244335,,758322,,508448,3286156,5420695,890204,890204,,-161697,,,,249874,9543961,8653757,4123266,-131882,,508448,508448,53161,ICCC
2019-12-31,,,-133746000,,-133746000,64555000,-76367000,-140922000,-140922000,,,,,,0,20531000,161453000,96898000,7176000,,-133746000,-133746000,53162,EDIT
2018-12-31,90654000.0,,-109954000,,-109954000,55010000,-58717000,-113727000,-113727000,,,,,,0,31937000,145664000,90654000,3773000,,-109954000,-109954000,53162,EDIT
2017-12-31,90654000.0,,-120324000,,-120324000,50502000,-69431000,-119933000,-119933000,,-978000.0,,,,0,13728000,133661000,83159000,-391000,,-120324000,-120324000,53162,EDIT
2016-12-31,90654000.0,,-97183000,,-97183000,46262000,-50926000,-97188000,-97188000,,-978000.0,,,,0,6053000,103241000,56979000,5000,,-97183000,-97230000,53162,EDIT
2019-12-31,955000,,-75353000,-55000,-75183000,37349000,-14300000,-52604000,-52604000,,-609000,,,,-115000,229958000,282562000,244258000,-22749000,,-75238000,-75183000,53165,RAIL
2018-12-31,42000,,-30412000,-55000,-40581000,28245000,-3627000,-31914000,-31914000,,-155000,,,,10169000,316519000,348433000,320146000,1502000,,-40581000,-40581000,53165,RAIL
2017-12-31,298000,,-31407000,-55000,-22562000,25197000,2996000,-22499000,-22499000,,-163000,,,,-8845000,409474000,431973000,406478000,-8908000,,-22562000,-22562000,53165,RAIL
2016-12-31,386000,,15788000,-55000,12324000,35990000,40179000,3803000,3803000,,-171000,,,,3464000,523731000,519928000,483552000,11985000,,12324000,12324000,53165,RAIL
2019-12-31,12622000,,-13630000,,-13630000,5954000,0,-18576000,-18576000,,,,,,0,0,18576000,0,4946000,,-13630000,-13630000,53166,AMPE
2018-12-31,6829000,,33986000,,33986000,4355000,0,-11184000,-11184000,,-5000.0,,,,0,0,11184000,0,45170000,,33986000,33986000,53166,AMPE
2017-12-31,10420732,,-51891945,,-51891945,5255467,0,-15676199,-15676199,,-5000.0,,,,0,0,15676199,0,-36326989,,-51891945,-51891945,53166,AMPE
2016-12-31,10546287,,-19163629,,-19163629,6536067,0,-17082354,-17082354,,-5000.0,,,,0,0,17082354,0,-2081275,,-19163629,-19163629,53166,AMPE
2019-12-31,17906000,,-29927000,,-29928000,12843000,735000,-30014000,-30014000,,,,,,1000,735000,30749000,0,87000,,-29928000,-29928000,53167,RESN
2018-12-31,14017000,,-24815000,,-24816000,11704000,524000,-25197000,-25197000,,,,,,1000,524000,25721000,0,382000,,-24816000,-24816000,53167,RESN
2017-12-31,10037000,,-21667000,,-21653000,9244000,653000,-18628000,-18628000,,,,,,-14000,653000,19281000,0,-3039000,,-21653000,-21653000,53167,RESN
2016-12-31,6876000,,-15269000,,-15247000,7810000,302000,-14384000,-14384000,,,,,,-22000,302000,14686000,0,-885000,,-15247000,-15247000,53167,RESN
2019-12-31,93070000,,63933000,,38876000,364651000,516044000,81110000,81110000,-22787000,-15471000,,,,25057000,788159000,707049000,272115000,-17177000,,38876000,38876000,53172,LINX
2018-12-31,73527000,,92144000,,71055000,279604000,439938000,90063000,90063000,-3256000,-8423000,,,,21089000,685559000,595496000,245621000,2081000,,71055000,71055000,53172,LINX
2017-12-31,64280000,,108761000,,84845000,263263000,402717000,74368000,74368000,806000,-8081000,,,,23916000,571590000,497222000,168873000,34393000,,84845000,84845000,53172,LINX
2016-12-31,59894000,,92899000,,68501000,214803000,347219000,68461000,68461000,4061000,-15378000,,,,24398000,494583000,426122000,147364000,24438000,,68501000,68501000,53172,LINX
2020-12-31,,,-7588000,,-8947000,24198000,22970000,-1228000,-1228000,,,,,,1359000,65111000,66339000,42141000,-6360000,,-8947000,-8947000,53173,WHG
2019-12-31,,,9402000,,5911000,27429000,33927000,6498000,6498000,,,,,,3491000,84079000,77581000,50152000,2904000,,5911000,5911000,53173,WHG
2018-12-31,,,36462000,,26751000,29194000,62341000,33147000,33147000,,,,,,9711000,122300000,89153000,59959000,3315000,,26751000,26751000,53173,WHG
2017-12-31,,,33893000,,19989000,29333000,68830000,39497000,39497000,,,,,,13904000,133785000,94288000,64955000,-5604000,,19989000,19989000,53173,WHG
2020-06-30,,,5884000,,4245000,15198000,22970000,0,5932000,1840000,,,,,1639000,22970000,17038000,0,-48000,,4245000,4245000,53174,IROQ
2019-06-30,,,4851000,,3558000,14443000,21623000,0,5017000,2163000,,,,,1293000,21623000,16606000,0,-166000,,3558000,3558000,53174,IROQ
2018-06-30,,,4463000,,1738000,13384000,20819000,0,4634000,2801000,,,,,2725000,20819000,16185000,0,-171000,,1738000,1738000,53174,IROQ
2017-06-30,,,6193000,,3919000,12956000,20728000,0,6353000,1419000,,,,,2274000,20728000,14375000,0,-160000,,3919000,3919000,53174,IROQ
2019-12-31,6317000,,-69442000,,-69442000,18126000,0,-24443000,-24443000,,-1000,,,,0,0,24443000,0,-44999000,,-69442000,-69442000,53175,NLTX
2018-12-31,32789000,,-31585000,,-31585000,14735000,25000000,-22524000,-22524000,,-4000,,,,0,25000000,47524000,0,-9061000,,-31585000,-31585000,53175,NLTX
2017-12-31,36267000,,-50183000,,-50183000,14852000,0,-51119000,-51119000,,-4000,,,,0,0,51119000,0,936000,,-50183000,-50183000,53175,NLTX
2016-12-31,28382000,,-37002000,,-37002000,9263000,0,-37645000,-37645000,,-1000,,,,0,0,37645000,0,643000,,-37002000,-37002000,53175,NLTX
2020-12-31,,,1627600000,,1209300000,4001500000,5975800000,0,1627600000,346700000,,,,,418300000,5975800000,4348200000,0,0,,1209300000,1141000000,53177,NTRSO
2019-12-31,,,1944100000,,1492200000,3917900000,6087600000,0,1944100000,225600000,,,,,451900000,6087600000,4143500000,0,0,,1492200000,1428900000,53177,NTRSO
2018-12-31,,,1957800000,,1556400000,3784600000,5974700000,0,1957800000,232300000,,,,,401400000,5974700000,4016900000,0,0,,1556400000,1489900000,53177,NTRSO
2017-12-31,,,1633900000,,1199000000,3533200000,5403300000,0,1633900000,236200000,,,,,434900000,5403300000,3769400000,0,0,,1199000000,1130400000,53177,NTRSO
2020-10-31,124100000,,407070000,,329701000,638428000,1194581000,432053000,432053000,,-33156000,,,,77369000,3378810000,2946757000,2184229000,-24983000,,329701000,329701000,53178,TTC
2019-10-31,109100000,,322133000,,273983000,590817000,1097647000,397730000,397730000,,-28835000,,,,48150000,3138084000,2740354000,2040437000,-75597000,,273983000,273983000,53178,TTC
2018-10-31,83500000,,372397000,,271939000,484426000,941011000,373085000,373085000,,-19096000,,,,100458000,2618650000,2245565000,1677639000,-688000,,271939000,271939000,53178,TTC
2017-10-31,83500000,,353184000,,267717000,565727000,920837000,355110000,355110000,,-19113000,,,,85467000,2505176000,2150066000,1584339000,-1926000,,267717000,267717000,53178,TTC
2019-12-29,,,482637000,,400709000,380793000,1011700000,630907000,630907000,,-150818000,,,,81928000,3618774000,2987867000,2607074000,-148270000,,400709000,400709000,53179,DPZ
2018-12-30,,,428678000,,361972000,371964000,944153000,572189000,572189000,,-146345000,,,,66706000,3432867000,2860678000,2488714000,-143511000,,361972000,361972000,53179,DPZ
2017-12-31,,,400153000,,277905000,344159000,865991000,521832000,521832000,,-122541000,,,,122248000,2787979000,2266147000,1921988000,-121679000,,277905000,277905000,53179,DPZ
2017-01-01,,,344658000,,214678000,313649000,767691000,454042000,454042000,,-110069000,,,,129980000,2472628000,2018586000,1704937000,-109484000,,214678000,214678000,53179,DPZ
2019-12-31,,,95908000,,89755000,7227000,0,-7227000,-7227000,,-24000,,,,6153000,0,7227000,0,103135000,,89755000,89755000,53180,LORL
2018-12-31,,,-29671000,,9614000,6850000,0,-6850000,-6850000,,-26000,,,,-39348000,0,6850000,0,-22821000,-63000.0,9677000,9614000,53180,LORL
2017-12-31,,,207577000,,134464000,7935000,0,-7935000,-7935000,,-27000,,,,73108000,0,7935000,0,215512000,-5000.0,134469000,134464000,53180,LORL
2016-12-31,,,76077000,,47200000,6726000,0,-6726000,-6726000,,-20000,,,,28507000,0,6726000,0,82803000,-370000.0,47570000,47200000,53180,LORL
2020-12-31,126200000,,460300000,,342000000,508400000,1188100000,553500000,553500000,,-10000000,,,,118300000,2704600000,2151100000,1516500000,-93200000,,342000000,342000000,53181,VNT
2019-12-31,136400000,,565800000,4900000.0,436500000,487600000,1192800000,568800000,568800000,,-10000000,,,,129300000,2772100000,2203300000,1579300000,-3000000,,436500000,436500000,53181,VNT
2018-12-31,136200000,,507300000,3100000.0,385500000,497800000,1135500000,501500000,501500000,,-10000000,,,,121800000,2665900000,2164400000,1530400000,5800000,,385500000,385500000,53181,VNT
2017-12-31,126200000,,523900000,3900000.0,373300000,440300000,1073100000,506600000,506600000,,-10000000,,,,150600000,2498200000,1991600000,1425100000,17300000,,373300000,373300000,53181,VNT
2020-04-30,,,-10466000,,-10466000,14517000,3932000,-10585000,-10585000,,,,,,0,59702000,70287000,55770000,119000,,-10466000,-15152000,53182,CDMOP
2019-04-30,,,-5340000,,-4215000,12846000,7224000,-5622000,-5622000,,,,,,-284000,53603000,59225000,46379000,282000,841000.0,-5056000,-8901000,53182,CDMOP
2018-04-30,,,-20563000,,-21813000,16456000,-2924000,-19380000,-19380000,,-27000.0,,,,0,53621000,73001000,56545000,-1183000,-1250000.0,-20563000,-26499000,53182,CDMOP
2017-04-30,,,1393000,,-28159000,18079000,19371000,1292000,1292000,,-7000.0,,,,0,57630000,56338000,38259000,101000,-29552000.0,1393000,-32799000,53182,CDMOP
2019-12-31,,,80872000,8483000,80526000,18453000,168014000,110179000,110179000,,-30582000,,,,0,185134000,74955000,17120000,-29307000,,80872000,80135000,53183,LTC
2018-12-31,,,155076000,7481000,154981000,19193000,166385000,109550000,109550000,,-30196000,,,,0,166469000,56919000,84000,48390000,,155076000,154356000,53183,LTC
2017-12-31,,,87340000,3488000,87340000,17513000,166633000,109836000,109836000,,-29949000,,,,0,166689000,56853000,56000,-22496000,,87340000,86978000,53183,LTC
2016-12-31,,,85115000,3488000,85115000,17412000,161807000,108006000,108006000,,-26442000,,,,0,161986000,53980000,179000,-22891000,,85115000,84730000,53183,LTC
2019-12-29,,,-75017000,,-84386000,82573000,134610000,11828000,11828000,42000,-3872000,,,,9369000,660943000,649115000,526333000,-86845000,,-84386000,-84386000,53184,FRGI
2018-12-30,,,5015000,,7787000,77713000,144658000,26349000,26349000,2137000,-3966000,,,,-2772000,688597000,662248000,543939000,-21334000,,7787000,7702000,53184,FRGI
2017-12-31,,,-43987000,,-36232000,83936000,145639000,15234000,15234000,10250000,-2877000,,,,-7755000,669132000,653898000,523493000,-59221000,,-36232000,-36232000,53184,FRGI
2017-01-01,,,25048000,,16712000,82757000,177906000,50154000,50154000,4774000,-2171000,,,,8336000,711770000,661616000,533864000,-25106000,,16712000,16577000,53184,FRGI
2019-12-31,2355307,,5934533,8366246,4464556,3419216,12378601,6604078,6604078,,-1289133,,,,847367,52400844,45796766,40022243,-669545,,5087166,4464556,53187,GTEC
2018-12-31,2512403,,8016507,7898064,5956665,2863575,14073230,8697252,8697252,,-1554864,,,,1392956,60213088,51515836,46139858,-680745,,6623551,5956665,53187,GTEC
2017-12-31,1838032,,-1078044,7895112,-3264935,10876728,11861444,-853316,-853316,,-1169954,,,,2192647,49073189,49926505,37211745,-224728,,-3270691,-3264935,53187,GTEC
2019-12-31,176248000,,-109803000,,-109965000,227839000,256739000,-147348000,-147348000,,-11118000,,,,162000,906458000,1053806000,649719000,61621000,,-109965000,-109965000,53188,JG
2018-12-31,134358000,,-66167000,,-66197000,155494000,197067000,-92785000,-92785000,,-7054000,,,,30000,714141000,806926000,517074000,26618000,,-66197000,-90291000,53188,JG
2017-12-31,71651000,,-94271000,,-90291000,92104000,71339000,-92416000,-92416000,,-122000,,,,-3980000,284709000,377125000,213370000,-1855000,,-90291000,-116682000,53188,JG
2016-12-31,33717000,,-57472000,,-61382000,46542000,22600000,-57659000,-57659000,,-122000,,,,3910000,70322000,127981000,47722000,187000,,-61382000,-73809000,53188,JG
2020-12-31,,,209445000,,164089000,324527000,577434000,0,226613000,26294000,,,,,45356000,577434000,350821000,0,-17168000,,164089000,159269000,53189,UCBIO
2019-12-31,,,238712000,,185721000,280991000,559307000,0,250581000,25976000,,,,,52991000,559307000,308726000,0,-11869000,,185721000,184346000,53189,UCBIO
2018-12-31,,,215926000,,166111000,259643000,522211000,0,236677000,25553000,,,,,49815000,522211000,285534000,0,-20751000,,166111000,164927000,53189,UCBIO
2017-12-31,,,172834000,,67821000,221857000,440445000,0,197418000,20187000,,,,,105013000,440445000,243027000,0,-24584000,,67821000,67250000,53189,UCBIO
2020-09-30,,,115005000,3603000,104720000,216931000,434056000,0,127984000,89141000,,,,,5661000,434056000,306072000,0,-12979000,,109344000,104720000,53190,CASH
2019-09-30,,,97942000,4047000,97004000,227373000,431102000,0,125313000,78416000,,,,,-3374000,431102000,305789000,0,-27371000,,101316000,97004000,53190,CASH
2018-09-30,,,57410000,3574000,51620000,149234000,285642000,0,67069000,69339000,,,,,5117000,285642000,218573000,0,-9659000,,52293000,51620000,53190,CASH
2017-09-30,,,55150000,3574000,44917000,117143000,254813000,0,77760000,59910000,,,,,10233000,254813000,177053000,0,-22610000,,44917000,44917000,53190,CASH
2019-12-31,,,11156048,,11174576,5541378,15991736,10450358,10450358,,-48311,,,,-18528,17846900,7396542,1855164,705690,,11174576,11174576,53195,BAOS
2018-12-31,,,113987424,,110314920,59974200,176243388,116269188,116269188,,-2305680,,,,3672504,193882512,77613324,17639124,-2281764,,110314920,110314920,53195,BAOS
2019-12-31,5416425,,-19390132,,-19390132,10196768,241257,-15371936,-15371936,,-2929369,,,,0,320383,15692319,79126,-4018196,,-19390132,-19390132,53196,ONDS
2018-12-31,3076502,,-12096864,,-12096864,5509695,150664,-8435533,-8435533,,-2663645,,,,0,190029,8625562,39365,-3661331,,-12096864,-12096864,53196,ONDS
2017-12-31,1002625,,-3022207,,-3022207,1586347,194635,-2394337,-2394337,,-642718,,,,0,274403,2668740,79768,-627870,,-3022207,-3022207,53196,ONDS
2016-12-31,1379977,,-3176876,,-3176876,1645800,470755,-2555022,-2555022,,-621454,,,,0,640747,3195769,169992,-621854,,-3176876,-3176876,53196,ONDS
2020-12-31,,,4544000000,,3562000000,,7675000000,5578000000,5578000000,508000000,-554000000,,,,982000000,13819000000,8241000000,6144000000,-1034000000,,3562000000,3562000000,53197,CNI
2019-12-31,,,5429000000,,4216000000,,7999000000,5945000000,5945000000,492000000,-538000000,,,,1213000000,14917000000,8972000000,6918000000,-516000000,,4216000000,4216000000,53197,CNI
2018-12-31,,,5682000000,,4328000000,,7593000000,5795000000,5795000000,469000000,-489000000,,,,1354000000,14321000000,8526000000,6728000000,-113000000,,4328000000,4328000000,53197,CNI
2017-12-31,,,5089000000,,5484000000,,7271000000,5558000000,5558000000,432000000,-481000000,,,,-395000000,13041000000,7483000000,5770000000,-469000000,,5484000000,5484000000,53197,CNI
2019-12-31,88393000,,-122447000,,-122447000,40648000,0,-129041000,-129041000,,,,,,0,0,129041000,0,6594000,,-122447000,-122447000,53199,GTHX
2018-12-31,70385000,,-85288000,,-85288000,18901000,0,-89286000,-89286000,,,,,,0,0,89286000,0,7996000,,-85288000,-85288000,53199,GTHX
2017-12-31,53674000,,-60121000,,-60121000,7294000,0,-60968000,-60968000,,,,,,0,0,60968000,0,847000,,-60121000,-64878000,53199,GTHX
2016-12-31,53674000,,-30291000,,-30291000,5230000,-25161000,-30391000,-30391000,,,,,,0,0,30391000,25161000,100000,,-30291000,-34696000,53199,GTHX
2019-12-31,52226000,,-54601000,,-54890000,290766000,321593000,-45890000,-45890000,,,,,,289000,353880000,399770000,32287000,-8711000,,-54890000,-54890000,53200,TRUE
2018-12-31,61348000,,-28498000,,-28321000,266935000,322417000,-27543000,-27543000,,-2649000.0,,,,-177000,353571000,381114000,31154000,-955000,,-28321000,-28321000,53200,TRUE
2017-12-31,59070000,,-35013000,,-32849000,247176000,294922000,-33796000,-33796000,,-2610000.0,,,,-2164000,323149000,356945000,28227000,-1217000,,-32849000,-32849000,53200,TRUE
2016-12-31,52280000,,-41053000,,-41708000,210749000,252340000,-34034000,-34034000,,-2530000.0,,,,655000,277507000,311541000,25167000,-7019000,,-41708000,-41708000,53200,TRUE
2020-12-31,,,-65767000,607239000,-8759000,36055000,154147000,-31701000,-31701000,,-72060000,,,,271000,254247000,285948000,100100000,-34066000,,-66038000,-8992000,53201,AKR
2019-12-31,,,22672000,644657000,53045000,35416000,216631000,55772000,55772000,,-73788000,,,,1468000,307099000,251327000,90468000,-33100000,,21204000,52632000,53201,AKR
2018-12-31,,,-14764000,622442000,31439000,34343000,192635000,39886000,39886000,857000.0,-69978000,,,,934000,272026000,232140000,79391000,-54650000,,-15698000,31172000,53201,AKR
2017-12-31,,,65312000,648440000,61470000,33756000,183351000,42477000,42477000,2184000.0,-58978000,,,,1004000,259255000,216778000,75904000,22835000,,64308000,60828000,53201,AKR
2020-12-31,4857000000,,1669000000,,123000000,4834000000,20180000000,10489000000,10489000000,,-984000000,,,,1580000000,24689000000,14200000000,4509000000,-8820000000,,89000000,123000000,53203,GILD
2019-12-31,8306000000,,5160000000,125000000.0,5386000000,4381000000,17774000000,5087000000,5087000000,,-995000000,,,,-204000000,22449000000,17362000000,4675000000,73000000,,5364000000,5386000000,53203,GILD
2018-12-31,4198000000,,7799000000,147000000.0,5455000000,4056000000,17274000000,9020000000,9020000000,,-1077000000,,,,2339000000,22127000000,13107000000,4853000000,-1221000000,,5460000000,5455000000,53203,GILD
2017-12-31,3734000000,,13529000000,59000000.0,4628000000,3878000000,21736000000,14124000000,14124000000,,-1118000000,,,,8885000000,26107000000,11983000000,4371000000,-595000000,,4644000000,4628000000,53203,GILD
2019-12-31,,,19678000,-20857000,16014000,25626000,53724000,23650000,23650000,,-5330000,,,,2254000,401648000,377998000,347924000,-3972000,,17424000,11881000,53208,CELP
2018-12-31,,,13416000,-22267000,11413000,23744000,44046000,15898000,15898000,,-6320000,,,,1318000,314960000,299062000,270914000,-2482000,,12098000,8968000,53208,CELP
2017-12-31,,,-1327000,-21952000,3237000,21055000,33603000,8105000,8105000,,-7335000,,,,596000,286342000,278237000,252739000,-9432000,,-1923000,3237000,53208,CELP
2016-12-31,,,-7967000,-20826000,1635000,21853000,35480000,8766000,8766000,,-6559000,,,,1195000,297997000,289231000,262517000,-16733000,,-9162000,1635000,53208,CELP
2019-12-31,,,4469661000,4250000,3127398000,935633000,6794500000,2968943000,2968943000,2075141000,-1264513000,,,,1565655000,25390306000,22421363000,18595806000,1500718000,224067000,2904006000,3127398000,53210,CIG
2018-12-31,,,1977415000,1360608000,1700099000,1004445000,4333831000,2784574000,2784574000,-215908000,-1289366000,,,,599124000,22266217000,19481643000,17932386000,-807159000,322569000,1378291000,1700099000,53210,CIG
2017-12-31,,,1645856000,4150000,1000954000,1076788000,4184319000,3022045000,3022045000,-701643000,-1533570000,,,,644260000,21711690000,18689645000,17527371000,-1376189000,322569000,1001596000,1000954000,53210,CIG
2016-12-31,,,367927000,4090000,334334000,1151541000,4495090000,2879120000,2879120000,-337620000,-1928397000,,,,33173000,18772656000,15893536000,14277566000,-2511193000,322569000,334754000,334334000,53210,CIG
2019-12-31,,,52800000,4800000,46400000,203000000,349000000,106200000,106200000,,-29100000,,,,6000000,1299100000,1192900000,950100000,-53400000,,46800000,46400000,53211,GTLS
2018-12-31,,,69000000,4500000,88000000,173100000,298300000,103300000,103300000,,-25800000,,,,13400000,1084300000,981000000,786000000,-34300000,34400000.0,55600000,88000000,53211,GTLS
2017-12-31,,,11100000,3000000,28000000,162300000,234300000,59800000,59800000,,-19400000,,,,-16600000,842900000,783100000,608600000,-48700000,1800000.0,27700000,28000000,53211,GTLS
2016-12-31,,,24100000,1400000,28200000,152300000,213200000,52100000,52100000,,-18800000,,,,10600000,722000000,669900000,508800000,-28000000,11200000.0,13500000,28200000,53211,GTLS
2020-10-31,1478000000,,3231000000,,2844000000,4925000000,10437000000,3921000000,3921000000,,-239000000,,,,387000000,56639000000,52718000000,46202000000,-690000000,,2844000000,2844000000,53213,HPQ
2019-10-31,1499000000,,2523000000,,3152000000,5290000000,11170000000,4265000000,4265000000,,-242000000,,,,-629000000,58756000000,54491000000,47586000000,-1742000000,,3152000000,3152000000,53213,HPQ
2018-10-31,1404000000,,3013000000,,5327000000,4866000000,10669000000,4319000000,4319000000,,-312000000,,,,-2314000000,58472000000,54153000000,47803000000,-1306000000,,5327000000,5327000000,53213,HPQ
2017-10-31,1190000000,,3276000000,,2526000000,4382000000,9578000000,4005000000,4005000000,,-309000000,,,,750000000,52056000000,48051000000,42478000000,-729000000,,2526000000,2526000000,53213,HPQ
2020-12-31,,,-2856000000,17567000000,-5176000000,38039000000,91840000000,25285000000,25285000000,,-7925000000,,,,965000000,171760000000,146475000000,79920000000,-28141000000,,-3821000000,-5369000000,53215,T
2019-12-31,,,18468000000,17713000000,13903000000,41094000000,97052000000,27741000000,27741000000,,-8422000000,,,,3493000000,181193000000,153452000000,84141000000,-9273000000,,14975000000,13900000000,53215,T
2018-12-31,,,24873000000,9795000000,19370000000,31289000000,91337000000,31618000000,31618000000,,-7957000000,,,,4920000000,170756000000,139138000000,79419000000,-6745000000,,19953000000,19370000000,53215,T
2017-12-31,,,15139000000,1146000000,29450000000,34354000000,82736000000,23995000000,23995000000,,-6300000000,,,,-14708000000,160546000000,136551000000,77810000000,-8856000000,,29847000000,29450000000,53215,T
2020-12-31,,,973800000,,785900000,1184500000,2214200000,1029700000,1029700000,,,,,,187900000,4895800000,3866100000,2681600000,-55900000,,785900000,785900000,53218,CHD
2019-12-31,,,773700000,,615900000,1149900000,1984000000,834100000,834100000,,-73600000.0,,,,157800000,4357700000,3523600000,2373700000,-60400000,,615900000,615900000,53218,CHD
2018-12-31,,,719500000,,568600000,1056600000,1840800000,784200000,784200000,,-79400000.0,,,,150900000,4145900000,3361700000,2305100000,-64700000,,568600000,568600000,53218,CHD
2017-12-31,,,692700000,,743400000,952300000,1729600000,777300000,777300000,,-52600000.0,,,,-50700000,3776200000,2998900000,2046600000,-84600000,,743400000,743400000,53218,CHD
2020-12-31,226000000,,530000000,,478000000,773000000,1983000000,984000000,984000000,,-210000000,,,,41000000,8473000000,7489000000,6490000000,-454000000,,489000000,478000000,53219,EMN
2019-12-31,234000000,,902000000,74000000.0,759000000,751000000,2234000000,1249000000,1249000000,,-221000000,,,,140000000,9273000000,8024000000,7039000000,-347000000,,762000000,759000000,53219,EMN
2018-12-31,235000000,,1310000000,75000000.0,1080000000,693000000,2479000000,1551000000,1551000000,,-238000000,,,,226000000,10151000000,8600000000,7672000000,-241000000,,1084000000,1080000000,53219,EMN
2017-12-31,227000000,,1289000000,77000000.0,1384000000,594000000,2475000000,1654000000,1654000000,,-244000000,,,,-99000000,9549000000,7895000000,7074000000,-365000000,,1388000000,1384000000,53219,EMN
2019-12-31,,,-8735000,,-7822000,17582000,11343000,-6239000,-6239000,,-2882000,,,,-913000,95998000,102237000,84655000,-2496000,,-7822000,-7822000,53221,CNFR
2018-12-31,,,-9175000,,-9227000,17683000,11445000,-6238000,-6238000,,-2644000,,,,52000,98911000,105149000,87466000,-2937000,,-9227000,-9227000,53221,CNFR
2017-12-31,,,-21989000,,-21542000,17367000,8525000,-8842000,-8842000,,-1362000,,,,-447000,96087000,104929000,87562000,-13147000,,-21542000,-21542000,53221,CNFR
2016-12-31,,,-8514000,,-8437000,17596000,10000000,-7596000,-7596000,,-647000,,,,-77000,94283000,101879000,84283000,-918000,,-8437000,-8437000,53221,CNFR
2019-12-31,,,214148000,362478000,117305000,1921706000,2218132000,169292000,169292000,990000,-39100000,,,,52436000,2218132000,2048840000,0,44856000,,161712000,104406000,53222,NMRK
2018-12-31,,,282385000,515400000,106732000,1744549000,2047579000,206115000,206115000,-818000,-51600000,,,,90487000,2047579000,1841464000,0,76270000,,191898000,101641000,53222,NMRK
2017-12-31,,,202574000,-16996000,144492000,1374774000,1596450000,130232000,130232000,1929000,-700700,,,,57478000,1596450000,1466218000,0,72342000,,145096000,144492000,53222,NMRK
2016-12-31,,,171205000,2007000,168401000,1125647000,1349983000,150070000,150070000,2069000,-700700,,,,3993000,1349983000,1199913000,0,21135000,,167212000,168401000,53222,NMRK
2020-06-30,,,-33757000,,-26844000,72442000,56294000,-16148000,-16148000,,-82000,,,,-6913000,366926000,383074000,310632000,-17609000,,-26844000,-26844000,53224,FLXS
2019-06-30,,,-42608000,,-32605000,79298000,81193000,1895000,1895000,,-82000,,,,-10003000,443588000,441693000,362395000,-44503000,,-32605000,-32605000,53224,FLXS
2018-06-30,,,25126000,,17666000,71949000,98219000,26270000,26270000,,-82000,,,,7460000,489180000,462910000,390961000,-1144000,,17666000,17666000,53224,FLXS
2017-06-30,3700000.0,,37586000,,23786000,70962000,108651000,33989000,33989000,,-82000,,,,13800000,468764000,434775000,360113000,3597000,,23786000,23786000,53224,FLXS
2020-12-31,,,7173200000,,5704600000,,8673100000,7390200000,7390200000,205500000,-217000000,,,,1468600000,42638100000,35247900000,33965000000,-217000000,,5704600000,5677700000,53226,PGR
2019-12-31,,,5160300000,225600000.0,3970300000,,5528900000,5350000000,5350000000,178900000,-189700000,,,,1180300000,38997700000,33647700000,33468800000,-189700000,,3980000000,3943400000,53226,PGR
2018-12-31,,,3163600000,214500000.0,2615300000,,3464200000,3330100000,3330100000,134100000,-166500000,,,,542600000,31954700000,28624600000,28490500000,-166500000,,2621000000,2593900000,53226,PGR
2017-12-31,,,2138900000,503700000.0,1592200000,,2402500000,2293000000,2293000000,109500000,-153100000,,,,540800000,26816100000,24523100000,24413600000,-154100000,,1598100000,1592200000,53226,PGR
2019-12-31,,,63501000,,57899000,73150000,199835000,20663000,20663000,32210000,-1505000,,,,5602000,334855000,314192000,135020000,26436000,,57899000,57899000,53227,OPRA
2018-12-31,,,41641000,,35160000,3063000,117992000,45301000,45301000,56934000,-184000,,,,6481000,172276000,126975000,54284000,-4188000,,35160000,35160000,53227,OPRA
2017-12-31,,,7504000,,6064000,3085000,83275000,8019000,8019000,55567000,-238000,,,,1440000,128893000,120874000,45618000,-515000,,6064000,6064000,53227,OPRA
2016-12-31,,,-18649000,,-15810000,3113000,64713000,-3373000,-3373000,52305000,-1402000,,,,-2839000,107285000,110658000,42572000,-15276000,,-15810000,-15810000,53227,OPRA
2020-03-31,,,-3856299,,-3856299,4909871,-96978,-5027269,-5027269,,-14771,,,,0,397118,5424387,494096,1170970,,-3856299,-11593385,53228,CEI
2019-03-31,,,16646153,,16643153,5152766,-261799,-5893335,-5893335,,-2438097,,,,3000,2742102,8635437,3003901,22539488,,16643153,10966438,53228,CEI
2018-03-31,,,-24771588,,-24771588,6214153,1684729,-6009959,-6009959,,-6018829,,,,0,6859767,12869726,5175038,-18761629,,-24771588,-26699672,53228,CEI
2017-03-31,,,-89138239,,-89123239,4044148,1784679,-4958207,-4958207,,-3165151,,,,-15000,5302024,10260231,3517345,-84180032,,-89123239,-89123239,53228,CEI
2019-12-31,,,4874000,,5500000,9837000,19754000,5462000,5462000,1017000,-5265000,,,,0,20415000,14953000,661000,-588000,626000,4874000,-3497000,53230,RHE
2018-12-31,,,-12007000,,-11895000,12375000,17276000,-792000,-792000,1059000,-5929000,,,,-38000,17914000,18706000,638000,-11215000,74000,-11969000,-19880000,53230,RHE
2017-12-31,,,506000,,-985000,12537000,23628000,5138000,5138000,1085000,-4095000,,,,-188000,24262000,19124000,634000,-4632000,-1679000,694000,-8599000,53230,RHE
2016-12-31,,,5803000,,-7462000,7714000,18907000,4919000,4919000,978000,-7149000,,,,-163000,27601000,22682000,8694000,884000,-13428000,5966000,-14797000,53230,RHE
2020-09-30,,,54872000,,54872000,85036000,298953000,213917000,213917000,,-73393000,,,,0,298953000,85036000,0,-159045000,,54872000,54872000,53231,GBDC
2019-09-30,,,-18579000,,-18579000,42695000,172298000,129603000,129603000,,-43225000,,,,0,172298000,42695000,0,-148182000,,-18579000,-18579000,53231,GBDC
2018-09-30,,,81970000,,81970000,42976000,152171000,109195000,109195000,,-32608000,,,,0,152171000,42976000,0,-27225000,,81970000,81970000,53231,GBDC
2017-09-30,,,82305000,,82288000,36667000,137764000,101097000,101097000,,-30995000,,,,17000,137764000,36667000,0,-18792000,,82288000,82288000,53231,GBDC
2019-12-31,68571000,,-48739000,-1335000,-53169000,68795000,80752000,-56614000,-56614000,,-75000,,,,4676000,180665000,237279000,99913000,7875000,,-53415000,-53169000,53232,XNET
2018-12-31,76763000,,-40882000,-1116000,-39278000,76155000,114937000,-37981000,-37981000,,-239000,,,,-89000,230604000,268585000,115667000,-2901000,1303000.0,-40793000,-39278000,53232,XNET
2017-12-31,66947000,,-46468000,-2160000,-37822000,56405000,84007000,-48068000,-48068000,,-239000,,,,-2252000,200583000,248651000,116576000,1600000,6407000.0,-44216000,-37822000,53232,XNET
2016-12-31,61169000,,-33275000,-1988000,-24111000,38942000,60278000,-39833000,-39833000,,-239000,,,,-2469000,140206000,180039000,79928000,6558000,6623000.0,-30806000,-24111000,53232,XNET
2019-12-31,72520000,,396462000,,307583000,401107000,898745000,425118000,425118000,,-31347000,,,,88879000,2487961000,2062843000,1589216000,-28656000,,307583000,307583000,53234,CW
2018-12-31,64525000,,356239000,,275749000,417165000,871261000,389571000,389571000,,-33983000,,,,80490000,2411835000,2022264000,1540574000,-33332000,,275749000,275749000,53234,CW
2017-12-31,61393000,,299619000,,214891000,399323000,800785000,340069000,340069000,,-41471000,,,,84728000,2271026000,1930957000,1470241000,-40450000,,214891000,214891000,53234,CW
2016-12-31,59424000,,267961000,,187329000,367168000,734691000,308099000,308099000,,-41248000,,,,78579000,2108931000,1800832000,1374240000,-40138000,-2053000.0,189382000,187329000,53234,CW
2019-12-31,1837000,,-6230000,,-6042000,7829000,122000,-9713000,-9713000,169000,-66000,,,,-188000,532000,10245000,410000,3483000,,-6042000,-6042000,53236,AEZS
2018-12-31,2932000,,9639000,,4187000,12003000,24777000,9842000,9842000,169000,-66000,,,,5452000,26881000,17039000,2104000,-203000,,4187000,4187000,53236,AEZS
2017-12-31,10704000,,-20275000,,-16796000,13293000,923000,-23074000,-23074000,169000,-66000,,,,-3479000,923000,23997000,0,243000,,-16796000,-16796000,53236,AEZS
2016-12-31,16495000,,-24959000,,-24959000,13892000,911000,-29476000,-29476000,169000,-66000,,,,0,911000,30387000,0,4517000,,-24959000,-24959000,53236,AEZS
2019-12-31,7236652,,-70918302,,-70918302,11864536,-5831282,-32660628,-32660628,1482349,-10633655,,,,0,24477707,57138335,30308989,-38257674,,-70918302,-70918302,53237,AREC
2018-12-31,3815235,,-12757312,,-12908576,7539600,3357219,-12304296,-12304296,1366322,-1959591,,,,0,31524825,43829121,28167606,-453016,,-12757312,-13023426,53237,AREC
2017-12-31,6850062,,-12592518,397856.0,-12935617,2072477,-497582,-11948511,-11948511,832485,-1035828,,,,0,20820998,32769509,21318580,-644007,,-12592518,-12988774,53237,AREC
2016-12-31,1760594,,-22089282,54757.0,-22144039,12969875,-2610824,-21340167,-21340167,1736019,-292970,,,,0,7601194,28941361,10212018,-749115,,-22089282,-22144039,53237,AREC
2020-12-31,,,30731000,,24696000,63126000,108092000,0,37945000,7021000,,,,,6035000,108092000,70147000,0,-7214000,,24696000,24696000,53239,CSTR
2019-12-31,,,29266000,,22422000,52043000,91261000,0,33575000,5643000,,,,,6844000,91261000,57686000,0,-4309000,,22422000,22422000,53239,CSTR
2018-12-31,,,10822000,,9655000,39219000,62309000,0,19090000,4000000,,,,,1167000,62309000,43219000,0,-8268000,,9655000,9655000,53239,CSTR
2017-12-31,,,6136000,,1501000,29114000,39901000,0,6184000,4603000,,,,,4635000,39901000,33717000,0,-48000,,1501000,1501000,53239,CSTR
2020-12-31,,,149600000,,147200000,4500000,494200000,0,157600000,332100000,,,,,2400000,494200000,336600000,0,-8000000,,147200000,147200000,53241,NTB
2019-12-31,,,175704000,,177075000,290624000,532628000,0,202655000,39349000,,,,,-1371000,532628000,329973000,0,-26951000,,177075000,177075000,53241,NTB
2018-12-31,,,196468000,,195184000,278703000,517811000,0,202459000,36649000,,,,,1284000,517811000,315352000,0,-5991000,,195184000,195184000,53241,NTB
2017-12-31,,,154339000,,153252000,257725000,454675000,0,162621000,34329000,,,,,1087000,454675000,292054000,0,-8282000,,153252000,153252000,53241,NTB
2020-12-31,,,-1340768000,108668000,-1410358000,1209221000,-131547000,0,-1340768000,,,,,,16916000,-131547000,1209221000,0,0,,-1357684000,-1464653000,53242,NRZ
2019-12-31,,,647699000,78550000,563296000,686499000,1296865000,0,631547000,-21181000.0,,,,,41766000,1556084000,924537000,259219000,16152000,,605933000,550015000,53242,NRZ
2018-12-31,,,931100000,90625000,963967000,389073000,1321754000,0,932681000,-21181000.0,,,,,-73431000,1542085000,609404000,220331000,-1581000,,1004531000,963967000,53242,NRZ
2017-12-31,,,1182280000,105957000,957533000,204166000,1386446000,0,1182280000,-21181000.0,,,,,167628000,1604857000,422577000,218411000,0,,1014652000,957533000,53242,NRZ
2020-02-29,8600000,,79750000,,61914000,214811000,303959000,72848000,72848000,,-9217000,,,,17836000,1387439000,1314591000,1083480000,6902000,,61914000,61914000,53243,APOG
2019-03-02,13000000,,58662000,,45694000,197440000,293565000,70425000,70425000,,-8449000,,,,12968000,1402637000,1332212000,1109072000,-11763000,,45694000,45694000,53243,APOG
2018-03-03,12500000,,109880000,,79488000,188934000,333518000,114284000,114284000,,-5508000,,,,30392000,1326173000,1211889000,992655000,-4404000,,79488000,79488000,53243,APOG
2017-03-04,8600000,,122805000,,85790000,161198000,292023000,122225000,122225000,,-971000,,,,37015000,1114533000,992308000,822510000,580000,,85790000,85790000,53243,APOG
2019-12-31,101717000,,-392725000,-212000,-394817000,2155592000,1797586000,-459723000,-459723000,,-14312000,,,,2440000,2193902000,2653625000,396316000,66998000,,-395165000,-394817000,53245,STG
2018-12-31,76022000,,-926950000,136000,-927022000,2596521000,1643609000,-1028934000,-1028934000,,-2171000,,,,0,1973985000,3002919000,330376000,101984000,,-926950000,-927022000,53245,STG
2017-12-31,32862000,,-918714000,64000,-918578000,1694717000,799901000,-927678000,-927678000,,-2171000,,,,0,970162000,1897840000,170261000,8964000,,-918714000,-918578000,53245,STG
2016-12-31,13932000,,-253567000,64000,-253567000,593033000,347924000,-259041000,-259041000,,-2171000,,,,0,418910000,677951000,70986000,5474000,,-253567000,-253567000,53245,STG
2019-12-31,64027000,,-16631000,,-16659000,163218000,212418000,-18732000,-18732000,3905000,-1306000,,,,28000,300562000,319294000,88144000,2101000,,-16659000,-16659000,53250,UPWK
2018-12-31,55488000,,-19892000,,-19907000,122299000,171896000,-11712000,-11712000,5821000,-2038000,,,,15000,253354000,265066000,81458000,-8180000,,-19907000,-19907000,53250,UPWK
2017-12-31,45604000,,-4145000,,-4123000,90378000,137109000,-3123000,-3123000,4250000,-960000,,,,-22000,202552000,205675000,65443000,-1022000,,-4123000,-10629000,53250,UPWK
2016-12-31,37902000,,-16234000,,-16233000,71783000,101867000,-13368000,-13368000,5550000,-858000,,,,-1000,164445000,177813000,62578000,-2866000,,-16233000,-16233000,53250,UPWK
2019-12-31,25016000,,-107460000,21120000,-51093000,72925000,2890000,-107459000,-107459000,12408000,-4623000,,,,24000,349783000,457242000,346893000,-1000,,-107484000,-51093000,53251,RENN
2018-12-31,26349000,,-148967000,33473000,72540000,105656000,21730000,-110275000,-110275000,12408000,-5103000,,,,9850000,498198000,608473000,476468000,-38692000,223298000.0,-158817000,72540000,53251,RENN
2017-12-31,17435000,,13228000,33942000,-110427000,71564000,11310000,-77689000,-77689000,12408000,-4322000,,,,4479000,174624000,252313000,163314000,90917000,-119252000.0,8749000,-110427000,53251,RENN
2016-12-31,7542000,,-60644000,33942000,-185352000,53338000,6904000,-53976000,-53976000,12408000,-7107000,,,,2470000,47481000,101457000,40577000,-6668000,-122238000.0,-63114000,-185352000,53251,RENN
2020-09-30,,,-1454000,,1123000,28392000,29359000,-1251000,-1251000,,-133000,,,,-2577000,94864000,96115000,65505000,-203000,,1123000,1123000,53252,SRDX
2019-09-30,,,7558000,,7592000,24550000,33812000,6857000,6857000,,-152000,,,,-34000,100077000,93220000,66265000,701000,,7592000,7592000,53252,SRDX
2018-09-30,,,-7532000,,-4457000,23111000,26366000,764000,764000,,-152000,,,,-3075000,81336000,80572000,54970000,-8296000,,-4457000,-4457000,53252,SRDX
2017-09-30,,,7033000,,3926000,20378000,30173000,7376000,7376000,,-152000,,,,3107000,73112000,65736000,42939000,-343000,,3926000,3926000,53252,SRDX
2019-12-28,,,637746000,,486896000,3473808000,4258091000,756783000,756783000,,-39898000,,,,150850000,9709003000,8952220000,5450912000,-119037000,,486896000,486896000,53253,AAP
2018-12-29,,,555264000,,423847000,3462593000,4226153000,725542000,725542000,,-56588000,,,,131417000,9580554000,8855012000,5354401000,-170278000,,423847000,423847000,53253,AAP
2017-12-30,,,520259000,,475505000,3501537000,4085049000,583512000,583512000,,-58801000,,,,44754000,9373784000,8790272000,5288735000,-63253000,,475505000,475505000,53253,AAP
2016-12-31,,,738835000,,459622000,3465517000,4255915000,790398000,790398000,,-59910000,,,,279213000,9567679000,8777281000,5311764000,-51563000,,459622000,459622000,53253,AAP
2019-12-31,,,-168946000,,-241166000,124609000,1063168000,13564000,13564000,53769000,-191047000,,,,72220000,1572245000,1558681000,509077000,-180910000,,-241166000,-241166000,53254,WLL
2018-12-31,,,343867000,,342494000,123250000,1549591000,560474000,560474000,17170000,-197474000,,,,1373000,2081414000,1520940000,531823000,-216607000,,342494000,342494000,53254,WLL
2017-12-31,,,-1720641000,,-1237648000,124288000,991072000,-1141179000,-1141179000,122847000,-191088000,,,,-482979000,1481435000,2622614000,490363000,-579462000,,-1237662000,-1237648000,53254,WLL
2016-12-31,,,-1426770000,7962000.0,-1339102000,146878000,781132000,-658209000,-658209000,-587000,-557620000,,,,-87646000,1284982000,1943191000,503850000,-768561000,,-1339124000,-1339102000,53254,WLL
2019-12-28,,,-172366500,26370000,-102640500,233274000,102391500,-130882500,-130882500,,-14023500,,,,-15667500,224265000,355147500,121873500,-41484000,,-156699000,-102640500,53255,FRGAP
2019-04-30,,,-3995000,26370000,-2156000,122774000,132546000,9772000,9772000,,-3023000,,,,-1839000,132546000,122774000,54473000,-13767000,,-2156000,-2156000,53255,FRGAP
2018-04-30,,,4481000,26370000,125000,162212000,174872000,12660000,12660000,,-3181000,,,,4346000,174872000,162212000,63602000,-8179000,,135000,125000,53255,FRGAP
2017-04-30,,,20767000,26370000,13013000,66532000,107786000,32929000,32929000,,-2557000,,,,7754000,173985000,141056000,66199000,-12162000,,13013000,13013000,53255,FRGAP
2019-12-31,1170000,,62514000,,62544000,21256000,85041000,62615000,62615000,,-322000,,,,-30000,92847000,30232000,7806000,-101000,,62544000,-60452000,53258,LPRO
2018-12-31,802000,,28316000,,28279000,18313000,47589000,28474000,28474000,,-341000,,,,37000,52192000,23718000,4603000,-158000,,28279000,-44098000,53258,LPRO
2017-12-31,691000,,15829000,,15770000,12518000,29361000,16152000,16152000,,-418000,,,,59000,32380000,16228000,3019000,-323000,,15770000,-13119000,53258,LPRO
2019-12-31,,,3372418,100,3323712,37456739,42884983,3528987,3528987,,,,,,48706,48450900,44921913,5565917,-156569,,3323712,3323712,53259,JYNT
2018-12-31,,,108968,100,146696,30057676,32351411,737495,737495,,,,,,-37728,36661660,35924165,4310249,-628527,,146696,146696,53259,JYNT
2017-12-31,,,-3396532,100,-3432412,22591413,21694630,-2914106,-2914106,,,,,,35880,24918868,27832974,3224238,-482426,,-3432412,-3432412,53259,JYNT
2016-12-31,,,-15009443,100,-15173872,26430501,17584031,-11412606,-11412606,,-15000.0,,,,164429,20523640,31936246,2939609,-3596837,,-15173872,-15173872,53259,JYNT
2019-12-31,174257,,-31683155,,-27545255,14331300,1721496,-20351245,-20351245,,-8399663,,,,-4137900,4712212,25063457,2990716,-11331910,,-27545255,-27545255,53260,COMS
2020-12-31,,,1146000,22334000,985000,4660000,17032000,2423000,2423000,,-1464000,,,,0,19248000,16825000,2216000,-1277000,,1146000,985000,53261,PINE
2019-12-31,,,3585358,23176183,3591421,2021850,11194226,3626588,3626588,,-41230,,,,0,13231304,9604716,2037078,-41230,,3585358,3591421,53261,PINE
2018-12-31,,,4014955,23176183,4014955,1184352,10100026,4014955,4014955,,-41230,,,,0,11719549,7704594,1619523,0,,4014955,4014955,53261,PINE
2017-12-31,,,2812769,23176183,2812769,887349,6985706,3099011,3099011,,-286242,,,,0,8454498,5355487,1468792,-286242,,2812769,2812769,53261,PINE
2019-12-31,57601000,,-166379000,,-153723000,16627000,-51590000,-70245000,-70245000,,-2108000,,,,-12656000,6011000,76256000,57601000,-96134000,,-153723000,-164872000,53262,ABUS
2018-12-31,57601000,,-61342000,,-57060000,16002000,-51989000,-70172000,-70172000,,-226000,,,,-4282000,5945000,76117000,57934000,8830000,,-57060000,-67151000,53262,ABUS
2017-12-31,57601000,,-108733000,,-84413000,16129000,-51976000,-70132000,-70132000,,-261000,,,,-24320000,10700000,80832000,62676000,-38601000,,-84413000,-85324000,53262,ABUS
2016-12-31,57601000,,-489166000,,-384164000,13438000,-53762000,-68292000,-68292000,,-261000,,,,-105002000,1491000,69783000,55253000,-420874000,,-384164000,-384164000,53262,ABUS
2020-08-31,,,7904562,,7904562,3286901,24051357,20764456,20764456,,-3518123,,,,0,24051357,3286901,0,-12859894,,7904562,7904562,53264,BLE
2019-08-31,,,30549569,,30549569,3370998,25373039,22002041,22002041,,-5349243,,,,0,25373039,3370998,0,8547528,,30549569,30549569,53264,BLE
2018-08-31,,,3651428,,3651428,3429845,25886914,22457069,22457069,,-4634977,,,,0,25886914,3429845,0,-18805641,,3651428,3651428,53264,BLE
2017-08-31,,,-1335371,,-1335371,3522364,26606046,23083682,23083682,,-3654302,,,,0,26606046,3522364,0,-24419053,,-1335371,-1335371,53264,BLE
2019-12-31,,,2464044,,1642794,1377028,4052094,2675066,2675066,,-370682,,,,821250,29410550,26735484,25358456,-211022,,1642794,1642794,53265,YGMZ
2018-12-31,,,3860915,,2854887,1212957,5247723,4034766,4034766,,-355332,,,,1006028,27646789,23612023,22399066,-173851,,2854887,2854887,53265,YGMZ
2017-12-31,,,1926355,,1238090,1492277,3809753,2317476,2317476,,-289967,,,,688265,20616011,18298535,16806258,-391121,,1238090,1238090,53265,YGMZ
2019-12-31,34037452,,-27879270,,-24034907,10774908,17177453,-27634907,-27634907,,-32727,,,,-3844363,17177453,44812360,0,-244364,,-24034907,-24034907,53266,SMMT
2019-01-31,39174000,,5031000,,7527000,11588000,57623000,6867000,6867000,-6000.0,-43000,,,,-2496000,57623000,50756000,0,-1836000,,7527000,7527000,53266,SMMT
2018-01-31,28970000,,-23952000,,-20190000,11999000,14168000,-26792000,-26792000,-9000.0,-23000,,,,-3762000,14168000,40960000,0,2840000,,-20190000,-20190000,53266,SMMT
2017-01-31,18952000,,-25707000,,-21371000,8277000,2376000,-24853000,-24853000,-9000.0,-23000,,,,-4336000,2376000,27229000,0,-854000,,-21371000,-21371000,53266,SMMT
2019-12-31,,,110288000,,110288000,8102000,63541000,55439000,55439000,,-7621000,,,,0,63541000,8102000,0,54849000,,110288000,102785000,53267,PML
2018-12-31,,,14261000,,14261000,8274000,64634000,56360000,56360000,,-5826000,,,,0,64634000,8274000,0,-42099000,,14261000,6254000,53267,PML
2017-12-31,,,73225000,,73225000,8242000,60001000,51759000,51759000,,-1510000,,,,0,60001000,8242000,0,21466000,,73225000,68161000,53267,PML
2016-12-31,,,14399000,,14399000,8376000,57365000,48989000,48989000,,-598000,,,,0,57365000,8376000,0,-34590000,,14399000,11675000,53267,PML
2019-12-31,,,100721000,121415000,95999000,53181000,645196000,272209000,272209000,,-219440000,,,,655000,2480820000,2208611000,1835624000,-171488000,,100066000,21532000,53268,GEL
2018-12-31,,,-10294000,-11204000,-6075000,64787000,634354000,256377000,256377000,,-229191000,,,,1498000,2912770000,2656393000,2278416000,-266671000,,-11792000,-75876000,53268,GEL
2017-12-31,,,78120000,-8079000,82647000,54429000,499141000,192232000,192232000,,-176762000,,,,-3959000,2028377000,1836145000,1529236000,-114112000,,82079000,60652000,53268,GEL
2016-12-31,,,114424000,-10281000,113249000,45625000,474248000,206427000,206427000,,-139947000,,,,3342000,1712493000,1506066000,1238245000,-92003000,,111082000,113249000,53268,GEL
2019-12-31,10992000,,-10227000,,-10443000,38958000,47317000,-5274000,-5274000,,-4869000,,,,216000,53943000,59217000,6626000,-4953000,,-10443000,-10443000,53270,ALIM
2018-12-31,11274000,,22054000,,21948000,37422000,42291000,-9050000,-9050000,,-4775000,,,,106000,46599000,55649000,4308000,31104000,,21948000,17459000,53270,ALIM
2017-12-31,9993000,,-21838000,,-22001000,36249000,32474000,-16452000,-16452000,,-5579000,,,,163000,35912000,52364000,3438000,-5386000,,-22001000,-22001000,53270,ALIM
2016-12-31,12375000,,-33002000,,-33174000,44694000,31989000,-27847000,-27847000,,-5178000,,,,172000,34333000,62180000,2344000,-5155000,,-33174000,-33174000,53270,ALIM
2019-12-31,15666000000,,103214000000,214149000000,45682000000,222914000000,818976000000,133428000000,133428000000,218454000000,-30409000000,,,,36199000000,2516810000000,2383382000000,1697834000000,-30214000000,,67015000000,45682000000,53272,PTR
2018-12-31,15666000000,,116770000000,195108000000,53036000000,218868000000,821150000000,149772000000,149772000000,211577000000,-22718000000,,,,42790000000,2374934000000,2225162000000,1553784000000,-33002000000,,73980000000,53036000000,53272,PTR
2017-12-31,15666000000,,53089000000,187799000000,22798000000,202426000000,730174000000,86647000000,86647000000,193828000000,-22408000000,,,,16296000000,2015890000000,1929243000000,1285716000000,-33558000000,,36793000000,22798000000,53272,PTR
2016-12-31,15666000000,,45140000000,183711000000,7857000000,191917000000,657263000000,43892000000,43892000000,192522000000,-23348000000,,,,15768000000,1616903000000,1573011000000,959640000000,1248000000,,29372000000,7857000000,53272,PTR
2020-12-31,46038000,,89523000,,71766000,275809000,407113000,85266000,85266000,,,,,,17757000,666686000,581420000,259573000,4257000,,71766000,71766000,53273,SSTK
2019-12-31,57216000,,24916000,,20108000,291276000,372347000,23855000,23855000,,,,,,4808000,650523000,626668000,278176000,1061000,,20108000,20108000,53273,SSTK
2018-12-31,58897000,,66113000,,54687000,261089000,355579000,35593000,35593000,,,,,,11426000,623250000,587657000,267671000,30520000,,54687000,54687000,53273,SSTK
2017-12-31,52486000,,30081000,,16727000,243122000,324009000,28401000,28401000,,,,,,13354000,557111000,528710000,233102000,1680000,,16727000,16727000,53273,SSTK
2020-06-30,,,-43740000,569000,-39817000,64635000,61941000,-2694000,-2694000,,-1860000,,,,-4169000,246838000,249532000,184897000,-41046000,,-39571000,-39817000,53274,TWIN
2019-06-30,,,14507000,602000,10673000,73160000,89641000,16481000,16481000,-1577000.0,-1927000,,,,3711000,302663000,286182000,213022000,-1974000,,10796000,10525000,53274,TWIN
2018-06-30,,,14420000,619000,9528000,62310000,80641000,18331000,18331000,-1577000.0,-282000,,,,4773000,240733000,222402000,160092000,-3911000,,9647000,9306000,53274,TWIN
2017-06-30,,,-9529000,646000,-6294000,52773000,48232000,-4541000,-4541000,-1577000.0,-303000,,,,-3414000,168182000,172723000,119950000,-4988000,,-6115000,-6294000,53274,TWIN
2020-12-31,,,147700000,12600000,23800000,2570300000,2824700000,254400000,254400000,,-43300000,,,,123900000,18001000000,17746600000,15176300000,-106700000,,23800000,23800000,53275,MAN
2019-12-31,,,685500000,18500000,465700000,2631200000,3375100000,722100000,722100000,,-44400000,,,,219800000,20863500000,20141400000,17488400000,-36600000,,465700000,465700000,53275,MAN
2018-12-31,,,754700000,73600000,556700000,2720000000,3579000000,836000000,836000000,,-47000000,,,,198000000,21991200000,21155200000,18412200000,-81300000,,556700000,556700000,53275,MAN
2017-12-31,,,737300000,82700000,545400000,2642800000,3484600000,823700000,823700000,,-49400000,,,,191900000,21034300000,20210600000,17549700000,-86400000,,545400000,545400000,53275,MAN
2020-06-30,595236,,-3144459,,-3014100,8037559,5570616,-3062179,-3062179,,-64682,,,,-130359,31894262,34956441,26323646,-82280,,-3014100,-3014100,53278,AHPI
2019-06-30,459455,,-2080237,,-2109685,7353194,5038627,-2774022,-2774022,,-56223,,,,29448,31381521,34155543,26342894,693785,,-2109685,-2109685,53278,AHPI
2018-06-30,472077,,-2019132,,-2192170,7973979,6450442,-1995614,-1995614,,-23569,,,,173038,33759953,35755567,27309511,-23518,,-2192170,-2192170,53278,AHPI
2017-06-30,410458,,-2052166,,-2088666,8197126,6555690,-2051894,-2051894,,-23569,,,,36500,33512030,35563924,26956340,-272,,-2088666,-2088666,53278,AHPI
2020-12-31,,,5473000000,105000000,4482000000,12179000000,20370000000,0,7378000000,813000000,,,,,981000000,20370000000,12992000000,0,-1905000000,,4492000000,4184000000,53279,TFC
2019-12-31,,,4019000000,174000000,3224000000,6664000000,11953000000,0,4624000000,665000000,,,,,782000000,11953000000,7329000000,0,-605000000,,3237000000,3028000000,53279,TFC
2018-12-31,,,4060000000,56000000,3237000000,5930000000,10992000000,0,4471000000,591000000,,,,,803000000,10992000000,6521000000,0,-411000000,,3257000000,3063000000,53279,TFC
2017-12-31,,,3326000000,47000000,2394000000,5835000000,10770000000,0,4128000000,807000000,,,,,911000000,10770000000,6642000000,0,-802000000,,2415000000,2220000000,53279,TFC
2020-12-31,8879000000,,7498000000,,9616000000,10890000000,33334000000,10129000000,10129000000,,-1449000000,,,,477000000,41908000000,31779000000,8574000000,-2631000000,2631000000,7021000000,9616000000,53282,PFE
2019-12-31,7984000000,,17682000000,303000000.0,16273000000,14103000000,41739000000,15042000000,15042000000,,-1574000000,,,,1384000000,51750000000,36708000000,10011000000,2640000000,4000000,16298000000,16272000000,53282,PFE
2018-12-31,7959000000,,11885000000,351000000.0,11153000000,13943000000,42519000000,15724000000,15724000000,-1002000000.0,-1316000000,,,,706000000,53647000000,37923000000,11128000000,-3839000000,10000000,11179000000,11152000000,53282,PFE
2017-12-31,7645000000,,12304000000,348000000.0,21308000000,14606000000,41720000000,14711000000,14711000000,-1002000000.0,-1270000000,,,,-9049000000,52546000000,37835000000,10826000000,-2407000000,2000000,21353000000,21307000000,53282,PFE
2019-12-31,5748000,,-12685000,,-13731000,57211000,54619000,-8340000,-8340000,,-4229000,,,,0,72552000,80892000,17933000,-4345000,-1046000,-12685000,-13731000,53284,KIDS
2018-12-31,4732000,,-12025000,,-12025000,47501000,42680000,-9553000,-9553000,,-2255000,,,,0,57559000,67112000,14879000,-2472000,-1046000,-12025000,-12025000,53284,KIDS
2017-12-31,3423000,,-8932000,,-8932000,37499000,34450000,-6472000,-6472000,,-2490000,,,,0,45620000,52092000,11170000,-2460000,-1046000,-8932000,-23530000,53284,KIDS
2016-12-31,2223000,,-6572000,,-6572000,28292000,26367000,-4148000,-4148000,,-1476000,,,,0,37298000,41446000,10931000,-2424000,-1046000,-6572000,-12448000,53284,KIDS
2019-12-31,6900000,,-51903000,,-51903000,74669000,35059000,-46510000,-46510000,,-10906000,,,,0,63038000,109548000,27979000,-5393000,,-51903000,-51903000,53285,MNKD
2018-12-31,8737000,,-86735000,,-86975000,79716000,7390000,-81063000,-81063000,,-9439000,,,,240000,27859000,108922000,20469000,-5672000,,-86975000,-86975000,53285,MNKD
2017-12-31,14118000,,-117282000,,-117333000,74959000,-6083000,-95160000,-95160000,,-13276000,,,,51000,11145000,106305000,17228000,-22122000,,-117333000,-117333000,53285,MNKD
2016-12-31,14917000,,125664000,,125664000,46928000,124666000,62821000,62821000,,-18477000,,,,0,174758000,111937000,50092000,62843000,,125664000,125664000,53285,MNKD
2019-12-31,,,-663000000,193000000,-415000000,2083000000,3676000000,837000000,837000000,,-397000000,,,,-260000000,6498000000,5661000000,2822000000,-1500000000,,-403000000,-415000000,53286,NLSN
2018-12-31,,,-882000000,196000000,-712000000,1951000000,3710000000,1084000000,1084000000,,-394000000,,,,-182000000,6515000000,5431000000,2805000000,-1966000000,,-700000000,-712000000,53286,NLSN
2017-12-31,,,828000000,198000000,429000000,1862000000,3807000000,1305000000,1305000000,,-374000000,,,,388000000,6572000000,5267000000,2765000000,-477000000,,440000000,429000000,53286,NLSN
2016-12-31,,,816000000,191000000,502000000,1877000000,3702000000,1222000000,1222000000,,-333000000,,,,309000000,6309000000,5087000000,2607000000,-406000000,,507000000,502000000,53286,NLSN
2019-12-31,,,-7338000,,-7547000,8256000,27038000,18782000,18782000,,-7636000,,,,209000,27038000,8256000,0,-26120000,,-7547000,-7547000,53287,GECC
2018-12-31,,,-8825000,,-9005000,6595000,27754000,21159000,21159000,,-5645000,,,,180000,27754000,6595000,0,-29984000,,-9005000,-9005000,53287,GECC
2017-12-31,,,-2630000,,-2754000,9990000,29728000,19738000,19738000,,-2039000,,,,124000,29728000,9990000,0,-22368000,,-2754000,-2754000,53287,GECC
2016-12-31,,,-26679000,,-26811000,2770500,8746500,5976000,5976000,,-630000,,,,132000,8746500,2770500,0,-32655000,,-26811000,-26811000,53287,GECC
2019-12-31,30992000,,-103223000,,-103319000,108231000,56095000,-83128000,-83128000,,-7134000,,,,96000,77595000,160723000,21500000,-20095000,,-103319000,-103319000,53288,PRCH
2018-12-31,24173000,,-50475000,,-49917000,63884000,38800000,-49257000,-49257000,,-3706000,,,,-558000,54137000,103394000,15337000,-1218000,,-49917000,-49917000,53288,PRCH
2019-12-31,131711000,,-253560000,,-254337000,210796000,112255000,-235245000,-235245000,,-27705000,,,,777000,136467000,371712000,24212000,-18315000,,-254337000,-254337000,53290,INSM
2018-12-31,145283000,,-324076000,,-324277000,168218000,7412000,-307338000,-307338000,,-25472000,,,,201000,9835000,317173000,2423000,-16738000,,-324277000,-324277000,53290,INSM
2017-12-31,109749000,,-192921000,,-192649000,79171000,0,-188920000,-188920000,,-5925000,,,,-272000,0,188920000,0,-4001000,,-192649000,-192649000,53290,INSM
2016-12-31,35454000,,-176175000,,-176273000,50679000,-87267000,-173400000,-173400000,,-3498000,,,,98000,0,173400000,87267000,-2775000,,-176273000,-176273000,53290,INSM
2020-12-31,39710000,,-12147000,,-9405000,95088000,122376000,-12422000,-12422000,,,,,,-2742000,150827000,163249000,28451000,275000,,-9405000,-9405000,53293,FROG
2019-12-31,28507000,,-3766000,,-5394000,61126000,84681000,-4952000,-4952000,,,,,,1628000,104716000,109668000,20035000,1186000,,-5394000,-5394000,53293,FROG
2018-12-31,25765000,,-25545000,,-26015000,53140000,52821000,-26084000,-26084000,,,,,,470000,63532000,89616000,10711000,539000,,-26015000,-26015000,53293,FROG
2020-03-31,,,-176445000,43741000,-179024000,298551000,158767000,-137386000,-137386000,-2398000,-59268000,,,,-512000,770237000,907623000,611470000,-39059000,,-175933000,-384962000,53295,BQ
2019-03-31,,,-231667000,4627000,-234241000,409335000,204354000,-201130000,-201130000,-3851000,-18654000,,,,-141000,803831000,1004961000,599477000,-30537000,,-231526000,-627514000,53295,BQ
2019-12-31,,,-1156000000,-407600000,11521400000,2099900000,8302800000,940300000,940300000,1606500000,-1385900000,,,,253000000,11541500000,10601200000,3238700000,-2096300000,13047200000,-1409000000,11521400000,53297,LBTYK
2018-12-31,,,161800000,-533100000,725300000,2031000000,8711800000,1105400000,1105400000,1712800000,-1478700000,,,,1573300000,11957900000,10852500000,3246100000,-943600000,2261500000,-1411500000,725300000,53297,LBTYK
2017-12-31,,,-2111100000,-412000000,-2778100000,1980400000,8302800000,840800000,840800000,1686300000,-1416100000,,,,238900000,11276400000,10435600000,2973600000,-2951900000,-370600000,-2350000000,-2778100000,53297,LBTYK
2016-12-31,,,243300000,970700000,1705300000,2479900000,10231700000,1709300000,1709300000,1921400000,-1866100000,,,,-1407000000,13731100000,12021800000,3499400000,-1466000000,117000000,1650300000,1705300000,53297,LBTYK
2019-12-31,23764000,,-32325000,,-32325000,11914000,0,-35678000,-35678000,,,,,,0,0,35678000,0,3353000,,-32325000,-32325000,53298,STOK
2018-12-31,8371000,,-12521000,,-12521000,4410000,0,-12781000,-12781000,,,,,,0,0,12781000,0,260000,,-12521000,-12521000,53298,STOK
2017-12-31,3598000,,-5558000,,-5558000,1956000,0,-5554000,-5554000,,,,,,0,0,5554000,0,-4000,,-5558000,-5558000,53298,STOK
2019-12-31,37244000,,-47339000,,-47339000,9676000,0,-46920000,-46920000,,,,,,0,0,46920000,0,-419000,,-47339000,-47339000,53303,ALNA
2018-12-31,26376000,,-35648000,,-35648000,9217000,0,-35593000,-35593000,,,,,,0,0,35593000,0,-55000,,-35648000,-35648000,53303,ALNA
2017-12-31,15519000,,-21650000,,-21650000,5431000,0,-20950000,-20950000,,-410000.0,,,,0,0,20950000,0,-700000,,-21650000,-21708000,53303,ALNA
2016-12-31,20103000,,-24507000,,-24507000,4083000,0,-24186000,-24186000,,-47000.0,,,,0,0,24186000,0,-321000,,-24507000,-24576000,53303,ALNA
2019-12-31,,,-1156000000,-407600000,11521400000,2099900000,8302800000,940300000,940300000,1606500000,-1385900000,,,,253000000,11541500000,10601200000,3238700000,-2096300000,13047200000,-1409000000,11521400000,53304,LBTYB
2018-12-31,,,161800000,-533100000,725300000,2031000000,8711800000,1105400000,1105400000,1712800000,-1478700000,,,,1573300000,11957900000,10852500000,3246100000,-943600000,2261500000,-1411500000,725300000,53304,LBTYB
2017-12-31,,,-2111100000,-412000000,-2778100000,1980400000,8302800000,840800000,840800000,1686300000,-1416100000,,,,238900000,11276400000,10435600000,2973600000,-2951900000,-370600000,-2350000000,-2778100000,53304,LBTYB
2016-12-31,,,243300000,970700000,1705300000,2479900000,10231700000,1709300000,1709300000,1921400000,-1866100000,,,,-1407000000,13731100000,12021800000,3499400000,-1466000000,117000000,1650300000,1705300000,53304,LBTYB
2019-12-31,,,-10825000,,-10825000,35885000,12444000,0,-23441000,,,,,,0,21856000,45297000,9412000,12616000,,-10825000,-10825000,53305,MOGO
2018-12-31,,,-22022000,,-22022000,35461000,13844000,0,-21617000,,,,,,0,22794000,44411000,8950000,-405000,,-22022000,-22022000,53305,MOGO
2017-12-31,,,-19729000,,-19729000,28848000,11260000,0,-17588000,,,,,,0,19458000,37046000,8198000,-2141000,,-19729000,-19729000,53305,MOGO
2016-12-31,,,-17091000,,-17092000,27173000,11099000,0,-16074000,,,,,,1000,21807000,37881000,10708000,-1017000,,-17092000,-17092000,53305,MOGO
2019-12-31,,,222208326,,222208326,11681284,34710740,23029456,23029456,,-4093873,,,,0,34710740,11681284,0,199178870,,222208326,222208326,53306,IGR
2018-12-31,,,-97842180,,-97842180,11444103,37403583,25959480,25959480,,-3581185,,,,0,37403583,11444103,0,-123801660,,-97842180,-97842180,53306,IGR
2017-12-31,,,109468330,,109468330,11853076,45437708,33584632,33584632,,-2736859,,,,0,45437708,11853076,0,75883698,,109468330,109468330,53306,IGR
2016-12-31,,,25009466,,25009466,11584547,42903394,31318847,31318847,,-938743,,,,0,42903394,11584547,0,-6309381,,25009466,25009466,53306,IGR
2019-12-31,10715000,,-5502000,,-4687000,46024000,64557000,2072000,2072000,,-5410000,,,,-815000,116176000,114104000,51619000,-7574000,,-4687000,-4687000,53316,HBIO
2018-12-31,10988000,,-7975000,,-2922000,45825000,66981000,4784000,4784000,,-5367000,,,,-3676000,120774000,115990000,53793000,-12759000,1377000.0,-4299000,-2922000,53316,HBIO
2017-12-31,5645000,,-2621000,,-865000,32607000,39170000,-635000,-635000,,-713000,,,,-605000,77407000,78042000,38237000,-1986000,1151000.0,-2016000,-865000,53316,HBIO
2016-12-31,5392000,,-3078000,,-4307000,41436000,48415000,-1135000,-1135000,,-639000,,,,1229000,104521000,105656000,56106000,-1943000,1151000.0,-4307000,-4307000,53316,HBIO
2020-12-31,,,175958000,,132578000,235653000,442648000,0,189804000,17191000,,,,,43380000,442648000,252844000,0,-13846000,,132578000,118537000,53317,CUBI
2019-12-31,,,102120000,,79327000,202837000,341497000,0,117955000,20705000,,,,,22793000,341497000,223542000,0,-15835000,,79327000,64868000,53317,CUBI
2018-12-31,,,91054000,,71695000,188175000,311233000,0,104536000,18522000,,,,,19359000,311233000,206697000,0,-13482000,,71695000,57236000,53317,CUBI
2017-12-31,,,123879000,,78837000,182607000,339485000,0,132765000,24113000,,,,,45042000,339485000,206720000,0,-8886000,,78837000,64378000,53317,CUBI
2019-12-28,9132969,,-29266222,-17023,-29506252,21316459,4401110,-26048318,-26048318,,,,,,108000,29518809,55567127,25117699,-3217904,,-29374222,-29506252,53318,KOPN
2018-12-29,12553237,,-34452492,-149053,-34533542,27210849,3741498,-36022588,-36022588,,,,,,30000,24465005,60487593,20723507,1570096,,-34482492,-34533542,53318,KOPN
2017-12-30,15515057,,-28343115,616661,-25240482,20341244,6358414,-29497887,-29497887,,,,,,-2963000,27841490,57339377,21483076,1154772,,-25380115,-25240482,53318,KOPN
2016-12-31,15252794,,-19901145,141957,-23568717,16961773,4041428,-28173139,-28173139,,,,,,3130000,22642566,50815705,18601138,8271994,,-23031145,-23568717,53318,KOPN
2019-12-31,690000000,,-332000000,,-656000000,2802000000,3656000000,100000000,100000000,64000000,-113000000,,,,324000000,7508000000,7408000000,3852000000,-432000000,,-656000000,-656000000,53319,ALC
2018-12-31,587000000,,-300000000,,-227000000,2799000000,3568000000,187000000,187000000,-5000000,-24000000,,,,-73000000,7153000000,6966000000,3585000000,-487000000,,-227000000,-227000000,53319,ALC
2017-12-31,545000000,,-127000000,,256000000,2596000000,3204000000,53000000,53000000,10000000,-27000000,,,,-383000000,6792000000,6739000000,3588000000,-180000000,,256000000,256000000,53319,ALC
2016-12-31,481000000,,-113000000,,-170000000,2526000000,3117000000,56000000,56000000,54000000,-31000000,,,,57000000,6596000000,6540000000,3479000000,-169000000,,-170000000,-170000000,53319,ALC
2019-12-31,32917000,,-38582000,,-33226000,30183000,47090000,-16826000,-16826000,,-12483000,,,,-5356000,59215000,76041000,12125000,-21756000,,-33226000,-33226000,53321,AVDL
2018-12-31,39329000,,-113197000,,-95304000,100359000,85753000,-60554000,-60554000,,-10622000,,,,-17893000,103269000,163823000,17516000,-52643000,,-95304000,-95304000,53321,AVDL
2017-12-31,33418000,,92660000,,68271000,58860000,156944000,61007000,61007000,,-1052000,,,,24389000,173245000,112238000,16301000,31653000,,68271000,68271000,53321,AVDL
2016-12-31,33641000,,-9718000,,-41276000,45149000,136998000,44320000,44320000,,-963000,,,,31558000,150246000,105926000,13248000,-54038000,,-41276000,-41276000,53321,AVDL
2020-04-30,,,-3374000,,-7526000,744361000,927444000,183083000,183083000,,-96094000,,,,-9530000,2639720000,2456637000,1712276000,-186457000,-13682000,6156000,-8165000,53322,HRB
2019-04-30,,,545160000,,422509000,722167000,1337959000,615792000,615792000,,-87051000,,,,99904000,3094881000,2479089000,1756922000,-70632000,-22747000,445256000,421469000,53322,HRB
2018-04-30,,,668732000,,613149000,668152000,1420202000,752050000,752050000,,-89372000,,,,41823000,3159931000,2407881000,1739729000,-90718000,-13760000,626909000,611657000,53322,HRB
2017-04-30,,,629287000,,408945000,675953000,1391937000,715984000,715984000,,-92951000,,,,208370000,3036314000,2320330000,1644377000,-86697000,-11972000,420917000,407940000,53322,HRB
2019-12-31,,,58616000,85233000,46893000,14978000,74029000,0,58616000,435000,,,,,0,74029000,15413000,0,0,,58616000,46893000,53323,DXF
2018-12-31,,,26188000,73414000,6524000,22162000,48940000,0,26188000,590000,,,,,18033000,48940000,22752000,0,0,,8155000,6524000,53323,DXF
2017-12-31,,,44376000,118577000,23061000,38033000,83083000,0,44376000,674000,,,,,15550000,83083000,38707000,0,0,,28826000,23061000,53323,DXF
2016-12-31,,,57169000,115937000,33558000,19836000,78157000,0,57169000,1152000,,,,,15221000,78157000,20988000,0,0,,41948000,33558000,53323,DXF
2019-12-28,,,12580000,1464000,7731000,167249000,278806000,81616000,81616000,,-56846000,,,,4830000,600273000,518657000,321467000,-69036000,,7750000,7731000,53324,DRVN
2018-12-29,,,9867000,1464000,7062000,144763000,224822000,58168000,58168000,,-41758000,,,,2805000,492715000,434547000,267893000,-48301000,,7062000,7062000,53324,DRVN
2020-01-31,185552000,,-203556000,,-208359000,738694000,733314000,-193509000,-193509000,2577000,-29254000,,,,4803000,973971000,1167480000,240657000,-10047000,,-208359000,-208359000,53328,DOCU
2019-01-31,185968000,,-428208000,,-426458000,748903000,510605000,-426215000,-426215000,1949000,-10844000,,,,-1750000,700969000,1127184000,190364000,-1993000,,-426458000,-426811000,53328,DOCU
2018-01-31,92428000,,-49142000,,-52276000,359456000,400231000,-51653000,-51653000,1949000,-624000,,,,3134000,518504000,570157000,118273000,2511000,,-52276000,-53737000,53328,DOCU
2017-01-31,89652000,,-115056000,,-115412000,305147000,278982000,-115817000,-115817000,1949000,-611000,,,,356000,381459000,497276000,102477000,761000,,-115412000,-116868000,53328,DOCU
2020-12-31,,,-1273714000,876977000,-1467231000,2835618000,4178915000,-435560000,-435560000,1778857000,-777119000,,,,52348000,12970486000,13406046000,8791571000,-838154000,-120267000,-1326062000,-1467231000,53331,CX
2019-12-31,,,253000000,1503000000,143000000,3011000000,4305000000,1313000000,1313000000,-19000000,-607000000,,,,162000000,13130000000,11817000000,8825000000,-1060000000,88000000,91000000,144000000,53331,CX
2018-12-31,,,717000000,1572000000,528000000,3019000000,4682000000,1650000000,1650000000,13000000,-610000000,,,,224000000,13531000000,11881000000,8849000000,-933000000,77000000,493000000,531000000,53331,CX
2018-01-01,,,661000000,1571000000,792000000,2867000000,4561000000,1687000000,1687000000,7000000,-807000000,,,,16000000,12926000000,11239000000,8365000000,-1026000000,222000000,645000000,797000000,53331,CX
2020-09-30,282042000,,583322000,42509000,497840000,458539000,1413476000,594758000,594758000,,-10427000,,,,85482000,4169039000,3574281000,2755563000,-11436000,,497840000,497840000,53332,DOX
2019-09-30,273936000,,567887000,42509000,479446000,492457000,1433497000,569746000,569746000,,-3911000,,,,88441000,4086669000,3516923000,2653172000,-1859000,,479446000,479446000,53332,DOX
2018-09-30,276615000,,421541000,43163000,354396000,481093000,1379561000,513364000,513364000,,-2764000,,,,67145000,3974837000,3461473000,2595276000,-91823000,,354396000,354396000,53332,DOX
2017-09-30,259097000,,512912000,43163000,436826000,472778000,1359499000,517333000,517333000,,-1600000,,,,76086000,3867155000,3349822000,2507656000,-4421000,,436826000,436826000,53332,DOX
2020-12-31,,,-1838000000,29115000000,-1098000000,816000000,3280000000,2145000000,2145000000,,-2592000000,,,,220000000,5844000000,3699000000,2564000000,-3983000000,,-2058000000,-1098000000,53333,BPY
2019-12-31,,,3353000000,31241000000,884000000,953000000,7057000000,5763000000,5763000000,,-2924000000,,,,196000000,10172000000,4409000000,3115000000,-2410000000,,3157000000,949000000,53333,BPY
2018-12-31,,,3735000000,34387000000,764000000,746000000,5174000000,4120000000,4120000000,,-2464000000,,,,81000000,8186000000,4066000000,3012000000,-385000000,,3654000000,862000000,53333,BPY
2017-12-31,,,2660000000,27729000000,136000000,669000000,4455000000,3511000000,3511000000,,-1967000000,,,,192000000,7096000000,3585000000,2641000000,-851000000,,2468000000,158000000,53333,BPY
2020-06-30,,,978900000,,635000000,308500000,1247100000,886600000,886600000,52000000,-7100000,,,,343900000,4185000000,3298400000,2937900000,92300000,,635000000,635000000,53337,DRD
2019-06-30,,,105100000,,78500000,90900000,214500000,59400000,59400000,64200000,-2800000,,,,26600000,2762100000,2702700000,2547600000,45700000,,78500000,78500000,53337,DRD
2018-06-30,,,32400000,,6500000,81100000,142700000,16000000,16000000,45600000,-2500000,,,,25900000,2490400000,2474400000,2347700000,16400000,,6500000,6500000,53337,DRD
2017-06-30,,,-36700000,,13700000,59400000,55000000,-50900000,-50900000,46500000,-2500000,,,,-50400000,2339900000,2390800000,2284900000,14200000,,13700000,13700000,53337,DRD
2019-12-31,,,200700000,348800000,137600000,264100000,639400000,375300000,375300000,,-221800000,,,,61500000,3005100000,2629800000,2365700000,-174600000,-3100000,139200000,135800000,53338,TRN
2018-12-31,,,151600000,351200000,159300000,292900000,570300000,277400000,277400000,9000000.0,-179300000,,,,42600000,2509100000,2231700000,1938800000,-125800000,54100000,109000000,156500000,53338,TRN
2017-12-31,,,195400000,356900000,702500000,336600000,622200000,285600000,285600000,9000000.0,-184000000,,,,-414800000,2397400000,2111800000,1775200000,-90200000,103400000,610200000,687100000,53338,TRN
2016-12-31,,,310000000,392600000,343600000,312600000,777800000,465200000,465200000,9000000.0,-181900000,,,,106800000,3089800000,2624600000,2312000000,-155200000,161500000,203200000,334200000,53338,TRN
2020-12-31,372000000,,-274400000,,-138900000,3177800000,4896200000,748800000,748800000,,-212000000,,,,-137000000,7024500000,6275700000,2128300000,-1023200000,,-137400000,-138900000,53339,ZBH
2019-12-31,449300000,,905800000,4700000.0,1131600000,3340800000,5729600000,1355200000,1355200000,,-226900000,,,,-225700000,7982200000,6627000000,2252600000,-449400000,,1131500000,1131600000,53339,ZBH
2018-12-31,391700000,,-271100000,4800000.0,-379200000,3241600000,5661000000,1431800000,1431800000,,-289300000,,,,108200000,7932900000,6501100000,2271900000,-1702900000,,-379300000,-379200000,53339,ZBH
2017-12-31,369900000,,464600000,-300000.0,1813800000,3095800000,5703200000,1633600000,1633600000,,-325300000,,,,-1348800000,7803300000,6169700000,2100100000,-1169000000,,1813400000,1813800000,53339,ZBH
2020-06-30,,,31839000,,-80407000,324376000,469945000,133931000,133931000,,-15324000,,,,6205000,2053903000,1919972000,1583958000,-102092000,-106041000,25634000,-80407000,53341,HAIN
2019-06-30,,,-56659000,,-183314000,314000000,410878000,83744000,83744000,,-19450000,,,,-3232000,2104606000,2020862000,1693728000,-140403000,-129887000,-53427000,-183314000,53341,HAIN
2018-06-30,,,72773000,,9694000,316285000,467257000,135038000,135038000,,-13910000,,,,-1971000,2265670000,2130632000,1798413000,-62265000,-65050000,74744000,9694000,53341,HAIN
2017-06-30,,,88007000,,67430000,312583000,519396000,189825000,189825000,,-18391000,,,,22466000,2343505000,2153680000,1824109000,-101818000,1889000,65541000,67430000,53341,HAIN
2019-12-31,,,-534163000,-24000,-532495000,342684000,488411000,145727000,145727000,,-114899000,,,,-1305000,2348789000,2203062000,1860378000,-679890000,,-532858000,-532495000,53346,PRTY
2018-12-31,,,162006000,291000,123259000,328524000,621703000,293179000,293179000,,-105706000,,,,38778000,2427515000,2134336000,1805812000,-131173000,,123228000,123259000,53346,PRTY
2017-12-31,,,188144000,355000,215340000,323299000,607353000,284054000,284054000,,-87366000,,,,-27196000,2371569000,2087515000,1764216000,-95910000,,215340000,215340000,53346,PRTY
2016-12-31,,,186714000,355000,117477000,298652000,572736000,274084000,274084000,,-89380000,,,,69237000,2283391000,2009307000,1710655000,-87370000,,117477000,117477000,53346,PRTY
2019-12-31,55965000,,45766000,,40773000,118693000,263355000,72840000,72840000,,-8493000,,,,4993000,626099000,553259000,362744000,-27074000,,40773000,40773000,53347,NOVT
2018-12-31,51024000,,61302000,,49109000,115948000,261528000,79006000,79006000,,-9814000,,,,10207000,614337000,535331000,352809000,-17704000,,51095000,50890000,53347,NOVT
2017-12-31,41673000,,76134000,46923000.0,60051000,102025000,225285000,69491000,69491000,,-7165000,,,,13827000,521290000,451799000,296005000,6643000,,62307000,39807000,53347,NOVT
2016-12-31,32002000,,32522000,46923000.0,22003000,81299000,162625000,41073000,41073000,,-4559000,,,,10519000,384758000,343685000,222133000,-8551000,,22003000,22003000,53347,NOVT
2019-12-31,,,25839949,169510785,14116545,41482375,92813198,34413988,34413988,,-4733256,,,,8166632,560618097,526204109,467804899,-8574039,,17673317,14116545,53348,AMEH
2018-12-31,,,82627131,226115349,10835002,42553787,158775641,93031028,93031028,,-560515,,,,22359640,519907752,426876724,361132111,-10403897,,60267491,10835002,53348,AMEH
2017-12-31,,,49711113,176365142,25801842,26249532,82902643,37577758,37577758,,-79689,,,,3886785,356355930,318778172,273453287,12133355,,45824328,25801842,53348,AMEH
2016-12-31,,,18836209,163237171,11453527,21032971,51160330,12012919,12012919,,-61589,,,,8816412,305934915,293921996,254774585,6823290,,10019797,11453527,53348,AMEH
2020-01-31,609018000,,-331651000,,-336668000,1568425000,1929138000,-263435000,-263435000,15130000,-96249000,,,,5017000,2358926000,2622361000,429788000,-68216000,,-336668000,-336668000,53349,SPLK
2019-01-31,437825000,,-263191000,,-275577000,1252333000,1458334000,-245139000,-245139000,13315000,-41963000,,,,12386000,1803010000,2048149000,344676000,-18052000,,-275577000,-275577000,53349,SPLK
2018-01-31,301114000,,-188861000,,-190218000,937019000,1052723000,-185410000,-185410000,13315000,-8794000,,,,1357000,1309132000,1494542000,256409000,-3451000,,-190218000,-190218000,53349,SPLK
2017-01-31,295850000,,-341953000,,-347460000,781399000,752511000,-324738000,-324738000,13315000,-8549000,,,,5507000,943564000,1268302000,191053000,-17215000,,-347460000,-347460000,53349,SPLK
2019-12-31,,,482389000,61409000,293382000,54558000,701766000,465132000,465132000,6831000,-24550000,,,,173530000,1155637000,690505000,453871000,17257000,6982000,308859000,293382000,53351,BTG
2018-12-31,,,267128000,41906000,28938000,51293000,628919000,281967000,281967000,6344000,-30645000,,,,132361000,1051424000,769457000,422505000,-14839000,-89646000,134767000,28938000,53351,BTG
2017-12-31,,,68896000,14289000,56852000,43613000,310753000,81069000,81069000,3325000,-12906000,,,,7330000,638677000,557608000,327924000,-12173000,-89646000,61566000,56852000,53351,BTG
2016-12-31,,,68530000,9575000,39131000,40918000,382400000,138881000,138881000,11558000,-10184000,,,,29930000,683293000,544412000,300893000,-70351000,-89646000,38600000,39131000,53351,BTG
2020-08-31,,,386878000,9302000,422439000,697678000,981807000,284129000,284129000,,-116977000,,,,-36731000,28406365000,28122236000,27424558000,102749000,,423609000,253771000,53352,CHSCP
2019-08-31,,,815601000,7390000,829880000,691877000,1384333000,692456000,692456000,,-167065000,,,,-12456000,31900453000,31207997000,30516120000,123145000,,828057000,661212000,53352,CHSCP
2018-08-31,,,671230000,9446000,775907000,635519000,1092120000,456601000,456601000,,-149202000,,,,-104076000,32683347000,32226746000,31591227000,214629000,,775306000,607239000,53352,CHSCP
2017-08-31,,,-110166000,12505000,71592000,609590000,893877000,284287000,284287000,,-171239000,,,,-181124000,32037426000,31753139000,31143549000,-394453000,,70958000,-96051000,53352,CHSCP
2019-12-31,3656679,,-2548711,,-2548711,5658958,6667867,-2647770,-2647770,,,,,,0,7663658,10311428,995791,99059,,-2548711,-2548711,53353,IDN
2018-12-31,2904166,,-3963576,,-3963576,5236170,4046837,-4093499,-4093499,,,,,,0,4433454,8526953,386617,259846,,-3963576,-3963576,53353,IDN
2017-12-31,1916107,,-6020505,,-6020505,5865278,3076461,-4704924,-4704924,,,,,,0,3598296,8303220,521835,-1315581,,-6020505,-6020505,53353,IDN
2016-12-31,2405593,,-5734681,,-5734681,6413933,3069915,-5749611,-5749611,,,,,,0,3838963,9588574,769048,14930,,-5734681,-5734681,53353,IDN
2020-12-31,,,821000000,,690000000,,3228000000,943000000,943000000,2285000000,-122000000,,,,131000000,10808000000,9865000000,7580000000,-122000000,,690000000,690000000,53355,CNA
2019-12-31,,,1223000000,,1000000000,,3578000000,1354000000,1354000000,2224000000,-131000000,,,,223000000,10767000000,9413000000,7189000000,-131000000,,1000000000,1000000000,53355,CNA
2018-12-31,,,964000000,,813000000,,3227000000,1102000000,1102000000,2125000000,-138000000,,,,151000000,10134000000,9032000000,6907000000,-138000000,,813000000,813000000,53355,CNA
2017-12-31,,,1310000000,,899000000,,2999000000,1471000000,1471000000,1528000000,-161000000,,,,411000000,9542000000,8071000000,6543000000,-161000000,,899000000,899000000,53355,CNA
2020-03-31,,,54112000,70290000,34274000,20150000,96121000,48179000,48179000,7077000,-157000,,,,8909000,158829000,110650000,62708000,5933000,,45203000,34274000,53357,SVM
2019-03-31,,,72918000,65735000,39724000,19041000,107672000,67871000,67871000,8042000,-152000,,,,20871000,170519000,102648000,62847000,5047000,,52047000,39724000,53357,SVM
2018-03-31,,,77815000,68943000,46994000,18685000,110895000,67795000,67795000,6168000,-152000,,,,18919000,170039000,102244000,59144000,10020000,,58896000,46994000,53357,SVM
2017-03-31,,,74735000,54814000,43674000,16818000,109649000,67546000,67546000,7418000,-378000,,,,19237000,163471000,95925000,53822000,7189000,,55498000,43674000,53357,SVM
2019-12-28,15100000,,103400000,,12400000,985800000,1188000000,187100000,187100000,,-41500000,,,,91000000,1797900000,1610800000,609900000,-83700000,,12400000,12400000,53358,TUP
2018-12-29,15000000,,276200000,,155900000,1047600000,1378400000,315800000,315800000,,-46500000,,,,120300000,2069700000,1753900000,691300000,-39600000,,155900000,155900000,53358,TUP
2017-12-30,16700000,,185100000,,-265400000,1145900000,1515100000,352500000,352500000,,-46100000,,,,450500000,2255800000,1903300000,740700000,-167400000,,-265400000,-265400000,53358,TUP
2016-12-31,18300000,,301300000,,223600000,1152800000,1498400000,327300000,327300000,,-48800000,,,,77700000,2213100000,1885800000,714700000,-26000000,,223600000,223600000,53358,TUP
2019-12-31,,,395645000,,390881000,65477000,1023335000,734023000,734023000,,-301520000,,,,4764000,1153473000,419450000,130138000,-338378000,,390881000,390305000,53363,GLPI
2018-12-31,,,344480000,,339516000,71128000,861485000,653264000,653264000,,-247684000,,,,4964000,1055727000,402463000,194242000,-308784000,,339516000,339041000,53363,GLPI
2017-12-31,,,390385000,,380598000,63151000,782149000,605518000,605518000,,-217068000,,,,9787000,971307000,365789000,189158000,-215133000,,380598000,379976000,53363,GLPI
2016-12-31,,,296850000,,289305000,71368000,719245000,480623000,480623000,57700000.0,-185896000,,,,7545000,828255000,347632000,109010000,-183773000,,289305000,288637000,53363,GLPI
2020-08-31,,,2943200,,2943200,1868887,11532521,9663634,9663634,,-1837877,,,,0,11532521,1868887,0,-6720434,,2943200,2943200,53364,BBK
2019-08-31,,,18899424,,18899424,1970242,11482761,9512519,9512519,,-2640153,,,,0,11482761,1970242,0,9386905,,18899424,18899424,53364,BBK
2018-08-31,,,2438546,,2438546,1990420,11576411,9585991,9585991,,-2194552,,,,0,11576411,1990420,0,-7147445,,2438546,2438546,53364,BBK
2017-08-31,,,-3672979,,-3672979,2031142,11666132,9634990,9634990,,-1895519,,,,0,11666132,2031142,0,-13307969,,-3672979,-3672979,53364,BBK
2020-12-31,269315000,,602976000,,557054000,1032439000,2065477000,721674000,721674000,,-69120000,,,,45922000,3198149000,2476475000,1132672000,-118698000,,557054000,557054000,53365,AKAM
2019-12-31,261365000,,531385000,,478035000,1032529000,1905993000,573518000,573518000,,-49364000,,,,53350000,2893617000,2320099000,987624000,-42133000,,478035000,478035000,53365,AKAM
2018-12-31,246165000,,343089000,,298373000,1015922000,1760989000,465591000,465591000,,-43202000,,,,44716000,2714474000,2248883000,953485000,-122502000,,298373000,298373000,53365,AKAM
2017-12-31,222434000,,314192000,,222766000,967314000,1613198000,392546000,392546000,,-18839000,,,,91426000,2489035000,2096489000,875837000,-78354000,,222766000,222766000,53365,AKAM
2019-12-31,21346000,,-57202000,,-57420000,5294000,0,-26640000,-26640000,,,,,,218000,0,26640000,0,-30562000,,-57420000,-57420000,53366,ETNB
2018-12-31,14924726,,-17615999,,-17646544,1615636,0,-16540362,-16540362,,,,,,30545,0,16540362,0,-1075636,,-17646544,-17646544,53366,ETNB
2020-11-30,,,23247848,,23247848,3459588,28213813,24754225,24754225,,-4605184,,,,0,28213813,3459588,0,-1506377,,23247848,23247848,53368,KTF
2019-11-30,,,53406047,,53406047,4160839,30445891,26285052,26285052,,-6609482,,,,0,30445891,4160839,0,27120995,,53406047,53406047,53368,KTF
2018-11-30,,,-4121674,,-4121674,4136638,32291865,28155227,28155227,,-6197143,,,,0,32291865,4136638,0,-32276901,,-4121674,-4121674,53368,KTF
2017-11-30,,,32003979,,32003979,4250754,35322674,31071920,31071920,,-5141577,,,,0,35322674,4250754,0,932059,,32003979,32003979,53368,KTF
2019-12-31,,,-113914000,,-118285000,43439000,101790000,31213000,31213000,,-7235000,,,,4371000,512951000,481738000,411161000,-145127000,,-118285000,-118285000,53369,TACO
2019-01-01,,,25618000,,18959000,43773000,110451000,39300000,39300000,,-9075000,,,,6659000,505490000,466190000,395039000,-13682000,,18959000,18959000,53369,TACO
2018-01-02,,,34047000,,49871000,38154000,105620000,42513000,42513000,,-7200000,,,,-15824000,471456000,428943000,365836000,-8466000,,49871000,49871000,53369,TACO
2017-01-03,,,36242000,,20913000,54420000,122327000,44047000,44047000,,-6327000,,,,15329000,452083000,408036000,329756000,-7805000,,20913000,20913000,53369,TACO
2020-07-31,,,-10724000,13728000,-10415000,11509000,4910000,-8465000,-8465000,,-84000,,,,29000,4910000,13375000,0,-2259000,,-10753000,-10415000,53370,RFL
2019-07-31,,,-4943000,13783000,-4693000,9848000,4931000,-6696000,-6696000,,-661000,,,,-19000,4931000,11627000,0,1753000,,-4924000,-4693000,53370,RFL
2018-07-31,,,-3639000,8868000,-11649000,6414000,4267000,-3845000,-3845000,,-661000,,,,8437000,4267000,8112000,0,206000,,-12076000,-11649000,53370,RFL
2017-07-31,,,204000,9335000,138000,3728000,5618000,221000,221000,,-661000,,,,66000,5618000,5397000,0,-17000,,138000,138000,53370,RFL
2020-12-31,,,1871000000,195000000,1804000000,1103000000,2057000000,810000000,810000000,,-164000000,,,,49000000,13066000000,12256000000,11009000000,1061000000,,1822000000,1769000000,53371,APTV
2019-12-31,,,1141000000,192000000,990000000,1217000000,2763000000,1408000000,1408000000,,-164000000,,,,132000000,14357000000,12949000000,11594000000,-267000000,,1009000000,990000000,53371,APTV
2018-12-31,,,1357000000,211000000,1067000000,1011000000,2733000000,1598000000,1598000000,,-141000000,,,,250000000,14435000000,12837000000,11702000000,-241000000,,1107000000,1067000000,53371,APTV
2017-12-31,,,1286000000,218000000,1355000000,984000000,2623000000,1522000000,1522000000,,-140000000,,,,223000000,12884000000,11362000000,10261000000,-236000000,365000000.0,1063000000,1355000000,53371,APTV
2019-12-31,15256000,,-21493000,,-21503000,6783000,2183000,-19856000,-19856000,,,,,,10000,2183000,22039000,0,-1637000,,-21503000,-21503000,53373,ONTX
2018-12-31,16924000,,-20534000,,-20573000,7586000,1228000,-23282000,-23282000,,,,,,-124000,1228000,24510000,0,2748000,,-20410000,-20573000,53373,ONTX
2017-12-31,19119000,,-24079000,830000.0,-24092000,7405000,787000,-25737000,-25737000,,,,,,13000,787000,26524000,0,1658000,,-24092000,-24092000,53373,ONTX
2016-12-31,20071000,,-19653000,830000.0,-19667000,9178000,5546000,-23703000,-23703000,,,,,,14000,5546000,29249000,0,4050000,,-19667000,-19667000,53373,ONTX
2017-12-31,,,-420132,,-420132,,0,0,,,,,,,0,0,0,0,-420132,,-420132,-443512,53375,BRPAU
2019-12-31,1791842,,-2959877,,-2959877,2960340,1754076,-2998106,-2998106,,-169,,,,0,5639466,8637572,3885390,38229,,-2959877,-2959877,53382,LGVN
2018-12-31,3875842,,-6336796,,-6336796,3165424,680649,-6360617,-6360617,,-169,,,,0,2134775,8495392,1454126,23821,,-6336796,-6336796,53382,LGVN
2019-12-29,,,4713000,63501000,-5069000,361859000,572915000,30654000,30654000,133088000,,,,,1620000,983149000,952495000,410234000,-25941000,-3337000,3093000,-30589000,53384,TPCO
2018-12-30,,,-52586000,39756000,248791000,369127000,581728000,28437000,28437000,130902000,-11353000.0,,,,-12723000,1030669000,1002232000,448941000,-81023000,289510000,-39863000,248791000,53384,TPCO
2017-12-31,,,-22625000,39756000,5535000,364702000,553446000,12443000,12443000,128995000,-26334000.0,,,,7188000,1015453000,1003010000,462007000,-35068000,35348000,-29813000,5535000,53384,TPCO
2016-12-25,,,-44939000,39756000,6537000,346690000,572959000,-1043000,-1043000,175949000,-26561000.0,,,,-9576000,1063363000,1064406000,490404000,-43896000,41900000,-35363000,6537000,53384,TPCO
2020-12-31,,,28440000,,21206000,51186000,89107000,0,29478000,8443000,,,,,7234000,89107000,59629000,0,-1038000,,21206000,21206000,53385,EBMT
2019-12-31,,,13968000,,10872000,38146000,59999000,0,17059000,4794000,,,,,3096000,59999000,42940000,0,-3091000,,10872000,10872000,53385,EBMT
2018-12-31,,,5896000,,4982000,29269000,40883000,0,8011000,3603000,,,,,914000,40883000,32872000,0,-2115000,,4982000,4982000,53385,EBMT
2017-12-31,,,6231000,,4103000,24791000,36869000,0,8748000,3330000,,,,,2128000,36869000,28121000,0,-2517000,,4103000,4103000,53385,EBMT
2020-08-31,,,1865524,,1865524,1471133,8987955,7516822,7516822,,-1243120,,,,0,8987955,1471133,0,-5651298,,1865524,1865524,53386,BAF
2019-08-31,,,13223099,,13223099,1449142,9383277,7934135,7934135,,-1922391,,,,0,9383277,1449142,0,5288964,,13223099,13223099,53386,BAF
2018-08-31,,,-224826,,-224826,1440049,9730427,8290378,8290378,,-1845668,,,,0,9730427,1440049,0,-8515204,,-224826,-224826,53386,BAF
2017-08-31,,,-471006,,-471006,1446642,9724120,8277478,8277478,,-1371682,,,,0,9724120,1446642,0,-8748484,,-471006,-471006,53386,BAF
2019-12-31,,,444168,,350893,,0,0,,,,,,,93275,0,0,0,444168,,350893,-123805,53387,SFTW
2018-12-31,,,-3732,,-3732,,0,0,,,,,,,0,0,0,0,-3732,,-3732,-3732,53387,SFTW
2019-12-31,,,2702195000,345798000,1989946000,941359000,3912232000,3083924000,3083924000,-113051000,-24570000,,,,639326000,16244274000,13160350000,12332042000,-381729000,,2062869000,1989946000,53390,ELP
2018-12-31,,,1955997000,303289000,1407063000,872243000,2903318000,2258159000,2258159000,-227084000,-25407000,,,,511993000,14934780000,12676621000,12031462000,-302162000,,1444004000,1407063000,53390,ELP
2017-12-31,,,1392941000,302661000,1033626000,854725000,2957768000,2039642000,2039642000,63401000,-85556000,,,,274686000,14024573000,11984931000,11066805000,-646701000,,1118255000,1033626000,53390,ELP
2016-12-31,,,1394162000,260044000,895772000,991593000,2444405000,1822407000,1822407000,-369595000,-47016000,,,,519690000,13101753000,11279346000,10657348000,-428245000,,874472000,895772000,53390,ELP
2020-10-31,700000,,-18133000,1472000,-13625000,55833000,89898000,33365000,33365000,,-877000,,,,-4292000,1059371000,1026006000,969473000,-51498000,,-13841000,-13625000,53395,CVGW
2019-10-31,700000,,49468000,1688000,36646000,59113000,128082000,68969000,68969000,,-948000,,,,12882000,1195777000,1126808000,1067695000,-19501000,,36586000,36646000,53395,CVGW
2018-10-31,700000,,44731000,1748000,32281000,56190000,113616000,57426000,57426000,,-831000,,,,12719000,1088758000,1031332000,975142000,-12695000,,32012000,32281000,53395,CVGW
2017-10-31,700000,,57774000,1016000,37270000,56651000,114544000,57893000,57893000,,-1023000,,,,20450000,1075565000,1017672000,961021000,-119000,,37324000,37270000,53395,CVGW
2020-02-01,,,-139642000,-8330000,-95873000,1775919000,1906519000,129600000,129600000,,-253018000,,,,-35658000,4434514000,4304914000,2527995000,-269242000,,-103984000,-95873000,53396,WOOF
2019-02-02,,,-459628000,-8330000,-413788000,1730887000,1904839000,158452000,158452000,,-243744000,,,,-45840000,4392173000,4233721000,2487334000,-618080000,,-413788000,-413788000,53396,WOOF
2019-12-31,2674000,,-5677000,438000,-5850000,5126000,1000000,-6800000,-6800000,,-181000,,,,216000,1000000,7800000,0,1123000,,-5893000,-5850000,53398,PPBT
2018-12-31,5268000,,-5569000,481000,-5200000,3762000,1000000,-8030000,-8030000,,-181000,,,,0,1000000,9030000,0,2461000,,-5569000,-5200000,53398,PPBT
2017-12-31,4640000,,-12913000,1280000,-12177000,5504000,100000,-10073000,-10073000,,-181000,,,,0,100000,10173000,0,-2840000,,-12913000,-12177000,53398,PPBT
2016-12-31,4180000,,-12125000,1280000,-12125000,2919000,0,-7099000,-7099000,,-181000,,,,0,0,7099000,0,-5026000,,-12125000,-12125000,53398,PPBT
2020-09-30,43006000,,-139549000,,-139931000,103267000,28694000,-117579000,-117579000,,-787000,,,,382000,90100000,207679000,61406000,-21970000,,-139931000,-139931000,53402,TWST
2019-09-30,35683000,,-107377000,,-107669000,80126000,6959000,-108850000,-108850000,,-1294000,,,,292000,54385000,163235000,47426000,1473000,,-107669000,-107669000,53402,TWST
2018-09-30,20347000,,-70994000,,-71236000,43450000,-6762000,-70559000,-70559000,,-1313000,,,,242000,25427000,95986000,32189000,-435000,,-71236000,-71236000,53402,TWST
2017-09-30,19169000,,-59030000,,-59310000,26060000,-13253000,-58482000,-58482000,,-905000,,,,280000,10767000,69249000,24020000,-548000,,-59310000,-59310000,53402,TWST
2020-12-31,,,49877000,,38046000,42717000,103230000,0,53482000,7031000,,,,,11831000,103230000,49748000,0,-3605000,,38046000,38046000,53403,BFC
2019-12-31,,,34289000,,26694000,35172000,77049000,0,35851000,6026000,,,,,7595000,77049000,41198000,0,-1562000,,26694000,26694000,53403,BFC
2018-12-31,,,32053000,,25456000,32589000,71664000,0,34046000,5029000,,,,,6597000,71664000,37618000,0,-1993000,,25456000,25456000,53403,BFC
2017-12-31,,,24139000,,15313000,26583000,54501000,0,24717000,3201000,,,,,8826000,54501000,29784000,0,-578000,,15313000,15313000,53403,BFC
2019-12-31,,,-10565000,,-10565000,6086000,-2684000,-9544000,-9544000,390000,,,,,0,0,9544000,2684000,-1021000,,-10565000,-10565000,53405,WWR
2018-12-31,,,-35684000,,-35684000,7009000,-3426000,-35368000,-35368000,993000,,,,,0,0,35368000,3426000,-316000,,-35684000,-35684000,53405,WWR
2017-12-31,,,-19288000,,-19288000,6614000,-3772000,-23815000,-23815000,1039000,,,,,0,0,23815000,3772000,4527000,,-19288000,-19288000,53405,WWR
2016-12-31,,,-19605000,,-19605000,7650000,-2762000,-13298000,-13298000,480000,-2600000.0,,,,0,0,13298000,2762000,-6307000,,-19605000,-19605000,53405,WWR
2019-12-31,,,1384000000,327000000,1062000000,2842000000,5979000000,1474000000,1474000000,1485000000,-47000000,,,,308000000,8477000000,7003000000,2498000000,-90000000,,1076000000,1062000000,53406,FNF
2018-12-31,,,755000000,342000000,628000000,2538000000,5312000000,791000000,791000000,1801000000,-43000000,,,,120000000,7592000000,6801000000,2280000000,-36000000,,635000000,628000000,53406,FNF
2017-12-31,,,874000000,364000000,771000000,2460000000,5341000000,917000000,917000000,1781000000,-48000000,,,,235000000,7668000000,6751000000,2327000000,-43000000,155000000.0,639000000,662000000,53406,FNF
2016-12-31,,,969000000,1246000000,650000000,2275000000,5105000000,1022000000,1022000000,1648000000,-64000000,,,,347000000,7260000000,6238000000,2155000000,-53000000,70000000.0,622000000,654000000,53406,FNF
2019-12-31,10632000,,-15938000,20961000,-16189000,7588000,0,-18220000,-18220000,,,,,,251000,0,18220000,0,2282000,,-16189000,-16189000,53411,FUSN
2018-12-31,6881000,,-11471000,15168000,-11652000,3218000,0,-10099000,-10099000,,,,,,181000,0,10099000,0,-1372000,,-11652000,-11652000,53411,FUSN
2017-12-31,5366000,,-6264000,15168000,-6264000,1620000,0,-6986000,-6986000,,,,,,0,0,6986000,0,722000,,-6264000,-6264000,53411,FUSN
2019-12-31,23029000,,-97039000,,-97039000,26647000,-6407000,-56083000,-56083000,,-22268000,,,,0,2836000,58919000,9243000,-40956000,,-97039000,-97039000,53414,AFIB
2018-12-31,19077000,,-47907000,,-47907000,13330000,-5344000,-37751000,-37751000,,-5231000,,,,0,2166000,39917000,7510000,-10156000,,-47907000,-47907000,53414,AFIB
2019-12-31,,,-26678000,,-23557000,47637000,69871000,-5471000,-5471000,,-6755000,,,,-3121000,233854000,239325000,163983000,-21207000,,-23557000,-43173000,53417,MEG
2018-12-31,,,-21459000,,-16491000,39206000,54071000,-9050000,-9050000,,-11085000,,,,-4968000,188805000,197855000,134734000,-12409000,,-16491000,-21028000,53417,MEG
2019-12-31,10088000,,-28043000,,-28043000,3974000,-14228000,-28290000,-28290000,,,,,,0,0,28290000,14228000,247000,,-28043000,-28043000,53418,AMTI
2018-12-31,8399000,,-29868000,,-29868000,1938000,-19531000,-29868000,-29868000,,,,,,0,0,29868000,19531000,0,,-29868000,-29868000,53418,AMTI
2019-12-29,,,91500000,,77700000,594800000,773200000,125200000,125200000,-6300000,-33400000,,,,13800000,2357500000,2232300000,1584300000,-33700000,,77700000,77700000,53419,SITE
2018-12-30,,,75200000,,73900000,578800000,678100000,106900000,106900000,-7600000,-32100000,,,,1300000,2112300000,2005400000,1434200000,-31700000,,73900000,73900000,53419,SITE
2017-12-31,,,72600000,,54600000,502200000,595500000,98400000,98400000,-5100000,-25200000,,,,18000000,1861700000,1763300000,1266200000,-25800000,,54600000,54600000,53419,SITE
2017-01-01,,,51900000,,30600000,446500000,515700000,74000000,74000000,-4800000,-22100000,,,,21300000,1648200000,1574200000,1132500000,-22100000,,30600000,-91400000,53419,SITE
2019-12-31,3394000,,-4797000,,-4797000,3338000,138000,-6594000,-6594000,,-4000,,,,0,689000,7283000,551000,1797000,,-4797000,-7500000,53421,SINT
2018-12-31,2991000,,-9689000,,-8652000,4001000,39000,-6953000,-6953000,,-1388000,,,,0,95000,7048000,56000,-2736000,1037000.0,-9689000,-22552000,53421,SINT
2017-12-31,3506000,,-5761000,,-9329000,3979000,9425000,-7485000,-7485000,,-1263000,,,,0,11227000,7485000,1802000,-2826000,-3568000.0,-5761000,-9329000,53421,SINT
2016-12-31,6345000,,-14763000,,-14763000,15939000,11601000,-10683000,-10683000,,-4511000,,,,0,15226000,25909000,3625000,-4080000,-3568000.0,-14763000,-21041000,53421,SINT
2019-12-31,124728,,-270427,,-358254,863865,222775,-174029,-174029,-591789,-34541,,,,87827,620168,794197,397393,-96398,,-358254,-358254,53424,ADN
2018-12-31,99974,,-464806,,-565383,860095,173246,-351282,-351282,-435541,-106060,,,,100577,373741,725023,200495,-113524,,-565383,-565383,53424,ADN
2019-12-31,,,373321000,21996000,230259000,675281000,1706092000,692457000,692457000,-70356000,-282650000,,,,137026000,3039324000,2346867000,1333232000,-319136000,,236295000,230259000,53425,NXST
2018-12-31,,,532945000,16210000,389477000,566678000,1648779000,790945000,790945000,-29381000,-220994000,,,,144680000,2766696000,1975751000,1117917000,-258000000,,388265000,389477000,53425,NXST
2017-12-31,,,241384000,10696000,474997000,538386000,1438561000,534614000,534614000,-29381000,-241195000,,,,-233943000,2431966000,1897352000,993405000,-293230000,,475327000,474997000,53425,NXST
2016-12-31,,,170672000,115213000,91537000,255206000,721193000,310970000,310970000,-29381000,-116081000,,,,77572000,1103190000,792220000,381997000,-140298000,,93100000,91537000,53425,NXST
2019-12-31,4300000,,-8908000,,-8908000,4708000,-4279000,-8987000,-8987000,,,,,,0,21000,9008000,4300000,79000,,-8908000,-8908000,53426,PHIO
2018-12-31,4300000,,-7360000,,-7360000,3176000,-4188000,-7364000,-7364000,,,,,,0,138000,7502000,4326000,4000,,-7360000,-7360000,53426,PHIO
2017-12-31,4300000,,-14073000,,-12452000,4011000,-5355000,-9366000,-9366000,,,,,,-1621000,15000,9381000,5370000,-4707000,,-12452000,-12452000,53426,PHIO
2016-12-31,4300000,,-8994000,,-8994000,3619000,-5396000,-9015000,-9015000,,,,,,0,19000,9034000,5415000,21000,,-8994000,-11069000,53426,PHIO
2019-12-31,3416466,,-7125655,,-7125655,3737987,0,-7154453,-7154453,,,,,,0,0,7154453,0,28798,,-7125655,-7125655,53430,EVOK
2018-12-31,4095014,,-7566080,,-7566080,3919671,0,-8014685,-8014685,,,,,,0,0,8014685,0,448605,,-7566080,-7566080,53430,EVOK
2017-12-31,7137493,,-12229512,,-12229512,4093189,0,-11230682,-11230682,,,,,,0,0,11230682,0,-998830,,-12229512,-12229512,53430,EVOK
2016-12-31,6951600,,-10748531,,-10748531,3592825,0,-10544425,-10544425,,-268029.0,,,,0,0,10544425,0,-204106,,-10748531,-10748531,53430,EVOK
2020-12-31,538080000,,554880000,,504446000,1576486000,2770936000,620789000,620789000,,-64687000,,,,50434000,3236700000,2615911000,465764000,-65909000,,504446000,504446000,53432,CTXS
2019-12-31,518877000,,509500000,,681813000,1453385000,2597857000,571565000,571565000,,-45974000,,,,-172313000,3010564000,2438999000,412707000,-62065000,,681813000,681813000,53432,CTXS
2018-12-31,439984000,,629455000,,575667000,1389577000,2587159000,694685000,694685000,,-80162000,,,,53788000,2973903000,2279218000,386744000,-65230000,,575667000,575667000,53432,CTXS
2017-12-31,415801000,,550346000,,-20719000,1308177000,2450728000,643872000,643872000,,-51609000,,,,528361000,2824686000,2180814000,373958000,-93526000,-42704000.0,21985000,-20719000,53432,CTXS
2020-12-31,,,73715702,,73715702,6067217,24269191,18090322,18090322,111652,,,,,0,24269191,6178869,0,55625380,,73715702,73715702,53434,CET
2019-12-31,,,251013464,,251013464,5859301,17961153,12010223,12010223,91629,,,,,0,17961153,5950930,0,239003241,,251013464,251013464,53434,CET
2018-12-31,,,-34279099,,-34279099,5701568,19477915,13684841,13684841,91506,,,,,0,19477915,5793074,0,-47963940,,-34279099,-34279099,53434,CET
2017-12-31,,,169206551,,169206551,5548748,12551977,6911428,6911428,91801,,,,,0,12551977,5640549,0,162295123,,169206551,169206551,53434,CET
2019-12-31,11055000,,9689000,2635000,6851000,198475000,249206000,31768000,31768000,,-21579000,,,,1576000,340141000,308373000,90935000,-22079000,-1815000,8113000,-659000,53436,BVS
2018-12-31,8095000,,6107000,2635000,-12207000,191672000,235009000,26627000,26627000,,-19171000,,,,1664000,319177000,292550000,84168000,-20520000,-16650000,4443000,-17988000,53436,BVS
2015-12-31,14747000,,-31971000,2635000,-34111000,148109000,179588000,6162000,6162000,,-14229000,,,,2140000,253650000,247488000,74062000,-38133000,-16650000,-34111000,-38108000,53436,BVS
2014-12-31,9465000,,-11353000,2635000,-12900000,145880000,169913000,5600000,5600000,,-11969000,,,,1547000,242893000,237293000,72980000,-16953000,-16650000,-12900000,-16618000,53436,BVS
2019-12-31,50359000,,-588922000,492746000,-702885000,258731000,1114052000,-71129000,-71129000,,-204311000,,,,91576000,3043383000,3114512000,1929331000,-517793000,-12000,-680498000,-741122000,53438,NBR
2018-12-31,56147000,,-518794000,454337000,-640948000,265822000,1080645000,-108194000,-108194000,,-227124000,,,,79269000,3057619000,3165813000,1976974000,-410600000,-14663000,-598063000,-666170000,53438,NBR
2017-12-31,51069000,,-580084000,230955000,-546811000,251184000,846216000,-298980000,-298980000,,-222889000,,,,-82970000,2564285000,2863265000,1718069000,-281104000,-43519000,-497114000,-533601000,53438,NBR
2016-12-31,33582000,,-1198075000,7770000,-1029742000,227639000,883541000,-249311000,-249311000,,-185360000,,,,-186831000,2227839000,2477150000,1344298000,-948764000,-18363000,-1011244000,-1007012000,53438,NBR
2019-12-31,,,-71453718,,-71453718,23643357,-53461222,-77104579,-77104579,,-19025,,,,0,36143568,113248147,89604790,5650861,,-71453718,-71453718,53439,CRBP
2018-12-31,,,-55672139,,-55672139,12956022,-43791685,-56747707,-56747707,,-7431,,,,0,4822272,61569979,48613957,1075568,,-55672139,-55672139,53439,CRBP
2017-12-31,,,-32421612,,-32421612,8964046,-23598770,-32562816,-32562816,,-9743,,,,0,2440195,35003011,26038965,141204,,-32421612,-32421612,53439,CRBP
2016-12-31,,,-19998675,,-19998675,6459747,-13525311,-19985058,-19985058,,-4401,,,,0,1911424,21896482,15436735,-13617,,-19998675,-19998675,53439,CRBP
2019-12-31,14799000,,-40304000,,-40454000,199693000,185033000,-29459000,-29459000,,-9074000,,,,150000,260981000,290440000,75948000,-10845000,,-40454000,-41099000,53441,ORGO
2018-12-31,10742000,,-64747000,,-64831000,158300000,124641000,-44401000,-44401000,,-10853000,,,,84000,193449000,237850000,68808000,-20346000,,-64831000,-64831000,53441,ORGO
2017-12-31,9065000,,-14550000,,-8388000,133929000,137288000,-5706000,-5706000,,-8127000,,,,-7025000,198508000,204214000,61220000,-8844000,,-7525000,-8811000,53441,ORGO
2016-12-31,6277000,,-14701000,6099000.0,-16987000,93029000,90531000,-8775000,-8775000,,-5374000,,,,65000,138732000,147507000,48201000,-5917000,,-14766000,-16987000,53441,ORGO
2020-03-31,2870497,,-56261922,,-60863262,61190662,-1838447,-65899606,-65899606,,-583707,,,,4601340,29577804,95477410,31416251,9637684,,-60863262,-60863262,53444,NEPT
2019-03-31,7211553,,-23021688,,-23191699,15285716,7614448,-14882821,-14882821,,-455136,,,,170011,24442042,39324863,16827594,-8138867,,-23191699,-23191699,53444,NEPT
2018-03-31,13550953,,7699183,,17530858,15304920,6324292,-22531581,-22531581,,-1336728,,,,-1640200,27645582,50177163,21321290,30230764,,9339383,17530858,53444,NEPT
2017-03-31,4468151,,2984748,11052812.0,6381442,15748480,11817058,-8399572,-8399572,,-2551744,,,,2172580,43216049,51615622,31398991,11384321,,812168,6381442,53444,NEPT
2019-12-31,,,-3283000,,-10887000,5290000,1633000,-3657000,-3657000,,-1855000,,,,0,6998000,10655000,5365000,374000,-7604000,-3283000,-11441000,53445,PSTV
2018-12-31,,,-8878000,,-12634000,6222000,-2540000,-8762000,-8762000,,-1922000,,,,0,2983000,11745000,5523000,-116000,-3756000,-8878000,-15121000,53445,PSTV
2017-12-31,,,-22686000,,-22686000,11187000,-6585000,-18997000,-18997000,,-2049000,,,,0,6411000,25408000,12996000,-3689000,-3756000,-22686000,-26663000,53445,PSTV
2016-12-31,,,-22046000,,-22046000,12174000,-6987000,-19706000,-19706000,,-2592000,,,,0,11380000,31086000,18367000,-2340000,-3756000,-22046000,-22046000,53445,PSTV
2019-12-31,,,8615000,1384000,-3367000,44761000,106249000,47504000,47504000,1451000,-11953000,,,,12086000,149387000,101883000,43138000,-38889000,,-3471000,-3367000,53449,HMTV
2018-12-31,,,-526000,1488000,-10906000,44499000,105905000,44217000,44217000,1108000,-12132000,,,,10271000,147079000,102862000,41174000,-44743000,,-10797000,-10906000,53449,HMTV
2017-12-31,,,5270000,1488000,-13436000,39437000,84499000,26733000,26733000,2101000,-10905000,,,,18706000,124464000,97731000,39965000,-21463000,,-13436000,-13436000,53449,HMTV
2016-12-31,,,28372000,1488000,18000000,38333000,97232000,40029000,40029000,2262000,-11651000,,,,10372000,138525000,98496000,41293000,-11657000,,18000000,18000000,53449,HMTV
2019-12-31,1127000,,-7837000,,-7852000,17191000,10830000,-7488000,-7488000,,,,,,14000,30467000,37955000,19637000,-349000,-1000,-7851000,-7852000,53450,FTEK
2018-12-31,1073000,,118000,,-28000,18564000,20064000,427000,427000,,,,,,33000,56535000,56108000,36471000,-309000,-113000,85000,-28000,53450,FTEK
2017-12-31,1070000,,-7115000,,-10449000,20933000,18022000,-3981000,-3981000,,,,,,-580000,45166000,49147000,27144000,-3134000,-3914000,-6535000,-10449000,53450,FTEK
2016-12-31,1752000,,-12924000,,-17388000,25564000,18794000,-8522000,-8522000,,,,,,1664000,55161000,63683000,36367000,-4402000,-2800000,-14588000,-17388000,53450,FTEK
2020-12-31,,,30341000,,25176000,3739000,56894000,30341000,30341000,16246000,,,,,5165000,144956000,114615000,88062000,0,,25176000,25176000,53451,CASS
2019-12-31,,,37466000,,30404000,7756000,71345000,42659000,42659000,14227000,-5193000.0,,,,7062000,162678000,120019000,91333000,-5193000,,30404000,30404000,53451,CASS
2018-12-31,,,36347000,,30268000,7067000,66121000,40083000,40083000,12919000,-3736000.0,,,,6079000,152002000,111919000,85881000,-20441000,,30268000,30268000,53451,CASS
2017-12-31,,,34899000,,25014000,6037000,60150000,37086000,37086000,11529000,-2187000.0,,,,9885000,137489000,100403000,77339000,-2187000,,25014000,25014000,53451,CASS
2019-12-31,,,-113542000,,-161354000,27220000,-63611000,-90831000,-90831000,,,,,,0,4227000,95058000,67838000,-22711000,-47812000,-113542000,-161354000,53454,ACRS
2018-12-31,,,-82104000,,-132738000,25761000,-57747000,-83508000,-83508000,,,,,,0,6151000,89659000,63898000,1404000,-50634000,-82104000,-132738000,53454,ACRS
2017-12-31,,,-52291000,,-68523000,18527000,-35328000,-53855000,-53855000,,,,,,-1830000,1683000,55538000,37011000,1564000,-18062000,-50461000,-68523000,53454,ACRS
2016-12-31,33260000.0,,-48079000,,-48079000,15091000,0,-48351000,-48351000,,,,,,0,0,48351000,0,272000,-18062000,-48079000,-48079000,53454,ACRS
2020-06-30,,,4807000,,3850000,10758000,17190000,0,4856000,1576000,,,,,957000,17190000,12334000,0,-49000,,3850000,3850000,53455,HFBL
2019-06-30,,,6026000,,4743000,9483000,17099000,0,6114000,1502000,,,,,1283000,17099000,10985000,0,-88000,,4743000,4743000,53455,HFBL
2018-06-30,,,5820000,,3568000,9503000,16866000,0,5945000,1418000,,,,,2252000,16866000,10921000,0,-125000,,3568000,3568000,53455,HFBL
2017-06-30,,,5410000,,3652000,10180000,17082000,0,5552000,1350000,,,,,1758000,17082000,11530000,0,-142000,,3652000,3652000,53455,HFBL
2020-02-01,,,172733000,,141130000,357089000,555589000,170826000,170826000,,,,,,31603000,1408199000,1237373000,852610000,1907000,,141130000,141130000,53458,OLLI
2019-02-02,,,160643000,,135013000,312790000,497651000,162054000,162054000,,-1261000.0,,,,25630000,1241377000,1079323000,743726000,-1411000,,135013000,135013000,53458,OLLI
2018-02-03,,,130487000,,127594000,278174000,431647000,135756000,135756000,,-4471000.0,,,,2893000,1077032000,941276000,645385000,-5269000,,127594000,127594000,53458,OLLI
2017-01-28,,,96259000,,59764000,242891000,360411000,102194000,102194000,,-5935000.0,,,,36495000,890315000,788121000,529904000,-5935000,,59764000,59764000,53458,OLLI
2019-12-31,,,155158000,,117216000,32811000,5409000,-29277000,-29277000,,-25166000,,,,37942000,14859000,44136000,9450000,184435000,,117216000,117216000,53459,LBRDK
2018-12-31,,,91877000,,69953000,23497000,14262000,-12014000,-12014000,,-23302000,,,,21924000,22256000,34270000,7994000,103891000,,69953000,69953000,53459,LBRDK
2017-12-31,,,2450600000,,2033667000,24065000,2357000,-25478000,-25478000,,-19570000,,,,416933000,13092000,38570000,10735000,2476078000,,2033667000,2033667000,53459,LBRDK
2016-12-31,10240000.0,,1475672000,,917303000,34703000,27788000,-21160000,-21160000,,-14956000,,,,558369000,30586000,51746000,2798000,1496832000,,917303000,917303000,53459,LBRDK
2020-12-31,,,195200000,,126600000,1801600000,2249300000,447700000,447700000,,-198300000,,,,68600000,4583700000,4136000000,2334400000,-252500000,,126600000,126600000,53460,MAT
2019-12-31,,,-158288000,,-213512000,1880450000,1999358000,118908000,118908000,,-201044000,,,,55224000,4504571000,4385663000,2505213000,-277196000,,-213512000,-213512000,53460,MAT
2018-12-31,,,-417103000,,-533299000,1939120000,1804424000,-134696000,-134696000,,-181886000,,,,116196000,4514810000,4649506000,2710386000,-282407000,,-533299000,-533299000,53460,MAT
2017-12-31,,,-501245000,,-1054579000,2168912000,1824571000,-344341000,-344341000,,-105214000,,,,553334000,4881493000,5225834000,3056922000,-156904000,,-1054579000,-1054579000,53460,MAT
2019-12-31,54724000,,-45488000,,-45515000,120928000,151596000,-24056000,-24056000,,-23524000,,,,27000,295686000,319742000,144090000,-21432000,,-45515000,-45515000,53462,BNFT
2018-12-31,47902000,,-52599000,,-52627000,121241000,129444000,-39699000,-39699000,,-13156000,,,,28000,258721000,298420000,129277000,-12900000,,-52627000,-52627000,53462,BNFT
2017-12-31,49549000,,-50279000,,-50294000,97851000,109460000,-37940000,-37940000,,-12381000,,,,15000,236842000,274782000,127382000,-12339000,,-50294000,-50294000,53462,BNFT
2016-12-31,56610000,,-40329000,,-40346000,89061000,113215000,-32456000,-32456000,,-7921000,,,,17000,236523000,268979000,123308000,-7873000,,-40346000,-40346000,53462,BNFT
2019-12-31,,,7139000,,3341000,92460000,112584000,13416000,13416000,,-6267000,,,,3798000,265763000,252347000,153179000,-6277000,,3341000,3341000,53466,III
2018-12-31,,,6112000,,5677000,94787000,115848000,13290000,13290000,,-6688000,,,,435000,275769000,262479000,159921000,-7178000,,5677000,5677000,53466,III
2017-12-31,,,2100000,,-2130000,89810000,112924000,10393000,10393000,,-6821000,,,,4198000,269554000,259161000,156630000,-8293000,,-2098000,-2130000,53466,III
2016-12-31,,,-5324000,1376000.0,-6505000,72563000,84140000,3708000,3708000,,-2664000,,,,1054000,216499000,212791000,132359000,-9032000,,-6378000,-6505000,53466,III
2019-12-31,647140,,-284428,,-284428,3729880,4870764,493744,493744,,-53227,,,,0,7436264,6942520,2565500,-778172,,-284428,-284428,53468,MEDS
2018-12-31,949948,,9038,,9038,2520397,3382729,-87616,-87616,,-57541,,,,0,3831778,3919394,449049,96654,,9038,9038,53468,MEDS
2017-12-31,949948,,288983,,288983,2536185,2931280,395095,395095,,-157056,,,,0,2931280,2536185,0,-106112,,288983,288983,53468,MEDS
2016-12-31,949948,,-1173108,,-2760125,3489145,2481866,-1007279,-1007279,,-151500,,,,0,2481866,3489145,0,-165829,-1587017.0,-1173108,-2760125,53468,MEDS
2019-12-31,,,-5755000,67340000,-3669000,26431000,170033000,47073000,47073000,,-52205000,,,,92000,530651000,483578000,360618000,-52828000,,-5847000,-28824000,53469,HT
2018-12-31,,,8632000,64718000,9990000,26881000,157876000,41164000,41164000,,-48491000,,,,267000,496147000,454983000,338271000,-32532000,,8365000,-14924000,53469,HT
2017-12-31,,,110202000,54286000,99868000,23553000,164954000,57649000,57649000,,-42662000,,,,5262000,495764000,438115000,330810000,52553000,,104940000,75358000,53469,HT
2016-12-31,,,116569000,44321000,116980000,24444000,166093000,66259000,66259000,,-44352000,,,,-4888000,464806000,398547000,298713000,50310000,,121457000,95076000,53469,HT
2020-03-31,,,-4315592,-1331340,-8673325,5567939,3375337,-5596938,-5596938,,-470031,,,,33184,15655575,21252513,12280238,1281346,-5587027,-4348776,-8673325,53470,AIHS
2019-03-31,,,-1133870,7344,-4549869,1776690,738920,-1042847,-1042847,,-33878,,,,21905,2551107,3593954,1812187,-91023,-3386750,-1155775,-4549869,53470,AIHS
2018-03-31,,,-9858972,7344,-9858972,1517804,494897,-1682465,-1682465,,-33878,,,,0,494897,2177362,0,-8176507,-3386750,-9858972,-9858972,53470,AIHS
2017-03-31,,,-509769,7344,-587882,252609,73237,-504082,-504082,,-33878,,,,0,73237,577319,0,-5687,-86876,-509769,-587882,53470,AIHS
2020-12-31,,,972000000,,817000000,2507000000,3767000000,0,1045000000,215000000,,,,,155000000,3767000000,2722000000,0,-73000000,,817000000,717000000,53473,HBAN
2019-12-31,,,1659000000,,1411000000,2413000000,4390000000,0,1756000000,221000000,,,,,248000000,4390000000,2634000000,0,-97000000,,1411000000,1337000000,53473,HBAN
2018-12-31,,,1628000000,,1393000000,2286000000,4273000000,0,1766000000,221000000,,,,,235000000,4273000000,2507000000,0,-138000000,,1393000000,1323000000,53473,HBAN
2017-12-31,,,1394000000,,1186000000,2204000000,4108000000,0,1682000000,222000000,,,,,208000000,4108000000,2426000000,0,-288000000,,1186000000,1110000000,53473,HBAN
2019-12-31,37046000,,-43755000,,-43755000,8605000,0,-45651000,-45651000,,,,,,0,0,45651000,0,1896000,,-43755000,-43755000,53475,AKRO
2018-12-31,11882000,,-81714000,,-81714000,1896000,0,-13778000,-13778000,,,,,,0,0,13778000,0,-67936000,,-81714000,-82234000,53475,AKRO
2017-12-31,3802909,,-4978909,,-4978909,1176000,0,-4978909,-4978909,,,,,,0,0,4978909,0,0,,-4978909,-5211272,53475,AKRO
2019-12-31,,,-215880000,372609000,-146626000,216511000,387623000,36388000,36388000,21740000,-95441000,,,,-56873000,2332306000,2295918000,1944683000,-252268000,,-159007000,-146626000,53476,NEXA
2018-12-31,,,131899000,425208000,74860000,159603000,602258000,351043000,351043000,-34666000,-89704000,,,,40923000,2491202000,2140159000,1888944000,-219144000,,90976000,74860000,53476,NEXA
2017-12-31,,,271459000,422068000,126885000,154494000,696659000,397428000,397428000,52039000,-74096000,,,,106194000,2449484000,2052056000,1752825000,-125969000,,165265000,126885000,53476,NEXA
2016-12-31,,,208892000,476344000,93167000,144213000,460612000,144465000,144465000,125223000,-36059000,,,,98383000,1964841000,1820376000,1504229000,64427000,,110509000,93167000,53476,NEXA
2019-12-31,,,206239000,8572000,183487000,27931000,247326000,100985000,100985000,300000,-46584000,,,,22028000,938091000,837106000,690765000,105254000,,184211000,183355000,53478,DRH
2018-12-31,,,90897000,7696000,87784000,27472000,250745000,118449000,118449000,300000,-40970000,,,,3101000,863704000,745255000,612959000,-27552000,,87796000,87784000,53478,DRH
2017-12-31,,,102084000,7696000,91877000,26511000,264742000,138941000,138941000,200000,-38481000,,,,10207000,870005000,731064000,605263000,-36857000,,91877000,91877000,53478,DRH
2016-12-31,,,127195000,7696000,114796000,23792000,278543000,156907000,156907000,400000,-41735000,,,,12399000,896558000,739651000,618015000,-29712000,,114796000,114796000,53478,DRH
2020-12-31,,,4674000000,,3367000000,10052000000,15527000000,4986000000,4986000000,,-283000000,,,,1307000000,77155000000,72169000000,61628000000,-312000000,,3367000000,3367000000,53479,HUM
2019-12-31,,,3470000000,,2707000000,7334000000,11031000000,3239000000,3239000000,,-242000000,,,,763000000,64888000000,61649000000,53857000000,231000000,,2707000000,2707000000,53479,HUM
2018-12-31,,,2074000000,,1683000000,7525000000,11030000000,3112000000,3112000000,,-218000000,,,,391000000,56912000000,53800000000,45882000000,-1038000000,,1683000000,1683000000,53479,HUM
2017-12-31,,,4020000000,,2448000000,6419000000,10271000000,3474000000,3474000000,,-242000000,,,,1572000000,53767000000,50293000000,43496000000,546000000,,2448000000,2448000000,53479,HUM
2020-12-31,,,508400000,1209100000,202200000,321400000,1143800000,610000000,610000000,52800000,-92300000,,,,81400000,2027500000,1417500000,883700000,-101600000,,427000000,202200000,53483,AMG
2019-12-31,,,308000000,1478300000,15700000,376800000,1296600000,697000000,697000000,57000000,-76200000,,,,2900000,2239600000,1542600000,943000000,-389000000,,305100000,15700000,53483,AMG
2018-12-31,,,713600000,1511200000,243600000,417700000,1391200000,767000000,767000000,69700000,-80600000,,,,181300000,2378400000,1611400000,987200000,-53400000,,532300000,243600000,53483,AMG
2017-12-31,,,1067100000,1568200000,689500000,373100000,1326000000,788200000,788200000,58000000,-87800000,,,,58400000,2305000000,1516800000,979000000,308100000,,1008700000,689500000,53483,AMG
2020-01-31,53513000,,48035000,,36997000,75017000,240070000,56055000,56055000,,-4416000,,,,11038000,325791000,269736000,85721000,-8020000,,36997000,36997000,53484,DSGX
2019-01-31,47872000,,39510000,,31277000,66885000,200177000,45241000,45241000,,-2128000,,,,8233000,275171000,229930000,74994000,-5731000,,31277000,31277000,53484,DSGX
2018-01-31,41804000,,34748000,,26879000,58576000,173735000,39878000,39878000,,-1297000,,,,7869000,237439000,197561000,63704000,-5130000,,26879000,26879000,53484,DSGX
2017-01-31,35556000,,31500000,,23838000,48020000,147728000,34151000,34151000,,-611000,,,,7662000,203779000,169628000,56051000,-2651000,,23838000,23838000,53484,DSGX
2019-12-31,,,-33157166,,-32511300,19727223,8150055,-16868275,-16868275,,-13844961,,,,-645866,15577166,32445441,7427111,-16288891,,-32511300,-32511300,53485,PTPI
2018-12-31,,,-32486073,,-32472708,11261842,11635418,-7691418,-7691418,,-11856847,,,,-13365,14051243,21742661,2415825,-24794655,,-32472708,-32472708,53485,PTPI
2020-12-31,,,707600000,,543600000,2364500000,3184500000,704500000,704500000,,-165900000,,,,162700000,20443900000,19739400000,17259400000,3100000,400000,544900000,543600000,53488,PAG
2019-12-31,,,591500000,18200000.0,435800000,2693200000,3455500000,652700000,652700000,,-208700000,,,,156700000,23179400000,22526700000,19723900000,-61200000,300000,434800000,435800000,53488,PAG
2018-12-31,,,604100000,25600000.0,471000000,2646300000,3414900000,664900000,664900000,,-195600000,,,,134300000,22785100000,22120200000,19370200000,-60800000,500000,469800000,471000000,53488,PAG
2017-12-31,,,548200000,32800000.0,613300000,2516000000,3222500000,611400000,611400000,,-170800000,,,,-64800000,21386900000,20775500000,18164400000,-63200000,-200000,613000000,613300000,53488,PAG
2019-12-31,,,618905,,226255,15504564,17377965,885255,885255,,-310582,,,,392650,101720247,100834992,84342282,-266350,,226255,226255,53491,WYY
2018-12-31,,,-263150,,-1456476,15044745,15269677,-190405,-190405,,-79540,,,,1193326,83678896,83869301,68409219,-72745,,-1456476,-1456476,53491,WYY
2017-12-31,219141.0,,-3495970,,-3533937,15395573,13690059,-2262969,-2262969,,-52158,,,,37967,75884246,78147215,62194187,-1233001,,-3533937,-3533937,53491,WYY
2016-12-31,699013.0,,-4207358,,-4133912,17116078,14010396,-4163254,-4163254,,-72231,,,,-73446,78420864,82584118,64410468,-44104,,-4133912,-4133912,53491,WYY
2019-12-31,,,-44004000,,-48066000,9980000,14134000,-39701000,-39701000,208000,-394000,,,,4062000,121724000,161425000,107590000,-4303000,,-48066000,-48066000,53492,EXK
2018-12-31,,,-17711000,,-12439000,8626000,41270000,-18495000,-18495000,150000,-394000,,,,-5272000,150509000,169004000,109239000,784000,,-12439000,-12439000,53492,EXK
2017-12-31,,,7887000,,9684000,7914000,45061000,7581000,7581000,86000,-629000,,,,-1797000,150499000,142918000,105438000,306000,,9684000,9684000,53492,EXK
2016-12-31,,,12319000,,3910000,9284000,52845000,19147000,19147000,84000,-1088000,,,,8409000,156767000,137620000,103922000,-6828000,,3910000,3910000,53492,EXK
2019-12-31,37975000,,-46672000,,-46672000,10879000,0,-48854000,-48854000,,,,,,0,0,48854000,0,2182000,,-46672000,-46672000,53494,CRVS
2018-12-31,38586000,,-46939000,,-46939000,10636000,0,-49222000,-49222000,,,,,,0,0,49222000,0,2283000,,-46939000,-46939000,53494,CRVS
2017-12-31,46305000,,-55663000,,-55663000,10219000,0,-56524000,-56524000,,,,,,0,0,56524000,0,861000,,-55663000,-55663000,53494,CRVS
2016-12-31,29356000,,-36375000,,-36375000,7620000,0,-36976000,-36976000,,,,,,0,0,36976000,0,601000,,-36375000,-36375000,53494,CRVS
2020-10-31,,,-125075281,,-125075281,9893372,60986681,51093309,51093309,,-9110112,,,,0,60986681,9893372,0,-176168590,,-125075281,-125075281,53496,HTD
2019-10-31,,,161600164,,161600164,10608421,65013456,54405035,54405035,,-18323558,,,,0,65013456,10608421,0,107195129,,161600164,161600164,53496,HTD
2018-10-31,,,3440571,,3440571,10488063,68305081,57817018,57817018,,-6743383,,,,0,68305081,10488063,0,-54376447,,3440571,3440571,53496,HTD
2017-10-31,,,90773409,,90773409,10899719,76450555,65550836,65550836,,-7158598,,,,0,76450555,10899719,0,25222573,,90773409,90773409,53496,HTD
2020-08-31,,,457634,,457634,413273,1533776,1120503,1120503,,-232034,,,,0,1533776,413273,0,-662869,,457634,457634,53499,BHV
2019-08-31,,,2124628,,2124628,436811,1685522,1248711,1248711,,-318259,,,,0,1685522,436811,0,875917,,2124628,2124628,53499,BHV
2018-08-31,,,-11390,,-11390,416868,1771664,1354796,1354796,,-250133,,,,0,1771664,416868,0,-1366186,,-11390,-11390,53499,BHV
2017-08-31,,,-91831,,-91831,405790,1813183,1407393,1407393,,-160740,,,,0,1813183,405790,0,-1499224,,-91831,-91831,53499,BHV
2020-07-31,,,-1261005,,-906005,5085360,5507223,-1239417,-1239417,,-202521,,,,-355000,19531846,20771263,14024623,-21588,,-906005,-906005,53500,MAYS
2019-07-31,,,2104801,,1514801,4833489,9247223,2452740,2452740,,-200588,,,,590000,21139795,18687055,11892572,-347939,,1514801,1514801,53500,MAYS
2018-07-31,,,1730141,,2974141,4598144,8226486,1852652,1852652,,-233474,,,,-1244000,19300882,17448230,11074396,-122511,,2974141,2974141,53500,MAYS
2017-07-31,,,2906539,,1925539,4616086,9477758,3178982,3178982,,-225938,,,,981000,19549387,16370405,10071629,-272443,,1925539,1925539,53500,MAYS
2020-02-01,,,20559000,30049000,16047000,249274000,280075000,31899000,31899000,-1098000,,,,,5315000,495212000,463313000,215137000,-11340000,,15244000,16047000,53501,VRA
2019-02-02,,,28226000,30049000,20757000,211840000,238587000,27245000,27245000,-498000,,,,,7469000,416097000,388852000,177510000,981000,,20757000,20757000,53501,VRA
2018-02-03,,,15394000,30049000,7016000,221605000,255143000,34320000,34320000,-782000,,,,,8378000,454648000,420328000,199505000,-18926000,,7016000,7016000,53501,VRA
2017-01-28,,,28042000,30049000,19758000,235496000,276046000,41879000,41879000,-1329000,-178000.0,,,,8284000,485937000,444058000,209891000,-13837000,,19758000,19758000,53501,VRA
2019-12-31,,,8090960,,8090960,1834484,9925444,8090960,8090960,,,,,,0,9925444,1834484,0,0,,8090960,8090960,53504,SJT
2018-12-31,,,17975968,,17975968,1491298,19467266,17975968,17975968,,,,,,0,19467266,1491298,0,0,,17975968,17975968,53504,SJT
2017-12-31,,,39130256,,39130256,1607011,33237267,31630256,31630256,,,,,,0,33237267,1607011,0,7500000,,39130256,39130256,53504,SJT
2016-12-31,,,13929035,,13929035,3133722,17526444,14392722,14392722,,,,,,0,17526444,3133722,0,-463687,,13929035,13929035,53504,SJT
2020-05-31,,,-8246086,,-8246086,4427482,25845204,21417722,21417722,,-3852722,,,,0,25845204,4427482,0,-29663808,,-8246086,-8246086,53505,FCT
2019-05-31,,,10144454,,10144454,4575637,29003546,24427909,24427909,,-4739046,,,,0,29003546,4575637,0,-14283455,,10144454,10144454,53505,FCT
2018-05-31,,,14060681,,14060681,4748323,26778785,22030462,22030462,,-3415428,,,,0,26778785,4748323,0,-7969781,,14060681,14060681,53505,FCT
2017-05-31,,,28672073,,28672073,5052825,28558375,23505550,23505550,,-2767008,,,,0,28558375,5052825,0,5166523,,28672073,28672073,53505,FCT
2019-12-31,57943000,,-72131000,,-72131000,19781000,0,-77724000,-77724000,,,,,,0,0,77724000,0,5593000,,-72131000,-72131000,53508,TPTX
2018-12-31,21062000,,-24785000,,-24785000,4578000,0,-25640000,-25640000,,,,,,1000,0,25640000,0,1711000,,-24785000,-24785000,53508,TPTX
2017-12-31,15241000,,-16593000,,-16593000,1488000,0,-16729000,-16729000,,,,,,1000,0,16729000,0,272000,,-16593000,-16593000,53508,TPTX
2020-02-29,,,35779135,,35779135,2837394,17301518,14464124,14464124,,-2768191,,,,0,17301518,2837394,0,21315011,,35779135,35779135,53509,DMB
2019-02-28,,,7792816,,7792816,2769249,17697065,14927816,14927816,,-2802025,,,,0,17697065,2769249,0,-7135000,,7792816,7792816,53509,DMB
2018-02-28,,,16768265,,16768265,2793838,17874780,15080942,15080942,,-2434250,,,,0,17874780,2793838,0,1687323,,16768265,16768265,53509,DMB
2017-02-28,,,6474893,,6474893,2878282,17349836,14471554,14471554,,-1956319,,,,0,17349836,2878282,0,-7996661,,6474893,6474893,53509,DMB
2020-12-31,,,732192000,,528359000,600312000,1346246000,0,745934000,,,,,,203833000,1346246000,600312000,0,-13742000,,528359000,528359000,53510,SBNYP
2019-12-31,,,787636000,,588926000,516837000,1316905000,0,800068000,,,,,,198710000,1316905000,516837000,0,-12432000,,588926000,587013000,53510,SBNYP
2018-12-31,,,673463000,,505342000,461022000,1159741000,0,698719000,,,,,,168121000,1159741000,461022000,0,-25256000,,505342000,504428000,53510,SBNYP
2017-12-31,,,575264000,,387209000,408070000,1010330000,0,602260000,,,,,,188055000,1010330000,408070000,0,-26996000,,387209000,387209000,53510,SBNYP
2019-12-31,,,199645000,,144137000,1093074000,1521017000,334774000,334774000,,-101472000,,,,55108000,10454343000,10119569000,8933326000,-135129000,-400000,144537000,144137000,53511,SAH
2018-12-31,,,75312000,,51650000,1139725000,1446125000,212777000,212777000,,-102457000,,,,22922000,9951630000,9738853000,8505505000,-137465000,-740000,52390000,51650000,53511,SAH
2017-12-31,,,108124000,,92983000,1147773000,1457676000,220959000,220959000,,-88919000,,,,13971000,9867208000,9646249000,8409532000,-112835000,-1170000,94153000,92983000,53511,SAH
2016-12-31,,,155212000,,93193000,1122656000,1429274000,229172000,229172000,,-77822000,,,,60696000,9731779000,9502607000,8302505000,-73960000,-1323000,94516000,93141000,53511,SAH
2020-02-29,,,1402332,,1033832,5387621,9961026,3678010,3678010,,-19016,,,,368500,31849796,28171786,21888770,-2275678,,1033832,1033832,53513,RMCF
2019-02-28,,,2955661,,2238799,5643418,10030224,3232933,3232933,,-70787,,,,716862,34545447,31312514,24515223,-277272,,2238799,2238799,53513,RMCF
2018-02-28,,,5124203,,2963908,6394043,12411133,5220869,5220869,,-121244,,,,2160295,38074695,32853826,25663562,-96666,,2963908,2963908,53513,RMCF
2017-02-28,,,5395705,,3450116,6663563,13089105,5584484,5584484,,-170351,,,,1945589,38296377,32711893,25207272,-188779,,3450116,3450116,53513,RMCF
2019-12-31,14026000,,-37175000,,-37175000,23872000,16113000,-21785000,-21785000,,-1474000,,,,0,29373000,51158000,13260000,-15390000,,-37175000,-37175000,53515,MBII
2018-12-31,10662000,,-20213000,,-20213000,19155000,10313000,-19504000,-19504000,,-2508000,,,,0,21220000,40724000,10907000,-709000,,-20213000,-20213000,53515,MBII
2017-12-31,10820000,,-30925000,,-30925000,19445000,7639000,-22626000,-22626000,,-7729000,,,,0,18167000,40793000,10528000,-8299000,,-30925000,-30925000,53515,MBII
2016-12-31,9670000,,-31071000,,-31071000,19210000,4520000,-24360000,-24360000,,-7302000,,,,0,14042000,38402000,9522000,-6711000,,-31071000,-31071000,53515,MBII
2020-01-31,,,163425058,,163425058,12633973,35502439,22868466,22868466,,,,,,0,35502439,12633973,0,140556592,,163425058,163425058,53516,NFJ
2019-01-31,,,-85552217,,-85552217,12850511,38243698,25393187,25393187,,,,,,0,38243698,12850511,0,-110945404,,-85552217,-85552217,53516,NFJ
2018-01-31,,,164121380,,164121380,13396017,41504570,28108553,28108553,,,,,,0,41504570,13396017,0,136012827,,164121380,164121380,53516,NFJ
2017-01-31,,,220558928,,220558928,13146754,46475641,33328887,33328887,,,,,,0,46475641,13146754,0,187230041,,220558928,220558928,53516,NFJ
2020-12-31,,,-1331200000,,-1392400000,244200000,-810000000,-1617200000,-1617200000,,-258200000,,,,2100000,15115900000,16733100000,15925900000,286000000,,-1333300000,-1392500000,53517,PBF
2019-12-31,,,479500000,545900000.0,319400000,272600000,1088200000,379500000,379500000,,-159600000,,,,104300000,24508200000,24128700000,23420000000,100000000,,375200000,318900000,53517,PBF
2018-12-31,,,208800000,572000000.0,128300000,273000000,1365300000,722600000,722600000,,-169900000,,,,33500000,27186100000,26463500000,25820800000,-513800000,,175300000,127600000,53517,PBF
2017-12-31,,,799000000,566295000.0,415600000,214900000,943100000,437200000,437200000,,-154400000,,,,315600000,21786600000,21349400000,20843500000,361800000,,483400000,414600000,53517,PBF
2018-05-31,,,23600843,,23600843,5823356,37370819,31547463,31547463,,-3351992,,,,0,37370819,5823356,0,-7946620,,23600843,23600843,53518,NID
2017-05-31,,,9595947,,9595947,5821161,38342105,32520944,32520944,,-2522246,,,,0,38342105,5821161,0,-22924997,,9595947,9595947,53518,NID
2016-05-31,,,54257983,,54257983,5851190,39939811,34088621,34088621,,-4096413,,,,0,39939811,5851190,0,20169362,,54257983,54257983,53518,NID
2015-05-31,,,33267834,,33267834,5838094,40439203,34601109,34601109,,-10788752,,,,0,40439203,5838094,0,-1333275,,33267834,33267834,53518,NID
2019-12-31,6269308,,-7359364,,-7359364,1535993,0,-7805301,-7805301,,-159,,,,0,0,7805301,0,445937,,-7359364,-7359364,53519,CELC
2018-12-31,6325995,,-7480815,,-7480815,1606543,0,-7932538,-7932538,,-111,,,,0,0,7932538,0,451723,,-7480815,-7480815,53519,CELC
2017-12-31,4928972,,-6251730,,-6251730,1023973,0,-5952945,-5952945,,-451664,,,,0,0,5952945,0,-298785,,-6251730,-6251730,53519,CELC
2016-12-31,3015130,,-3310408,,-3310408,313296,0,-3328426,-3328426,,-451664,,,,0,0,3328426,0,18018,,-3310408,-3310408,53519,CELC
2020-12-31,,,308404000,,279380000,,308404000,308404000,308404000,,,,,,29024000,308404000,0,0,0,,279380000,279380000,53520,AB
2019-12-31,,,266292000,,238563000,,266292000,266292000,266292000,,,,,,27729000,266292000,0,0,0,,238563000,238563000,53520,AB
2018-12-31,,,270647000,,242397000,,270647000,270647000,270647000,,,,,,28250000,270647000,0,0,0,,242397000,242397000,53520,AB
2017-12-31,,,232393000,,207422000,,232393000,232393000,232393000,,,,,,24971000,232393000,0,0,0,,207422000,207422000,53520,AB
2019-12-31,,,104659977,,104659977,4819100,8783760,3964660,3964660,,,,,,0,8783760,4819100,0,100695317,,104659977,104659977,53523,CRF
2018-12-31,,,-33773233,,-33773233,4180404,7233587,3053183,3053183,,,,,,0,7233587,4180404,0,-36826416,,-33773233,-33773233,53523,CRF
2017-12-31,,,44342261,,44342261,2575163,4664732,2089569,2089569,,,,,,0,4664732,2575163,0,42252692,,44342261,44342261,53523,CRF
2016-12-31,,,10035775,,10035775,1560596,2895251,1334655,1334655,,,,,,0,2895251,1560596,0,8701120,,10035775,10035775,53523,CRF
2020-12-31,,,70265000,,59504000,85017000,189504000,0,71321000,33166000,,,,,10761000,189504000,118183000,0,-1056000,,59504000,59504000,53525,CTBI
2019-12-31,,,71992000,,64540000,88728000,186828000,0,78790000,19310000,,,,,7452000,186828000,108038000,0,-6798000,,64540000,64540000,53525,CTBI
2018-12-31,,,70542000,,59228000,86012000,185413000,0,77286000,22115000,,,,,11314000,185413000,108127000,0,-6744000,,59228000,59228000,53525,CTBI
2017-12-31,,,68511000,,51493000,83430000,175970000,0,75161000,17379000,,,,,17018000,175970000,100809000,0,-6650000,,51493000,51493000,53525,CTBI
2019-12-31,25033000,,-48518000,,-48692000,193823000,171083000,-49829000,-49829000,,,,,,174000,205225000,255054000,34142000,1311000,,-48692000,-48692000,53526,POSH
2018-12-31,15484000,,-14384000,,-14475000,124202000,125468000,-15020000,-15020000,,,,,,91000,148305000,163325000,22837000,636000,,-14475000,-14475000,53526,POSH
2020-02-01,,,245278000,,191257000,1029412000,1522301000,318139000,318139000,,,,,,54021000,4308212000,3990073000,2785911000,-72861000,,191257000,191257000,53528,AEO
2019-02-02,,,345100000,,261902000,980610000,1487638000,340697000,340697000,,,,,,83198000,4035720000,3695023000,2548082000,4403000,,261902000,261902000,53528,AEO
2018-02-03,,,287173000,,204163000,879685000,1372174000,331068000,331068000,,,,,,83010000,3795549000,3464481000,2423375000,-43895000,,204163000,204163000,53528,AEO
2017-01-28,,,335262000,,212449000,857562000,1366927000,354142000,354142000,,,,,,122813000,3609865000,3255723000,2242938000,-18880000,,212449000,212449000,53528,AEO
2020-09-30,,,-107700000,,-80900000,1256900000,1699200000,193800000,193800000,,-126900000,,,,-26800000,6943900000,6750100000,5244700000,-301500000,,-80900000,-104900000,53529,BECN
2019-09-30,,,-10800000,,-10600000,1281800000,1736600000,177000000,177000000,,-148100000,,,,-200000,7105200000,6928200000,5368600000,-187800000,,-10600000,-34600000,53529,BECN
2018-09-30,,,68100000,,98600000,1132800000,1593300000,259000000,259000000,,-118300000,,,,-30500000,6418300000,6159300000,4825000000,-190900000,,98600000,72900000,53529,BECN
2017-09-30,,,163345000,,100864000,727631000,1075939000,231841000,231841000,,-53802000,,,,62481000,4376670000,4144829000,3300731000,-68496000,,100864000,100864000,53529,BECN
2020-12-31,,,-266489000,,-266489000,114082000,-157108000,-271190000,-271190000,,,,,,0,42087000,313277000,199195000,4701000,,-266489000,-266489000,53530,DCPH
2019-12-31,,,-192256000,,-192256000,65716000,-132610000,-198326000,-198326000,,-67000.0,,,,0,25000000,223326000,157610000,6070000,,-192256000,-192256000,53530,DCPH
2018-12-31,,,-99854000,,-99854000,21212000,-82887000,-104099000,-104099000,,-84000.0,,,,0,0,104099000,82887000,4245000,,-99854000,-99854000,53530,DCPH
2017-12-31,39514000.0,,-50284000,,-50284000,11421000,0,-50935000,-50935000,,-95000.0,,,,0,0,50935000,0,651000,,-50284000,-50284000,53530,DCPH
2020-02-02,,,444000000,-2000000,417300000,4643500000,5401300000,757800000,757800000,,-120000000,,,,28900000,9909000000,9151200000,4507700000,-313800000,,415100000,417300000,53531,PVH
2019-02-03,,,775600000,200000,746400000,4388400000,5310500000,922100000,922100000,,-120800000,,,,31000000,9656800000,8734700000,4346300000,-146500000,,744600000,746400000,53531,PVH
2018-02-04,,,510200000,2000000,537800000,4167300000,4894400000,727100000,727100000,,-128500000,,,,-25900000,8914800000,8187700000,4020400000,-216900000,,536100000,537800000,53531,PVH
2017-01-29,,,674200000,2000000,549000000,3596800000,4370300000,773500000,773500000,,-120900000,,,,125500000,8203100000,7429600000,3832800000,-99300000,,548700000,549000000,53531,PVH
2020-12-31,140727000,,386682000,28260000,338138000,302842000,900814000,457245000,457245000,,-64168000,,,,46183000,5050589000,4593344000,4149775000,-70563000,,340499000,338138000,53532,AMKR
2019-12-31,81736000,,159810000,26500000,120888000,336293000,649439000,231410000,231410000,,-71587000,,,,37182000,4052650000,3821240000,3403211000,-71600000,,122628000,120888000,53532,AMKR
2018-12-31,157182000,,185815000,25360000,127092000,294325000,710565000,259058000,259058000,,-78946000,,,,56250000,4316466000,4057408000,3605901000,-73243000,,129565000,127092000,53532,AMKR
2017-12-31,166627000,,307496000,23433000,263550000,296665000,761079000,297787000,297787000,,-85554000,,,,39791000,4207031000,3909244000,3445952000,9709000,,267705000,263550000,53532,AMKR
2020-02-02,,,23928000,-2166000,18921000,297550000,328149000,28108000,28108000,,-4471000,,,,5429000,615624000,587516000,287475000,-4180000,,18499000,18921000,53533,DLTH
2019-02-03,,,31615000,-239000,23156000,273221000,310402000,37181000,37181000,,-5949000,,,,8450000,568102000,530921000,257700000,-5566000,,23165000,23156000,53533,DLTH
2018-01-28,,,35505000,3279000,23351000,223947000,261019000,37072000,37072000,,-1988000,,,,11878000,471447000,434375000,210428000,-1567000,,23627000,23351000,53533,DLTH
2017-01-29,,,35054000,2609000,21315000,179145000,214146000,35001000,35001000,,-194000,,,,13525000,376116000,341115000,161970000,53000,,21529000,21315000,53533,DLTH
2019-12-31,,,199638000,8588000,158592000,560110000,939985000,379875000,379875000,,-156391000,,,,35326000,3974988000,3595113000,3035003000,-180237000,-1766000,164312000,158592000,53535,SABR
2018-12-31,,,398413000,7205000,337531000,501937000,1075542000,573605000,573605000,,-157017000,,,,57492000,3866956000,3293351000,2791414000,-175192000,1739000,340921000,337531000,53535,SABR
2017-12-31,,,377613000,5198000,242531000,534211000,1097231000,563020000,563020000,,-153925000,,,,128037000,3598484000,3035464000,2501253000,-185407000,-1932000,249576000,242531000,53535,SABR
2016-12-31,,,328035000,2579000,242562000,578753000,1098385000,519632000,519632000,,-158251000,,,,86645000,3373387000,2853755000,2275002000,-191597000,5549000,241390000,242562000,53535,SABR
2020-12-31,,,-455000000,785000000,-374000000,14256000000,16156000000,1900000000,1900000000,,-1570000000,,,,-81000000,49335000000,47435000000,33179000000,-2355000000,,-374000000,-374000000,53539,PRU
2019-12-31,,,5185000000,604000000,4186000000,13389000000,18404000000,5015000000,5015000000,,-1540000000,,,,947000000,64710000000,59695000000,46306000000,-1370000000,,4238000000,4140000000,53539,PRU
2018-12-31,,,4910000000,414000000,4074000000,11948000000,17072000000,5124000000,5124000000,,-1423000000,,,,822000000,63281000000,58157000000,46209000000,-1637000000,,4088000000,4026000000,53539,PRU
2017-12-31,,,6536000000,275000000,7863000000,11911000000,18515000000,6604000000,6604000000,,-1334000000,,,,-1438000000,59802000000,53198000000,41287000000,-1402000000,,7974000000,7768000000,53539,PRU
2020-12-31,119718000,,21586000,,20447000,208736000,352227000,20515000,20515000,,,,,,1139000,540522000,520007000,188295000,1071000,,20447000,20447000,53541,GLUU
2019-12-31,95127000,,9342000,,8871000,163514000,270269000,7241000,7241000,,-40000.0,,,,471000,411381000,404140000,141112000,2101000,,8871000,8871000,53541,GLUU
2018-12-31,94934000,,-12650000,,-13199000,145527000,237405000,-9475000,-9475000,,-235000.0,,,,549000,366561000,376036000,129156000,-3175000,,-13199000,-13199000,53541,GLUU
2017-12-31,87679000,,-98396000,,-97570000,142911000,156005000,-84916000,-84916000,,-130000.0,,,,-826000,286827000,371743000,130822000,-13480000,,-97570000,-97570000,53541,GLUU
2020-06-24,,,4900000,,24400000,136300000,408600000,110000000,110000000,,-59600000,,,,-19500000,3078500000,2968500000,2669900000,-105100000,,24400000,24400000,53542,EAT
2019-06-26,,,171800000,,154900000,149100000,522900000,226200000,226200000,,-61600000,,,,16900000,3217900000,2991700000,2695000000,-54400000,,154900000,154900000,53542,EAT
2018-06-27,,,170200000,,125900000,136000000,547600000,260200000,260200000,500000.0,-59000000,,,,44300000,3135400000,2875200000,2587800000,-90000000,,125900000,125900000,53542,EAT
2017-06-28,,,208500000,,150800000,132800000,568100000,278900000,278900000,500000.0,-49600000,,,,57700000,3150800000,2871900000,2582700000,-70400000,,150800000,150800000,53542,EAT
2019-12-31,,,-2400,,-2400,,0,0,,,,,,,0,0,0,0,-2400,,-2400,-2400,53543,IPV
2019-12-31,58287000,,692518000,161330000,533228000,438562000,1259478000,761729000,761729000,,-52866000,,,,88161000,3589427000,2827698000,2329949000,-69211000,,604357000,533228000,53546,ALB
2018-12-31,70054000,,883965000,173787000,693562000,409736000,1234756000,754966000,754966000,,-52405000,,,,144826000,3374950000,2619984000,2140194000,128999000,,739139000,693562000,53546,ALB
2017-12-31,78630000,,531285000,143147000,54850000,420022000,1145271000,646619000,646619000,,-62549000,,,,431817000,3071976000,2425357000,1926705000,-115334000,,99468000,54850000,53546,ALB
2016-12-31,79075000,,574901000,147542000,643675000,354604000,970306000,536627000,536627000,,-63260000,,,,96263000,2677203000,2140576000,1706897000,38274000,202131000.0,478638000,643675000,53546,ALB
2019-12-28,,,88644000,,67983000,850967000,1017806000,81639000,81639000,,-55000,,,,20661000,3543299000,3461660000,2525493000,7005000,,67983000,67983000,53548,WMK
2018-12-29,,,82136000,,62738000,795998000,965501000,85103000,85103000,,-288000,,,,19398000,3509270000,3424167000,2543769000,-2967000,,62738000,62738000,53548,WMK
2017-12-30,,,79023000,,98414000,789704000,943523000,76419000,76419000,,-288000,,,,-19391000,3466807000,3390388000,2523284000,2604000,,98414000,98414000,53548,WMK
2016-12-31,,,124661000,,87162000,720819000,889838000,99219000,99219000,,-288000,,,,37499000,3136720000,3037501000,2246882000,25442000,,87162000,87162000,53548,WMK
2020-10-31,,,90414573,,90414573,47758389,245135521,197377132,197377132,,-22323140,,,,0,245135521,47758389,0,-106962559,,90414573,90414573,53549,NVG
2019-10-31,,,506769234,,506769234,45177899,243105524,197927625,197927625,,-39720049,,,,0,243105524,45177899,0,308841609,,506769234,506769234,53549,NVG
2018-10-31,,,-14478888,,-14478888,43834830,242016801,198181971,198181971,,-28465796,,,,0,242016801,43834830,0,-212660859,,-14478888,-14478888,53549,NVG
2017-10-31,,,132686192,,132686192,43043740,236237886,193194146,193194146,,-17563843,,,,0,236237886,43043740,0,-60507954,,132686192,132686192,53549,NVG
2020-12-31,495000000,,1292000000,37000000,1102000000,2360000000,4733000000,1878000000,1878000000,,-153000000,,,,182000000,11673000000,9795000000,6940000000,-586000000,,1110000000,1102000000,53550,BAX
2019-12-31,542000000,,970000000,30000000,1001000000,2384000000,4916000000,1990000000,1990000000,,-111000000,,,,-41000000,11362000000,9372000000,6446000000,-1020000000,,1011000000,1001000000,53550,BAX
2018-12-31,618000000,,1617000000,22000000,1546000000,2401000000,4811000000,1801000000,1801000000,-9000000.0,-93000000,,,,65000000,11099000000,9298000000,6288000000,-184000000,-6000000.0,1552000000,1546000000,53550,BAX
2017-12-31,615000000,,1100000000,-8000000,602000000,2516000000,4585000000,1510000000,1510000000,-56000000.0,-85000000,,,,491000000,10584000000,9074000000,5999000000,-410000000,-7000000.0,609000000,602000000,53550,BAX
2019-12-31,,,-6951589,-2080199,-6497230,6302789,2062294,-6185631,-6185631,,-897694,,,,0,15126026,21311657,13063732,-765958,,-6951589,-6497230,53551,IMAC
2018-12-31,,,-3784873,-1625840,-3053743,3922461,1037129,-3551396,-3551396,,-153824,,,,0,6701071,10252467,5663942,-459329,,-3784873,-3053743,53551,IMAC
2017-12-31,,,-916532,-575994,-57181,585607,-244818,-915067,-915067,,-27151,,,,0,786025,1701092,1030843,-1465,,-916532,-57181,53551,IMAC
2016-12-31,,,-397440,283357,-380797,46192,-22855,-219047,-219047,,-27151,,,,0,15000,234047,37855,-178393,,-397440,-380797,53551,IMAC
2019-12-29,,,-5207000,,-5995000,26754000,37021000,10267000,10267000,,-10562000,,,,788000,372511000,362244000,335490000,-15474000,,-5995000,-5995000,53553,SMTX
2018-12-30,,,229000,,-448000,16386000,21661000,5275000,5275000,,-3117000,,,,677000,216131000,210856000,194470000,-5046000,,-448000,-448000,53553,SMTX
2017-12-31,,,-7285000,,-7845000,13960000,10851000,-3109000,-3109000,,-903000,,,,560000,139231000,142340000,128380000,-4176000,,-7845000,-7845000,53553,SMTX
2017-01-01,,,55000,,-232000,14013000,15027000,1014000,1014000,,-823000,,,,287000,167868000,166854000,152841000,-959000,,-232000,-232000,53553,SMTX
2019-12-31,,,52765000,1228000,51032000,6086000,72152000,52765000,52765000,,,,,,0,75756000,22991000,3604000,0,,52765000,51032000,53555,DMLP
2018-12-31,,,53907000,1826000,51941000,4913000,67767000,53907000,53907000,,,,,,0,70529000,16622000,2762000,1635000,,53907000,51941000,53555,DMLP
2017-12-31,,,38424000,1782000,37083000,4930000,52656000,38424000,38424000,,,,,,0,55116000,16692000,2460000,0,,38424000,37083000,53555,DMLP
2016-12-31,,,20967000,1809000,20231000,4990000,34464000,20967000,20967000,,,,,,0,36197000,15230000,1733000,0,,20967000,20231000,53555,DMLP
2019-12-31,,,5260000,,2546000,60967000,84198000,19421000,19421000,,-410000,,,,2085000,338531000,319110000,254333000,-14161000,,3175000,2546000,53559,PNTG
2018-12-31,,,20631000,9432000.0,15684000,49286000,73637000,21387000,21387000,,-410000,,,,4352000,286058000,264671000,212421000,-756000,,16279000,15684000,53559,PNTG
2017-12-31,,,15402000,4920000.0,9867000,45767000,63713000,15402000,15402000,,-410000,,,,5375000,250991000,235589000,187278000,0,,10027000,9867000,53559,PNTG
2016-12-31,,,12982000,4920000.0,7891000,41401000,57238000,12982000,12982000,,-410000,,,,5065000,217225000,204243000,159987000,0,,7917000,7891000,53559,PNTG
2019-12-31,5119,,-2507799,,-2507799,2627143,199689,-2432573,-2432573,,-96891,,,,0,244748,2677321,45059,-75226,,-2507799,-2507799,53560,VRME
2018-12-31,187655,,-2932462,,-2932462,2454228,46082,-2595801,-2595801,,-96891,,,,0,74884,2670685,28802,-336661,,-2932462,-2932462,53560,VRME
2017-12-31,128044,,-3385340,,-3385340,2707460,0,-2835504,-2835504,,-218316,,,,0,0,2835504,0,-549836,,-3385340,-3982218,53560,VRME
2016-12-31,250180,,-1646255,,-1646255,3496850,12692,-3734338,-3734338,,-12871,,,,0,37055,3771393,24363,2088083,,-1646255,-1646255,53560,VRME
2020-12-31,33457000,,18784000,,14246000,70314000,136246000,21054000,21054000,,-3562000,,,,4538000,264488000,243434000,128242000,-2270000,,14246000,14246000,53563,CPSI
2019-12-31,36861000,,23696000,,20468000,71095000,144145000,25183000,25183000,,-6694000,,,,3228000,274634000,249451000,130489000,-1487000,,20468000,19704000,53563,CPSI
2018-12-31,36371000,,18108000,,17632000,77988000,149728000,24882000,24882000,,-7577000,,,,476000,280411000,255529000,130683000,-6774000,,17632000,17037000,53563,CPSI
2017-12-31,33737000,,-13483000,,-17416000,79944000,147273000,23186000,23186000,,-7736000,,,,3933000,276927000,253741000,129654000,-36669000,,-17416000,-17100000,53563,CPSI
2020-08-31,2240000,,-90468000,,-75347000,16480000,957000,-18035000,-18035000,,-2525000,,,,0,8642000,26677000,7685000,-72433000,15121000,-90468000,-75347000,53566,PIXY
2019-08-31,1209000,,-24610000,,-18082000,16066000,1913000,-15556000,-15556000,,-8507000,,,,0,10451000,26007000,8538000,-9054000,6528000,-24610000,-18082000,53566,PIXY
2018-08-31,3828000,,-18049000,,-16823000,9301000,331000,-12798000,-12798000,,-1751000,,,,0,1819000,14617000,1488000,-5251000,1226000,-18049000,-16823000,53566,PIXY
2017-08-31,2683334,,-7491990,,-7491990,8435509,3692222,-7491990,-7491990,,-1751000,,,,0,20244419,27736409,16552197,0,1226000,-7491990,-7491990,53566,PIXY
2020-08-31,,,89851,,89851,415051,2005670,1590619,1590619,,-346822,,,,0,2005670,415051,0,-1500768,,89851,89851,53567,MHE
2019-08-31,,,3124706,,3124706,408098,2101215,1693117,1693117,,-493467,,,,0,2101215,408098,0,1431589,,3124706,3124706,53567,MHE
2018-08-31,,,-151064,,-151064,385948,2119532,1733584,1733584,,-419645,,,,0,2119532,385948,0,-1884648,,-151064,-151064,53567,MHE
2017-08-31,,,-177406,,-177406,386304,2169133,1782829,1782829,,-324532,,,,0,2169133,386304,0,-1960235,,-177406,-177406,53567,MHE
2020-04-30,,,-2998657,,-2998657,2579912,18652733,16072821,16072821,,-3854813,,,,0,18652733,2579912,0,-19071478,,-2998657,-2998657,53568,BKN
2019-04-30,,,20321606,,20321606,2471635,18808994,16337359,16337359,,-4160987,,,,0,18808994,2471635,0,3984247,,20321606,20321606,53568,BKN
2018-04-30,,,12917539,,12917539,2442756,18253737,15810981,15810981,,-3270533,,,,0,18253737,2442756,0,-2893442,,12917539,12917539,53568,BKN
2017-04-30,,,-5672187,,-5672187,2495440,18711961,16216521,16216521,,-2641432,,,,0,18711961,2495440,0,-21888708,,-5672187,-5672187,53568,BKN
2019-12-31,23327000,,-68279000,,-68299000,29178000,-17802000,-70307000,-70307000,,-4257000,,,,20000,15078000,85385000,32880000,2028000,,-68299000,-85462000,53569,OM
2018-12-31,22916000,,-49755000,,-49780000,17532000,-6115000,-46563000,-46563000,,-4639000,,,,25000,2007000,48570000,8122000,-3192000,,-49780000,-73080000,53569,OM
2020-03-31,92437000,,-146680000,,-146745000,46299000,0,-138736000,-138736000,,-3581000,,,,65000,0,138736000,0,-7944000,,-146745000,-146745000,53570,UROV
2019-03-31,92198000,,-111299000,,-111346000,18585000,0,-110783000,-110783000,,-259000,,,,47000,0,110783000,0,-516000,,-111346000,-111346000,53570,UROV
2018-03-31,32359000,,-37037000,,-37074000,4640000,0,-36999000,-36999000,,-259000,,,,37000,0,36999000,0,-38000,,-37074000,-37074000,53570,UROV
2017-03-31,26047370,,-26970082,,-26970082,1016166,0,-27063536,-27063536,,-259000,,,,0,0,27063536,0,93454,,-26970082,-26970082,53570,UROV
2019-12-31,,,30479000,,27525000,184224000,367359000,66237000,66237000,80973000,-34258000,,,,2954000,1098046000,1031809000,730687000,-35758000,,27525000,27525000,53572,HNGR
2018-12-31,,,4380000,,-858000,130267000,345951000,59127000,59127000,120102000,-37566000,,,,5238000,1048760000,989633000,702809000,-54747000,,-858000,-858000,53572,HNGR
2017-12-31,,,-77374000,,-104671000,149381000,349720000,35049000,35049000,126031000,-57688000,,,,27297000,1040769000,1005720000,691049000,-112423000,,-104671000,-104671000,53572,HNGR
2016-12-31,,,-123316000,,-106471000,151671000,345660000,14078000,14078000,135024000,-45199000,,,,-15910000,1042054000,1027976000,696394000,-137394000,935000.0,-107406000,-106471000,53572,HNGR
2020-06-30,,,-1467600000,303300000,-1006700000,2878200000,2741100000,-370200000,-370200000,,-234100000,,,,-377700000,4717800000,5088000000,1976700000,-1097400000,87200000,-1089900000,-1013200000,53573,COTY
2019-06-30,,,-3945400000,458300000,-3784200000,3308000000,3798800000,244100000,244100000,,-252800000,,,,-54800000,6287900000,6043800000,2489100000,-4189500000,121000000,-3890600000,-3784200000,53573,COTY
2018-06-30,,,-394500000,666800000,-168800000,3641500000,4186000000,300200000,300200000,,-222700000,,,,-32200000,6841800000,6541600000,2655800000,-694700000,234500000,-362300000,-168800000,53573,COTY
2017-06-30,,,-658000000,554100000,-422200000,4040700000,4622000000,306200000,306200000,,-219600000,,,,-259500000,7650300000,7344100000,3028300000,-964200000,234500000,-398500000,-422200000,53573,COTY
2019-12-31,1229480,,-9402078,,-9402078,15771187,8941718,-8058949,-8058949,,-1793610,,,,0,33030357,41089306,24088639,-1343129,,-9402078,-9402078,53577,BOXL
2018-12-31,671653,,-7177883,,-7177883,14978079,8653169,-6996563,-6996563,,-841788,,,,0,37841277,44837840,29188108,-181320,,-7177883,-7177883,53577,BOXL
2017-12-31,465940,,-6539566,,-6539566,13189879,6413781,-7242038,-7242038,,-635445,,,,0,25743612,32985650,19329831,702472,,-6539566,-6539566,53577,BOXL
2016-12-31,1008433,,-2061983,,-2061983,7689898,7412077,-1286254,-1286254,,-818234,,,,0,20371826,21658080,12959749,-775729,,-2061983,-2061983,53577,BOXL
2020-01-31,111297000,,29937000,10627000,20191000,153601000,295509000,27613000,27613000,,-481000,,,,2567000,457109000,429496000,161600000,2324000,,27370000,20191000,53583,CGNT
2019-01-31,100006000,,19941000,7711000,8728000,137142000,264104000,18889000,18889000,,-499000,,,,7620000,433460000,414571000,169356000,1052000,,12321000,8728000,53583,CGNT
2019-12-31,3830000,,-1863000,-253000,-3777000,25431000,30986000,1725000,1725000,,-76000,,,,201000,113493000,111768000,82507000,-3588000,-1713000,-2064000,-3777000,53584,IIN
2018-12-31,4671000,,7246000,-253000,5547000,23185000,36231000,8375000,8375000,,-646000,,,,484000,113948000,105573000,77717000,-1129000,-1215000,6762000,5547000,53584,IIN
2017-12-31,4458000,,2462000,-253000,2058000,17228000,25270000,3584000,3584000,,-716000,,,,8000,86954000,83370000,61684000,-1122000,-1334000,2454000,2058000,53584,IIN
2016-12-31,4688000,,-3113000,455000,-4943000,13854000,16716000,-1826000,-1826000,,-553000,,,,217000,68980000,70806000,52264000,-1287000,-1770000,-3330000,-4943000,53584,IIN
2020-12-31,,,-839243000,1467769000,-713529000,31200000,707225000,32859000,32859000,,-693656000,,,,-35367000,1348250000,1315391000,641025000,-872102000,,-803876000,-713529000,53589,BPYU
2019-12-31,,,490594000,1594975000,432880000,28397000,993395000,463362000,463362000,,-678460000,,,,9683000,1604927000,1141565000,611532000,27232000,,480911000,416943000,53589,BPYU
2018-12-31,,,3569583000,1627292000,4090541000,54228000,1479228000,779835000,779835000,,-576700000,,,,-594186000,2167804000,1387969000,688576000,6474645000,,4163769000,4078589000,53589,BPYU
2017-12-31,,,655977000,352874000,657334000,67176000,1806260000,1035056000,1035056000,,-541945000,,,,-10896000,2524661000,1489605000,718401000,-379079000,,666873000,641398000,53589,BPYU
2020-12-31,,,472600000,413600000,284200000,236700000,1761900000,659400000,659400000,622800000,-184200000,,,,103800000,4644400000,3985000000,2882500000,-186800000,,368800000,284200000,53591,EHC
2019-12-31,,,562300000,580500000,358700000,329300000,1864100000,692500000,692500000,623600000,-159700000,,,,115900000,4605000000,3912500000,2740900000,-130200000,-600000.0,446400000,357400000,53591,EHC
2018-12-31,,,493200000,542000000,292300000,298200000,1764600000,681600000,681600000,585100000,-147300000,,,,118900000,4277300000,3595700000,2512700000,-188400000,1100000.0,374300000,291400000,53591,EHC
2017-12-31,,,496400000,463800000,271100000,245200000,1610000000,649400000,649400000,531600000,-154400000,,,,145800000,3913900000,3264500000,2303900000,-153000000,-400000.0,350600000,270200000,53591,EHC
2019-12-31,,,-58970000,,-58859000,21628000,-39644000,-61272000,-61272000,,,,,,-111000,0,61272000,39644000,2302000,,-58859000,-58859000,53592,ISEE
2018-12-31,,,62024000,,63087000,23612000,-34837000,-58449000,-58449000,,,,,,-1063000,0,58449000,34837000,120473000,,63087000,63087000,53592,ISEE
2017-12-31,66289000.0,,109493000,,114205000,29183000,143688000,114505000,114505000,,,,,,-4712000,209977000,95472000,66289000,-5012000,,114205000,114205000,53592,ISEE
2016-12-31,66289000.0,,-193826000,,-193420000,50178000,-145386000,-195564000,-195564000,,,,,,-406000,50909000,246473000,196295000,1738000,,-193420000,-193420000,53592,ISEE
2019-12-31,,,33811000,3499000,26401000,,33811000,33811000,33811000,,,,,,7311000,270779000,236968000,236968000,0,,26500000,26401000,53593,NODK
2018-12-31,,,39165000,3263000,31081000,,34587000,34587000,34587000,,,,,,7921000,207792000,173205000,173205000,4578000,,31244000,31081000,53593,NODK
2017-12-31,,,22006000,3178000,15991000,,22006000,22006000,22006000,,,,,,6394000,189140000,167134000,167134000,0,,15612000,15991000,53593,NODK
2016-12-31,,,6117000,3522000,4551000,,6117000,6117000,6117000,,,,,,1479000,163747000,157630000,157630000,0,,4638000,4551000,53593,NODK
2019-12-31,33121000,,-47497000,,-47599000,18261000,0,-51382000,-51382000,,,,,,102000,0,51382000,0,3885000,,-47599000,-97499000,53594,TCRR
2018-12-31,16977000,,-24251000,,-24251000,9476000,0,-26453000,-26453000,,,,,,0,0,26453000,0,2202000,,-24251000,-61549000,53594,TCRR
2017-12-31,8147000,,-13070000,,-13070000,5033000,0,-13180000,-13180000,,,,,,0,0,13180000,0,110000,,-13070000,-14864000,53594,TCRR
2016-12-31,7670000,,-9915000,,-9915000,2260000,0,-9930000,-9930000,,,,,,0,0,9930000,0,15000,,-9915000,-10702000,53594,TCRR
2020-12-31,,,32395000,,26361000,83937000,123726000,0,34270000,5519000,,,,,6034000,123726000,89456000,0,-1875000,,26361000,26361000,53596,CBTX
2019-12-31,,,62088000,,50517000,83582000,146131000,0,58021000,4528000,,,,,11571000,146131000,88110000,0,4067000,,50517000,50517000,53596,CBTX
2018-12-31,,,58653000,,47289000,74499000,140669000,0,61763000,4407000,,,,,11364000,140669000,78906000,0,-3110000,,47289000,47289000,53596,CBTX
2017-12-31,,,44024000,,27571000,69895000,122316000,0,47888000,4533000,,,,,16453000,122316000,74428000,0,-3864000,,27571000,27571000,53596,CBTX
2019-12-31,,,402700000,169000000,310600000,370700000,1060800000,498300000,498300000,-2500000,-131100000,,,,71700000,9298200000,8799900000,8237400000,-95600000,5200000,331000000,310600000,53597,DK
2018-12-31,,,485500000,175500000,340100000,342200000,1134100000,623800000,623800000,-31300000,-125900000,,,,101900000,10233100000,9609300000,9099000000,-138300000,-8700000,383600000,340100000,53597,DK
2017-12-31,,,299300000,313600000,288800000,198400000,563800000,211100000,211100000,1000000,-93800000,,,,-29200000,7267100000,7056000000,6703300000,88200000,-5900000,328500000,288800000,53597,DK
2016-12-31,,,-391200000,190600000,-153700000,105400000,138000000,-83800000,-83800000,1000000,-54400000,,,,-171500000,4197900000,4281700000,4059900000,-307400000,86300000,-219700000,-153700000,53597,DK
2020-03-31,608000,,396000,,387000,11039000,12700000,1053000,1053000,,-657000,,,,9000,31899000,30846000,19199000,-657000,,387000,387000,53601,CYAN
2019-03-31,923000,,-3579000,,-3596000,12540000,10716000,-2747000,-2747000,,-582000,,,,17000,30202000,32949000,19486000,-832000,,-3596000,-3596000,53601,CYAN
2018-03-31,563000,,915000,,1025000,11394000,13909000,1952000,1952000,,-499000,,,,-110000,34115000,32163000,20206000,-1037000,,1025000,1025000,53601,CYAN
2017-03-31,593000,,-1210000,,-1215000,12313000,12344000,-562000,-562000,,-528000,,,,5000,32042000,32604000,19698000,-648000,,-1215000,-1215000,53601,CYAN
2019-12-31,31685000,,55126000,,47319000,219446000,314292000,62243000,62243000,918000,-7857000,,,,7807000,898260000,836017000,583968000,-7117000,,47319000,47319000,53603,ROG
2018-12-31,33075000,,110589000,,87651000,161726000,310783000,113974000,113974000,2008000,-6781000,,,,22938000,879091000,765117000,568308000,-3385000,,87651000,87651000,53603,ROG
2017-12-31,29547000,,132925000,,80459000,160010000,318575000,129018000,129018000,2008000,-5884000,,,,52466000,821043000,692025000,502468000,3907000,,80459000,80459000,53603,ROG
2016-12-31,28582000,,82280000,,48283000,134217000,249485000,86686000,86686000,2008000,-3530000,,,,33997000,656314000,569628000,406829000,-4406000,,48283000,48283000,53603,ROG
2020-12-31,,,-1549035000,179800000,-1148777000,166986000,979234000,-119002000,-119002000,-115725000,-169423000,,,,-293741000,1751709000,1870711000,772475000,-1430033000,-7151000,-1255294000,-1148777000,53606,MUR
2019-12-31,,,203498000,337151000,1149732000,513084000,2250015000,453738000,453738000,68219000,-187175000,,,,14683000,2829682000,2375944000,579667000,-250240000,1064487000,188815000,1149732000,53606,MUR
2018-12-31,,,43002000,368343000,411094000,245369000,1352375000,230723000,230723000,39034000,-180359000,,,,-126136000,1833322000,1602599000,480947000,-187721000,250348000,169138000,411094000,53606,MUR
2017-12-31,,,-282884000,368343000,-311789000,269166000,963950000,-153753000,-153753000,38045000,-178263000,,,,270131000,1306988000,1460741000,343038000,-129131000,241226000,-553015000,-311789000,53606,MUR
2019-12-31,,,32671000,,34420000,1088464000,1301429000,0,39063000,136502000,,,,,-1749000,1436357000,1397294000,134928000,-6392000,,34420000,34420000,53608,LDI
2018-12-31,,,-103344000,,-110384000,1011209000,977221000,0,-107148000,36881000,,,,,-475000,1110687000,1217835000,133466000,3804000,,-102869000,-110384000,53608,LDI
2017-12-31,,,29806000,,20855000,1085250000,1224426000,0,11651000,95664000,,,,,1436000,1337061000,1325410000,112635000,18155000,,28370000,20855000,53608,LDI
2014-12-31,,,22193250,,21684130,446100293,507017498,0,19003250,30221703,,,,,509120,562067290,543064040,55049792,3190000,,21684130,21684130,53608,LDI
2020-12-31,,,666025000,,506035000,314565000,1609390000,713119000,713119000,54331000,-47094000,,,,159990000,9636573000,8923454000,8027183000,-47094000,,506035000,506035000,53610,JBHT
2019-12-31,,,680895000,,516320000,325784000,1637490000,757225000,757225000,55336000,-54684000,,,,164575000,9165258000,8408033000,7527768000,-76330000,,516320000,516320000,53610,JBHT
2018-12-31,,,640818000,,489585000,292676000,1460670000,681021000,681021000,51080000,-40427000,,,,151233000,8614874000,7933853000,7154204000,-40203000,,489585000,489585000,53610,JBHT
2017-12-31,,,595239000,,686263000,249457000,1301589000,623789000,623789000,44825000,-28785000,,,,-91024000,7189568000,6565779000,5887979000,-28550000,,686263000,686263000,53610,JBHT
2020-08-31,10235000,,-11511000,,-11511000,4232000,2710000,-11757000,-11757000,,,,,,0,2710000,14467000,0,246000,,-11511000,-11511000,53611,ORMP
2019-08-31,13522000,,-14055000,,-14355000,3722000,2613000,-14631000,-14631000,,,,,,300000,2703000,17334000,90000,576000,,-14355000,-14355000,53611,ORMP
2018-08-31,11979000,,-12727000,,-12727000,4083000,2535000,-13527000,-13527000,,-67000.0,,,,0,2449000,15976000,-86000,800000,,-12727000,-12727000,53611,ORMP
2017-08-31,10281000,,-10080000,,-10480000,2759000,2269000,-10771000,-10771000,,-78000.0,,,,400000,2456000,13227000,187000,691000,,-10480000,-10480000,53611,ORMP
2019-12-31,,,-14235000,,-13820000,6372000,-3362000,-11012000,-11012000,,,,,,-415000,5084000,16096000,8446000,-3223000,,-13820000,-13820000,53612,EMX
2018-12-31,,,58435000,,62118000,4141000,-2649000,-15870000,-15870000,,-337000.0,,,,-3683000,3536000,19406000,6185000,74305000,,62118000,62118000,53612,EMX
2017-12-31,,,-9883286,,-7393384,3178740,2857927,-7223403,-7223403,120618.0,-337000.0,,,,-2489902,2857927,10081330,0,-2659883,,-7393384,-7393384,53612,EMX
2016-12-31,,,-4122814,,-2683482,2665844,2227322,-7827557,-7827557,111366.0,-337000.0,,,,-1439332,2227322,10054879,0,3704743,,-2683482,-2683482,53612,EMX
2019-12-31,,,-28889000,91848000,-28816000,52534000,31090000,-24149000,-24149000,,-975000,,,,10935000,185006000,209155000,153916000,-4740000,,-39824000,-9727000,53613,GNLN
2018-12-31,,,-5569000,91848000,-5888000,35694000,35735000,-1451000,-1451000,,-3192000,,,,319000,178935000,180386000,143200000,-4118000,,-5888000,-5888000,53613,GNLN
2017-12-31,,,2474090,91848000,2291557,17063415,20570397,2715773,2715773,,-269710,,,,182533,88259975,85544202,67689578,-241683,,2291557,2291557,53613,GNLN
2016-12-31,,,195912,91848000,86985,14267358,14954003,114490,114490,,-183878,,,,108927,66689944,66575454,51735941,81422,,86985,86985,53613,GNLN
2020-06-30,,,1464000000,322000000,999000000,1741000000,4496000000,2497000000,2497000000,,-369000000,,,,402000000,12303000000,9806000000,7807000000,-1033000000,,1062000000,999000000,53616,FOX
2019-06-30,,,2224000000,200000000,1595000000,1419000000,4062000000,2431000000,2431000000,,-203000000,,,,581000000,11389000000,8958000000,7327000000,-207000000,,1643000000,1595000000,53616,FOX
2018-06-30,,,2170000000,275000000,2187000000,1262000000,3648000000,2215000000,2215000000,,-43000000,,,,-58000000,10153000000,7938000000,6505000000,-45000000,,2228000000,2187000000,53616,FOX
2017-06-30,,,2241000000,154000000,1372000000,1117000000,3821000000,2535000000,2535000000,,-23000000,,,,832000000,9921000000,7386000000,6100000000,-294000000,,1409000000,1372000000,53616,FOX
2019-12-31,,,-21427964,,-21427964,9977196,-12551610,-22528806,-22528806,,,,,,0,213194,22742000,12764804,1100842,,-21427964,-21427964,53617,MRKR
2018-12-31,,,-147957910,,-147957910,24379871,-123791762,-148171633,-148171633,,,,,,0,205994,148377627,123997756,213723,,-147957910,-147957910,53617,MRKR
2017-12-31,,,-10982177,,-10982177,6412121,-5067921,-11480042,-11480042,,,,,,0,183064,11663106,5250985,497865,,-10982177,-10982177,53617,MRKR
2016-12-31,3800035.0,,-2455381,,-2455381,4692234,0,-8492269,-8492269,,,,,,0,0,8492269,0,6036888,,-2455381,-2455381,53617,MRKR
2019-12-31,8057147,,-26558544,,-26558544,12236417,14455,-21704112,-21704112,,-56382,,,,0,25832530,47536642,25818075,-4854432,,-26558544,-26558544,53618,XXII
2018-12-31,14989746,,-7966911,,-7966911,8585533,898987,-24018627,-24018627,,-10939,,,,0,26426347,50444974,25527360,16051716,,-7966911,-7966911,53618,XXII
2017-12-31,3366468,,-13029117,,-13029117,8278487,-707912,-13299864,-13299864,,-29104,,,,0,16600244,29900108,17308156,270747,,-13029117,-13029117,53618,XXII
2016-12-31,2340958,,-11581430,,-11581430,7775010,-429699,-11387847,-11387847,,-37745,,,,0,12279979,23667826,12709678,-193583,,-11581430,-11581430,53618,XXII
2020-12-31,,,-2000000,,-19100000,208800000,254700000,45600000,45600000,,-30600000,,,,17100000,1443400000,1397800000,1188700000,-47600000,,-19100000,-19100000,53619,MTW
2019-12-31,,,59000000,,46600000,235800000,344100000,108000000,108000000,,-34200000,,,,12400000,1834100000,1726100000,1490000000,-49000000,,46600000,46600000,53619,MTW
2018-12-31,,,-71700000,,-67100000,257500000,328100000,70300000,70300000,,-40900000,,,,-4800000,1846800000,1776500000,1518700000,-142000000,-200000.0,-66900000,-67100000,53619,MTW
2017-12-31,,,-39500000,,9400000,252500000,281900000,28500000,28500000,100000.0,-41100000,,,,-49500000,1581300000,1552800000,1299400000,-68000000,-600000.0,10000000,9400000,53619,MTW
2020-02-29,,,1160986000,,888433000,1940135000,3178370000,1238303000,1238303000,-68000,-83007000,,,,272553000,21424087000,20185784000,18245717000,-77317000,,888433000,888433000,53621,KMX
2019-02-28,,,1112806000,,842413000,1730328000,2919281000,1189006000,1189006000,-53000,-75792000,,,,270393000,19146000000,17956994000,16226719000,-76200000,,842413000,842413000,53621,KMX
2018-02-28,,,1063608000,,664112000,1617101000,2750041000,1132990000,1132990000,-50000,-70745000,,,,399496000,17976809000,16843819000,15226768000,-69382000,,664112000,664112000,53621,KMX
2017-02-28,,,1006405000,,626970000,1488504000,2552278000,1063774000,1063774000,-50000,-56416000,,,,379435000,16637118000,15573344000,14084840000,-57369000,,626970000,626970000,53621,KMX
2019-12-31,4146000,,19105000,,12862000,107451000,148799000,37202000,37202000,,-3910000,,,,6243000,545974000,508772000,397175000,-18097000,,12862000,12862000,53622,CSTE
2018-12-31,3635000,,29128000,,24405000,118109000,165518000,43774000,43774000,,-4176000,,,,4560000,575871000,532097000,410353000,-14646000,,24568000,24608000,53622,CSTE
2017-12-31,4164000,,34960000,16481000.0,26202000,127719000,197223000,65340000,65340000,,-4126000,,,,7402000,588147000,522807000,390924000,-30380000,,27558000,25065000,53622,CSTE
2016-12-31,3290000,,89486000,12939000.0,74596000,110524000,212486000,98672000,98672000,,-3895000,,,,13003000,538543000,439871000,326057000,-9186000,,76483000,72348000,53622,CSTE
2020-12-31,,,-360859000,,-374094000,8493000,-111951000,-122038000,-122038000,1594000,-18164000,,,,14246000,415435000,537473000,527386000,-238821000,-1847000,-375105000,-378026000,53623,VVI
2019-12-31,,,26110000,85903000.0,22035000,9965000,90469000,63225000,63225000,17279000,-14199000,,,,2506000,1371695000,1308470000,1281226000,-37115000,-81000,23604000,20561000,53623,VVI
2018-12-31,,,65009000,20257000.0,49170000,10793000,88006000,75469000,75469000,1744000,-9640000,,,,17095000,1296184000,1220715000,1208178000,-12204000,1481000,47914000,48458000,53623,VVI
2017-12-31,,,104350000,20454000.0,57707000,12296000,96273000,81949000,81949000,2028000,-8304000,,,,45898000,1306965000,1225016000,1210692000,22401000,-268000,58452000,57007000,53623,VVI
2019-12-31,,,2270726,,2270726,413839,0,-413839,-413839,,,,,,0,0,413839,0,2684565,,2270726,-288512,53624,THBR
2020-12-31,,,4296000000,,3135000000,16588000000,22086000000,0,4296000000,1202000000,,,,,1161000000,31357000000,27061000000,9271000000,0,,3135000000,3036000000,53625,AXP
2019-12-31,,,8429000000,,6759000000,13051000000,27322000000,0,8591000000,5680000000,,,,,1670000000,39983000000,31392000000,12661000000,-162000000,,6759000000,6631000000,53625,AXP
2018-12-31,,,8122000000,,6921000000,11885000000,25513000000,0,8164000000,5464000000,,,,,1201000000,36986000000,28822000000,11473000000,-42000000,,6921000000,6787000000,53625,AXP
2017-12-31,,,7425000000,,2748000000,11089000000,23793000000,0,7503000000,5201000000,,,,,4677000000,33872000000,26369000000,10079000000,-78000000,,2748000000,2646000000,53625,AXP
2019-12-31,,,-116159000,10633000,-93913000,33986000,132930000,-55205000,-55205000,,-30099000,,,,-77000,514757000,569962000,381827000,-60954000,,-116082000,-106254000,53626,USWS
2018-12-31,,,-70462000,52798000,-65896000,36412000,117731000,-27121000,-27121000,,-32636000,,,,352000,648847000,675968000,531116000,-43341000,,-70814000,-63754000,53626,USWS
2017-12-31,,,-99276000,52798000,-99276000,20008000,78302000,-39056000,-39056000,,-27028000,,,,0,499354000,538410000,421052000,-60220000,,-99276000,-99276000,53626,USWS
2016-12-31,,,-95404000,52798000,-95404000,8564000,33247000,-41401000,-41401000,,-45376000,,,,0,294755000,336156000,261508000,-54003000,,-95404000,-92305000,53626,USWS
2019-12-31,,,-241677000,,-236455000,106081000,-145834000,-251915000,-251915000,,-31862000,,,,-5222000,73414000,325329000,219248000,10238000,,-236455000,-236455000,53627,TBPH
2018-12-31,,,-226085000,,-215524000,97058000,-141693000,-238751000,-238751000,,-10482000,,,,-10561000,60370000,299121000,202063000,12666000,,-215524000,-215524000,53627,TBPH
2017-12-31,,,-271711000,,-285405000,95592000,-164531000,-260123000,-260123000,,-8547000,,,,13694000,15386000,275509000,179917000,-11588000,,-285405000,-285405000,53627,TBPH
2016-12-31,,,-180559000,,-190669000,84509000,-95958000,-180467000,-180467000,,-1404000,,,,10110000,48648000,229115000,144606000,-92000,,-190669000,-190669000,53627,TBPH
2020-12-31,132428000,,115432000,,100103000,535076000,823417000,93777000,93777000,,,,,,14595000,1783639000,1689862000,960222000,21655000,,100837000,100103000,53628,NYT
2019-12-29,132428000,,164460000,1860000.0,139966000,870946000,1073829000,174222000,174222000,-32000000.0,-26859000.0,,,,24494000,1780184000,1605962000,706355000,-9762000,,139966000,139966000,53628,NYT
2018-12-30,132428000,,176091000,1860000.0,125684000,847129000,1071422000,188282000,188282000,-23000000.0,-31076000.0,,,,48631000,1725598000,1537316000,654176000,-12191000,,127460000,125684000,53628,NYT
2017-12-31,132428000,,111224000,84000.0,4296000,786018000,1042297000,211408000,211408000,-17000000.0,-29680000.0,,,,103956000,1658639000,1447231000,616342000,-100184000,-431000.0,7268000,4296000,53628,NYT
2019-12-31,44175000,,-61014000,,-62147000,177378000,210932000,-10621000,-10621000,,-781000,,,,1133000,381765000,392386000,170833000,-50393000,,-62147000,-62147000,53629,FARO
2018-12-31,46082000,,4558000,,4930000,169717000,221553000,5754000,5754000,,-486000,,,,-372000,403627000,397873000,182074000,-1196000,,4930000,4930000,53629,FARO
2017-12-31,41061000,,5827000,,-14516000,152299000,198682000,5322000,5322000,,-4000,,,,20343000,360917000,355595000,162235000,505000,,-14516000,-14516000,53629,FARO
2016-12-31,30125000,,12626000,,11107000,120683000,177960000,13284000,13284000,,-48000,,,,1519000,325584000,312300000,147624000,-658000,,11107000,11107000,53629,FARO
2019-12-31,6200000,,-10839000,,-10839000,4217000,0,-10417000,-10417000,,-608000,,,,0,0,10417000,0,-422000,,-10839000,-12612000,53631,VOR
2018-12-31,2433000,,-4152000,,-4152000,427000,0,-2860000,-2860000,,-1003000,,,,0,0,2860000,0,-1292000,,-4152000,-4152000,53631,VOR
2019-12-31,15616000,,-19088000,,-19088000,6465000,0,-22081000,-22081000,,,,,,0,0,22081000,0,2993000,,-19088000,-19088000,53634,KRYS
2018-12-31,7761000,,-10889000,,-10889000,4155000,0,-11916000,-11916000,,,,,,0,0,11916000,0,1027000,,-10889000,-10889000,53634,KRYS
2017-12-31,3208000,,-7920000,,-7920000,1564000,0,-4772000,-4772000,,-3200000.0,,,,0,0,4772000,0,-3148000,,-7920000,-7920000,53634,KRYS
2016-12-31,741000,,-1150000,,-1150000,402000,0,-1143000,-1143000,,-7000.0,,,,0,0,1143000,0,-7000,,-1150000,-1150000,53634,KRYS
2019-12-31,,,926088,-1198732,1909444,6830354,46937924,18470254,18470254,,-19768193,,,,-249480,185788133,167317879,138850209,-17544166,,1175568,-5911251,53636,SOHON
2018-12-31,,,-138808,441706,109936,6180962,46883665,19818060,19818060,,-19953746,,,,469349,177373121,157555061,130489456,-19956868,,-608157,-5719978,53636,SOHON
2017-12-31,,,1767293,1154775,442503,6335926,40389325,17053780,17053780,,-15727628,,,,1737804,153666693,136612913,113277368,-15286487,,29489,-3339136,53636,SOHON
2016-12-31,,,-467485,2329175,926716,6021065,40012581,18972445,18972445,,-17735107,,,,-1367634,152845752,133873307,112833171,-19439930,,900149,-218173,53636,SOHON
2019-12-31,11812000,,-13467000,,-13467000,1478000,0,-13290000,-13290000,,-304000,,,,0,0,13290000,0,-177000,,-13467000,-13467000,53637,LABP
2018-12-31,6803000,,-6044000,,-6044000,1136000,0,-7939000,-7939000,,-4000,,,,0,0,7939000,0,1895000,,-6044000,-6044000,53637,LABP
2019-12-31,9858000,,-18606000,,-18606000,9000000,0,-18858000,-18858000,,,,,,0,0,18858000,0,252000,,-18606000,-18606000,53638,AGRX
2018-12-31,9777000,,-20256000,,-19779000,8739000,0,-18516000,-18516000,,-1116000.0,,,,-477000,0,18516000,0,-1740000,,-19779000,-19779000,53638,AGRX
2017-12-31,14428000,,-28304000,,-28304000,12383000,0,-26811000,-26811000,,-1918000.0,,,,0,0,26811000,0,-1493000,,-28304000,-28304000,53638,AGRX
2016-12-31,20929000,,-31816000,,-28741000,8792000,0,-29721000,-29721000,,-2446000.0,,,,-3075000,0,29721000,0,-2095000,,-28741000,-28741000,53638,AGRX
2019-12-31,,,72420000,,68996000,30262000,481268000,273919000,273919000,,-126605000,,,,3402000,589740000,315821000,108472000,-201499000,,69018000,68996000,53639,SBRA
2018-12-31,,,282126000,4333000.0,279082000,34958000,568432000,303020000,303020000,,-147072000,,,,3011000,617978000,314958000,49546000,-20894000,,279115000,269314000,53639,SBRA
2017-12-31,,,159016000,4442000.0,158383000,26901000,390421000,232525000,232525000,,-88426000,,,,651000,408281000,175756000,17860000,-73509000,,158365000,148141000,53639,SBRA
2016-12-31,,,71254000,35000.0,70276000,17672000,254823000,163136000,163136000,,-64073000,,,,1049000,260526000,97390000,5703000,-91882000,,70205000,60034000,53639,SBRA
2020-12-31,,,22704000,1452000,18552000,142229000,303691000,43551000,43551000,15084000,-18847000,,,,5072000,1742101000,1698550000,1438410000,-20847000,,17632000,18552000,53641,USX
2019-12-31,,,-2654000,628000,-3647000,164276000,297701000,25239000,25239000,13849000,-21635000,,,,389000,1707361000,1682122000,1409660000,-27893000,,-3043000,-3647000,53641,USX
2018-12-31,,,33966000,3496000,24899000,151487000,353173000,89599000,89599000,14133000,-34866000,,,,7860000,1804915000,1715316000,1451742000,-55633000,,26106000,24899000,53641,USX
2017-12-31,,,-21124000,2289000,-4060000,139005000,274751000,28608000,28608000,13769000,-49758000,,,,-17187000,1555385000,1526777000,1280634000,-49732000,,-3937000,-4060000,53641,USX
2019-12-31,,,-55744000,,-55744000,32592000,-22876000,-55621000,-55621000,,-4400000,,,,0,42736000,98357000,65612000,-123000,,-55744000,-55744000,53642,STRO
2018-12-31,,,-35317000,,-35317000,21380000,-15843000,-37356000,-37356000,,-1800000,,,,0,38419000,75775000,54262000,2039000,,-35317000,-35317000,53642,STRO
2017-12-31,,,-19688000,,-19688000,16374000,-156000,-16639000,-16639000,,-700000,,,,0,51741000,68380000,51897000,-3049000,,-19688000,-19688000,53642,STRO
2016-12-31,,,1702000,,1702000,14817000,16181000,1364000,1364000,,-700000,,,,0,59731000,58367000,43550000,338000,,-19688000,-19688000,53642,STRO
2020-06-30,1049612,,5239439,,4161439,19944851,25200046,4205583,4205583,,,,,,1078000,32470688,28265105,7270642,1033856,,4161439,4161439,53643,ELMD
2019-06-30,583311,,2920330,,1980330,20279010,23847944,2985623,2985623,,,,,,940000,31299750,28314127,7451806,-65293,,1980330,1980330,53643,ELMD
2018-06-30,251443,,2732173,,1831173,18804867,21772612,2716302,2716302,,,,,,901000,28306696,25590394,6534084,15871,,1831173,1831173,53643,ELMD
2017-06-30,596876,,3519472,,2229472,16269214,20568429,3702339,3702339,,-49867.0,,,,1290000,25861144,22158805,5292715,-182867,,2229472,2229472,53643,ELMD
2019-12-31,,,13344000,,17707000,85978000,114099000,19622000,19622000,,-5397000,,,,-4363000,341869000,322247000,227770000,-6278000,,17707000,17707000,53644,CECE
2018-12-31,,,2497000,,-7121000,87462000,111537000,14392000,14392000,,-7140000,,,,9618000,337339000,322947000,225802000,-11895000,,-7121000,-7121000,53644,CECE
2017-12-31,,,1409000,,-3029000,88975000,113194000,10477000,10477000,,-6721000,,,,4438000,345051000,334574000,231857000,-9068000,,-3029000,-3029000,53644,CECE
2016-12-31,,,-32964000,,-38218000,82743000,135559000,38785000,38785000,,-8212000,,,,5290000,417011000,378226000,281452000,-71749000,,-38254000,-38218000,53644,CECE
2020-12-31,,,209481000,,158440000,483156000,706090000,222934000,222934000,,-13453000,,,,51041000,2796166000,2573232000,2090076000,-13453000,,158440000,158440000,53645,LCII
2019-12-31,,,191414000,,146509000,310175000,539202000,198311000,198311000,,-8796000,,,,44905000,2371482000,2173171000,1832280000,-6897000,,146509000,146509000,53645,LCII
2018-12-31,,,192352000,,148551000,295029000,520344000,198795000,198795000,,-6436000,,,,43801000,2475807000,2277012000,1955463000,-6443000,,148551000,148551000,53645,LCII
2017-12-31,,,212844000,,132884000,254184000,493114000,217190000,217190000,,-1437000,,,,79960000,2147770000,1930580000,1654656000,-4346000,,132884000,132884000,53645,LCII
2020-12-31,,,202234000,,178040000,483160000,786049000,0,230606000,72283000,,,,,24194000,786049000,555443000,0,-28372000,,178040000,175905000,53646,FULT
2019-12-31,,,263988000,,226339000,477485000,825703000,0,286021000,62197000,,,,,37649000,825703000,539682000,0,-22033000,,226339000,226339000,53646,FULT
2018-12-31,,,232970000,,208393000,466182000,767625000,0,243963000,57480000,,,,,24577000,767625000,523662000,0,-10993000,,208393000,208393000,53646,FULT
2017-12-31,,,234454000,,171753000,439731000,743905000,0,240403000,63771000,,,,,62701000,743905000,503502000,0,-5949000,,171753000,171753000,53646,FULT
2020-09-30,,,13646440,,13646440,3532186,18481955,14949769,14949769,,-3136490,,,,0,18481955,3532186,0,-1303329,,13646440,13646440,53647,EVM
2019-09-30,,,31188459,,31188459,3410201,18834967,15424766,15424766,,-4719501,,,,0,18834967,3410201,0,15763693,,31188459,31188459,53647,EVM
2018-09-30,,,-3477954,,-3477954,3000717,16939957,13939240,13939240,,-3633769,,,,0,16939957,3000717,0,-17417194,,-3477954,-3477954,53647,EVM
2017-09-30,,,-431527,,-431527,3053224,17848874,14795650,14795650,,-2689380,,,,0,17848874,3053224,0,-15227177,,-431527,-431527,53647,EVM
2019-12-31,,,268000000,14000000,202000000,341000000,653000000,312000000,312000000,,-99000000,,,,59000000,5639000000,5327000000,4986000000,-44000000,,209000000,200500000,53651,KBR
2018-12-31,,,396000000,20000000,281000000,294000000,584000000,290000000,290000000,,-66000000,,,,86000000,4913000000,4623000000,4329000000,106000000,,310000000,279200000,53651,KBR
2017-12-31,,,247000000,-8000000,432000000,244000000,439000000,195000000,195000000,,-21000000,,,,-193000000,4171000000,3976000000,3732000000,52000000,,440000000,429000000,53651,KBR
2016-12-31,,,33000000,-12000000,-61000000,133000000,274000000,141000000,141000000,,-13000000,,,,84000000,4268000000,4127000000,3994000000,-108000000,,-51000000,-61000000,53651,KBR
2020-01-31,69224000,,-124902000,,-125656000,163508000,117465000,-115457000,-115457000,,-12600000,,,,754000,173395000,288852000,55930000,-9445000,,-125656000,-125656000,53654,DOMO
2019-01-31,75740000,,-153061000,,-154309000,161257000,92910000,-144117000,-144117000,,-11100000,,,,1248000,142464000,286581000,49554000,-8944000,,-154309000,-154309000,53654,DOMO
2018-01-31,78261000,,-176177000,,-176562000,161125000,63605000,-175817000,-175817000,,-1200000,,,,385000,108524000,284341000,44919000,-360000,,-176562000,-176562000,53654,DOMO
2017-01-31,76164000,,-182347000,,-183120000,148041000,41345000,-182877000,-182877000,,-100000,,,,773000,74540000,257417000,33195000,530000,,-183120000,-183120000,53654,DOMO
2019-12-31,,,946894,,946894,408505,2158710,1474306,1474306,,-527412,,,,0,2180898,706592,22188,-527412,,946894,666662,53655,PW
2018-12-31,,,838811,,838811,398443,1952611,1317026,1317026,,-478215,,,,0,1974623,657597,22012,-478215,,838811,558579,53655,PW
2017-12-31,,,718473,,718473,384092,1959550,1338316,1338316,,-489564,,,,0,1982265,643949,22715,-619843,,718473,438602,53655,PW
2016-12-31,,,247183,,247183,339815,1962194,1385238,1385238,,-502447,,,,0,1975921,590683,13727,-1138055,,247183,-32687,53655,PW
2019-12-31,9080891,,-29794022,,-29815070,20155376,3361361,-25874906,-25874906,,-2286196,,,,21048,10129508,36004414,6768147,-3919116,,-29815070,-29815070,53656,BNGO
2018-12-31,9484163,,-18480881,,-18496392,14220331,3289409,-20415085,-20415085,,-1381024,,,,15511,12000735,32415820,8711326,1934204,,-18496392,-18496392,53656,BNGO
2017-12-31,12009170,,-23346812,,-23365364,14079658,3474531,-22614297,-22614297,,-590927,,,,18552,9505043,32119340,6030512,-732515,,-23365364,-23365364,53656,BNGO
2016-12-31,11431941,,-18835691,,-18848615,12950572,3214097,-21168416,-21168416,,-470072,,,,12924,6792789,27961205,3578692,2332725,,-18848615,-18848615,53656,BNGO
2020-06-30,,,-13468195,,-13468232,6335679,-6656699,-15072017,-15072017,,-10457,,,,37,13739283,28811300,20395982,1603822,,-13468232,-13468232,53658,IMMP
2019-06-30,,,-18343984,,-18343984,6366161,-10953990,-19199302,-19199302,,-10457,,,,0,5637211,24836513,16591201,855318,,-18343984,-18343984,53658,IMMP
2018-06-30,,,-12744344,,-12746020,7242061,-3136227,-12187217,-12187217,,-10457,,,,1676,6853603,19040820,9989830,-557127,,-12746020,-12746020,53658,IMMP
2017-06-30,,,-10104593,,-9367206,4346952,-3409011,-9457578,-9457578,,-10457,,,,-737387,4116733,13574311,7525744,-647015,,-9367206,-9367206,53658,IMMP
2020-12-31,,,123512000,,99586000,209506000,381242000,0,127877000,43859000,,,,,23926000,381242000,253365000,0,-4365000,,99586000,99586000,53662,BANF
2019-12-31,,,169562000,,134879000,192748000,410863000,0,173286000,44829000,,,,,34683000,410863000,237577000,0,-3724000,,134879000,134879000,53662,BANF
2018-12-31,,,159752000,,125814000,176559000,381873000,0,165427000,39887000,,,,,33938000,381873000,216446000,0,-5675000,,125814000,125814000,53662,BANF
2017-12-31,,,136305000,,86439000,159386000,336697000,0,141175000,36136000,,,,,49866000,336697000,195522000,0,-4870000,,86439000,86439000,53662,BANF
2019-12-31,,,-7821000,,-10103000,22366000,18473000,-3893000,-3893000,,-823000,,,,2282000,62550000,66443000,44077000,-3928000,,-10103000,-10103000,53665,BTN
2018-12-31,,,-9900000,,-12327000,20393000,12179000,-8214000,-8214000,,-447000,,,,2427000,64689000,72903000,52510000,-1686000,,-12327000,-12327000,53665,BTN
2017-12-31,,,-174000,,-3617000,21538000,18934000,-2604000,-2604000,,-153000,,,,3418000,72646000,75250000,53712000,2430000,-25000.0,-3592000,-3617000,53665,BTN
2016-12-31,,,3888000,,-408000,16874000,21156000,4282000,4282000,,-47000,,,,3019000,76254000,71972000,55098000,-394000,-1277000.0,869000,-408000,53665,BTN
2020-09-30,1096000000,,985000000,,874000000,4318000000,7919000000,2520000000,2520000000,-15000000,-528000000,,,,111000000,17117000000,14597000000,9198000000,-1535000000,,874000000,767000000,53667,BDX
2019-09-30,1032000000,,1176000000,,1233000000,4334000000,8288000000,2921000000,2921000000,1000000,-639000000,,,,-57000000,17290000000,14369000000,9002000000,-1745000000,,1233000000,1081000000,53667,BDX
2018-09-30,1004000000,,1173000000,,311000000,4029000000,7805000000,2772000000,2772000000,1000000,-706000000,,,,862000000,15983000000,13211000000,8178000000,-1599000000,,311000000,159000000,53667,BDX
2017-09-30,770000000,,976000000,,1100000000,2953000000,5965000000,2243000000,2243000000,-1000000,-521000000,,,,-124000000,12093000000,9850000000,6128000000,-1267000000,,1100000000,1030000000,53667,BDX
2019-12-31,,,1088149,,1088149,591077,2954155,1415354,1415354,50553,-210085,,,,0,5967772,4552418,3013617,-327205,,1088149,828764,53669,CTRM
2018-12-31,,,1505238,,1505238,213153,2818294,1898077,1898077,50553,-210085,,,,0,4405310,2507233,1587016,-392839,,1505238,1505238,53669,CTRM
2018-09-30,,,980938,,980938,220713,2236024,1337355,1337355,40345,-210085,,,,0,3960822,2623467,1724798,-356417,,980938,-665837,53669,CTRM
2017-09-30,,,1054373,,1054373,136760,930770,535080,535080,40115,-210085,,,,0,2421673,1886593,1490903,519293,,1054373,1019273,53669,CTRM
2019-12-31,,,2960000,35557000,371000,30462000,121018000,20444000,20444000,,-55154000,,,,1764000,468115000,447671000,347097000,-17484000,,1196000,-10437000,53670,BHR
2018-12-31,,,5017000,39494000,1320000,27009000,117105000,32713000,32713000,,-53831000,,,,2432000,411964000,379251000,294859000,-27696000,,2585000,-6085000,53670,BHR
2017-12-31,,,27802000,41874000,23022000,20680000,113752000,40810000,40810000,,-42811000,,,,-522000,409963000,369153000,296211000,-13008000,,28324000,15822000,53670,BHR
2016-12-31,,,25894000,54181000,19316000,32341000,122792000,44554000,44554000,,-43476000,,,,1574000,403270000,358716000,280478000,-18660000,,24320000,15192000,53670,BHR
2019-12-31,333844000,,-1678813000,,-1669781000,1695916000,253826000,-1751161000,-1751161000,-24773000,,,,,-9032000,3099698000,4850859000,2845872000,72348000,,-1669781000,-2464796000,53671,DADA
2018-12-31,270163000,,-1905872000,,-1878375000,1497403000,-122124000,-1964355000,-1964355000,74665000,-3122000.0,,,,-27497000,1922015000,3886370000,2044139000,58483000,,-1878375000,-2390021000,53671,DADA
2017-12-31,191977000,,-1463203000,,-1449090000,972635000,-374699000,-1586763000,-1586763000,47452000,-8908000.0,,,,-14113000,1217965000,2804728000,1592664000,123560000,,-1449090000,-1823336000,53671,DADA
2020-09-30,,,326000000,33000000,245000000,179000000,328000000,109000000,109000000,40000000,-70000000,,,,78000000,3044000000,2935000000,2716000000,217000000,1000000,248000000,245000000,53676,MTOR
2019-09-30,,,377000000,30000000,291000000,250000000,640000000,377000000,377000000,13000000,-61000000,,,,82000000,4388000000,4011000000,3748000000,0,1000000,295000000,291000000,53676,MTOR
2018-09-30,,,278000000,30000000,117000000,261000000,625000000,350000000,350000000,14000000,-62000000,,,,149000000,4178000000,3828000000,3553000000,-72000000,-3000000,129000000,117000000,53676,MTOR
2017-09-30,,,381000000,25000000,324000000,253000000,497000000,241000000,241000000,3000000,-86000000,,,,52000000,3347000000,3106000000,2850000000,140000000,-1000000,329000000,324000000,53676,MTOR
2019-12-29,,,-9031000,,-9068000,22349000,31508000,4757000,4757000,,-4287000,,,,37000,152489000,147732000,120981000,-13788000,,-9068000,-9068000,53679,UFAB
2018-12-30,,,4561000,,3699000,25387000,39335000,9581000,9581000,,-3778000,,,,862000,174910000,165329000,135575000,-5020000,,3699000,3699000,53679,UFAB
2017-12-31,,,7620000,,6487000,25338000,40054000,10310000,10310000,,-2746000,,,,1133000,175288000,164978000,135234000,-2690000,,6487000,6487000,53679,UFAB
2017-01-01,,,9941739,,6684120,22730453,39862985,13205532,13205532,,-2134976,,,,3257619,170462953,157257421,130599968,-3263793,,6684120,6684120,53679,UFAB
2020-12-31,,,-20000000,,-4000000,328000000,386000000,17500000,17500000,,-25100000,,,,-16000000,842500000,825000000,456500000,-37500000,,-4000000,-4000000,53680,CDAY
2019-12-31,,,34300000,,78700000,278200000,407300000,92700000,92700000,,-32400000,,,,-44400000,824100000,731400000,416800000,-58400000,,78700000,78700000,53680,CDAY
2018-12-31,,,-26900000,,-60600000,252400000,351600000,64900000,64900000,,-57500000,,,,8400000,740700000,675800000,389100000,-91800000,-25800000.0,-35300000,-68300000,53680,CDAY
2017-12-31,,,-40500000,37800000.0,3300000,213800000,304600000,59500000,59500000,,-87100000,,,,-48500000,676200000,616700000,371600000,-100000000,-6000000.0,8000000,-17200000,53680,CDAY
2019-12-31,,,1361345000,40419000,1282357000,3366818000,5205078000,1399036000,1399036000,,-85754000,,,,69895000,23894091000,22495055000,18689013000,-37691000,,1291450000,1282357000,53681,CBRE
2018-12-31,,,1379006000,71105000,1063219000,3312581000,4890876000,1126307000,1126307000,,-98685000,,,,313058000,21340088000,20213781000,16449212000,252699000,,1065948000,1063219000,53681,CBRE
2017-12-31,,,1171333000,60118000,697109000,2831369000,4323688000,1086205000,1086205000,,-126961000,,,,467757000,18628787000,17542582000,14305099000,85128000,,703576000,697109000,53681,CBRE
2016-12-31,,,882070000,42758000,573079000,2613158000,3985297000,1005212000,1005212000,,-144851000,,,,296900000,17369108000,16363896000,13383811000,-123142000,,585170000,573079000,53681,CBRE
2020-12-31,,,-158000000,,-132000000,225000000,531000000,208000000,208000000,,-112000000,,,,-26000000,950000000,742000000,419000000,-366000000,,-132000000,-132000000,53682,WH
2019-12-31,,,207000000,,157000000,409000000,982000000,464000000,464000000,,-104000000,,,,50000000,1430000000,966000000,448000000,-257000000,,157000000,157000000,53682,WH
2018-12-31,,,223000000,,162000000,393000000,888000000,396000000,396000000,,-67000000,,,,61000000,1282000000,886000000,394000000,-173000000,,162000000,162000000,53682,WH
2017-12-31,,,243000000,,230000000,332000000,704000000,297000000,297000000,,-7000000,,,,13000000,1016000000,719000000,312000000,-54000000,,230000000,230000000,53682,WH
2019-12-31,,,-21890000,,-21890000,6432000,32026000,-5567000,-5567000,,-17157000,,,,0,70530000,76097000,38504000,-16323000,,-21890000,-21890000,53683,NYC
2018-12-31,,,-24112000,,-24112000,8975000,27810000,-10855000,-10855000,,-13294000,,,,0,62399000,73254000,34589000,-13257000,,-24112000,-24112000,53683,NYC
2017-12-31,,,-23073000,,-23073000,8087000,25520000,-12106000,-12106000,,-11230000,,,,0,58384000,70490000,32864000,-10967000,,-23073000,-23073000,53683,NYC
2016-12-31,,,-19765000,,-19765000,4933000,21509000,-9010000,-9010000,,-7404000,,,,0,47607000,56617000,26098000,-10755000,,-19765000,-19765000,53683,NYC
2019-12-31,,,-1481265,1730058,-1486923,16249895,18070703,-12188206,-12188206,134992,-302749,,,,0,41389138,53577344,23318435,10706941,,-1481265,-1486923,53684,BOMN
2018-12-31,,,-9158831,1345578,-9113937,10138837,6830763,-11563053,-11563053,52639,-1804,,,,0,20021393,31584446,13190630,2404222,,-9158831,-9113937,53684,BOMN
2017-12-31,,,-6479457,1234987,-6467910,5294683,2570996,-6224785,-6224785,52639,-8255,,,,0,9014345,15239130,6443349,-254672,,-6479457,-6467910,53684,BOMN
2016-12-31,,,-3173375,1234987,-3173375,1738701,817686,-2586838,-2586838,52639,-7798,,,,0,3843517,6430355,3025831,-586537,,-3173375,-3173375,53684,BOMN
2020-12-31,,,-109214000,,-97412000,117820000,159754000,21506000,21506000,-1553000,-24194000,,,,-11802000,1481889000,1460383000,1322135000,-130720000,,-97412000,-97412000,53685,WNC
2019-12-31,,,117731000,,89575000,143125000,306382000,142786000,142786000,-1553000,-27340000,,,,28156000,2319136000,2176350000,2012754000,-25055000,,89575000,89575000,53685,WNC
2018-12-31,,,96004000,,69421000,128160000,283651000,136023000,136023000,-1553000,-28759000,,,,26583000,2267278000,2131255000,1983627000,-40019000,,69421000,69421000,53685,WNC
2017-12-31,,,122538000,,111422000,103413000,260875000,140421000,140421000,-1553000,-16400000,,,,11116000,1767161000,1626740000,1506286000,-17883000,,111422000,111422000,53685,WNC
2019-12-31,34910000,,-42337000,,-42997000,8719000,0,-43629000,-43629000,,,,,,660000,0,43629000,0,1292000,,-42997000,-42997000,53686,RAPT
2018-12-31,31767000,,-36147000,,-36147000,5180000,0,-36947000,-36947000,,,,,,0,0,36947000,0,800000,,-36147000,-36147000,53686,RAPT
2017-12-31,25618000,,-29115000,,-29115000,3713000,0,-29331000,-29331000,,,,,,0,0,29331000,0,216000,,-29115000,-29115000,53686,RAPT
2020-12-31,,,31339000,,26209000,54205000,101916000,0,34915000,12796000,,,,,5130000,101916000,67001000,0,-3576000,,26209000,26209000,53688,MPB
2019-12-31,,,21426000,,17701000,47947000,81345000,0,23844000,9554000,,,,,3725000,81345000,57501000,0,-2418000,,17701000,17701000,53688,MPB
2018-12-31,,,12725000,,10596000,36439000,62159000,0,18778000,6942000,,,,,2129000,62159000,43381000,0,-6053000,,10596000,10494000,53688,MPB
2017-12-31,,,11589000,,7089000,25263000,42970000,0,13192000,4515000,,,,,4500000,42970000,29778000,0,-1603000,,7089000,7089000,53688,MPB
2019-12-31,68645000,,-109194000,,-109194000,9706000,0,-78351000,-78351000,,-14749000,,,,0,0,78351000,0,-30843000,,-109194000,-109194000,53689,BVXV
2018-12-31,71913000,,-87727000,,-87727000,5154000,0,-77067000,-77067000,,-9202000,,,,0,0,77067000,0,-10660000,,-87727000,-87727000,53689,BVXV
2017-12-31,18777000,,-34551000,,-34551000,4879000,0,-23656000,-23656000,,-9202000,,,,0,0,23656000,0,-10895000,,-34551000,-34551000,53689,BVXV
2016-12-31,7794000,,-9184000,,-9184000,4106000,0,-11900000,-11900000,,-9202000,,,,0,0,11900000,0,2716000,,-9184000,-9184000,53689,BVXV
2020-12-31,,,91946000,,66289000,494351000,796342000,0,215721000,86270000,,,,,25657000,796342000,580621000,0,-123775000,,66289000,56539000,53690,TCBIL
2019-12-31,,,396310000,,312015000,512113000,982160000,0,408576000,61471000,,,,,84295000,982160000,573584000,0,-12266000,,312015000,302265000,53690,TCBIL
2018-12-31,,,373351000,,293387000,443622000,905884000,0,397658000,64604000,,,,,79964000,905884000,508226000,0,-24307000,,293387000,283637000,53690,TCBIL
2017-12-31,,,325708000,,197063000,377564000,791584000,0,355655000,58365000,,,,,128645000,791584000,435929000,0,-29947000,,197063000,187313000,53690,TCBIL
2019-12-31,32700000,,54000000,1400000,45800000,349300000,466200000,84200000,84200000,,-21100000,,,,8100000,1137600000,1053400000,671400000,-30200000,,45900000,45800000,53691,TNC
2018-12-31,30700000,,35800000,1900000,33400000,348300000,445000000,66000000,66000000,,-23300000,,,,2300000,1123500000,1057500000,678500000,-30200000,,33500000,33400000,53691,TNC
2017-12-31,32000000,,-1300000,1971000,-6200000,320100000,407000000,54900000,54900000,,-25400000,,,,4900000,1003100000,948200000,596100000,-56200000,,-6200000,-6200000,53691,TNC
2016-12-31,34738000,,66491000,1971000,46614000,248359000,351595000,68498000,68498000,,-1279000,,,,19877000,808572000,740074000,456977000,-2156000,,46614000,46614000,53691,TNC
2020-12-31,22600000,,235100000,,186200000,149400000,465500000,293500000,293500000,,-42200000,,,,48900000,1216100000,922600000,750600000,-58400000,,186200000,186200000,53693,NGVT
2019-12-31,19700000,,227900000,,183700000,163400000,490400000,307300000,307300000,,-54600000,,,,44200000,1292900000,985600000,802500000,-79400000,,183700000,183700000,53693,NGVT
2018-12-31,21500000,,221800000,,169100000,132600000,418200000,264100000,264100000,,-33200000,,,,40000000,1133600000,869500000,715400000,-42300000,,181800000,169100000,53693,NGVT
2017-12-31,19800000,,174800000,14000000.0,126500000,106500000,329000000,202700000,202700000,,-18100000,,,,29600000,972400000,769700000,643400000,-27900000,,145200000,126500000,53693,NGVT
2019-12-31,,,-20676000,3703000,-21223000,20750000,17392000,-9482000,-9482000,,-2900000,,,,-146000,47415000,56897000,30023000,-11194000,,-20530000,-21223000,53696,XSPA
2018-12-31,,,-35909000,4029000,-37205000,23649000,18311000,-12736000,-12736000,,-1827000,,,,-278000,49644000,62380000,31333000,-23173000,-1115000.0,-35631000,-37205000,53696,XSPA
2017-12-31,,,-16001000,4956000,-28840000,24198000,17458000,-14716000,-14716000,,-731000,,,,111000,48823000,63539000,31365000,-1285000,-12277000.0,-16112000,-28840000,53696,XSPA
2016-12-31,,,-19279000,4641000,-24006000,8349000,5248000,-4418000,-4418000,,-1698000,,,,0,11986000,16404000,6738000,-14861000,-4724000.0,-19279000,-24006000,53696,XSPA
2019-12-31,,,84335000,,62906000,170981000,276478000,99839000,99839000,,-10747000,,,,21429000,1119138000,1019299000,842660000,-15504000,,62906000,62906000,53698,ALG
2018-12-31,10429000.0,,94531000,,73486000,151522000,256115000,101088000,101088000,,-5493000,,,,21045000,1008822000,907734000,752707000,-6557000,,73486000,73486000,53698,ALG
2017-12-31,9849000.0,,82367000,,44315000,142638000,234693000,88738000,88738000,,-4839000,,,,38052000,912380000,823642000,677687000,-6371000,,44315000,44315000,53698,ALG
2016-12-31,8847000.0,,62189000,,40045000,128632000,205099000,67620000,67620000,,-5914000,,,,22144000,844748000,777128000,639649000,-5431000,,40045000,40045000,53698,ALG
2020-09-30,21645000,,-636498000,,-494497000,167513000,550539000,-120781000,-120781000,5777000,-24474000,,,,-140106000,1773927000,1894708000,1223388000,-515717000,1895000,-496392000,-497144000,53699,HP
2019-09-30,27467000,,-51222000,,-33656000,194416000,995286000,221318000,221318000,5382000,-25188000,,,,-18712000,2798490000,2577172000,1803204000,-272540000,-1146000,-32510000,-36758000,53699,HP
2018-09-30,18167000,,15841000,,482672000,199257000,839711000,61132000,61132000,5053000,-24265000,,,,-477169000,2487268000,2426136000,1647557000,-45291000,-10338000,493010000,478326000,53699,HP
2017-09-30,12047000,,-184598000,,-128212000,147548000,555424000,-147114000,-147114000,5053000,-19747000,,,,-56735000,1804741000,1951855000,1249317000,-37484000,-349000,-127863000,-130023000,53699,HP
2019-12-31,14600000,,-16200000,,-16500000,29400000,32500000,-18000000,-18000000,,-3000000,,,,300000,209700000,227700000,177200000,1800000,,-16500000,-24300000,53700,LEU
2018-12-31,26100000,,-104100000,,-104100000,50500000,-17900000,-101100000,-101100000,,-4100000,,,,0,193000000,294100000,210900000,-3000000,,-104100000,-111900000,53700,LEU
2017-12-31,15700000,,12100000,,12200000,16500000,30200000,-12600000,-12600000,,-5300000,,,,-100000,218400000,231000000,188200000,24700000,,12200000,5300000,53700,LEU
2016-12-31,47900000,,-67600000,,-67000000,46200000,45100000,-61500000,-61500000,,-19700000,,,,-600000,311300000,372800000,266200000,-6100000,,-67000000,-67000000,53700,LEU
2019-12-31,,,-24192000,,-24610000,10583000,52494000,41911000,41911000,,-14128000,,,,418000,52494000,10583000,0,-66103000,,-24610000,-24610000,53702,FCRD
2018-12-31,,,-10244000,,-10599000,15033000,66942000,51909000,51909000,,-16730000,,,,355000,66942000,15033000,0,-62153000,,-10599000,-10599000,53702,FCRD
2017-12-31,,,-7736000,702000.0,-7904000,20136000,78773000,58637000,58637000,,-18755000,,,,168000,78773000,20136000,0,-66373000,,-7904000,-7904000,53702,FCRD
2016-12-31,,,17304000,715000.0,17149000,23513000,84585000,61072000,61072000,,-16217000,,,,155000,84585000,23513000,0,-43768000,,17149000,17149000,53702,FCRD
2019-10-31,,,3997000,,3997000,7537000,0,-7537000,-7537000,,,,,,0,0,7537000,0,11534000,,3997000,3997000,53703,RADI
2018-10-31,,,-147000,,-147000,6703000,0,-6703000,-6703000,,,,,,0,0,6703000,0,6556000,,-147000,-147000,53703,RADI
2019-12-31,,,18544000,1221000,18011000,12894000,69728000,35862000,35862000,-602000,-20826000,,,,0,83802000,47940000,14074000,-17318000,,18544000,16784000,53704,OLP
2018-12-31,,,21564000,1449000,20665000,12300000,67912000,31822000,31822000,-2000,-18847000,,,,0,79508000,47686000,11596000,-10258000,,21564000,19492000,53704,OLP
2017-12-31,,,24249000,1742000,24147000,11598000,65698000,32945000,32945000,481000,-18586000,,,,0,76742000,43797000,11044000,-8696000,,24249000,23075000,53704,OLP
2016-12-31,,,24481000,1794000,24422000,10992000,62151000,33294000,33294000,481000,-18162000,,,,0,71587000,38293000,9436000,-8813000,,24481000,23423000,53704,OLP
2019-12-31,11682000,,10802000,,10722000,17438000,39419000,10299000,10299000,,,,,,80000,43346000,33047000,3927000,503000,,10722000,10603000,53705,SMSI
2018-12-31,8602000,,-2727000,,-2740000,14391000,21952000,-1041000,-1041000,,-472000.0,,,,13000,26285000,27326000,4333000,-1686000,,-2740000,-3144000,53705,SMSI
2017-12-31,8952000,,-7207000,,-6661000,14737000,17892000,-5797000,-5797000,,-1120000.0,,,,-546000,22974000,28771000,5082000,-1410000,,-6661000,-6661000,53705,SMSI
2016-12-31,15906000,,-15572000,,-15343000,19556000,20671000,-14791000,-14791000,,-313000.0,,,,-229000,28235000,43026000,7564000,-781000,,-15343000,-15343000,53705,SMSI
2019-12-31,,,-12446458,,-12446458,7717163,-3254275,-10971438,-10971438,,-187549,,,,0,3498614,14470052,6752889,-1475020,,-12446458,-12446458,53707,OPGN
2018-12-31,,,-13368098,,-13368098,8600871,-4579371,-13180242,-13180242,,-191195,,,,0,2946307,16126549,7525678,-187856,,-13368098,-13368098,53707,OPGN
2017-12-31,,,-15419308,,-15419308,9460329,-5805462,-15265791,-15265791,,-233505,,,,0,3211007,18476798,9016469,-153517,,-15419308,-15419308,53707,OPGN
2016-12-31,,,-19166753,,-19166753,12131882,-6877455,-19009337,-19009337,,-143347,,,,0,4025685,23035022,10903140,-157416,,-19166753,-19499303,53707,OPGN
2019-12-31,11699000,,-17144000,,-17144000,80548000,79457000,-17325000,-17325000,,-1377000,,,,0,210430000,227755000,130973000,181000,,-17144000,-17144000,53709,CDLX
2018-12-31,16210000,,-53199000,,-53199000,76106000,54681000,-40917000,-40917000,,-3990000,,,,0,150684000,191601000,96003000,-12282000,,-53199000,-53199000,53709,CDLX
2017-12-31,12150000,,-25384000,,-25384000,52027000,50106000,-17099000,-17099000,,-8332000,,,,0,130365000,147464000,80259000,-8285000,,-25384000,-25384000,53709,CDLX
2016-12-31,13349000,,-76678000,,-76678000,51971000,41316000,-27023000,-27023000,,-6170000,,,,0,112821000,139844000,71505000,-49655000,,-76678000,-76678000,53709,CDLX
2020-12-31,407000000,,-512000000,,-545000000,165000000,182000000,-367000000,-367000000,-29000000,-11000000,,,,32000000,1373000000,1740000000,1191000000,-145000000,,-544000000,-545000000,53710,VNE
2019-12-31,562000000,,-521000000,89000000.0,-500000000,189000000,311000000,-460000000,-460000000,-29000000,-12000000,,,,1000000,1902000000,2362000000,1591000000,-61000000,,-522000000,-500000000,53710,VNE
2018-12-31,466000000,,-253000000,101000000.0,-276000000,156000000,430000000,-211000000,-211000000,-4000000,-1000000,,,,42000000,2228000000,2439000000,1798000000,-42000000,,-295000000,-276000000,53710,VNE
2017-12-31,375000000,,-314000000,122000000.0,-217000000,109000000,465000000,-61000000,-61000000,5000000,-1000000,,,,30000000,2322000000,2383000000,1857000000,-253000000,,-344000000,-217000000,53710,VNE
2019-12-31,,,21042000,,2563000,22714000,54691000,20747000,20747000,4488000,,,,,23890000,84521000,63774000,29830000,295000,5411000,-2848000,2545000,53712,EGY
2018-12-31,,,55474000,,98232000,11398000,64528000,55151000,55151000,-7554000,-448000.0,,,,-43254000,104943000,49792000,40415000,323000,-496000,98728000,97007000,53712,EGY
2017-12-31,,,20650000,,9651000,10377000,37328000,18619000,18619000,1416000,-1421000.0,,,,10378000,77025000,58406000,39697000,2031000,-621000,10272000,9593000,53712,EGY
2016-12-31,,,-9019000,,-26550000,9561000,22198000,-4423000,-4423000,8819000,-1747000.0,,,,9248000,59784000,64207000,37586000,-4596000,-8283000,-18267000,-26550000,53712,EGY
2019-12-31,205210000,,-134846000,,-90433000,531029000,601361000,-134878000,-134878000,,,,,,-44413000,911383000,1046261000,310022000,32000,,-90433000,-90433000,53713,PEGA
2018-12-31,181710000,,-11543000,,10617000,425138000,589816000,-17032000,-17032000,,,,,,-22160000,891581000,908613000,301765000,5489000,,10617000,10617000,53713,PEGA
2017-12-31,162886000,,86235000,,98548000,352731000,608794000,93177000,93177000,,,,,,-12313000,888467000,795290000,279673000,-6942000,,98548000,98548000,53713,PEGA
2016-12-31,145548000,,55335000,,45015000,323878000,522973000,53547000,53547000,,,,,,10320000,762229000,708682000,239256000,1788000,,45015000,45015000,53713,PEGA
2020-10-31,4381205,,-10092363,-496983,-10018355,5596997,0,-9978202,-9978202,,,,,,0,0,9978202,0,-114161,,-10092363,-10018355,53715,ANIX
2019-10-31,5473427,,-11818652,-422975,-11647054,5662828,83750,-11471255,-11471255,,,,,,0,250000,11721255,166250,-347397,,-11818652,-11647054,53715,ANIX
2018-10-31,6813043,,-14243084,-251377,-13996025,6911830,344090,-13706079,-13706079,,,,,,0,1112500,14818579,768410,-537005,,-14243084,-13996025,53715,ANIX
2017-10-31,1597550,,-5008991,-251377,-5008991,4410682,257944,-6075584,-6075584,,-500455.0,,,,0,362500,6438084,104556,1066593,,-5008991,-7017766,53715,ANIX
2019-12-31,,,-112576000,,-112576000,19260000,-25972000,-45232000,-45232000,,,,,,0,12519000,57751000,38491000,-67344000,,-112576000,-112576000,53716,CMRX
2018-12-31,,,-69474000,,-69474000,23582000,-48023000,-71605000,-71605000,,,,,,0,7216000,78821000,55239000,2131000,,-69474000,-69474000,53716,CMRX
2017-12-31,,,-70984000,,-70984000,27148000,-44954000,-72102000,-72102000,,,,,,0,4494000,76596000,49448000,1118000,,-70984000,-70984000,53716,CMRX
2016-12-31,,,-76390000,,-76390000,25007000,-52945000,-77952000,-77952000,,,,,,0,5702000,83654000,58647000,1562000,,-76390000,-76390000,53716,CMRX
2019-12-31,24875659,,-54746235,,-54746235,46684297,13291956,-58268000,-58268000,,-48612,,,,0,13291956,71559956,0,3521765,,-54746235,-54746235,53717,MGTX
2018-12-31,33620223,,-83340265,,-82865874,44483938,0,-78104161,-78104161,,-33429,,,,-474391,0,78104161,0,-5236104,,-82865874,-84672386,53717,MGTX
2017-12-31,22359712,,-31044535,,-31044535,9325017,0,-31684729,-31684729,,-42863,,,,0,0,31684729,0,640194,,-31044535,-31851498,53717,MGTX
2016-12-31,14037918,,-19792276,,-19486393,6026529,0,-20064447,-20064447,,-25440,,,,0,0,20064447,0,272171,,-19792276,-19571818,53717,MGTX
2019-12-31,,,-120809112,1969759,-119359219,27203156,-82005389,-109208545,-109208545,,-7948539,,,,-257335,4111930,113320475,86117319,-11600567,,-120551777,-119359219,53718,INO
2018-12-31,,,-94798019,96269,-96967830,29315159,-64775979,-94091138,-94091138,,-7948539,,,,2169811,30481897,124573035,95257876,-706881,,-96967830,-96967830,53718,INO
2017-12-31,,,-88205772,96269,-88205772,28290369,-56352532,-84642901,-84642901,,-25933,,,,0,42220086,126862987,98572618,-3562871,,-88205772,-88205772,53718,INO
2016-12-31,,,-73740339,96269,-73740339,23892263,-53343674,-77235937,-77235937,,-25933,,,,0,35368361,112604298,88712035,3495598,,-73740339,-73740339,53718,INO
2019-12-31,,,215231000,313284000,119648000,34213000,303343000,232772000,232772000,,-17538000,,,,0,410191000,177419000,106848000,-17541000,,215231000,117176000,53719,OMP
2018-12-31,,,147752000,312927000,51286000,23897000,202652000,150346000,150346000,,-2580000,,,,0,273770000,123424000,71118000,-2594000,,147752000,51174000,53719,OMP
2017-12-31,,,95405000,313446000,49215000,18597000,136690000,102363000,102363000,,-6965000,,,,22858000,182216000,79853000,45526000,-6958000,,72547000,11638000,53719,OMP
2016-12-31,,,64985000,313446000,40128000,12112000,91577000,70940000,70940000,,-5481000,,,,24857000,120852000,49912000,29275000,-5955000,,40128000,40128000,53719,OMP
2019-12-31,,,58504000,26266000,56724000,38142000,516456000,213849000,213849000,,-153185000,,,,1948000,707481000,493632000,191025000,-155345000,,56556000,56724000,53721,TGH
2018-12-31,,,56275000,29178000,50378000,41949000,503917000,206885000,206885000,,-139308000,,,,2025000,676872000,469987000,172955000,-150610000,,54250000,50378000,53721,TGH
2017-12-31,,,22360000,57740000,19365000,39677000,428010000,148471000,148471000,,-125025000,,,,1618000,587568000,439097000,159558000,-126111000,,20742000,19365000,53721,TGH
2016-12-31,,,-61323000,58859000,-52483000,34540000,417736000,125235000,125235000,,-85215000,,,,-3447000,594264000,469029000,176528000,-186558000,,-57876000,-52483000,53721,TGH
2020-09-30,,,-6805000,-414000,-6085000,88473000,110603000,13294000,13294000,,-9811000,,,,-493000,132327000,119033000,21724000,-20099000,,-6312000,-6085000,53722,RICK
2019-09-30,,,24189000,-156000,20294000,106578000,153142000,37492000,37492000,,-10209000,,,,3744000,181059000,143567000,27917000,-13303000,,20445000,20294000,53722,RICK
2018-09-30,,,17842000,-103000,20879000,96187000,140655000,36746000,36746000,,-9954000,,,,-3118000,165748000,129002000,25093000,-18904000,,20960000,20879000,53722,RICK
2017-09-30,,,14641000,2480000,8259000,84713000,122084000,30451000,30451000,,-8764000,,,,6359000,144896000,114445000,22812000,-15810000,,8282000,8259000,53722,RICK
2019-12-31,1161000,,-3727900,,-3727900,2544400,0,-3705400,-3705400,,-22500,,,,0,0,3705400,0,-22500,,-3727900,-3978500,53723,KRBP
2018-12-31,1321700,,-3815700,,-3815700,1860900,0,-3182600,-3182600,,-633100,,,,0,0,3182600,0,-633100,,-3815700,-3815700,53723,KRBP
2020-12-31,,,-245909000,,-230203000,30339000,411003000,61045000,61045000,,-75550000,,,,-447000,758982000,697937000,347979000,-306954000,,-245462000,-230203000,53724,MAC
2019-12-31,,,104143000,198708000.0,96820000,22634000,608479000,255119000,255119000,,-200771000,,,,1589000,976432000,721313000,367953000,-150976000,,102554000,95630000,53724,MAC
2018-12-31,,,65368000,238200000.0,60020000,24160000,661493000,309897000,309897000,,-182962000,,,,-3604000,1029797000,719900000,368304000,-244529000,,68972000,58914000,53724,MAC
2017-12-31,,,177267000,286421000.0,146130000,28240000,662129000,298458000,298458000,,-171776000,,,,15594000,1057440000,758982000,395311000,-121191000,,161673000,145373000,53724,MAC
2019-12-31,160000000,,4302000000,3632000000,3195000000,10224000000,13660000000,8975000000,8975000000,-5693000000,-5077000000,,,,819000000,120860000000,111885000000,107200000000,-4673000000,,3483000000,3195000000,53727,CEA
2018-12-31,135000000,,3867000000,3587000000,2709000000,9384000000,12222000000,7807000000,7807000000,-5083000000,-3621000000,,,,926000000,114930000000,107123000000,102708000000,-3940000000,,2941000000,2709000000,53727,CEA
2017-12-31,92000000,,8620000000,3412000000,6352000000,8902000000,11324000000,7011000000,7011000000,-4678000000,-3086000000,,,,1800000000,101721000000,94710000000,90397000000,1609000000,,6820000000,6352000000,53727,CEA
2016-12-31,92000000,,6507000000,2910000000,4508000000,8800000000,15963000000,6936000000,6936000000,237000000,-2641000000,,,,1542000000,98560000000,91624000000,82597000000,-429000000,,4965000000,4508000000,53727,CEA
2019-12-31,,,-148284000,,-22450000,94519000,54157000,-65074000,-65074000,24712000,-60267000,,,,-29676000,1775392000,1840466000,1721235000,-83210000,96158000,-118608000,-31032000,53728,RYAM
2018-12-31,,,126491000,,128416000,96644000,291147000,170923000,170923000,23580000,-55923000,,,,27040000,1956994000,1786071000,1665847000,-44432000,28965000,99451000,114616000,53728,RYAM
2017-12-31,,,342660000,,324964000,82600000,140753000,57596000,57596000,557000,-39967000,,,,19233000,940416000,882820000,799663000,285064000,1537000,323427000,311164000,53728,RYAM
2016-12-31,,,112601000,,73286000,42827000,186158000,144470000,144470000,-1139000,-34627000,,,,39315000,868731000,724261000,682573000,-31869000,1537000,73286000,67882000,53728,RYAM
2020-12-31,,,12760000,,9163000,35030000,51198000,0,13159000,3009000,,,,,3597000,51198000,38039000,0,-399000,,9163000,9163000,53730,BFIN
2019-12-31,,,15897000,,11672000,34334000,54582000,0,16181000,4067000,,,,,4225000,54582000,38401000,0,-284000,,11672000,11672000,53730,BFIN
2018-12-31,,,26048000,,19342000,35895000,65320000,0,25619000,3806000,,,,,6706000,65320000,39701000,0,429000,,19342000,19342000,53730,BFIN
2017-12-31,,,16194000,,9004000,32378000,56585000,0,19325000,4882000,,,,,7190000,56585000,37260000,0,-3131000,,9004000,9004000,53730,BFIN
2019-12-31,,,151500000,32600000,140100000,323500000,823600000,305600000,305600000,,-134900000,,,,10900000,1782200000,1476600000,958600000,-154100000,,140600000,138200000,53732,OUT
2018-12-31,,,112800000,42500000,107900000,287000000,746300000,274300000,274300000,,-125700000,,,,4900000,1606200000,1331900000,859900000,-161500000,,107900000,105200000,53732,OUT
2017-12-31,,,129900000,45500000,125800000,261700000,685300000,233800000,233800000,,-116900000,,,,4100000,1520500000,1286700000,835200000,-103900000,,125800000,124400000,53732,OUT
2016-12-31,,,96300000,100000,90900000,264800000,695800000,206800000,206800000,,-113800000,,,,5400000,1513900000,1307100000,818100000,-110500000,,90900000,90900000,53732,OUT
2019-12-31,58683000,,-274248000,,-272966000,189846000,157559000,-116606000,-116606000,,-21872000,,,,-1282000,192408000,309014000,34849000,-157642000,,-272966000,-272966000,53733,ACOR
2018-12-31,105183000,,20423000,,33682000,172154000,373793000,94786000,94786000,,-21597000,,,,-13259000,471433000,376647000,97640000,-74363000,,33682000,33682000,53733,ACOR
2017-12-31,160605000,,-251885000,,-223359000,179519000,476331000,112449000,112449000,,-18664000,,,,-28526000,588287000,475838000,111956000,-364334000,,-223359000,-223359000,53733,ACOR
2016-12-31,203437000,,-42268000,,-34618000,217837000,411492000,-9782000,-9782000,,-16527000,,,,-6665000,519601000,529383000,108109000,-32486000,,-35603000,-34618000,53733,ACOR
2020-12-31,,,1490000,,843000,44412000,45081000,669000,669000,,,,,,647000,62071000,61402000,16990000,821000,,843000,843000,53735,NHTC
2019-12-31,,,-5597000,,-5611000,62769000,57510000,-5259000,-5259000,,,,,,14000,77614000,82873000,20104000,-338000,,-5611000,-5611000,53735,NHTC
2018-12-31,,,34521000,,31035000,118811000,152543000,33732000,33732000,,,,,,3486000,191910000,158178000,39367000,789000,,31035000,31035000,53735,NHTC
2017-12-31,,,43426000,,23578000,115859000,158918000,43059000,43059000,,,,,,19848000,197563000,154504000,38645000,367000,,23578000,23578000,53735,NHTC
2019-12-31,,,2334000,4267000,-26429000,25462000,57265000,9056000,9056000,,-7904000,,,,28837000,276768000,267712000,219503000,-6722000,,-26503000,-26429000,53738,RDIB
2018-12-31,,,17464000,4337000,14034000,27337000,73236000,23624000,23624000,,-6837000,,,,3298000,308931000,285307000,235695000,-6160000,,14166000,14034000,53738,RDIB
2017-12-31,,,34169000,4331000,30865000,27147000,62672000,18583000,18583000,,-6194000,,,,3293000,279556000,260973000,216884000,15586000,,30876000,30865000,53738,RDIB
2016-12-31,,,13830000,4418000,9678000,26906000,62884000,20289000,20289000,,-6782000,,,,4138000,270866000,250577000,207982000,-6459000,,9692000,9678000,53738,RDIB
2019-12-31,,,380830000,,352687000,75867000,1309744000,697156000,697156000,,-316170000,,,,27551000,1388818000,691662000,79074000,-316326000,,353279000,339041000,53740,TRTN
2018-12-31,,,427313000,121513000.0,349555000,80033000,1356275000,731335000,731335000,,-322731000,,,,70641000,1404601000,673266000,48326000,-304022000,,356672000,349555000,53740,TRTN
2017-12-31,,,260252000,133542000.0,344598000,87609000,1140622000,548974000,548974000,-28000.0,-282347000,,,,-93274000,1203513000,654539000,62891000,-288722000,,353526000,344598000,53740,TRTN
2016-12-31,,,-5833000,143504000.0,-13517000,65618000,724709000,256279000,256279000,16000.0,-184014000,,,,-48000,808965000,552686000,84256000,-262112000,,-5785000,-13517000,53740,TRTN
2021-01-02,,,205201000,,155801000,413519000,628803000,215284000,215284000,,-9155000,,,,49400000,1091721000,876437000,462918000,-10083000,,155801000,155801000,53741,YETI
2019-12-28,20500000.0,,67258000,,50434000,365043000,475314000,89771000,89771000,,-21779000,,,,16824000,913734000,823963000,438420000,-22513000,,50434000,50434000,53741,YETI
2018-12-29,10800000.0,,69615000,,57763000,270172000,383128000,102156000,102156000,,-31280000,,,,11852000,778833000,676677000,395705000,-32541000,,57763000,57763000,53741,YETI
2017-12-30,8800000.0,,32059000,,15401000,221834000,294601000,63967000,63967000,,-32607000,,,,16658000,639239000,575272000,344638000,-31908000,,15401000,15401000,53741,YETI
2019-12-31,,,-157308520,281157393,-69059517,30811998,102237642,17574956,17574956,1732321,-5813702,,,,899425,109957591,92382635,7719949,-174883476,,-158207945,-83032282,53745,KRP
2018-12-31,,,-52257542,291932233,-50426542,21499641,62526995,19145859,19145859,-3331548,-4091900,,,,24681,66926662,47780803,4399667,-71403401,,-52282223,-56767549,53745,KRP
2017-12-31,,,1218884,291932233,1218884,10483256,28511693,2049628,2049628,318829,-830744,,,,0,30983402,28933774,2471709,-830744,,1218884,1218884,53745,KRP
2016-12-31,,,-6192771,291932233,-6212619,2497010,3326185,-775033,-775033,318829,-424841,,,,19848,3606659,4381692,280474,-5417738,,-6212619,-6212619,53745,KRP
2020-12-31,,,882525000,,704216000,567410000,1792492000,972265000,972265000,-1985000,-129803000,,,,178309000,2388855000,1416590000,596363000,-89740000,,704216000,704216000,53746,FLT
2019-12-31,,,1077819000,,895073000,612016000,2118179000,1233249000,1233249000,-1296000,-150048000,,,,182746000,2648848000,1415599000,530669000,-155430000,,895073000,895073000,53746,FLT
2018-12-31,,,1095125000,,811483000,571765000,1945797000,1099398000,1099398000,25000,-138494000,,,,283642000,2433492000,1334094000,487695000,-4273000,,811483000,811483000,53746,FLT
2017-12-31,,,893590000,,740200000,558411000,1706792000,883760000,883760000,61000,-107146000,,,,153390000,2249538000,1365778000,542746000,9830000,,740200000,740200000,53746,FLT
2019-12-31,,,793815,,577415,14994383,20098620,5104237,5104237,,-4310422,,,,216400,88789889,83685652,68691269,-4310422,,577415,-1860469,53748,FPAY
2018-12-31,,,-9461262,,-9461262,15808627,10630411,-5178216,-5178216,,-4156424,,,,0,61489180,66667396,50858769,-4283046,,-9461262,-11888102,53748,FPAY
2017-12-31,,,-8330761,,-8330761,6426230,26731604,-6162499,-6162499,7218714.0,-2168262,,,,0,67046364,73208863,40314760,-2168262,,-8330761,-10647157,53748,FPAY
2016-12-31,,,-12253707,,-12253707,10467352,18210640,-10328523,-10328523,4654261.0,-1925184,,,,0,47579585,57908108,29368945,-1925184,,-12253707,-13465671,53748,FPAY
2019-12-31,24234000,,-32903000,,-32900000,9085000,0,-33319000,-33319000,,-23000,,,,-3000,0,33319000,0,416000,,-32900000,-33259000,53750,LPTX
2018-12-31,21074000,,-23118000,,-23138000,8921000,0,-29995000,-29995000,,-19000,,,,20000,0,29995000,0,6877000,,-23138000,-23138000,53750,LPTX
2017-12-31,20788000,,-29884000,,-29727000,9849000,0,-30637000,-30637000,,-649000,,,,-157000,0,30637000,0,753000,,-29727000,-29971000,53750,LPTX
2016-12-31,20163000,,-25632000,,-25632000,4012000,0,-24175000,-24175000,,-1233000,,,,0,0,24175000,0,-1457000,,-25632000,-25632000,53750,LPTX
2019-12-31,12272000,,3790000,,3750000,25706000,41512000,3315000,3315000,,,,,,40000,90617000,87302000,49105000,475000,,3750000,3750000,53752,PCTI
2018-12-31,11851000,,-5062000,,-12889000,23738000,31381000,-4626000,-4626000,,,,,,7827000,82979000,87605000,51598000,-436000,,-12889000,-12889000,53752,PCTI
2017-12-31,11142000,,1538000,,3822000,25440000,38811000,1733000,1733000,,,,,,-2471000,91437000,89704000,52626000,-195000,-187000.0,4009000,3822000,53752,PCTI
2016-12-31,10158000,,-1021000,,-17681000,24621000,34411000,-899000,-899000,,,,,,11776000,85006000,85905000,50595000,-122000,-4884000.0,-12797000,-17681000,53752,PCTI
2019-12-31,36810000,,21998000,,14313000,76370000,134995000,21815000,21815000,,-2686000,,,,7685000,195892000,174077000,60897000,183000,,14313000,14313000,53758,EGRX
2018-12-31,44419000,,34038000,,31903000,60509000,151396000,46468000,46468000,,-2736000,,,,2135000,213312000,166844000,61916000,-11667000,,31903000,31903000,53758,EGRX
2017-12-31,32607000,,72945000,,51943000,71416000,179521000,75498000,75498000,,-1136000,,,,21002000,236707000,161209000,57186000,-2553000,,51943000,51943000,53758,EGRX
2016-12-31,28289000,,53427000,,81453000,53329000,134176000,52558000,52558000,,-8000,,,,-28026000,189482000,136924000,55306000,869000,,81453000,81453000,53758,EGRX
2020-12-31,,,103972000,,120632000,75587000,901616000,0,190133000,635896000,,,,,-16660000,901616000,711483000,0,-86161000,,120632000,120632000,53759,SSB
2019-12-31,,,230425000,,186483000,338196000,635063000,0,265374000,31493000,,,,,43942000,635063000,369689000,0,-34949000,,186483000,186483000,53759,SSB
2018-12-31,,,224255000,,178871000,335560000,645182000,0,280247000,29375000,,,,,45384000,645182000,364935000,0,-55992000,,178871000,178871000,53759,SSB
2017-12-31,,,168805000,,87554000,276919000,537125000,0,234306000,25900000,,,,,81251000,537125000,302819000,0,-65501000,,87554000,87554000,53759,SSB
2019-12-31,4420000,,-32147000,,-32147000,52524000,25769000,-31300000,-31300000,125000,-847000,,,,0,46291000,77591000,20522000,-847000,,-32147000,-32147000,53760,CDXC
2018-12-31,5478000,,-33316000,,-33316000,43674000,16055000,-33172000,-33172000,75000,-79000,,,,0,31557000,64729000,15502000,-144000,,-33316000,-33316000,53760,CDXC
2017-12-30,4007000,,-16530000,,-11378000,22101000,10477000,-15631000,-15631000,75000,-153000,,,,0,21201000,36832000,10724000,-899000,5152000.0,-16530000,-11378000,53760,CDXC
2016-12-31,2522768,,-3551595,,-2928185,10672976,10390534,-2805210,-2805210,75000,-333286,,,,0,21664648,24469858,11274114,-746385,623410.0,-3551595,-2928185,53760,CDXC
2019-12-28,6024567,,16205971,,13266142,34535188,61852549,21292794,21292794,,-1857961,,,,2939829,251742619,230449825,189890070,-5086823,,13266142,13266142,53761,EML
2018-12-29,6950969,,17590329,,14505937,33027735,58725045,18746341,18746341,,-1202272,,,,3084392,234275463,215529122,175550418,-1156012,,14505937,14505937,53761,EML
2017-12-30,5622829,,11454942,,5045255,31094289,51044544,14327426,14327426,,-976512,,,,6409687,204239613,189912187,153195069,-2872484,,5045255,5045255,53761,EML
2016-12-31,2568307,,11223415,,7785323,22642031,36346210,11135872,11135872,,-121500,,,,3438092,137608258,126472386,101262048,87543,,7785323,7785323,53761,EML
2019-12-31,40300000,,-165000000,,-157700000,1268800000,1372300000,63200000,63200000,,-211200000,,,,200000,2419600000,2356400000,1047300000,-228200000,7500000,-165200000,-157700000,53762,REV
2018-12-31,42400000,,-291900000,,-294200000,1417500000,1447500000,-12400000,-12400000,,-189400000,,,,2200000,2564500000,2576900000,1117000000,-279500000,-100000,-294100000,-294200000,53762,REV
2017-12-31,35700000,,-163500000,,-183200000,1430900000,1558600000,92000000,92000000,500000.0,-158800000,,,,21800000,2693700000,2601700000,1135100000,-255500000,2100000,-185300000,-183200000,53762,REV
2016-12-31,37000000,,8500000,,-21900000,1121700000,1438300000,277300000,277300000,2300000.0,-111300000,,,,25500000,2334000000,2056700000,895700000,-268800000,-4900000,-17000000,-21900000,53762,REV
2020-12-31,,,19657000,,15501000,23088000,50495000,0,20333000,7074000,,,,,4156000,50495000,30162000,0,-676000,,15501000,15501000,53763,FVCB
2019-12-31,,,20012000,,15828000,24473000,48889000,0,20774000,3642000,,,,,4184000,48889000,28115000,0,-762000,,15828000,15828000,53763,FVCB
2018-12-31,,,13107000,,10869000,19730000,39555000,0,17033000,2792000,,,,,2238000,39555000,22522000,0,-3926000,,10869000,10869000,53763,FVCB
2017-12-31,,,14536000,,7690000,16715000,33883000,0,14940000,2228000,,,,,6846000,33883000,18943000,0,-404000,,7690000,7690000,53763,FVCB
2020-08-29,,,177888000,,135770000,361801000,639227000,172729000,172729000,,,,,,42118000,1804159000,1631430000,1164932000,5159000,,135770000,135770000,53765,UNF
2019-08-31,,,237924000,,179134000,339940000,670181000,226908000,226908000,,,,,,58790000,1809376000,1582468000,1139195000,11016000,,179134000,179134000,53765,UNF
2018-08-25,,,187246000,,163895000,353527000,639765000,189576000,189576000,,,,,,23351000,1696489000,1506913000,1056724000,-2330000,,163895000,163895000,53765,UNF
2017-08-26,,,115123000,,70196000,337007000,597369000,171483000,171483000,,,,,,44927000,1590958000,1419475000,993589000,-56360000,,70196000,69818000,53765,UNF
2020-01-31,,,-1169000,52599000,7427000,19258000,12485000,-6773000,-6773000,,,,,,-12813000,418034000,424807000,405549000,5604000,,11644000,7427000,53766,REX
2019-01-31,,,14588000,52334000,31645000,20551000,30215000,9664000,9664000,,,,,,-22922000,486671000,477007000,456456000,4924000,,37510000,31645000,53766,REX
2018-01-31,,,25393000,50434000,39706000,19760000,44161000,24401000,24401000,,,,,,-19519000,452586000,428185000,408425000,992000,,44912000,39706000,53766,REX
2017-01-31,,,56911000,47839000,32333000,21388000,71039000,49651000,49651000,,,,,,17393000,453799000,404148000,382760000,7260000,,39518000,32333000,53766,REX
2019-12-31,,,-115613000,961518000,-100661000,42683000,500939000,290215000,290215000,,-234787000,,,,0,664373000,374158000,163434000,-405828000,,-115613000,-110724000,53767,GLOG
2018-12-31,,,126398000,1103380000,47683000,41993000,487704000,292518000,292518000,,-167182000,,,,0,636162000,343644000,148458000,-166120000,,126398000,37620000,53767,GLOG
2017-12-31,,,84209000,845105000,15506000,39850000,394593000,217556000,217556000,,-135484000,,,,0,532483000,314927000,137890000,-133347000,,84209000,5442000,53767,GLOG
2016-12-31,,,28051000,564039000,-21486000,38642000,338243000,176644000,176644000,,-122713000,,,,0,461385000,284741000,123142000,-148593000,,28051000,-31549000,53767,GLOG
2020-12-31,,,671000000,2861000000,399000000,,6240000000,1258000000,1258000000,4125000000,-1003000000,,,,-97000000,17640000000,16382000000,11400000000,-587000000,,768000000,399000000,53769,THC
2019-12-31,,,296000000,2360000000,-232000000,344000000.0,6695000000,2030000000,2030000000,3471000000,-985000000,,,,153000000,18479000000,16449000000,11784000000,-1734000000,11000000.0,143000000,-232000000,53769,THC
2018-12-31,,,639000000,2226000000,111000000,319000000.0,6659000000,1989000000,1989000000,3549000000,-1004000000,,,,176000000,18313000000,16324000000,11654000000,-1350000000,3000000.0,463000000,111000000,53769,THC
2017-12-31,,,-101000000,2552000000,-704000000,319000000.0,6794000000,1666000000,1666000000,4258000000,-1028000000,,,,219000000,19179000000,17513000000,12385000000,-1767000000,3000000.0,-320000000,-704000000,53769,THC
2020-12-31,,,463328000,5325000,431450000,131663000,1244765000,848857000,848857000,,-328728000,,,,31056000,1269655000,420798000,24890000,-385529000,,432272000,429345000,53771,MPW
2019-12-31,,,373780000,107000,374684000,96411000,846256000,597532000,597532000,,-237830000,,,,-2621000,870248000,272716000,23992000,-223752000,,376401000,372376000,53771,MPW
2018-12-31,,,1019404000,13830000,1016685000,80086000,788533000,575364000,575364000,,-223274000,,,,927000,798687000,223323000,10154000,444040000,,1018477000,1013000000,53771,MPW
2017-12-31,,,293919000,14572000,289793000,58599000,679347000,495642000,495642000,,-176954000,,,,2681000,714803000,219161000,35456000,-201723000,,291238000,288384000,53771,MPW
2019-12-31,,,-94448000,562000,-93321000,13649000,54801000,6453000,6453000,6635000,-18616000,,,,-1127000,107688000,101235000,52887000,-100901000,,-93321000,-93321000,53772,CTT
2018-12-31,,,-122007000,562000,-122007000,13085000,49226000,3926000,3926000,6303000,-16255000,,,,0,100490000,96564000,51264000,-125933000,,-122007000,-122007000,53772,CTT
2017-12-31,,,-13510000,562000,-13510000,12281000,44144000,-2436000,-2436000,5264000,-11187000,,,,0,92433000,94869000,48289000,-11074000,,-13510000,-13510000,53772,CTT
2016-12-31,,,-11070000,562000,-11070000,9934000,39440000,-4408000,-4408000,5017000,-6706000,,,,0,81855000,86263000,42415000,-6662000,,-11070000,-11070000,53772,CTT
2019-12-31,11600000,,40587000,,209829000,151101000,240805000,78104000,78104000,,-17202000,,,,-15859000,761608000,683504000,520803000,-37517000,153383000,56446000,209829000,53773,KAMN
2018-12-31,9100000,,25136000,,54169000,146923000,227317000,71294000,71294000,,-20046000,,,,9259000,735994000,664700000,508677000,-46158000,38292000,15877000,54169000,53773,KAMN
2017-12-31,8200000,,44922000,,49826000,156827000,234029000,69002000,69002000,,-19192000,,,,25214000,724944000,655942000,490915000,-24080000,30118000,19708000,49826000,53773,KAMN
2016-12-31,7700000,,89704000,,58854000,426590000,544021000,107266000,107266000,2465000.0,-15747000,,,,30850000,1808376000,1701110000,1264355000,-17562000,30118000,58854000,58854000,53773,KAMN
2020-02-29,42306000,,-51236000,,-51365000,56204000,59389000,-47637000,-47637000,,-3131000,,,,129000,132507000,180144000,73118000,-3599000,,-51365000,-51365000,53774,ACCD
2019-02-28,35708000,,-56441000,,-56496000,43121000,34243000,-53977000,-53977000,,-2916000,,,,55000,94811000,148788000,60568000,-2464000,,-56496000,-56496000,53774,ACCD
2018-02-28,31487000,,-61286000,,-61286000,43385000,23393000,-59461000,-59461000,,-1799000,,,,0,76828000,136289000,53435000,-1825000,,-61286000,-61286000,53774,ACCD
2019-12-31,,,173177000,-1299000,117695000,78818000,358091000,234734000,234734000,193000,-60852000,,,,37764000,638648000,403914000,280557000,-61557000,,135413000,117695000,53777,PLNT
2018-12-31,,,131804000,-8215000,88021000,72446000,293053000,185466000,185466000,-119000,-50746000,,,,28642000,530704000,345238000,237651000,-53662000,,103162000,88021000,53777,PLNT
2017-12-31,,,429181000,-17451000,33146000,60369000,240019000,147377000,147377000,512000,-35337000,,,,373580000,429942000,282565000,189923000,281804000,,55601000,33146000,53777,PLNT
2016-12-31,,,89908000,-83996000,21500000,50008000,195803000,114293000,114293000,512000,-27146000,,,,18661000,378241000,263948000,182438000,-24385000,,71247000,21500000,53777,PLNT
2020-02-29,,,64890000,,48234000,132053000,239228000,107175000,107175000,,-13463000,,,,16656000,1061817000,954642000,822589000,-42285000,,48234000,48234000,53778,AZZ
2019-02-28,,,63005000,,51208000,121665000,199921000,78256000,78256000,,-14971000,,,,11797000,927087000,848831000,727166000,-15251000,,51208000,51208000,53778,AZZ
2018-02-28,,,30899000,,45169000,112061000,171143000,59082000,59082000,,-13860000,,,,-14270000,810430000,751348000,639287000,-28183000,,45169000,45169000,53778,AZZ
2017-02-28,,,85297000,,61264000,105124000,211934000,106810000,106810000,,-14732000,,,,24033000,863538000,756728000,651604000,-21513000,,61264000,61264000,53778,AZZ
2019-12-31,,,-21743000,57017000,-15958000,20305000,19963000,-13721000,-13721000,,-39860000,,,,0,45657000,59378000,25694000,-8022000,,-21743000,-15959000,53782,ARL
2018-12-31,,,183902000,62802000,173699000,24814000,62882000,15398000,15398000,,-66063000,,,,1210000,122469000,107071000,59587000,168504000,,182692000,172798000,53782,ARL
2017-12-31,,,-8696000,53809000,-8431000,19023000,62439000,17737000,17737000,,-66171000,,,,180000,126530000,108793000,64091000,-26433000,,-8876000,-9536000,53782,ARL
2016-12-31,,,-2363000,54254000,-2732000,18294000,57206000,15127000,15127000,,-59362000,,,,46000,120156000,105029000,62950000,-17490000,-1000.0,-2409000,-3833000,53782,ARL
2020-03-31,,,-291132713,,-291132713,33733029,122151901,88418872,88418872,,-15479924,,,,0,122151901,33733029,0,-379551585,,-291132713,-291132713,53783,OXLCO
2019-03-31,,,-20981998,,-20981998,25262087,89398979,64136892,64136892,,-15051475,,,,0,89398979,25262087,0,-85118890,,-20981998,-20981998,53783,OXLCO
2018-03-31,,,38005588,,38005588,21061618,74815772,53754154,53754154,,-13400159,,,,0,74815772,21061618,0,-15748566,,38005588,38005588,53783,OXLCO
2017-03-31,,,105201826,,105201826,16089994,57944128,41854134,41854134,,-11711709,,,,0,57944128,16089994,0,63347692,,105201826,105201826,53783,OXLCO
2020-12-31,,,7996000000,2389000000,5581000000,9000000,50724000000,9358000000,9358000000,41357000000,-728000000,,,,1923000000,50724000000,41366000000,0,-1362000000,,6073000000,5581000000,53784,UL
2019-12-31,840000000.0,,8289000000,694000000,5625000000,12121000000,22878000000,9917000000,9917000000,41357000000,-757000000,,,,2263000000,51980000000,42063000000,29102000000,-1628000000,,6026000000,5625000000,53784,UL
2018-12-31,900000000.0,,12360000000,720000000,9369000000,11941000000,22279000000,9438000000,9438000000,41427000000,-754000000,,,,2572000000,50982000000,41544000000,28703000000,2922000000,,9788000000,9369000000,53784,UL
2018-01-01,900000000.0,,8126000000,758000000,6023000000,12927000000,23231000000,9404000000,9404000000,44031000000,-696000000,,,,1670000000,53715000000,44311000000,30484000000,-1278000000,,6456000000,6023000000,53784,UL
2019-12-31,,,138114000,81549000,55707000,1647676000,1842190000,0,86791000,107723000,,,,,53171000,2045154000,1958363000,202964000,51323000,,84943000,55707000,53785,BGCP
2018-12-31,,,179817000,119507000,197520000,1508628000,1693509000,0,122172000,62709000,,,,,76120000,1893577000,1771405000,200068000,57645000,123816000.0,103697000,194142000,53785,BGCP
2017-12-31,,,4136000,552270000,51475000,1448334000,1495664000,0,-20315000,67645000,,,,,92772000,1673993000,1694308000,178329000,24451000,176278000.0,-88636000,51475000,53785,BGCP
2016-12-31,,,120461000,502557000,185022000,1256827000,1329290000,0,28123000,44340000,,,,,56339000,1496691000,1468568000,167401000,92338000,190905000.0,64122000,185022000,53785,BGCP
2020-05-31,,,489221000,136516000,413333000,1590780000,1989783000,399003000,399003000,,-4627000,,,,134362000,3578682000,3179679000,1588899000,90218000,,354859000,413333000,53787,EDU
2019-05-31,,,313560000,164411000,238065000,1418315000,1720222000,301907000,301907000,,-1615000,,,,85714000,3096491000,2794584000,1376269000,11653000,,227846000,238065000,53787,EDU
2018-05-31,,,356645000,223106000,296130000,1118731000,1381690000,262959000,262959000,,-1615000,,,,59408000,2447430000,2184471000,1065740000,93686000,,297237000,296130000,53787,EDU
2017-05-31,,,327420000,39130000,274457000,787774000,1049923000,262149000,262149000,,-1615000,,,,50624000,1799509000,1537360000,749586000,65271000,,276796000,274457000,53787,EDU
2020-12-31,,,88086000,,73883000,121721000,247473000,0,111560000,14192000,,,,,14203000,247473000,135913000,0,-23474000,,73883000,73883000,53788,VBTX
2019-12-31,,,115860000,,90739000,114244000,293663000,0,165707000,13712000,,,,,25121000,293663000,127956000,0,-49847000,,90739000,90739000,53788,VBTX
2018-12-31,,,50237000,,39341000,55201000,119496000,0,58924000,5371000,,,,,10896000,119496000,60572000,0,-8687000,,39341000,39341000,53788,VBTX
2017-12-31,,,28181000,,15152000,34834000,70970000,0,31836000,4300000,,,,,13029000,70970000,39134000,0,-3655000,,15152000,15110000,53788,VBTX
2020-12-31,,,122842000,,100560000,1726792000,2371359000,522967000,522967000,,-226591000,,,,22803000,12325995000,11803028000,9954636000,-400125000,,100039000,70421000,53792,WCC
2019-12-31,,,282061000,-6812000.0,223426000,1168641000,1581461000,350713000,350713000,,-69252000,,,,59863000,8358917000,8008204000,6777456000,-68652000,,222198000,223426000,53792,WCC
2018-12-31,,,281025000,-5584000.0,227343000,1150066000,1567381000,354318000,354318000,,-69493000,,,,55670000,8176601000,7822283000,6609220000,-73293000,,225355000,227343000,53792,WCC
2017-12-31,,,252440000,-3596000.0,163460000,1099799000,1484655000,320839000,320839000,,-68399000,,,,89307000,7679021000,7358182000,6194366000,-68399000,,163133000,163460000,53792,WCC
2019-12-31,,,70210000,,70214000,15098000,106815000,0,70210000,18531000,,,,,-4000,110485000,40275000,3670000,0,,70214000,70114000,53793,GPMT
2018-12-31,,,63073000,,63075000,12509000,91607000,0,63073000,13428000,,,,,-2000,93803000,30730000,2196000,0,,63075000,62975000,53793,GPMT
2017-12-31,,,53301000,,53305000,9737000,74020000,0,53301000,10982000,,,,,-4000,75374000,22073000,1354000,0,,53305000,25773000,53793,GPMT
2016-12-31,,,35346000,,35357000,7173000,49397000,0,35346000,6878000,,,,,-11000,50002000,14656000,605000,0,,35357000,35357000,53793,GPMT
2020-08-31,13950000,,48843000,,38629000,84391000,152543000,54202000,54202000,,-4759000,,,,10214000,474692000,420490000,322149000,-5359000,,38629000,38629000,53794,LNN
2019-08-31,13936000,,2107000,,2172000,94557000,114608000,6115000,6115000,,-4767000,,,,-65000,444072000,437957000,329464000,-4008000,,2172000,2172000,53794,LNN
2018-08-31,16032000,,33853000,,20277000,96418000,151462000,39012000,39012000,,-4687000,,,,13576000,547705000,508693000,396243000,-5159000,,20277000,20277000,53794,LNN
2017-08-31,17147000,,35715000,,23179000,87616000,145012000,40249000,40249000,,-4757000,,,,12536000,517985000,477736000,372973000,-4534000,,23179000,23179000,53794,LNN
2019-12-31,51418056,,-41907079,,-41907079,6163586,0,-59265316,-59265316,,-422989,,,,0,0,59265316,0,17358237,,-41907079,-41907079,53795,TMDI
2018-12-31,32858339,,-22639272,,-22639272,5297337,0,-39690342,-39690342,,-422989,,,,0,0,39690342,0,17051070,,-22639272,-22639272,53795,TMDI
2017-12-31,12900855,,-33586984,,-33586984,5965841,0,-18884056,-18884056,,-422989,,,,0,0,18884056,0,-14702928,,-33586984,-33586984,53795,TMDI
2016-12-31,22577885,,-23323496,,-23323496,4925265,0,-27527790,-27527790,,-422989,,,,0,0,27527790,0,4204294,,-23323496,-23323496,53795,TMDI
2019-12-31,,,-18070161,,-18070161,18707132,284137,-18422995,-18422995,,-82908,,,,0,1490529,19913524,1206392,352834,,-18070161,-18070161,53797,AVCO
2018-12-31,,,-8052296,-862200.0,-7774122,8019149,335045,-7684104,-7684104,,-314653,,,,0,1509317,9193421,1174272,-368192,,-8052296,-7774122,53797,AVCO
2017-12-31,,,-4049645,-585394.0,-3464285,2703052,247763,-2455289,-2455289,,-138110,,,,0,1077550,3532839,829787,-1594356,,-4049645,-3464285,53797,AVCO
2016-12-31,,,77508,-585394.0,55581,466447,543380,76933,76933,,-138110,,,,21927,616446,539513,73066,575,,55581,55581,53797,AVCO
2020-03-31,,,140744000,82610000,60825000,59100000,175529000,116429000,116429000,,-2816000,,,,13968000,274048000,157619000,98519000,24315000,,126776000,60825000,53798,HLNE
2019-03-31,,,129557000,59496000,33573000,50236000,159560000,109324000,109324000,,-3039000,,,,30560000,252179000,142855000,92619000,20233000,,98997000,33573000,53798,HLNE
2018-03-31,,,139630000,57648000,17341000,38212000,164564000,126352000,126352000,,-5989000,,,,33333000,244033000,117681000,79469000,13278000,,106297000,17341000,53798,HLNE
2017-03-31,,,74754000,26585000,612000,31589000,107704000,76115000,76115000,,-14565000,,,,316000,179820000,103705000,72116000,-1361000,,74438000,612000,53798,HLNE
2020-12-30,,,10473000,,8442000,,61677000,0,10473000,51204000,,,,,2031000,61677000,51204000,0,0,,8442000,8442000,53799,CVLY
2019-12-31,,,23672000,,18647000,43460000.0,75401000,0,26578000,5363000,,,,,5025000,75401000,48823000,0,-2906000,,18647000,18647000,53799,CVLY
2018-12-31,,,24724000,,19542000,41927000.0,74534000,0,27623000,4984000,,,,,5182000,74534000,46911000,0,-2899000,,19542000,19542000,53799,CVLY
2017-12-31,,,21908000,,12004000,37864000.0,66894000,0,23978000,5052000,,,,,9904000,66894000,42916000,0,-2070000,,12004000,12004000,53799,CVLY
2020-12-31,,,10722000,,8305000,34065000,54342000,0,14050000,6227000,,,,,2417000,54342000,40292000,0,-3328000,,8305000,8305000,53800,PFHD
2019-12-31,,,2992000,,2336000,23249000,29989000,0,2992000,3748000,,,,,656000,29989000,26997000,0,0,,2336000,2336000,53800,PFHD
2018-12-31,,,2775000,,2106000,17157000,22637000,0,2775000,2705000,,,,,669000,22637000,19862000,0,0,,2106000,2106000,53800,PFHD
2017-12-31,,,3658000,,1814000,11245000,16783000,0,3658000,1880000,,,,,1844000,16783000,13125000,0,0,,1814000,1814000,53800,PFHD
2019-12-31,,,52464000,,52464000,4174000,31192000,27018000,27018000,,-3302000,,,,0,31192000,4174000,0,25446000,,52464000,48573000,53803,PMX
2018-12-31,,,5928000,,5928000,4237000,31677000,27440000,27440000,,-2471000,,,,0,31677000,4237000,0,-21512000,,5928000,1796000,53803,PMX
2017-12-31,,,37534000,,37534000,4226000,30316000,26090000,26090000,,-716000,,,,0,30316000,4226000,0,11444000,,37534000,34926000,53803,PMX
2016-12-31,,,10559000,,10559000,4248000,29908000,25660000,25660000,,-366000,,,,0,29908000,4248000,0,-15101000,,10559000,9156000,53803,PMX
2019-12-31,,,-91125000,,-79044000,51552000,81224000,-87361000,-87361000,,-4958000,,,,-12081000,625012000,712373000,543788000,-3764000,,-79044000,-79044000,53806,TUSK
2018-12-31,,,389228000,,235965000,73097000,596280000,403306000,403306000,,-3187000,,,,153263000,1690084000,1286778000,1093804000,-14078000,,235965000,235965000,53806,TUSK
2017-12-31,,,61796000,,58964000,49886000,208927000,66917000,66917000,,-4310000,,,,2832000,691496000,624579000,482569000,-5121000,,58964000,58964000,53806,TUSK
2016-12-31,,,-38568000,,-24140000,18048000,57604000,-32759000,-32759000,,-4096000,,,,-14428000,230625000,263384000,173021000,-5809000,,-24140000,-24140000,53806,TUSK
2019-12-31,29209000000,,22855000000,34507000000,12826000000,50155000000,119603000000,25462000000,25462000000,,-74000000,,,,11656000000,175391000000,149929000000,55788000000,-2607000000,,11199000000,12826000000,53808,YNDX
2018-12-31,22579000000,,52459000000,35771000000,45984000000,35724000000,91764000000,21324000000,21324000000,,-945000000,,,,8201000000,127657000000,106333000000,35893000000,31135000000,,44258000000,45984000000,53808,YNDX
2017-12-31,18866000000,,14097000000,9821000000,9201000000,26836000000,70102000000,13161000000,13161000000,,-897000000,,,,5016000000,94054000000,80893000000,23952000000,936000000,,9081000000,9201000000,53808,YNDX
2016-12-31,15832000000,,11107000000,1506000000,6798000000,17885000000,56171000000,12847000000,12847000000,,-1208000000,,,,4324000000,75925000000,63078000000,19754000000,-1740000000,,6783000000,6798000000,53808,YNDX
2019-12-31,,,29254316,,29254316,5413571,27781915,22368344,22368344,,-4260823,,,,0,27781915,5413571,0,6885972,,29254316,29254316,53810,AIF
2018-12-31,,,-740183,,-740183,5626585,28837515,23210930,23210930,,-4023132,,,,0,28837515,5626585,0,-23951113,,-740183,-740183,53810,AIF
2017-12-31,,,22427155,,22427155,5725550,27276649,21551099,21551099,,-3183260,,,,0,27276649,5725550,0,876056,,22427155,22427155,53810,AIF
2016-12-31,,,39370498,,39370498,5510421,29646217,24135796,24135796,,-2421760,,,,0,29646217,5510421,0,15234702,,39370498,39370498,53810,AIF
2020-12-31,,,-1307000000,93000000,-1165000000,316000000,250000000,-712000000,-712000000,3000000,-295000000,,,,-142000000,9741000000,10453000000,9491000000,-595000000,,-1165000000,-1165000000,53812,X
2019-12-31,,,-452000000,1000000,-630000000,461000000,936000000,-126000000,-126000000,-15000000,-149000000,,,,178000000,12937000000,13063000000,12001000000,-326000000,,-630000000,-630000000,53812,X
2018-12-31,,,812000000,1000000,1115000000,405000000,1873000000,950000000,950000000,-3000000,-176000000,,,,-303000000,14178000000,13228000000,12305000000,-138000000,,1115000000,1115000000,53812,X
2017-12-31,,,301000000,1000000,387000000,381000000,1392000000,522000000,522000000,-12000000,-236000000,,,,-86000000,12250000000,11728000000,10858000000,-221000000,,387000000,387000000,53812,X
2019-12-25,,,34639000,,24900000,37208000,96746000,41683000,41683000,,-3687000,,,,9739000,442330000,400647000,345584000,-7044000,,24900000,24900000,53816,LOCO
2018-12-26,,,-12963000,,-8994000,36729000,96455000,41901000,41901000,,-3502000,,,,-3969000,435828000,393927000,339373000,-54864000,,-8994000,-8994000,53816,LOCO
2017-12-27,,,3546000,,8619000,34287000,96253000,43838000,43838000,,-3278000,,,,-5073000,401701000,357863000,305448000,-40292000,,8619000,8619000,53816,LOCO
2016-12-28,,,31474000,,18339000,31965000,93348000,45330000,45330000,,-3183000,,,,13135000,380123000,334793000,286775000,-13856000,,18339000,18339000,53816,LOCO
2020-08-29,,,48026000,,34700000,184451000,331850000,132140000,132140000,,-32813000,,,,13326000,816641000,684501000,484791000,-84114000,,34700000,34700000,53818,SMPL
2019-08-31,,,64286000,,47536000,125960000,217405000,83949000,83949000,,-13627000,,,,16750000,523383000,439434000,305978000,-19663000,,47536000,47536000,53818,SMPL
2018-08-25,,,53091000,,70455000,108727000,180366000,64141000,64141000,,-12551000,,,,-17364000,431429000,367288000,251063000,-11050000,,70455000,70455000,53818,SMPL
2017-08-26,,,2825000,,-2035000,95967000,162550000,57189000,57189000,,-24386000,,,,4860000,396171000,338982000,233621000,-54364000,,-2035000,450000,53818,SMPL
2019-12-31,,,42800000,,200000,1269400000,1769300000,203200000,203200000,,-150600000,,,,42600000,8751000000,8547800000,6981700000,-160400000,,200000,200000,53819,CWK
2018-12-31,,,-210800000,,-185800000,1267700000,1577500000,19800000,19800000,,-175000000,,,,-25000000,8219900000,8200100000,6642400000,-230600000,,-185800000,-185800000,53819,CWK
2017-12-31,,,-341800000,,-221300000,1156100000,1284100000,-142600000,-142600000,,-183100000,,,,-120500000,6923900000,7066500000,5639800000,-199200000,,-221300000,-221300000,53819,CWK
2016-12-31,,,-458900000,,-434200000,1148700000,1147900000,-261400000,-261400000,,-162800000,,,,-24300000,6215700000,6477100000,5067800000,-197500000,,-434600000,-434200000,53819,CWK
2020-12-31,,,320900000,,247600000,420400000,895500000,409900000,409900000,,-79600000,,,,73200000,4280200000,3870300000,3384700000,-89000000,,247700000,247600000,53820,LEG
2019-12-31,,,430100000,500000.0,333800000,471500000,1050100000,515300000,515300000,,-90700000,,,,96200000,4752500000,4237200000,3702400000,-85200000,,333900000,333800000,53820,LEG
2018-12-31,,,384400000,600000.0,305900000,423800000,893300000,449000000,449000000,,-60900000,,,,78300000,4269500000,3820500000,3376200000,-64600000,,306100000,305900000,53820,LEG
2017-12-31,,,432000000,600000.0,292600000,417900000,882900000,444300000,444300000,,-43500000,,,,138400000,3943800000,3499500000,3060900000,-12300000,-900000.0,293600000,292600000,53820,LEG
2020-03-31,4300000,,57601000,,45878000,112035000,177050000,60715000,60715000,,-1331000,,,,12784000,385871000,325156000,208821000,-3114000,1061000,44817000,45878000,53821,CSWI
2019-03-31,4300000,,61441000,,45574000,96134000,161370000,60936000,60936000,,-1442000,,,,15389000,350155000,289219000,188785000,505000,-478000,46052000,45574000,53821,CSWI
2018-03-31,4600000,,48247000,,-11882000,92638000,149340000,52102000,52102000,,-2317000,,,,15565000,326222000,274120000,176882000,-3855000,-44564000,32682000,-11882000,53821,CSWI
2017-03-31,4800000,,32160000,,11071000,89721000,128956000,34435000,34435000,,-2695000,,,,14360000,287460000,253025000,158504000,-2275000,-6729000,17800000,11071000,53821,CSWI
2019-12-31,,,7600000,846000,4928000,65003000,126012000,23733000,23733000,,-12059000,,,,2765000,231694000,207961000,105682000,-16133000,,4835000,4928000,53824,ALSK
2018-12-31,,,11029000,939000,9080000,66647000,124734000,24179000,24179000,,-13429000,,,,2041000,232468000,208289000,107734000,-13150000,,8988000,9080000,53824,ALSK
2017-12-31,,,-3646000,991000,-6101000,66612000,122301000,19372000,19372000,,-14860000,,,,2584000,226905000,207533000,104604000,-23018000,,-6230000,-6101000,53824,ALSK
2016-12-31,,,3752000,1045000,2386000,70209000,124729000,19830000,19830000,,-15447000,,,,1499000,226866000,207036000,102137000,-16078000,,2253000,2386000,53824,ALSK
2020-12-31,140102000,,748743000,,602739000,808021000,1801031000,796243000,796243000,,-38616000,,,,146004000,3085177000,2288934000,1284146000,-47500000,,602739000,602739000,53826,MTD
2019-12-31,143950000,,681394000,,561109000,814383000,1741211000,733188000,733188000,,-37411000,,,,120285000,3008652000,2275464000,1267441000,-51794000,,561109000,561109000,53826,MTD
2018-12-31,141071000,,651858000,,512611000,806602000,1684378000,689181000,689181000,,-34511000,,,,139247000,2935586000,2246405000,1251208000,-37323000,,512611000,512611000,53826,MTD
2017-12-31,128308000,,574222000,,375972000,790861000,1575751000,613911000,613911000,,-32785000,,,,198250000,2725053000,2111142000,1149302000,-39689000,,375972000,375972000,53826,MTD
2019-12-28,,,327952000,,263802000,1141456000,1508550000,401731000,401731000,-34637000,-37617000,,,,64150000,3519286000,3117555000,2010736000,-73779000,,263802000,261372000,53827,CRI
2018-12-29,,,355975000,,282068000,1132076000,1497483000,404337000,404337000,-38930000,-34569000,,,,73907000,3462269000,3057932000,1964786000,-48362000,,282068000,279920000,53827,CRI
2017-12-30,,,391072000,,302848000,1107285000,1483354000,419250000,419250000,-43181000,-30044000,,,,88224000,3400504000,2981254000,1917150000,-28178000,,302848000,300441000,53827,CRI
2016-12-31,,,395440000,,257709000,995406000,1378519000,425928000,425928000,-42815000,-27044000,,,,137731000,3198543000,2772615000,1820024000,-32841000,,257709000,255663000,53827,CRI
2020-08-31,,,-16184000,,-17358000,12064000,-3024000,-18248000,-18248000,,-136000,,,,1174000,45168000,63416000,48192000,2064000,,-17358000,-17358000,53828,KRUS
2019-08-31,,,1524000,,1456000,7673000,11574000,1736000,1736000,,-188000,,,,68000,64245000,62509000,52671000,-212000,,1456000,1456000,53828,KRUS
2018-08-31,,,1747000,,1742000,5965000,9739000,2099000,2099000,,-128000,,,,5000,51744000,49645000,42005000,-352000,,1742000,1742000,53828,KRUS
2017-08-31,,,947000,,707000,3364000,5761000,1027000,1027000,,-85000,,,,240000,37251000,36224000,31490000,-80000,,707000,707000,53828,KRUS
2019-12-31,,,-1206455,,-1206455,5687383,12670384,6983001,6983001,,-3154215,,,,0,12670384,5687383,0,-8189456,,-1206455,-1206455,53830,HCAP
2018-12-31,,,5012058,,5066798,6960325,16183921,9223596,9223596,,-3045772,,,,-54740,16183921,6960325,0,-4211538,,5066798,5066798,53830,HCAP
2017-12-31,,,1760801,,1632586,6308641,18704260,12395619,12395619,,-3448816,,,,128215,18704260,6308641,0,-10634818,,1632586,1632586,53830,HCAP
2016-12-31,,,6068078,,6006487,7048693,20893474,13844781,13844781,,-3730768,,,,61591,20893474,7048693,0,-7776703,,6006487,6006487,53830,HCAP
2017-12-31,,,-20592000,,-20592000,1325000,-19267000,-20592000,-20592000,,,,,,0,23841000,44433000,43108000,0,,-20592000,-20592000,53832,OXBRW
2016-12-31,,,2581000,,2581000,1420000,4001000,2581000,2581000,,,,,,0,19062000,16481000,15061000,0,,2581000,2581000,53832,OXBRW
2015-12-31,,,4601000,,4601000,1435000,6036000,4601000,4601000,,,,,,0,6380000,1779000,344000,0,,4601000,4601000,53832,OXBRW
2014-12-31,,,4000000,,4000000,1128000,5128000,4000000,4000000,,,,,,0,5559000,1559000,431000,0,,4000000,4000000,53832,OXBRW
2020-10-31,,,14389000000,103000000,11432000000,21138000000,42830000000,0,15662000000,6030000000,,,,,2952000000,42830000000,27168000000,0,-1273000000,,11437000000,11164000000,53833,RY
2019-10-31,,,15914000000,102000000,12860000000,20407000000,44138000000,0,17111000000,6620000000,,,,,3043000000,44138000000,27027000000,0,-1197000000,,12871000000,12591000000,53833,RY
2018-10-31,,,15760000000,94000000,12400000000,19355000000,41269000000,0,16837000000,5077000000,,,,,3329000000,41269000000,24432000000,0,-1077000000,,12431000000,12115000000,53833,RY
2017-10-31,,,14672000000,599000000,11428000000,18577000000,39519000000,0,15687000000,5255000000,,,,,3203000000,39519000000,23832000000,0,-1015000000,,11469000000,11128000000,53833,RY
2019-12-31,,,926088,-1198732,1909444,6830354,46937924,18470254,18470254,,-19768193,,,,-249480,185788133,167317879,138850209,-17544166,,1175568,-5911251,53835,SOHOO
2018-12-31,,,-138808,441706,109936,6180962,46883665,19818060,19818060,,-19953746,,,,469349,177373121,157555061,130489456,-19956868,,-608157,-5719978,53835,SOHOO
2017-12-31,,,1767293,1154775,442503,6335926,40389325,17053780,17053780,,-15727628,,,,1737804,153666693,136612913,113277368,-15286487,,29489,-3339136,53835,SOHOO
2016-12-31,,,-467485,2329175,926716,6021065,40012581,18972445,18972445,,-17735107,,,,-1367634,152845752,133873307,112833171,-19439930,,900149,-218173,53835,SOHOO
2019-12-31,37669978,,-49983009,,-49984054,13599748,277542,-50992184,-50992184,,-482000,,,,1045,339920,51332104,62378,1009175,,-49984054,-49984054,53839,CBMG
2018-12-31,24150480,,-38940538,,-38945492,13529587,88642,-37591425,-37591425,,-482000,,,,4954,224403,37815828,135761,-1349113,,-38945492,-38945492,53839,CBMG
2017-12-31,14609917,,-25487860,,-25490310,13141249,174599,-27576567,-27576567,,-482000,,,,2450,336817,27913384,162218,2088707,,-25490310,-25490310,53839,CBMG
2016-12-31,11475587,,-28204283,,-28208376,12095546,-232487,-23803620,-23803620,,-482000,,,,4093,627930,24431550,860417,-4400663,,-28208376,-28208376,53839,CBMG
2019-12-31,59208000,,-76769000,,-76769000,23761000,0,-82969000,-82969000,,,,,,0,0,82969000,0,6200000,,-76769000,-76769000,53841,MGTA
2018-12-31,41340000,,-57515000,,-57515000,18623000,0,-59963000,-59963000,,,,,,0,0,59963000,0,2448000,,-57515000,-57603000,53841,MGTA
2017-12-31,27899000,,-35491000,,-35491000,7828000,0,-35727000,-35727000,,,,,,0,0,35727000,0,236000,,-35491000,-35507000,53841,MGTA
2016-12-31,5782000,,-9431000,,-9431000,3486000,0,-9268000,-9268000,,-163000.0,,,,0,0,9268000,0,-163000,,-9431000,-9735000,53841,MGTA
2020-09-30,,,1017900000,1401200000,798900000,773800000,2240100000,1412300000,1412300000,,-33400000,,,,230800000,5566500000,4154200000,3326400000,-394400000,,787100000,783600000,53843,BEN
2019-09-30,,,1647800000,1464400000,1195700000,746900000,2384300000,1622700000,1622700000,,-22400000,,,,442300000,5669400000,4046700000,3285100000,25100000,,1205500000,1184800000,53843,BEN
2018-09-30,,,2215200000,1352300000,764400000,717200000,2782100000,2063100000,2063100000,,-46300000,,,,1472500000,6204500000,4141400000,3422400000,152100000,,742700000,746800000,53843,BEN
2017-09-30,,,2549100000,2257700000,1696700000,653700000,2927600000,2273900000,2273900000,,-51500000,,,,759400000,6392200000,4118300000,3464600000,275200000,,1789700000,1684300000,53843,BEN
2019-12-31,,,21945000,35236000,4431000,29256000,93608000,27621000,27621000,647000,-4431000,,,,12528000,229038000,201417000,135430000,-5676000,,9417000,4431000,53845,SMTS
2018-12-31,,,52180000,30250000,18814000,27470000,115452000,55889000,55889000,684000,-2950000,,,,26340000,232371000,176482000,116919000,-3709000,,25840000,18814000,53845,SMTS
2017-12-31,,,9488000,26107000,-4645000,27882000,104139000,17239000,17239000,843000,-2420000,,,,10348000,205118000,187879000,100979000,-7751000,,-860000,-4645000,53845,SMTS
2016-12-31,,,-6964000,25694000,-12265000,21834000,61348000,-6500000,-6500000,343000,-3333000,,,,5757000,143180000,149680000,81832000,-464000,,-12721000,-12265000,53845,SMTS
2020-07-31,200575000,,-24331000,,-27198000,227603000,404292000,-23886000,-23886000,,-17945000,,,,2867000,742307000,766193000,338015000,-445000,,-27198000,-27198000,53847,GWRE
2019-07-31,188541000,,12452000,,20732000,205152000,395164000,1471000,1471000,,-17334000,,,,-8280000,719514000,718043000,324350000,10981000,,20732000,20732000,53847,GWRE
2018-07-31,171657000,,-8276000,,-26743000,200033000,356066000,-15624000,-15624000,,-6442000,,,,18467000,652849000,668473000,296783000,7348000,,-26743000,-26743000,53847,GWRE
2017-07-31,130323000,,28526000,,18072000,165790000,317974000,21861000,21861000,,-13000,,,,10454000,509533000,487672000,191559000,6665000,,18072000,18072000,53847,GWRE
2019-12-31,,,17809961,,17809961,2092844,13281746,11188902,11188902,,-613500,,,,0,13281746,2092844,0,6621059,,17809961,17809961,53848,MPV
2018-12-31,,,3639558,,3639558,2258251,13668990,11410739,11410739,,-613500,,,,0,13668990,2258251,0,-7771181,,3639558,3639558,53848,MPV
2017-12-31,,,19137518,,19137518,2130516,14084097,11953581,11953581,,-613500,,,,0,14084097,2130516,0,7183937,,19137518,19137518,53848,MPV
2016-12-31,,,11642632,,11642632,1876016,12813758,10937742,10937742,,-613500,,,,0,12813758,1876016,0,704890,,11642632,11642632,53848,MPV
2019-12-31,42966000,,-54121000,,-54121000,10156000,0,-53122000,-53122000,,,,,,0,0,53122000,0,-999000,,-54121000,-54121000,53850,MRNS
2018-12-31,28194000,,-36726000,,-36726000,8985000,0,-37179000,-37179000,,,,,,0,0,37179000,0,453000,,-36726000,-36726000,53850,MRNS
2017-12-31,12076000,,-18898000,,-18898000,6967000,0,-19043000,-19043000,,-159000.0,,,,0,0,19043000,0,145000,,-18898000,-18898000,53850,MRNS
2016-12-31,21705000,,-28643000,,-28643000,6537000,0,-28242000,-28242000,,-464000.0,,,,0,0,28242000,0,-401000,,-28643000,-28643000,53850,MRNS
2020-06-30,,,684000,,2266000,14046000,15762000,910000,910000,,-127000,,,,-1582000,51146000,50236000,35384000,-226000,,2266000,2266000,53851,SMED
2019-06-30,,,384000,,214000,12003000,13270000,447000,447000,,-87000,,,,170000,44312000,43865000,31042000,-63000,,214000,214000,53851,SMED
2018-06-30,,,-651000,,-672000,11168000,11402000,-577000,-577000,,-94000,,,,21000,40141000,40718000,28739000,-74000,,-672000,-672000,53851,SMED
2017-06-30,,,-1289000,,-1293000,11523000,11837000,-487000,-487000,,-115000,,,,4000,38188000,38675000,26351000,-802000,,-1293000,-1293000,53851,SMED
2019-12-31,4594000,,-8592000,,-9695000,12550000,17065000,-1207000,-1207000,,-314000,,,,1103000,25750000,26957000,8685000,-7385000,,-9695000,-9695000,53853,EVOL
2018-12-31,4170000,,-15213000,,-14787000,13269000,20287000,1757000,1757000,,-478000,,,,-426000,30636000,28879000,10349000,-16970000,,-14787000,-14787000,53853,EVOL
2017-12-31,2042000,,3937000,,2516000,11279000,20132000,5701000,5701000,,-365000,,,,1421000,28812000,23111000,8680000,-1764000,,2516000,2516000,53853,EVOL
2016-12-31,3014000,,4892000,,3435000,8820000,19481000,6605000,6605000,,-340000,,,,1457000,24778000,18173000,5297000,-1713000,,3435000,3435000,53853,EVOL
2019-12-31,54996000,,-25469000,,-25469000,18440000,46279000,-27157000,-27157000,,,,,,0,46279000,73436000,0,1688000,,-25469000,-28299000,53854,PIRS
2018-12-31,41490000,,-27066000,,-26754000,18442000,29101000,-30831000,-30831000,,,,,,-312000,29101000,59932000,0,3765000,,-26754000,-26754000,53854,PIRS
2017-12-31,21785000,,-16544000,,-17647000,18084000,25275000,-14594000,-14594000,,,,,,1103000,25275000,39869000,0,-1950000,,-17647000,-17647000,53854,PIRS
2016-12-31,19199000,,-22637000,,-22799000,9391000,5831000,-22759000,-22759000,,,,,,162000,5831000,28590000,0,122000,,-22799000,-22799000,53854,PIRS
2019-12-31,34026000,,-16970000,,-11752000,62597000,218746000,30649000,30649000,,-36248000,,,,-5449000,304714000,274065000,85968000,-47619000,,-11521000,-11752000,53855,AGS
2018-12-31,31745000,,-29223000,,-20846000,63038000,206361000,34043000,34043000,,-37607000,,,,-8377000,285299000,251256000,78938000,-63266000,,-20846000,-20846000,53855,AGS
2017-12-31,25715000,,-46995000,,-45106000,44015000,160366000,18987000,18987000,,-55511000,,,,-1889000,211955000,192968000,51589000,-65982000,,-45106000,-45106000,53855,AGS
2016-12-31,21346000,,-84374000,,-81374000,46108000,133833000,-13802000,-13802000,,-59963000,,,,-3000000,166806000,180608000,32973000,-70572000,,-81374000,-81374000,53855,AGS
2019-12-31,,,62316000,101463000,46777000,88458000,172598000,84969000,84969000,-829000,-25680000,,,,2318000,415565000,330596000,242967000,-22653000,,59998000,46777000,53856,GCMG
2018-12-31,,,65080000,125665000,39199000,92955000,168082000,75127000,75127000,-829000,-26468000,,,,1395000,378496000,303369000,210414000,-10047000,,63685000,39199000,53856,GCMG
2017-12-31,,,74345000,125665000,53039000,86908000,159432000,72524000,72524000,-829000,-23415000,,,,1325000,377006000,304482000,217574000,1821000,,73020000,53039000,53856,GCMG
2019-12-31,,,8997000000,306000000,6634000000,32699000000,44517000000,11818000000,11818000000,,-3035000000,,,,2366000000,255765000000,243947000000,211248000000,-2821000000,,6631000000,6629000000,53858,CVS
2018-12-31,,,1406000000,318000000,-594000000,20827000000,30878000000,10051000000,10051000000,,-2619000000,,,,2002000000,193919000000,183868000000,163041000000,-8645000000,,-596000000,-597000000,53858,CVS
2017-12-31,,,8268000000,4000000,6622000000,18737000000,28507000000,9770000000,9770000000,,-1062000000,,,,1637000000,184765000000,174995000000,156258000000,-1710000000,-8000000.0,6631000000,6598000000,53858,CVS
2016-12-31,,,8637000000,4000000,5317000000,18284000000,28860000000,10576000000,10576000000,,-1078000000,,,,3317000000,177526000000,166950000000,148666000000,-1939000000,-1000000.0,5320000000,5290000000,53858,CVS
2020-12-31,,,1139000000,,890000000,979000000,3232000000,1896000000,1896000000,,-486000000,,,,249000000,8530000000,6634000000,5298000000,-757000000,,890000000,890000000,53859,URI
2019-12-31,,,1514000000,,1174000000,1092000000,3745000000,2246000000,2246000000,,-587000000,,,,340000000,9351000000,7105000000,5606000000,-732000000,,1174000000,1174000000,53859,URI
2018-12-31,,,1476000000,,1096000000,1038000000,3430000000,2084000000,2084000000,,-481000000,,,,380000000,8047000000,5963000000,4617000000,-608000000,,1096000000,1096000000,53859,URI
2017-12-31,,,1048000000,,1346000000,903000000,2851000000,1689000000,1689000000,,-410000000,,,,-298000000,6641000000,4952000000,3790000000,-641000000,,1346000000,1346000000,53859,URI
2020-12-31,,,-129573000,,-129573000,13289000,111083000,0,97794000,,,,,,0,111083000,13289000,0,-227367000,,-129573000,-148941000,53860,CMO
2019-12-31,,,-35338000,,-35338000,12691000,-22495000,0,-35186000,,,,,,0,-22495000,12691000,0,-152000,,-35338000,-54806000,53860,CMO
2018-12-31,,,50072000,,50072000,12286000,62358000,0,50072000,,,,,,0,62358000,12286000,0,0,,50072000,30602000,53860,CMO
2017-12-31,,,77648000,,79589000,9604000,87252000,0,77648000,,,,,,-1941000,87252000,9604000,0,0,,79589000,61997000,53860,CMO
2019-12-31,30711000,,-23947000,,-21968000,74834000,81613000,-23932000,-23932000,,,,,,-1979000,127068000,151000000,45455000,-15000,,-21968000,-21968000,53861,CDNA
2018-12-31,14514000,,-48215000,,-46756000,44646000,43582000,-15578000,-15578000,,-3901000.0,,,,-1434000,76569000,92147000,32987000,-32637000,,-46781000,-46756000,53861,CDNA
2017-12-31,12388000,,-57269000,180000.0,-55469000,32901000,26953000,-18336000,-18336000,,-5863000.0,,,,-1709000,48324000,66660000,21371000,-38933000,,-55560000,-55469000,53861,CDNA
2016-12-31,12388000,,-41362000,279000.0,-39469000,31891000,11124000,-20767000,-20767000,,-1860000.0,,,,-1606000,40631000,61398000,29507000,-20595000,,-39756000,-39469000,53861,CDNA
2020-12-31,,,563864000,25295000,435030000,1019702000,1729801000,0,624006000,86093000,,,,,128793000,1729801000,1105795000,0,-60142000,,435071000,435030000,53865,BOKF
2019-12-31,,,630868000,8124000,500758000,1002863000,1763249000,0,682099000,78287000,,,,,130183000,1763249000,1081150000,0,-51231000,,500685000,497531000,53865,BOKF
2018-12-31,,,565485000,10936000,445646000,902699000,1593651000,0,618321000,72631000,,,,,119061000,1593651000,975330000,0,-52836000,,446424000,441909000,53865,BOKF
2017-12-31,,,518278000,22967000,334644000,902488000,1543795000,0,556397000,84910000,,,,,182593000,1543795000,987398000,0,-38119000,,335685000,331083000,53865,BOKF
2019-12-31,21753000,,-35258000,,-35258000,7579000,0,-29332000,-29332000,,,,,,0,0,29332000,0,-5926000,,-35258000,-35258000,53867,BDTX
2018-12-31,6950000,,-8931000,,-8931000,1954000,0,-8904000,-8904000,,,,,,0,0,8904000,0,-27000,,-8931000,-8931000,53867,BDTX
2017-12-31,3453000,,-4602000,,-4602000,666000,0,-4119000,-4119000,,-65000.0,,,,0,0,4119000,0,-483000,,-4602000,-4602000,53867,BDTX
2019-12-31,,,-1319,,-1319,,0,0,,,,,,,0,0,0,0,-1319,,-1319,-1319,53868,FTIV
2018-12-31,,,-11724,,-11724,,0,0,,,,,,,0,0,0,0,-11724,,-11724,-11724,53868,FTIV
2020-12-31,,,264040000,,206115000,543802000,872147000,328345000,328345000,,-23959000,,,,57896000,2655400000,2327055000,1783253000,-64305000,,206144000,206115000,53869,LECO
2019-12-31,56845000.0,,368493000,905000.0,293109000,578498000,1010595000,375252000,375252000,,-25942000,,,,75410000,3003272000,2628020000,1992677000,-6759000,,293083000,293109000,53869,LECO
2018-12-31,54168000.0,,368660000,650000.0,287066000,574180000,1028521000,400173000,400173000,,-24503000,,,,81667000,3028674000,2628501000,2000153000,-31513000,,286993000,287066000,53869,LECO
2017-12-31,47899000.0,,366236000,816000.0,247503000,483209000,879685000,348577000,348577000,,-24220000,,,,118761000,2624431000,2275854000,1744746000,17659000,,247475000,247503000,53869,LECO
2020-12-31,,,14877000,4711000,14768000,15095000,120434000,44652000,44652000,,-36488000,,,,0,211906000,167254000,91472000,-29775000,,14877000,14768000,53871,IRT
2019-12-31,,,46354000,6478000,45896000,12745000,115929000,50369000,50369000,,-39226000,,,,0,203223000,152854000,87294000,-4015000,,46354000,45896000,53871,IRT
2018-12-31,,,26610000,7050000,26288000,10817000,107906000,51868000,51868000,,-36006000,,,,0,191232000,139364000,83326000,-25258000,,26610000,26288000,53871,IRT
2017-12-31,,,31441000,22019000,30206000,9526000,90494000,46767000,46767000,,-28702000,,,,0,161216000,114449000,70722000,-15326000,,31441000,30206000,53871,IRT
2020-12-31,,,80895000,285451000,76403000,36795000,250295000,98231000,98231000,,-30849000,,,,0,330135000,231904000,79840000,-17336000,,80895000,61349000,53872,REXR
2019-12-31,,,64001000,66272000,61979000,30300000,203941000,74750000,74750000,,-26875000,,,,0,267213000,192463000,63272000,-10749000,,64001000,50477000,53872,REXR
2018-12-31,,,47075000,32329000,46210000,25194000,160823000,55587000,55587000,,-25416000,,,,0,212494000,156907000,51671000,-8512000,,47075000,36138000,53872,REXR
2017-12-31,,,41700000,25208000,40712000,21610000,118916000,32454000,32454000,,-20209000,,,,0,161355000,128901000,42439000,9246000,,41700000,34427000,53872,REXR
2019-12-31,108610000,,-144998000,,-146004000,138999000,403150000,36724000,36724000,,-130572000,,,,1006000,835726000,799002000,432576000,-181722000,,-146004000,-146004000,53875,GOGO
2018-12-31,120090000,,-165324000,,-162031000,153092000,379878000,-26921000,-26921000,,-122809000,,,,-3293000,893764000,920685000,513886000,-138403000,,-162031000,-162031000,53875,GOGO
2017-12-31,133286000,,-173992000,,-171995000,157688000,372202000,-64262000,-64262000,,-111944000,,,,-1997000,699090000,763352000,326888000,-109730000,,-171995000,-171995000,53875,GOGO
2016-12-31,96713000,,-123191000,,-124505000,146104000,321822000,-26637000,-26637000,,-83647000,,,,1314000,596550000,623187000,274728000,-96554000,,-124505000,-124505000,53875,GOGO
2019-12-31,7900000,,-10618000,,-10649000,3693000,0,-11593000,-11593000,,,,,,31000,0,11593000,0,975000,,-10649000,-10649000,53877,DMAC
2018-12-31,4522000,,-5654000,,-5734000,2379000,500000,-6401000,-6401000,,,,,,80000,500000,6901000,0,747000,,-5734000,-5734000,53877,DMAC
2017-12-31,3206000,,-4260000,,-4260000,1313000,0,-4519000,-4519000,,,,,,34292,0,4519000,0,262806,,-4260000,-4260000,53877,DMAC
2016-12-31,1763415,,-2200830,,-2223144,718045,0,-2481460,-2481460,,-48375.0,,,,22314,0,2481460,0,280630,,-2223144,-2223144,53877,DMAC
2020-12-31,,,269942000,18484000,222759000,985596000,1813518000,0,497122000,330800000,,,,,39901000,1813518000,1316396000,0,-227180000,,230041000,212784000,53878,TCF
2019-12-31,,,357167000,20226000,295468000,871128000,1693164000,0,555924000,266112000,,,,,50241000,1693164000,1137240000,0,-198757000,,306926000,285473000,53878,TCF
2018-12-31,,,401724000,18459000,304358000,769984000,1416124000,0,450774000,195366000,,,,,86096000,1416124000,965350000,0,-49050000,,315628000,289247000,53878,TCF
2017-12-31,,,245160000,17827000,268637000,743359000,1305094000,0,336325000,225410000,,,,,-33624000,1305094000,968769000,0,-91165000,,278784000,242912000,53878,TCF
2019-12-29,12350000,,-15524000,,-15444000,8814000,5905000,-15259000,-15259000,,-350000,,,,-80000,10310000,25569000,4405000,-265000,,-15444000,-15444000,53879,QUIK
2018-12-30,9948000,,-13627000,,-13779000,9982000,6334000,-13596000,-13596000,,-108000,,,,152000,12629000,26225000,6295000,31000,,-13779000,-13779000,53879,QUIK
2017-12-31,9572000,,-14044000,,-14131000,9900000,5522000,-13950000,-13950000,,-115000,,,,87000,12149000,26099000,6627000,-94000,,-14131000,-14131000,53879,QUIK
2017-01-01,12265000,,-19083000,,-19148000,10310000,3773000,-18802000,-18802000,,-175000,,,,65000,11421000,30223000,7648000,-281000,,-19148000,-19148000,53879,QUIK
2020-10-02,,,441203000,39955000,491845000,1719484000,2588981000,869497000,869497000,,-62206000,,,,55320000,13566975000,12697478000,10977994000,-428294000,137984000,385883000,491745000,53882,J
2019-09-27,,,350959000,53967000,847979000,1720092000,2481963000,761871000,761871000,,-83847000,,,,36954000,12737868000,11975997000,10255905000,-410912000,557019000,314005000,846769000,53882,J
2018-09-28,,,330981000,90009000,163431000,1523567000,2162437000,638870000,638870000,,-76760000,,,,325632000,10579773000,9940903000,8417336000,-307889000,167616000,5349000,162623000,53882,J
2017-09-29,,,243154000,58999000,293727000,912774000,1260035000,347261000,347261000,,-12035000,,,,73103000,6330126000,5982865000,5070091000,-104107000,123560000,170051000,290650000,53882,J
2019-12-31,32747000,,-7360000,,-5418000,26299000,52111000,-7544000,-7544000,,,,,,-1942000,85585000,93129000,33474000,184000,,-5418000,-5418000,53887,PDFS
2018-12-31,27998000,,-9459000,,-7716000,23934000,42991000,-9376000,-9376000,,,,,,-1743000,85794000,95170000,42803000,-83000,,-7716000,-7716000,53887,PDFS
2017-12-31,30078000,,-74000,,-1337000,23684000,54821000,190000,190000,,-964000.0,,,,1263000,101871000,101681000,47050000,-264000,,-1337000,-1337000,53887,PDFS
2016-12-31,27559000,,12956000,,9103000,22056000,63387000,12966000,12966000,,-964000.0,,,,3853000,107461000,94495000,44074000,-10000,,9103000,9103000,53887,PDFS
2019-12-31,64196000,,-68952000,,-68760000,203415000,197660000,-69951000,-69951000,,-2986000,,,,-192000,326801000,396752000,129141000,999000,,-68760000,-68760000,53888,EB
2018-12-31,46071000,,-62928000,,-64078000,169362000,170958000,-44475000,-44475000,,-11295000,,,,1150000,291611000,336086000,120653000,-18453000,,-64078000,-64078000,53888,EB
2017-12-31,30608000,,-38560000,,-38547000,121029000,119930000,-31707000,-31707000,,-6462000,,,,-13000,201597000,233304000,81667000,-6853000,,-38547000,-38547000,53888,EB
2016-12-31,22723000,,-40261000,,-40392000,90140000,77810000,-35053000,-35053000,,-3513000,,,,131000,133499000,168552000,55689000,-5208000,,-40392000,-40392000,53888,EB
2019-12-31,,,798182000,,560080000,44126000,1063645000,816281000,816281000,848000,-922000,,,,238102000,1379988000,563707000,316343000,-18099000,,560080000,560080000,53892,KL
2018-12-31,,,394310000,,273943000,31565000,624366000,391317000,391317000,1152000,-1496000,,,,120367000,915911000,524594000,291545000,2993000,,273943000,273943000,53892,KL
2017-12-31,,,196079000,,132426000,24185000,428537000,206283000,206283000,1003000,-9592000,,,,38749000,747495000,541212000,318958000,-10204000,-24904000.0,157330000,132426000,53892,KL
2016-12-31,,,79767000,,42107000,10367000,194866000,109335000,109335000,377000,-10809000,,,,33033000,403340000,294005000,208474000,-29568000,-4627000.0,46734000,42107000,53892,KL
2019-12-31,168028000,,1840114000,1269324000,1199619000,3009648000,5395851000,2218175000,2218175000,,-491061000,,,,401614000,17476555000,15258380000,12080704000,-378061000,,1438500000,1199619000,53894,FMS
2018-12-31,114074000,,2736736000,1143547000,1981924000,2856828000,5154743000,2183841000,2183841000,,-448471000,,,,511079000,16546873000,14363032000,11392130000,552895000,,2225657000,1981924000,53894,FMS
2017-12-31,110997000,,1997615000,1008084000,1279788000,3640465000,6018254000,2266792000,2266792000,,-416199000,,,,443081000,17783572000,15516780000,11765318000,-269177000,,1554534000,1279788000,53894,FMS
2016-12-31,146511000,,2045494000,1073475000,1143980000,3132715000,5615946000,2336720000,2336720000,,-426809000,,,,625442000,16569715000,14232995000,10953769000,-291226000,,1420052000,1143980000,53894,FMS
2020-03-31,,,-447546000,4055000,-447781000,166603000,221468000,-126231000,-126231000,147270000,-2888000,,,,-29000,511529000,637760000,290061000,-321315000,,-447517000,-447781000,53896,MMYT
2019-03-31,,,-168623000,193000,-167759000,198661000,193729000,-152947000,-152947000,120910000,-299000,,,,-740000,486011000,638958000,292282000,-15676000,,-167883000,-167759000,53896,MMYT
2018-03-31,,,-220149000,298000,-218412000,459519000,382101000,-213960000,-213960000,106560000,-422000,,,,91000,675256000,889216000,293155000,-6189000,,-220240000,-218412000,53896,MMYT
2017-03-31,,,-110110000,661000,-110168000,228255000,195639000,-114202000,-114202000,67051000,-8574000,,,,193000,447616000,561818000,251977000,4092000,,-110303000,-110168000,53896,MMYT
2019-12-31,,,272670000,84542000,213936000,15059000,737376000,356752000,356752000,62328000,-109226000,,,,56023000,3119917000,2763165000,2382541000,-84082000,,216647000,213936000,53898,SWX
2018-12-31,,,243336000,81379000,182277000,21059000,673443000,343274000,343274000,59898000,-96671000,,,,61684000,2880013000,2536739000,2206570000,-99938000,,181652000,182277000,53898,SWX
2017-12-31,,,259030000,-2365000,193841000,19424000,654621000,326300000,326300000,57946000,-78064000,,,,65088000,2548792000,2222492000,1894171000,-67270000,,193942000,193841000,53898,SWX
2016-12-31,,,231523000,20373000,152041000,19760000,656982000,295714000,295714000,52376000,-73660000,,,,78468000,2460490000,2164776000,1803508000,-64191000,,153055000,152041000,53898,SWX
2019-12-31,8000000,,-2106000000,,-1934000000,479000000,973000000,27000000,27000000,,-78000000,,,,-172000000,4467000000,4440000000,3494000000,-2133000000,,-1934000000,-1944000000,53899,CNDT
2018-12-31,11000000,,-395000000,,-416000000,560000000,1211000000,168000000,168000000,12000000.0,-112000000,,,,21000000,5393000000,5225000000,4182000000,-563000000,,-416000000,-426000000,53899,CNDT
2017-12-31,12000000,,-16000000,,181000000,611000000,1292000000,178000000,178000000,-4000000.0,-137000000,,,,-193000000,6022000000,5844000000,4730000000,-194000000,4000000.0,177000000,171000000,53899,CNDT
2016-12-31,31000000,,-1227000000,,-983000000,679000000,1262000000,-37000000,-37000000,-22000000.0,-40000000,,,,-244000000,6408000000,6445000000,5146000000,-1190000000,4000000.0,-983000000,-983000000,53899,CNDT
2019-12-31,8289000,,-41899000,,-42526000,22664000,1016000,-29937000,-29937000,,-4354000,,,,0,6567000,36504000,5551000,-11962000,,-41899000,-42906000,53903,VIVE
2018-12-31,13258000,,-49324000,,-49981000,39027000,7320000,-44965000,-44965000,,-4372000,,,,0,18517000,63482000,11197000,-4359000,,-49324000,-49981000,53903,VIVE
2017-12-31,11901000,,-36959000,,-36959000,29273000,7444000,-33730000,-33730000,,-3169000,,,,0,15288000,49018000,7844000,-3229000,,-36959000,-36959000,53903,VIVE
2016-12-31,8129000,,-20111000,,-20111000,13104000,2529000,-18704000,-18704000,,-1370000,,,,0,7141000,25845000,4612000,-1407000,,-20111000,-20111000,53903,VIVE
2019-12-31,,,-59994000,,-56672000,154453000,1049612000,56076000,56076000,180278000,-71171000,,,,-3322000,1238213000,1182137000,188601000,-116070000,,-56672000,-56672000,53906,PDCE
2018-12-31,,,7429000,,2023000,170504000,1144705000,78140000,78140000,-128333000,-70730000,,,,5406000,1313065000,1234925000,168360000,-70711000,,2023000,2023000,53906,PDCE
2017-12-31,,,-339432000,,-127504000,120370000,741974000,-204100000,-204100000,23399000,-78694000,,,,-211928000,864835000,1068935000,122861000,-135332000,,-127504000,-127504000,53906,PDCE
2016-12-31,,,-393123000,,-245928000,100270000,398821000,-272887000,-272887000,142954000,-61972000,,,,-147195000,477186000,750073000,78365000,-120236000,,-245928000,-245928000,53906,PDCE
2019-12-31,16788000,,-21654000,864000,-20657000,5482000,0,-22270000,-22270000,,,,,,0,0,22270000,0,616000,,-21654000,-20657000,53909,CGEM
2018-12-31,9584000,,-14189000,1000,-14189000,5002000,0,-14586000,-14586000,,,,,,0,0,14586000,0,397000,,-14189000,-14189000,53909,CGEM
2017-12-31,,,-82674,,-93579,,0,0,,,,,,,10905,0,0,0,-82674,,-93579,-93579,53912,LACQU
2019-12-31,,,103540000,184855000,73956000,145079000,487332000,162187000,162187000,24682000,-105374000,,,,29245000,1300539000,1138352000,813207000,-58647000,,74295000,73956000,53914,HHC
2018-12-31,,,73218000,105914000,57012000,133874000,406446000,106810000,106810000,33119000,-82028000,,,,15492000,1064537000,957727000,658091000,-33592000,,57726000,57012000,53914,HHC
2017-12-31,,,120822000,5565000,168404000,110386000,438420000,192635000,192635000,25937000,-64568000,,,,-45801000,1100120000,907485000,661700000,-71813000,,166623000,168404000,53914,HHC
2016-12-31,,,320776000,3772000,202303000,108772000,447641000,221947000,221947000,15394000,-65724000,,,,118450000,1035005000,813058000,587364000,98829000,,202326000,202303000,53914,HHC
2016-12-31,,,-137688,,637647,137688,0,-137688,-137688,,,,,,0,0,137688,0,0,775335,-137688,637647,53915,AFGC
2015-12-31,,,-3497200,,-3555900,1486000,2924300,1339500,1339500,98800.0,-1762100.0,,,,58700,4383100,3043600,1458800,-4836700,775335,-3555900,-3792100,53915,AFGC
2020-12-31,518072000,,-169638000,,-162115000,1029938000,1583422000,35412000,35412000,,-155227000,,,,-7523000,3339817000,3304405000,1756395000,-205050000,,-162115000,-162115000,53917,Z
2019-12-31,477347000,,-309619000,,-305361000,1080304000,1310816000,-246835000,-246835000,,-101792000,,,,-4258000,2742837000,2989672000,1432021000,-62784000,,-305361000,-305361000,53917,Z
2018-12-31,410818000,,-150960000,,-119858000,814774000,1179964000,-45628000,-45628000,,-41255000,,,,-31102000,1333554000,1379182000,153590000,-86062000,,-119858000,-119858000,53917,Z
2017-12-31,319985000,,-184006000,,-94420000,659017000,991591000,12589000,12589000,,-27517000,,,,-89586000,1076794000,1064205000,85203000,-196595000,,-94420000,-94420000,53917,Z
2020-12-31,,,5132700000,284300000,3672100000,6376300000,11079600000,4274000000,4274000000,429300000,,,,,1430300000,68791300000,64517300000,57711700000,858700000,,3702400000,3672100000,53919,IBA
2019-12-31,,,4357804000,80360000,3219931000,6116620000,10097894000,3964336000,3964336000,16938000,-288617000.0,,,,1124978000,61655245000,57690909000,51557351000,393468000,,3232826000,3219931000,53919,IBA
2018-12-31,,,4516551000,69450000,3349967000,6024406000,9629716000,3737336000,3737336000,-132026000,-185913000.0,,,,1154978000,61052092000,57314756000,51422376000,779215000,,3361573000,3349967000,53919,IBA
2017-12-31,,,6038879000,58975000,4948242000,5423379000,10547066000,5277333000,5277333000,-153646000,-188597000.0,,,,1084444000,58050025000,52772692000,47502959000,761546000,,4954435000,4948242000,53919,IBA
2020-11-30,68600000,,922300000,13900000,747400000,1203000000,2300400000,1028800000,1028800000,,-135600000,,,,174900000,5601300000,4572500000,3300900000,-106500000,,747400000,747400000,53923,MKC
2019-11-30,67300000,,860100000,12500000,702700000,1081800000,2145300000,996200000,996200000,,-165200000,,,,157400000,5347400000,4351200000,3202100000,-136100000,,702700000,702700000,53923,MKC
2018-11-30,69400000,,776100000,11300000,933400000,1081800000,2093300000,942100000,942100000,,-174600000,,,,-157300000,5302800000,4360700000,3209500000,-166000000,,933400000,933400000,53923,MKC
2017-11-30,66100000,,628700000,11000000,477400000,962500000,1814900000,786300000,786300000,,-95700000,,,,151300000,4730300000,3944000000,2915400000,-157600000,,477400000,477400000,53923,MKC
2020-07-31,,,7876920,,7876920,2606452,13115989,10509537,10509537,,-1585659,,,,0,13115989,2606452,0,-2632617,,7876920,7876920,53924,MPA
2019-07-31,,,19052533,,19052533,2034301,13640382,11606081,11606081,,-2857228,,,,0,13640382,2034301,0,7446452,,19052533,19052533,53924,MPA
2018-07-31,,,3328579,,3328579,1977187,14110185,12132998,12132998,,-2695495,,,,0,14110185,1977187,0,-8804419,,3328579,3328579,53924,MPA
2017-07-31,,,-3585401,,-3585401,1965940,14168033,12202093,12202093,,-2048522,,,,0,14168033,1965940,0,-15787494,,-3585401,-3585401,53924,MPA
2020-12-27,,,-173262000,,-141841000,408307000,440645000,307000,307000,,,,,,-31421000,1846360000,1846053000,1405715000,-173569000,,-141841000,-141841000,53925,TBI
2019-12-29,,,70044000,,63073000,520868000,626158000,67741000,67741000,,-2783000.0,,,,6971000,2368779000,2301038000,1742621000,2303000,,63073000,63073000,53925,TBI
2018-12-30,,,75663000,,65754000,543960000,665600000,80591000,80591000,,-4881000.0,,,,9909000,2499207000,2418616000,1833607000,-4928000,,65754000,65754000,53925,TBI
2017-12-31,,,77550000,,55456000,510794000,634473000,77564000,77564000,,-5494000.0,,,,22094000,2508771000,2431207000,1874298000,-14000,,55456000,55456000,53925,TBI
2020-12-31,43500000,,-9500000,,-47200000,447000000,749400000,258900000,258900000,,-36400000,,,,37700000,1998600000,1739700000,1249200000,-268400000,,-47200000,-47200000,53927,NVT
2019-12-31,48200000,,257400000,,222700000,490900000,865800000,326700000,326700000,,-44700000,,,,34700000,2204000000,1877300000,1338200000,-69300000,,222700000,222700000,53927,NVT
2018-12-31,45600000,,268700000,,230800000,477300000,876100000,353200000,353200000,,-31200000,,,,37900000,2213600000,1860400000,1337500000,-84500000,,230800000,230800000,53927,NVT
2017-12-31,42500000,,313300000,,361700000,445900000,841900000,353500000,353500000,,-200000,,,,-48400000,2097900000,1744400000,1256000000,-40200000,,361700000,361700000,53927,NVT
2020-12-31,85258000,,34284000,,33484000,138629000,267019000,43132000,43132000,,-1585000,,,,800000,541239000,498107000,274220000,-8848000,,33484000,33484000,53928,CALX
2019-12-31,81184000,,-16532000,,-17694000,119668000,187925000,-12927000,-12927000,,-958000,,,,1162000,424330000,437257000,236405000,-3605000,,-17694000,-17694000,53928,CALX
2018-12-31,89963000,,-18768000,,-19298000,126932000,197382000,-19513000,-19513000,,-632000,,,,530000,441320000,460833000,243938000,745000,,-19298000,-19298000,53928,CALX
2017-12-31,127541000,,-81789000,,-83032000,122656000,172890000,-77307000,-77307000,,-160000,,,,1243000,510367000,587674000,337477000,-4482000,,-83032000,-83032000,53928,CALX
2020-12-31,,,3738000000,,3167000000,,4133000000,4133000000,4133000000,,-477000000,,,,571000000,37925000000,33792000000,33792000000,-395000000,,3167000000,3167000000,53929,GD
2019-12-31,,,4202000000,,3484000000,2395000000.0,7059000000,4664000000,4664000000,,-472000000,,,,718000000,39350000000,34686000000,32291000000,-462000000,,3484000000,3484000000,53929,GD
2018-12-31,,,4085000000,,3345000000,2232000000.0,6715000000,4483000000,4483000000,,-374000000,,,,727000000,36193000000,31710000000,29478000000,-398000000,-13000000.0,3358000000,3345000000,53929,GD
2017-12-31,,,4077000000,,2912000000,2065000000.0,6242000000,4177000000,4177000000,,-117000000,,,,1165000000,30973000000,26796000000,24731000000,-100000000,-13000000.0,2912000000,2912000000,53929,GD
2019-12-31,,,6542770,-263087,7454319,11656681,19241475,6101654,6101654,,,,,,-909976,34666653,28564999,15425178,441116,,7452746,7454319,53930,PAYS
2018-12-31,,,2581241,-206930,2588054,7835074,11397223,2472628,2472628,,,,,,0,23423675,20951047,12026452,108613,,2581241,2588054,53930,PAYS
2017-12-31,,,1791710,-200117,1791141,4055836,6699819,1767792,1767792,,-31623.0,,,,6000,15234091,13466299,8534272,23918,,1785710,1791141,53930,PAYS
2016-12-31,,,1297651,-194686,1400799,2606505,4537434,1358609,1358609,,-77107.0,,,,0,10416672,9058063,5879238,-60958,,1297651,1400799,53930,PAYS
2019-12-31,,,5223000,,4145000,1588000,0,-1588000,-1588000,,,,,,1078000,0,1588000,0,6811000,,4145000,4145000,53931,IOR
2018-12-31,,,10393000,,8210000,1810000,0,-1810000,-1810000,,,,,,2183000,0,1810000,0,12203000,,8210000,8210000,53931,IOR
2017-12-31,,,3139000,,1508000,1348000,0,-1348000,-1348000,,,,,,1631000,0,1348000,0,4487000,,1508000,1508000,53931,IOR
2016-12-31,,,3202000,,2081000,1292000,0,-1292000,-1292000,,,,,,1121000,0,1292000,0,4494000,,2081000,2081000,53931,IOR
2019-12-31,,,-2370629,,-2370629,1637674,-734819,-2372493,-2372493,,-4495,,,,0,1175896,3548389,1910715,1864,,-2370629,-2370629,53933,GOVX
2018-12-31,,,-2560094,,-2560094,1647268,-915449,-2562717,-2562717,,-2590,,,,0,963203,3525920,1878652,2623,,-2560094,-2560094,53933,GOVX
2017-12-31,,,-2170162,,-2170162,1232368,-942080,-2174448,-2174448,,-2590,,,,0,1075270,3249718,2017350,4286,,-2170162,-2170162,53933,GOVX
2016-12-31,,,-3271701,,-3271701,2131426,-1141941,-3273367,-3273367,,-2590,,,,0,828918,4102285,1970859,1666,,-3271701,-3271701,53933,GOVX
2020-12-31,,,70130000,,50771000,20590000,92108000,0,71518000,,,,,,19359000,92108000,20590000,0,-1388000,,50771000,50771000,53934,HIFS
2019-12-31,,,53548000,,38927000,19964000,74163000,0,54199000,,,,,,14621000,74163000,19964000,0,-651000,,38927000,38927000,53934,HIFS
2018-12-31,,,42729000,,30399000,19106000,62780000,0,43674000,,,,,,12330000,62780000,19106000,0,-945000,,30399000,30399000,53934,HIFS
2017-12-31,,,44127000,,25757000,18509000,63703000,0,45194000,,,,,,18370000,63703000,18509000,0,-1067000,,25757000,25757000,53934,HIFS
2019-12-31,,,297000000,118000000,275000000,8000000,492000000,380000000,380000000,26000000,-87000000,,,,-1000000,563000000,183000000,71000000,-83000000,,298000000,267000000,53935,TCP
2018-12-31,,,-164000000,121000000,-178000000,6000000,655000000,524000000,524000000,28000000,-93000000,,,,1000000,722000000,198000000,67000000,-688000000,,-165000000,-191000000,53935,TCP
2017-12-31,,,264000000,129000000,236000000,8000000,479000000,346000000,346000000,28000000,-83000000,,,,1000000,546000000,200000000,67000000,-82000000,,263000000,219000000,53935,TCP
2016-12-31,,,264000000,124000000,237000000,7000000,465000000,335000000,335000000,27000000,-72000000,,,,1000000,523000000,188000000,58000000,-71000000,,263000000,211000000,53935,TCP
2019-12-31,,,170771000,70078000,169117000,50060000,456798000,243191000,243191000,,-75344000,,,,0,655037000,411846000,198239000,-72420000,,170771000,169117000,53936,CUBE
2018-12-31,,,165488000,62590000,163889000,46184000,410513000,220979000,220979000,,-64445000,,,,0,597079000,376100000,186566000,-55491000,,165488000,163889000,53936,CUBE
2017-12-31,,,135611000,60556000,134288000,44445000,384455000,194329000,194329000,,-59590000,,,,0,557557000,363228000,173102000,-58718000,,135611000,134288000,53936,CUBE
2016-12-31,,,88376000,60262000,87905000,42223000,350930000,146842000,146842000,,-52976000,,,,0,507377000,360535000,156447000,-58466000,,88376000,79923000,53936,CUBE
2019-12-31,,,45431000000,29397000000,33012000000,17849000000,42109000000,22614000000,22614000000,1183000000,-15544000000,,,,6124000000,154642000000,132028000000,112533000000,22817000000,,39307000000,33012000000,53937,PAM
2018-12-31,,,8447000000,16160000000,8435000000,14228000000,35831000000,21239000000,21239000000,319000000,-11746000000,,,,658000000,110080000000,88841000000,74249000000,-12792000000,3019000000.0,7789000000,8435000000,53937,PAM
2017-12-31,,,15157000000,17792000000,10799000000,12285000000,22592000000,12697000000,12697000000,-2461000000,-8588000000,,,,-985000000,82008000000,69311000000,59416000000,2460000000,-1893000000.0,16142000000,10799000000,53937,PAM
2016-12-31,,,-1525000000,3020000000,-11000000,5042000000,4969000000,2522000000,2522000000,-2613000000,-4183000000,,,,-1201000000,25110000000,22588000000,20141000000,-4047000000,72000000.0,-324000000,-11000000,53937,PAM
2019-12-31,,,71000000,,36000000,1247000000,1606000000,359000000,359000000,,-69000000,,,,35000000,4988000000,4629000000,3382000000,-288000000,,36000000,36000000,53939,REZI
2018-12-31,,,104000000,,405000000,873000000,1370000000,497000000,497000000,,-20000000,,,,-301000000,4827000000,4330000000,3457000000,-393000000,,405000000,405000000,53939,REZI
2017-12-31,,,166000000,,-394000000,871000000,1316000000,445000000,445000000,,-20000000,,,,560000000,4519000000,4074000000,3203000000,-279000000,,-394000000,-394000000,53939,REZI
2016-12-31,,,310000000,,177000000,851000000,1365000000,329000000,329000000,185000000.0,-20000000,,,,133000000,4455000000,4126000000,3090000000,-19000000,,177000000,177000000,53939,REZI
2020-06-30,,,10085000,,7770000,1000000,111552000,26856000,26856000,58865000,-8910000,,,,2315000,405135000,378279000,293583000,-16771000,,7770000,7770000,53940,IBEX
2019-06-30,,,-904000,,10965000,1000000,85911000,10817000,10817000,49112000,-7252000,,,,3615000,368380000,357563000,282469000,-11721000,15484000.0,-4519000,10965000,53940,IBEX
2018-06-30,,,-20870000,20000000.0,-15881000,1000000,61216000,-16657000,-16657000,57305000,-2447000,,,,-108000,342200000,358857000,280984000,-4213000,4881000.0,-20762000,-15881000,53940,IBEX
2017-06-30,,,-8718000,20000000.0,-7764000,1000000,99519000,3544000,3544000,82143000,-6151000,,,,295000,334034000,330490000,234515000,-12262000,4881000.0,-9013000,-7764000,53940,IBEX
2020-12-31,56464000,,-38700000,12524000,-46911000,241428000,282765000,-15127000,-15127000,,-23311000,,,,702000,351737000,366864000,68972000,-23573000,,-39402000,-46911000,53942,BL
2019-12-31,43006000,,-30421000,4905000,-32535000,215228000,230001000,-28233000,-28233000,,-8650000,,,,1725000,288976000,317209000,58975000,-2188000,,-32146000,-32535000,53942,BL
2018-12-31,30754000,,-27704000,4387000,-28714000,175546000,176914000,-29386000,-29386000,,-4000,,,,1072000,227788000,257174000,50874000,1682000,,-28776000,-28714000,53942,BL
2017-12-31,23874000,,-32843000,4387000,-33408000,140125000,134218000,-29781000,-29781000,,-13000,,,,565000,175603000,205384000,41385000,-3062000,,-33408000,-33408000,53942,BL
2019-12-31,,,-829000,,-830000,26851000,159202000,55453000,55453000,,-65586000,,,,1000,366184000,310731000,206982000,-56282000,,-830000,-830000,53945,INSW
2018-12-31,,,-89045000,,-88940000,25907000,63187000,-35148000,-35148000,,-59530000,,,,-105000,270361000,305509000,207174000,-53897000,,-88940000,-88940000,53945,INSW
2017-12-31,,,-106044000,,-106088000,23927000,92060000,-10720000,-10720000,,-41247000,,,,44000,290101000,300821000,198041000,-95324000,,-106088000,-106088000,53945,INSW
2016-12-31,,,-17783000,,-18223000,30732000,205690000,95073000,95073000,,-40362000,,,,440000,398319000,303246000,192629000,-112856000,,-18223000,-18223000,53945,INSW
2019-12-31,,,16497,,16497,4217202,13683187,3007734,3007734,,-3805313,,,,0,27241462,24233728,13558275,-2991237,,16497,-1918149,53946,EDRY
2018-12-31,,,1119735,,1119735,4047842,13463964,3993967,3993967,,-2948705,,,,0,24522871,20528904,11058907,-2874232,,1119735,554506,53946,EDRY
2017-12-31,,,849701,,849701,2326876,9741804,2628656,2628656,,-1817574,,,,0,19158019,16529363,9416215,-1778955,,849701,849701,53946,EDRY
2016-12-31,,,-10141353,,-10141353,1578963,3487908,-1919689,-1919689,,-1161169,,,,0,7878953,9798642,4391045,-8221664,,-10141353,-10141353,53946,EDRY
2019-12-31,35000,,-1347000,,-1347000,807000,0,-842000,-842000,,,,,,0,0,842000,0,-505000,,-1347000,-1347000,53947,XTLB
2018-12-31,38000,,2986000,,2986000,755000,0,-793000,-793000,,,,,,0,0,793000,0,3779000,,2986000,2986000,53947,XTLB
2017-12-31,43000,,-781000,,-781000,1203000,0,-1246000,-1246000,,,,,,0,0,1246000,0,465000,,-781000,-781000,53947,XTLB
2016-12-31,443000,,-2545000,,-2545000,1270000,-5000,-1713000,-1713000,,,,,,0,0,1713000,5000,-832000,,-2545000,-2545000,53947,XTLB
2019-12-31,,,-97165000,,-97165000,65854000,-27247000,-93101000,-93101000,,-8120000,,,,0,148364000,241465000,175611000,-4064000,,-97165000,-97165000,53948,ESPR
2018-12-31,,,-201810000,,-201810000,33097000,-171488000,-204585000,-204585000,,-28000,,,,0,0,204585000,171488000,2775000,,-201810000,-201810000,53948,ESPR
2017-12-31,,,-166988000,,-166988000,21379000,-147603000,-168982000,-168982000,,-198000,,,,0,0,168982000,147603000,1994000,,-166988000,-166988000,53948,ESPR
2016-12-31,,,-74978000,,-74978000,18282000,-57868000,-76150000,-76150000,,-400000,,,,0,0,76150000,57868000,1172000,,-74978000,-74978000,53948,ESPR
2019-12-31,43242000,,-100125000,,-99873000,50891000,-10400000,-104883000,-104883000,350000,-1460000,,,,-252000,17416000,122299000,27816000,4758000,,-99873000,-99873000,53949,CVAC
2018-12-31,41722000,,-71131000,,-71241000,26374000,-4873000,-73632000,-73632000,663000,-275000,,,,110000,12871000,86503000,17744000,2501000,,-71241000,-71241000,53949,CVAC
2020-12-31,,,37408000,,27825000,65277000,118768000,0,39093000,14398000,,,,,9583000,118768000,79675000,0,-1685000,,27825000,27825000,53951,OSBC
2019-12-31,,,51857000,,39455000,63691000,130087000,0,52123000,14273000,,,,,12402000,130087000,77964000,0,-266000,,39455000,39455000,53951,OSBC
2018-12-31,,,43936000,,34012000,58363000,120038000,0,47828000,13847000,,,,,9924000,120038000,72210000,0,-3892000,,34012000,34012000,53951,OSBC
2017-12-31,,,34302000,,15138000,53604000,103451000,0,37221000,12626000,,,,,19164000,103451000,66230000,0,-2919000,,15138000,15138000,53951,OSBC
2020-07-31,,,9860302,,9860302,2283553,13007500,10723947,10723947,,-1344462,,,,0,13007500,2283553,0,-863645,,9860302,9860302,53952,MYF
2019-07-31,,,13189443,,13189443,1944677,14976103,13031426,13031426,,-2579631,,,,0,14976103,1944677,0,158017,,13189443,13189443,53952,MYF
2018-07-31,,,3013542,,3013542,1964132,16055322,14091190,14091190,,-2674893,,,,0,16055322,1964132,0,-11077648,,3013542,3013542,53952,MYF
2017-07-31,,,-2066199,,-2066199,2006495,15989056,13982561,13982561,,-2075770,,,,0,15989056,2006495,0,-16048760,,-2066199,-2066199,53952,MYF
2020-04-30,,,-27038473,,-27038473,6575225,44924499,38349274,38349274,,-8247629,,,,0,44924499,6575225,0,-65387747,,-27038473,-27038473,53953,BFK
2019-04-30,,,39942755,,39942755,6461427,46242126,39780699,39780699,,-9411986,,,,0,46242126,6461427,0,162056,,39942755,39942755,53953,BFK
2018-04-30,,,22750865,,22750865,6620677,47185209,40564532,40564532,,-8008669,,,,0,47185209,6620677,0,-17813667,,22750865,22750865,53953,BFK
2017-04-30,,,-5429613,,-5429613,7004999,49246669,42241670,42241670,,-6144570,,,,0,49246669,7004999,0,-47671283,,-5429613,-5429613,53953,BFK
2019-12-31,,,41615000,,41615000,2659000,20088000,17429000,17429000,,-2867000,,,,0,20088000,2659000,0,24186000,,41615000,41615000,53955,HYB
2018-12-31,,,-14086000,,-14086000,2682000,20772000,18090000,18090000,,-2649000,,,,0,20772000,2682000,0,-32176000,,-14086000,-14086000,53955,HYB
2017-12-31,,,23674000,,23674000,2725000,21101000,18376000,18376000,,-1823000,,,,0,21101000,2725000,0,5298000,,23674000,23674000,53955,HYB
2016-12-31,,,42271000,,42271000,2780000,21426000,18646000,18646000,,-1217000,,,,0,21426000,2780000,0,23625000,,42271000,42271000,53955,HYB
2020-06-30,370411000,,345205000,1319000,234225000,824635000,2311678000,601898000,601898000,,-149204000,,,,110837000,3109736000,2507838000,798058000,-256693000,,234368000,234225000,53957,OTEX
2019-06-30,321836000,,440574000,1215000,285501000,727639000,2121437000,601034000,601034000,,-137487000,,,,154937000,2868755000,2267721000,747318000,-160460000,,285637000,285501000,53957,OTEX
2018-06-30,322909000,,386126000,1037000,242224000,736077000,2050110000,534195000,534195000,,-132381000,,,,143826000,2815241000,2281046000,765131000,-148069000,,242300000,242224000,53957,OTEX
2017-06-30,281215000,,249551000,961000,1025659000,614807000,1660056000,418318000,418318000,,-116179000,,,,-776364000,2291057000,1872739000,631001000,-168767000,,1025915000,1025659000,53957,OTEX
2019-12-31,,,-11444000,,-9024000,69943000,101810000,9431000,9431000,,-20043000,,,,-2420000,203374000,193943000,101564000,-20875000,,-9024000,-9024000,53958,PAYA
2018-12-31,,,-7197000,3852000.0,-3170000,63770000,89051000,6942000,6942000,,-13630000,,,,-3879000,185078000,178136000,96027000,-14139000,,-3318000,-3170000,53958,PAYA
2017-12-31,,,-1702000,3852000.0,9399000,59959000,86201000,17892000,17892000,,-5880000,,,,-11101000,182139000,164247000,95938000,-19594000,,9399000,9399000,53958,PAYA
2020-09-30,,,-522600000,18200000,-690900000,1521100000,3196800000,1275200000,1275200000,,-465500000,,,,163500000,17578800000,16303600000,14382000000,-1797800000,,-686100000,-691000000,53959,WRK
2019-09-30,,,1144700000,16200000,862900000,1641000000,3581500000,1527300000,1527300000,,-489400000,,,,276800000,18289000000,16761700000,14707500000,-382600000,,867900000,862800000,53959,WRK
2018-09-30,,,1034800000,17200000,1906100000,1451300000,3362000000,1590500000,1590500000,,-352800000,,,,-874500000,16285100000,14694600000,12923100000,-555700000,,1909300000,1905900000,53959,WRK
2017-09-30,,,857600000,48300000,708200000,1405400000,2718200000,1083200000,1083200000,,-222500000,,,,159000000,14859700000,13776500000,12141500000,-225600000,,698600000,708100000,53959,WRK
2020-09-30,2955976,,2960901,,3269783,6100545,11801975,2745454,2745454,,,,,,-308882,21595199,18849745,9793224,215447,,3269783,3269783,53961,ISSC
2019-09-30,2489806,,1852101,,1850296,5877920,9896470,1528744,1528744,,,,,,1805,17572589,16043845,7676119,323357,,1850296,1850296,53961,ISSC
2018-09-30,3575801,,-3590254,,-3653905,6674187,6538449,-3711539,-3711539,,,,,,63651,13850372,17561911,7311923,121285,,-3653905,-3653905,53961,ISSC
2017-09-30,4456657,,4816547,,4568627,7339234,8118325,-3677566,-3677566,,,,,,247920,16786674,20464240,8668349,8494113,,4568627,4568627,53961,ISSC
2019-12-31,,,110411000,62109000,77164000,253131000,452424000,130207000,130207000,,-19113000,,,,25677000,1643704000,1513497000,1191280000,-19796000,,84734000,77164000,53965,TTEC
2018-12-31,,,56238000,7677000,35817000,182428000,351244000,99637000,99637000,,-28674000,,,,16483000,1509171000,1409534000,1157927000,-43399000,,39755000,35817000,53965,TTEC
2017-12-31,,,88887000,6978000,7256000,182314000,367297000,120476000,120476000,,-13734000,,,,78075000,1477365000,1356889000,1110068000,-31589000,,10812000,7256000,53965,TTEC
2016-12-31,,,50298000,6981000,33678000,175797000,333666000,89194000,89194000,,-7943000,,,,12863000,1275258000,1186064000,941592000,-38896000,,37435000,33678000,53965,TTEC
2019-12-31,4848000,,-13210000,,-12956000,4554000,-4042000,-8596000,-8596000,,,,,,-254000,806000,9402000,4848000,-4614000,,-12956000,-12956000,53969,YTEN
2018-12-31,4848000,,-9185000,,-9185000,4837000,-4227000,-9064000,-9064000,,,,,,0,556000,9620000,4783000,-121000,,-9185000,-9185000,53969,YTEN
2017-12-31,4848000,,-9396000,,-9396000,5630000,-3653000,-9283000,-9283000,,,,,,0,944000,10227000,4597000,-113000,,-9396000,-10823000,53969,YTEN
2016-12-31,4848000,,-10286000,,-7604000,5737000,-4511000,-10248000,-10248000,,,,,,-1097000,1159000,11407000,5670000,-38000,1585000.0,-9189000,-7604000,53969,YTEN
2019-12-31,,,71100000,-200000,48800000,107700000,228100000,91000000,91000000,,-18900000,,,,19400000,934900000,843900000,706800000,-19900000,,51700000,48800000,53972,SP
2018-12-31,,,76000000,100000,53200000,84600000,184000000,81500000,81500000,,-9600000,,,,19600000,775400000,693900000,591400000,-5500000,,56400000,53200000,53972,SP
2017-12-31,,,72200000,200000,41200000,81700000,185300000,82600000,82600000,,-9200000,,,,27700000,911300000,828700000,726000000,-10400000,,44500000,41200000,53972,SP
2016-12-31,,,41800000,200000,23100000,84700000,176400000,60400000,60400000,,-10500000,,,,15800000,891800000,831400000,715400000,-18600000,,26000000,23100000,53972,SP
2019-12-31,,,9553000,,9553000,17594000,52521000,34927000,34927000,,-15829000,,,,0,52521000,17594000,0,-25374000,,9553000,9553000,53974,OFS
2018-12-31,,,9572000,,9572000,15217000,42834000,27617000,27617000,,-9232000,,,,0,42834000,15217000,0,-18045000,,9572000,9572000,53974,OFS
2017-12-31,,,7910000,,7910000,11736000,33426000,21690000,21690000,,-5813000,,,,0,33426000,11736000,0,-13780000,,7910000,7910000,53974,OFS
2016-12-31,,,13828000,,13828000,11647000,31094000,19447000,19447000,,-5302000,,,,0,31094000,11647000,0,-5619000,,13828000,13828000,53974,OFS
2020-11-30,,,-577971867,,-575749881,8600312,9612109,1011797,1011797,,-12634856,,,,-2221986,9612109,8600312,0,-578983664,,-575749881,-575749881,53977,TYG
2019-11-30,,,-194073226,,-191409708,21145695,28278630,7132935,7132935,,-25853742,,,,-2663518,28278630,21145695,0,-201206161,,-191409708,-191409708,53977,TYG
2018-11-30,,,71674747,,96354291,23207503,-1307021,-24514524,-24514524,,-25421946,,,,-24679544,-1307021,23207503,0,96189271,,96354291,96354291,53977,TYG
2017-11-30,,,-130738515,,-113427641,26160696,1956784,-24203912,-24203912,,-24752116,,,,-17310874,1956784,26160696,0,-106534603,,-113427641,-113427641,53977,TYG
2019-12-31,,,-1382000,,-955000,8966000,7875000,-1176000,-1176000,,-20000,,,,-540000,93811000,94987000,85936000,-206000,-113000,-842000,-955000,53979,HSON
2018-12-31,,,-5167000,,7867000,10330000,7754000,-2592000,-2592000,,-20000,,,,99000,66932000,69524000,59178000,-2575000,13133000,-5266000,7867000,53979,HSON
2017-12-31,,,-1975000,,-2941000,43617000,42060000,-1918000,-1918000,,-8000,,,,869000,59615000,61533000,17555000,-57000,-97000,-2844000,-2941000,53979,HSON
2016-12-31,,,-8191000,,-8790000,177334000,174417000,-6007000,-6007000,,-357000,,,,742000,422744000,428751000,248327000,-2184000,143000,-8933000,-8790000,53979,HSON
2020-03-28,853589000,,833984000,,792721000,428108000,2137432000,824450000,824450000,,-39820000,,,,41263000,3162666000,2338216000,1025234000,9534000,,792721000,792721000,53980,XLNX
2019-03-30,743027000,,968332000,,889750000,398416000,2103172000,956799000,956799000,,-52883000,,,,78582000,3059040000,2102241000,955868000,11533000,,889750000,889750000,53980,XLNX
2018-03-31,639750000,,691379000,,463981000,362329000,1723604000,719373000,719373000,,-45837000,,,,227398000,2467023000,1747650000,743419000,-27994000,,463981000,463981000,53980,XLNX
2017-04-01,601443000,,698076000,,628133000,335150000,1648110000,706390000,706390000,,-53953000,,,,69943000,2356742000,1650352000,708632000,-8314000,,628133000,628133000,53980,XLNX
2019-12-31,,,555986000,83806000,545964000,24569000,870899000,842499000,842499000,,-248384000,,,,1705000,894798000,52299000,23899000,-286513000,,554281000,545964000,53981,VICI
2018-12-31,,,533558000,83573000,523619000,24429000,798403000,770288000,770288000,,-212663000,,,,1441000,897977000,127689000,99574000,-236730000,,532117000,523619000,53981,VICI
2017-12-31,,,42636000,84875000,42662000,11280000,158629000,144196000,144196000,,-63354000,,,,-1901000,201436000,57240000,42807000,-101560000,,44537000,42662000,53981,VICI
2016-12-31,,,42636000,84875000,0,2009000,5046000,7000,7000,,-7000,,,,0,18785000,18778000,13739000,-7000,,44537000,42662000,53981,VICI
2020-12-31,,,249359000,,197853000,384616000,706548000,0,276013000,45919000,,,,,51506000,706548000,430535000,0,-26654000,,197853000,188971000,53983,BKU
2019-12-31,,,403996000,,313098000,395158000,891085000,0,437483000,58444000,,,,,90898000,891085000,453602000,0,-33487000,,313098000,299727000,53983,BKU
2018-12-31,,,415650000,,324866000,402596000,1156190000,0,434634000,318960000,,,,,90784000,1156190000,721556000,0,-18984000,,324866000,311819000,53983,BKU
2017-12-31,,,404461000,,614273000,385867000,1039429000,0,426472000,227090000,,,,,-209812000,1039429000,612957000,0,-22011000,,614273000,591023000,53983,BKU
2019-12-31,42000000,,341850000,25602000,253668000,840906000,1312607000,429701000,429701000,,-54980000,,,,80070000,3944850000,3515149000,2632243000,-87851000,,261780000,253668000,53984,FLS
2018-12-31,39600000,,176274000,18465000,119671000,840811000,1230534000,350123000,350123000,,-58160000,,,,51224000,3832666000,3482543000,2602132000,-173849000,,125050000,119671000,53984,FLS
2017-12-31,38600000,,263007000,16367000,2652000,842840000,1088953000,207513000,207513000,,-59730000,,,,258679000,3660831000,3453318000,2571878000,55494000,,4328000,2652000,53984,FLS
2016-12-31,42800000,,212912000,20961000,132455000,931295000,1236798000,262703000,262703000,,-60137000,,,,77380000,3990487000,3727784000,2753689000,-49791000,,135532000,132461000,53984,FLS
2019-12-31,51357000,,-122828000,,-124827000,204405000,126858000,-128904000,-128904000,,-10693000,,,,1999000,302328000,431232000,175470000,6076000,,-124827000,-124827000,53985,NTRA
2018-12-31,49811000,,-127833000,,-128154000,154872000,91599000,-113084000,-113084000,,-10476000,,,,321000,257654000,370738000,166055000,-14749000,,-128154000,-128154000,53985,NTRA
2017-12-31,50064000,,-137174000,,-137628000,155306000,70029000,-135341000,-135341000,,-4213000,,,,454000,209625000,344966000,139596000,-1833000,,-137628000,-137628000,53985,NTRA
2016-12-31,41862000,,-100185000,,-100327000,135926000,78838000,-98950000,-98950000,,-533000,,,,142000,212512000,311462000,133674000,-1235000,,-100327000,-100327000,53985,NTRA
2020-12-31,,,18377000,,18377000,66599000,113831000,0,47232000,,,,,,0,113831000,66599000,0,-28855000,,18377000,1406000,53986,ARI
2019-12-31,,,230174000,,230174000,64831000,300012000,0,235181000,,,,,,0,300012000,64831000,0,-5007000,,230174000,207782000,53986,ARI
2018-12-31,,,219986000,,219986000,56894000,269292000,0,212398000,,,,,,0,269292000,56894000,0,7588000,,219986000,189241000,53986,ARI
2017-12-31,,,193031000,,193031000,52377000,255464000,0,203087000,,,,,,0,255464000,52377000,0,-10056000,,193031000,153357000,53986,ARI
2019-12-31,,,1087374000,252726000,297612000,5527349000,8076938000,2282412000,2282412000,243278000,-2117003000,,,,-125887000,33446980000,31164568000,25370042000,-1195038000,-904628000,1213261000,297612000,53987,BRFS
2018-12-31,,,-2447808000,567150000,-4448061000,5064759000,4867668000,-12449000,-12449000,-230911000,-1555410000,,,,-333302000,30188421000,30200870000,25320753000,-2435359000,-2333093000,-2114506000,-4448061000,53987,BRFS
2017-12-31,,,-1218574000,512571000,-1098854000,4671206000,5712945000,997808000,997808000,-23540000,-1836901000,,,,-251809000,28314160000,27316352000,22601215000,-2216382000,-132089000,-966765000,-1098854000,53987,BRFS
2016-12-31,,,-317500000,379400000,-372400000,5543100000,7526500000,1785900000,1785900000,197500000,-4506400000,,,,49900000,33732900000,31947000000,26206400000,-2103400000,-132089000,-367400000,-372400000,53987,BRFS
2020-06-30,1131724,,-13446538,,-13446538,3300935,0,-4432659,-4432659,,-93670,,,,0,0,4432659,0,-9013879,,-13446538,-13446538,53990,NNVC
2019-06-30,5921720,,-8424440,,-8424440,2737962,0,-8659682,-8659682,,-93670,,,,0,0,8659682,0,235242,,-8424440,-8424440,53990,NNVC
2018-06-30,5913720,,-8563455,,-8563455,3357949,0,-9271669,-9271669,,-544488,,,,0,0,9271669,0,708214,,-8563455,-8563455,53990,NNVC
2017-06-30,6565966,,-10304490,,-10304490,3034758,0,-9600724,-9600724,,-2128515,,,,0,0,9600724,0,-703766,,-10304490,-10304490,53990,NNVC
2020-10-31,3188389,,3401807,,3343585,6737294,12729448,2803765,2803765,,-70203,,,,58222,20043810,17240045,7314362,598042,,3343585,3343585,53994,CODA
2019-10-31,2801331,,6232553,,5225199,7374551,16429319,6253437,6253437,,-91096,,,,1007354,25056934,18803497,8627615,-20884,,5225199,5225199,53994,CODA
2018-10-31,2571714,,3102899,,4988531,6779881,12662362,3310767,3310767,,-249090,,,,-1885632,18019429,14708662,5357067,-207868,,4988531,4988531,53994,CODA
2017-10-31,1380381,,3342284,,3339663,6769327,11967725,3818017,3818017,,-597011,,,,2621,18025173,14207156,6057448,-475733,,3339663,3339663,53994,CODA
2020-03-31,,,-54017275,,-54017275,2819136,30372952,27553816,27553816,,-3957900,,,,0,30372952,2819136,0,-81571091,,-54017275,-54017275,53995,PHT
2019-03-31,,,5092937,,5092937,2924337,30600686,27676349,27676349,,-4210958,,,,0,30600686,2924337,0,-22583412,,5092937,5092937,53995,PHT
2018-03-31,,,17454253,,17454253,3426427,31540164,28113737,28113737,,-3310065,,,,0,31540164,3426427,0,-10659484,,17454253,17454253,53995,PHT
2017-03-31,,,67989658,,67989658,2946015,34114494,31168479,31168479,,-3309973,,,,0,34114494,2946015,0,36821179,,67989658,67989658,53995,PHT
2019-12-31,79025000,,-144594000,,-112689000,59873000,0,-138898000,-138898000,,,,,,-9208000,0,138898000,0,-5696000,22697000,-135386000,-112689000,53997,SPPI
2018-12-31,75157000,,-128607000,,-120741000,62690000,0,-137847000,-137847000,,-3132000.0,,,,-1901000,0,137847000,0,9240000,5965000,-126706000,-120741000,53997,SPPI
2017-12-31,51525000,,-122693000,,-92189000,64759000,0,-116284000,-116284000,,-8072000.0,,,,-21941000,0,116284000,0,-6409000,8563000,-100752000,-92189000,53997,SPPI
2016-12-31,59123000,,-72083000,,-69770000,86018000,110601000,-60486000,-60486000,,-9694000.0,,,,-2313000,146444000,206930000,35843000,-11597000,8563000,-69770000,-69770000,53997,SPPI
2019-12-31,32350000,,-45513000,,-45513000,13232000,0,-45582000,-45582000,,,,,,0,0,45582000,0,69000,,-45513000,-45513000,53998,APLT
2018-12-31,11471000,,-16521000,,-16521000,2047000,0,-13518000,-13518000,,-1642000.0,,,,0,0,13518000,0,-3003000,,-16521000,-16521000,53998,APLT
2017-12-31,3703000,,-4282000,,-4282000,582000,0,-4285000,-4285000,,-1642000.0,,,,0,0,4285000,0,3000,,-4282000,-4282000,53998,APLT
2019-12-31,2343848,,-48279317,,-48279317,28080386,-10155155,-41424327,-41424327,,-8993379,,,,0,29349083,70773410,39504238,-6854990,,-48279317,-48279317,54000,ADMA
2018-12-31,3926120,,-65743445,,-65743445,30308541,-25209345,-60288944,-60288944,,-5522783,,,,0,16985290,77274234,42194635,-5454501,,-65743445,-65743445,54000,ADMA
2017-12-31,5570029,,-43758975,,-43758975,21356143,-13403761,-40964607,-40964607,,-3285847,,,,0,15760560,56725167,29164321,-2794368,,-43758975,-43758975,54000,ADMA
2016-12-31,7688238,,-19515151,,-19515151,13942433,4300276,-17330395,-17330395,,-2239569,,,,0,10661037,27991432,6360761,-2184756,,-19515151,-19515151,54000,ADMA
2020-12-31,,,10907000,,8858000,19354000,34722000,0,11305000,4063000,,,,,2049000,34722000,23417000,0,-398000,,8858000,8858000,54002,FXNC
2019-12-31,,,11794000,,9556000,19644000,36112000,0,12156000,4312000,,,,,2238000,36112000,23956000,0,-362000,,9556000,9556000,54002,FXNC
2018-12-31,,,12422000,,10135000,19075000,35588000,0,12561000,3952000,,,,,2287000,35588000,23027000,0,-139000,,10135000,10135000,54002,FXNC
2017-12-31,,,10174000,,6448000,19115000,33146000,0,10865000,3166000,,,,,3726000,33146000,22281000,0,-691000,,6448000,6448000,54002,FXNC
2020-06-30,,,-8799000,,-8799000,1695000,13702000,12007000,12007000,,-1200000,,,,0,13702000,1695000,0,-20806000,,-8799000,-8799000,54004,PCM
2019-06-30,,,10604000,,10604000,1642000,11891000,10249000,10249000,,302000,,,,0,11891000,1642000,0,355000,,10604000,10604000,54004,PCM
2018-06-30,,,12271000,,12271000,1704000,13798000,12094000,12094000,,-2854000,,,,0,13798000,1704000,0,177000,,12271000,12271000,54004,PCM
2017-06-30,,,21958000,,21958000,1780000,14829000,13049000,13049000,,-1847000,,,,0,14829000,1780000,0,8909000,,21958000,21958000,54004,PCM
2020-09-30,,,287062000,,214509000,382469000,711002000,292899000,292899000,,-2059000,,,,72553000,3461537000,3168638000,2750535000,-5837000,,214509000,214509000,54005,MMS
2019-09-30,,,317320000,409000.0,240824000,318332000,671184000,319798000,319798000,,-2957000,,,,76825000,2886815000,2567017000,2215631000,-2478000,,240495000,240824000,54005,MMS
2018-09-30,,,299209000,2552000.0,220751000,284294000,594385000,299783000,299783000,,-1000000,,,,78393000,2392236000,2092453000,1797851000,-574000,,220816000,220751000,54005,MMS
2017-09-30,,,314235000,5683000.0,209426000,284510000,611905000,315187000,315187000,,-2162000,,,,102053000,2450961000,2135774000,1839056000,-952000,,212182000,209426000,54005,MMS
2020-12-31,,,964000000,296000000,500000000,944000000,1910000000,625000000,625000000,341000000,-73000000,,,,397000000,10165000000,9540000000,8255000000,339000000,,567000000,500000000,54007,BWA
2019-12-31,413000000.0,,1265000000,138000000,746000000,484000000,2101000000,1206000000,1206000000,-2000000,-55000000,,,,468000000,10168000000,8962000000,8067000000,59000000,,797000000,746000000,54007,BWA
2018-12-31,440000000.0,,1196000000,119000000,931000000,497000000,2230000000,1297000000,1297000000,-4000000,-59000000,,,,211000000,10530000000,9233000000,8300000000,-101000000,,985000000,931000000,54007,BWA
2017-12-31,408000000.0,,1063000000,109100000,440000000,485000000,2115000000,1222000000,1222000000,-4000000,-71000000,,,,580000000,9799000000,8577000000,7684000000,-159000000,,483000000,440000000,54007,BWA
2020-09-30,,,3111000,,2190000,15622000,21464000,0,4089000,1753000,,,,,921000,21464000,17375000,0,-978000,,2190000,2190000,54009,MGYR
2019-09-30,,,4261000,,2996000,15070000,21861000,0,4921000,1870000,,,,,1265000,21861000,16940000,0,-660000,,2996000,2996000,54009,MGYR
2018-09-30,,,3501000,,2030000,14441000,20825000,0,4467000,1917000,,,,,1471000,20825000,16358000,0,-966000,,2030000,2030000,54009,MGYR
2017-09-30,,,2417000,,1423000,13651000,18861000,0,3507000,1703000,,,,,994000,18861000,15354000,0,-1090000,,1423000,1423000,54009,MGYR
2019-12-31,,,-11797564,,-8772757,2469162,867431,-6987734,-6987734,,-2995398,,,,-3024807,867431,7855165,0,-4809830,,-8772757,-8772757,54011,CREG
2018-12-31,,,-66573097,-3544624.0,-65996898,5548475,8200481,-29558650,-29558650,,-8738148,,,,2627458,8200481,37759131,0,-37014447,,-69200555,-65996898,54011,CREG
2017-12-31,,,369778,-478637.0,-7342551,5548509,13099673,5806447,5806447,,-5564473,,,,8039476,13099673,7293226,0,-5436669,,-7669698,-7342551,54011,CREG
2016-12-31,,,-55576093,-132431.0,-48295432,4531730,4408435,-123295,-123295,,-7178248,,,,-6933525,4482850,4606145,74415,-55452798,,-48642568,-48295432,54011,CREG
2019-12-31,,,6380065,19361905,5682024,6879472,25225585,14620052,14620052,,-6055310,,,,0,89622156,75002104,64396571,-8239987,,6380065,5682024,54012,PME
2018-12-31,,,14812698,18892322,13397301,6135644,31016506,19089305,19089305,,-1210974,,,,0,64256088,45166783,33239582,-4276607,,14812698,13397301,54012,PME
2017-12-31,,,32520131,18147859,29659693,5734826,22082789,11272354,11272354,,-2403213,,,,0,63209687,51937333,41126898,21247777,,32520131,29659693,54012,PME
2016-12-31,,,-14676327,14674123,-13717623,2159729,-8788007,-13992969,-13992969,,-1972267,,,,984,20540769,34533738,29328776,-683358,,-14677311,-13717623,54012,PME
2020-11-30,,,-3939098,,-3939098,13860014,20756660,6896646,6896646,,-439378,,,,0,20756660,13860014,0,-10835744,,-3939098,-3939098,54013,BIF
2019-11-30,,,59127223,,59127223,15128472,22447483,7319011,7319011,,-439378,,,,0,22447483,15128472,0,51808212,,59127223,59127223,54013,BIF
2018-11-30,,,94582611,,94582611,16639649,26475870,9836221,9836221,,-138478,,,,0,26475870,16639649,0,84746390,,94582611,94582611,54013,BIF
2017-11-30,,,247458610,,247458610,16367164,21637489,5270325,5270325,,-887118,,,,0,21637489,16367164,0,242188285,,247458610,247458610,54013,BIF
2020-08-31,,,5233718,,5233718,4352017,28372843,24020826,24020826,,-4995683,,,,0,28372843,4352017,0,-18787108,,5233718,5233718,54015,MHN
2019-08-31,,,48814903,,48814903,4244778,28647142,24402364,24402364,,-6880901,,,,0,28647142,4244778,0,24412539,,48814903,48814903,54015,MHN
2018-08-31,,,-1217223,,-1217223,4282039,29517233,25235194,25235194,,-6424354,,,,0,29517233,4282039,0,-26452417,,-1217223,-1217223,54015,MHN
2017-08-31,,,-1808933,,-1808933,4392106,30749288,26357182,26357182,,-5013273,,,,0,30749288,4392106,0,-28166115,,-1808933,-1808933,54015,MHN
2017-12-31,,,,,0,,0,0,,,,,,,0,0,0,0,47312000,,,,54016,NEWTI
2016-12-31,,,27305000.0,,27305000,31489000.0,30965000,-820000,-820000.0,,-8440000.0,,,,0,30965000,31785000,0,28125000,,27305000.0,27305000.0,54016,NEWTI
2015-12-31,,,35736000.0,,35736000,25450000.0,26070000,294000,294000.0,,-6479000.0,,,,0,26070000,25776000,0,35442000,,35736000.0,35736000.0,54016,NEWTI
2014-12-31,,,8018000.0,,3974000,45603000.0,63154000,14411000,14411000.0,-43000.0,-7891000.0,,,,4129000,130112000,115701000,66958000,-6393000,,3889000.0,3974000.0,54016,NEWTI
2020-12-31,,,3429000000,31000000,7517000000,7911000000,13726000000,0,3429000000,2386000000,,,,,426000000,13726000000,10297000000,0,0,4555000000,3003000000,7249000000,54017,PNC
2019-12-31,,,6480000000,29000000,5369000000,7992000000,17054000000,0,6480000000,2582000000,,,,,1062000000,17054000000,10574000000,0,0,4555000000,5418000000,5108000000,54017,PNC
2018-12-31,,,6428000000,42000000,5301000000,7677000000,16724000000,0,6428000000,2619000000,,,,,1082000000,16724000000,10296000000,0,0,4555000000,5346000000,5040000000,54017,PNC
2017-12-31,,,5490000000,72000000,5338000000,7445000000,15888000000,0,5490000000,2953000000,,,,,102000000,15888000000,10398000000,0,0,4555000000,5388000000,5053000000,54017,PNC
2020-12-31,,,270700000,,200300000,727200000,1089300000,310400000,310400000,,-39700000,,,,70400000,3950600000,3640200000,2861300000,-39700000,,200300000,200300000,54018,ASGN
2019-12-31,,,236800000,,174700000,763700000,1130000000,315200000,315200000,,-71800000,,,,62000000,3923900000,3608700000,2793900000,-78400000,-100000.0,174800000,174700000,54018,ASGN
2018-12-31,,,204200000,,157700000,688400000,1023700000,276800000,276800000,,-56000000,,,,46200000,3399800000,3123000000,2376100000,-72600000,-300000.0,158000000,157700000,54018,ASGN
2017-12-31,,,197100000,,157700000,592000000,850100000,224700000,224700000,,-27600000,,,,39200000,2626000000,2401300000,1775900000,-27600000,-200000.0,157900000,157700000,54018,ASGN
2020-11-30,,,17399894,,17399894,2560002,19044709,16484707,16484707,,-1651228,,,,0,19044709,2560002,0,915187,,17399894,17399894,54020,FLC
2019-11-30,,,39922183,,39922183,2589499,19116264,16526765,16526765,,-3397385,,,,0,19116264,2589499,0,23395418,,39922183,39922183,54020,FLC
2018-11-30,,,-11424916,,-11424916,2530982,18733568,16202586,16202586,,-2946314,,,,0,18733568,2530982,0,-27627502,,-11424916,-11424916,54020,FLC
2017-11-30,,,34208328,,34208328,2662993,19005601,16342608,16342608,,-2131308,,,,0,19005601,2662993,0,17865720,,34208328,34208328,54020,FLC
2019-12-31,,,93818394,,93818394,5132836,10179992,5047156,5047156,,-5133907,,,,0,10179992,5132836,0,88771238,,93818394,93818394,54021,GPM
2018-12-31,,,-51248740,,-51248740,5604544,10324261,4719717,4719717,,-5251330,,,,0,10324261,5604544,0,-55968457,,-51248740,-51248740,54021,GPM
2017-12-31,,,62074667,,62074667,5013888,8977651,3963763,3963763,,-3222555,,,,0,8977651,5013888,0,58110904,,62074667,62074667,54021,GPM
2016-12-31,,,17874781,,17874781,2293223,4382848,2089625,2089625,,-860012,,,,0,4382848,2293223,0,15785156,,17874781,17874781,54021,GPM
2019-12-31,201404000,,564192000,255000,527747000,830188000,1804611000,534669000,534669000,,,,,,37007000,2230176000,1695507000,425565000,29523000,,527185000,527747000,54024,JFIN
2018-12-31,184302000,,705673000,255000,611758000,877047000,2480261000,1152934000,1152934000,,,,,,93915000,2881940000,1729006000,401679000,-447261000,,611758000,611758000,54024,JFIN
2017-12-31,180967000,,701192000,255000,539545000,980463000,2021497000,729124000,729124000,,,,,,161647000,2250850000,1521726000,229353000,-27932000,,539545000,539545000,54024,JFIN
2016-12-31,88705000,,-508017000,255000,-389751000,522715000,447897000,-289195000,-289195000,,,,,,-118266000,591098000,880293000,143201000,-218822000,,-389751000,-389751000,54024,JFIN
2019-12-31,,,38359000,,31285000,21005000,57854000,36849000,36849000,,-2169000,,,,7074000,102515000,65666000,44661000,1510000,,31285000,31031000,54025,TIG
2018-12-31,,,25068000,,19522000,15706000,42774000,27068000,27068000,,-1557000,,,,5546000,78503000,51435000,35729000,-2000000,,19522000,19267000,54025,TIG
2020-12-31,,,49068000,,35299000,63927000,138579000,0,51669000,22983000,,,,,13769000,138579000,86910000,0,-2601000,,35299000,35299000,54027,HTBK
2019-12-31,,,56312000,,40461000,54080000,141210000,0,67392000,19738000,,,,,15851000,141210000,73818000,0,-11080000,,40461000,40461000,54027,HTBK
2018-12-31,,,48655000,,35331000,48495000,123799000,0,56523000,18781000,,,,,13324000,123799000,67276000,0,-7868000,,35331000,35331000,54027,HTBK
2017-12-31,,,50299000,,23828000,43279000,111037000,0,50970000,16788000,,,,,26471000,111037000,60067000,0,-671000,,23828000,23828000,54027,HTBK
2020-12-31,,,-2599000000,145000000,-2590000000,271000000,1783000000,859000000,859000000,,-436000000,,,,-19000000,23290000000,22431000000,21507000000,-3458000000,,-2580000000,-2790000000,54029,PAA
2019-12-31,,,2246000000,133000000,2171000000,297000000,2925000000,2027000000,2027000000,,-425000000,,,,66000000,33669000000,31642000000,30744000000,219000000,,2180000000,1967000000,54029,PAA
2018-12-31,,,2414000000,133000000,2216000000,316000000,3007000000,2171000000,2171000000,,-431000000,,,,198000000,34055000000,31884000000,31048000000,243000000,,2216000000,2009000000,54029,PAA
2017-12-31,,,902000000,133000000,856000000,270000000,2090000000,1303000000,1303000000,,-510000000,,,,44000000,26223000000,24920000000,24133000000,-401000000,,858000000,685000000,54029,PAA
2019-12-31,,,341297445,,341297445,7738606,62191667,54453061,54453061,,,,,,0,62191667,7738606,0,286844384,,341297445,339415595,54032,TY
2018-12-31,,,-73451197,,-73451197,7998755,61290134,53291379,53291379,,,,,,0,61290134,7998755,0,-126742576,,-73451197,-75333047,54032,TY
2017-12-31,,,280958443,,280958443,7669091,59288897,51619806,51619806,,,,,,0,59288897,7669091,0,229338637,,280958443,279076593,54032,TY
2016-12-31,,,185422388,,185422388,7023599,58971987,51948388,51948388,,,,,,0,58971987,7023599,0,133474000,,185422388,183540538,54032,TY
2019-12-31,,,-347694000,,-347694000,96388000,-264938000,-361326000,-361326000,,,,,,0,66512000,427838000,331450000,13632000,,-347694000,-347694000,54033,BPMC
2018-12-31,,,-236642000,,-236642000,47928000,-199100000,-247028000,-247028000,,,,,,0,44521000,291549000,243621000,10386000,,-236642000,-236642000,54033,BPMC
2017-12-31,,,-148119000,,-148119000,27986000,-123261000,-151247000,-151247000,,,,,,0,21426000,172673000,144687000,3128000,,-148119000,-148119000,54033,BPMC
2016-12-31,,,-72495000,,-72495000,19218000,-53359000,-72577000,-72577000,,-469000.0,,,,0,27772000,100349000,81131000,82000,,-72495000,-72495000,54033,BPMC
2019-12-31,561423000,,-576677000,,-571541000,67881000,40918000,-587942000,-587942000,-444000,-3205000,,,,-5136000,41333000,629275000,415000,11265000,,-571541000,-571541000,54035,ZEAL
2018-12-31,438219000,,625051000,,581278000,43543000,34621000,-446511000,-446511000,-630000,-33427000,,,,43773000,37977000,484488000,3356000,1071562000,,581278000,581278000,54035,ZEAL
2017-12-31,323949000,,-279913000,,-274413000,47343000,122159000,-248526000,-248526000,-607000,-24661000,,,,-5500000,136322000,384848000,14163000,-31387000,,-274413000,-274413000,54035,ZEAL
2016-12-31,262059000,,-162796000,,-157296000,58603000,199933000,-119032000,-119032000,-1697000,-40526000,,,,-5500000,230864000,349896000,30931000,-43764000,,-157296000,-157296000,54035,ZEAL
2019-12-31,17629000,,-18746000,,-18746000,15993000,12947000,-20675000,-20675000,,,,,,0,28947000,49622000,16000000,1929000,,-18746000,-19800000,54036,FREQ
2018-12-31,11518000,,-19168000,3773000.0,-19168000,7426000,0,-18944000,-18944000,,-106000.0,,,,0,0,18944000,0,-224000,,-19168000,-19168000,54036,FREQ
2017-12-31,11552000,,-20237000,3773000.0,-20237000,4754000,0,-16306000,-16306000,,-174000.0,,,,0,0,16306000,0,-3931000,,-20237000,-20237000,54036,FREQ
2018-12-31,5253000,,-11162000,,-11162000,2533000,0,-7786000,-7786000,,,,,,0,0,7786000,0,-3376000,,-11162000,-11162000,54037,LUMO
2017-12-31,6321000,,-8946000,,-8946000,2676000,0,-8997000,-8997000,,,,,,0,0,8997000,0,51000,,-8946000,-8946000,54037,LUMO
2019-12-31,,,-53237000,,-53240000,45027000,-9178000,-54205000,-54205000,,-2535000,,,,3000,2289000,56494000,11467000,968000,,-53240000,-53240000,54039,ACRX
2018-12-31,13137000.0,,-47147000,,-47149000,20765000,-14962000,-35727000,-35727000,,-12558000,,,,2000,2151000,37878000,17113000,-11420000,,-47149000,-47149000,54039,ACRX
2017-12-31,13137000.0,,-52209000,,-51508000,16609000,-22073000,-38682000,-38682000,,-14037000,,,,-701000,7995000,46677000,30068000,-13527000,,-51508000,-51508000,54039,ACRX
2016-12-31,13137000.0,,-43191000,,-43157000,15597000,-16360000,-31957000,-31957000,,-12152000,,,,-34000,17357000,49314000,33717000,-11234000,,-43157000,-43157000,54039,ACRX
2019-12-31,,,147111000,51656000,145463000,68886000,1033084000,430479000,430479000,,-367173000,,,,0,1764685000,1334206000,731601000,-283368000,,147111000,145068000,54040,INVH
2018-12-31,,,-5013000,140075000,-4927000,73631000,1002066000,367894000,367894000,,-383595000,,,,0,1722962000,1355068000,720896000,-372907000,,-5013000,-5744000,54040,INVH
2017-12-31,,,-105826000,151790000,-105337000,118019000,619617000,192020000,192020000,,-256970000,,,,0,1054456000,862436000,434839000,-297846000,,-105826000,-89073000,54040,INVH
2016-12-31,,,-78239000,151790000,-78239000,56123000,531767000,207963000,207963000,,-286048000,,,,0,922587000,714624000,390820000,-286202000,,-78239000,-78239000,54040,INVH
2019-12-31,,,-4040536,,-3142576,14581576,15439575,-2685086,-2685086,,,,,,-897960,24598274,27283360,9158699,-1990450,,-3142576,-3142576,54043,OPRX
2018-12-31,,,226344,,226344,8449041,12206697,920302,920302,,,,,,0,21206363,20286061,8999666,-693958,,226344,226344,54043,OPRX
2017-12-31,,,-2104029,,-2104029,6489117,5952808,-1763249,-1763249,,,,,,0,12127422,13890671,6174614,-340780,,-2104029,-2104029,54043,OPRX
2016-12-31,,,-1539203,,-1539203,5076993,4340066,-1531512,-1531512,,,,,,0,7751462,9282974,3411396,-7691,,-1539203,-1539203,54043,OPRX
2019-12-31,415995000,,2706511000,,2294552000,1950815000,5119567000,2627286000,2627286000,125471000,-39215000,,,,411959000,10603507000,7976221000,5483940000,79225000,,2294552000,2294552000,54047,LX
2018-12-31,320165000,,2109528000,,1977306000,869842000,3050194000,1821933000,1821933000,38254000,-23059000,,,,132222000,7596896000,5774963000,4546702000,287595000,,1977306000,1977306000,54047,LX
2017-12-31,235292000,,474579000,,240352000,609140000,1320092000,475660000,475660000,38254000,-75517000,,,,234227000,5582189000,5106529000,4262097000,-1081000,,240352000,25994000,54047,LX
2016-12-31,127317000,,-59681000,,-117939000,463677000,602032000,11038000,11038000,38254000,-48343000,,,,58258000,4338686000,4327648000,3736654000,-70719000,,-117939000,-222917000,54047,LX
2020-06-30,97300000,,811200000,61200000,612200000,1282800000,2535500000,1190800000,1190800000,-35400000,-206900000,,,,186900000,12467500000,11276700000,9932000000,-379600000,-7700000,624300000,611800000,54048,AMCR
2019-06-30,64000000,,608200000,65700000,430200000,815200000,1799100000,938300000,938300000,-18400000,-207900000,,,,171500000,9458200000,8519900000,7659100000,-330100000,700000,436700000,429400000,54048,AMCR
2018-06-30,72700000,,705400000,68800000,575200000,784200000,1856800000,1042900000,1042900000,-43000000,-210000000,,,,118800000,9319100000,8276200000,7462300000,-337500000,700000,586600000,573900000,54048,AMCR
2017-06-30,69100000,,729900000,69600000,564000000,912500000,1911800000,971300000,971300000,-41100000,-190900000,,,,148900000,9101000000,8129700000,7189200000,-241400000,700000,581000000,562300000,54048,AMCR
2019-12-31,,,-14255000,4609364000,-203743000,112915000,1464875000,1071338000,1071338000,,-262519000,,,,50704000,1630242000,558904000,165367000,-1085593000,,-64959000,-203743000,54050,ETRN
2018-12-31,,,594419000,4801840000,218398000,123810000,1331647000,990469000,990469000,,-122032000,,,,83142000,1495098000,504629000,163451000,-396050000,,511277000,218398000,54050,ETRN
2017-12-31,,,534859000,5094995000,-27156000,80339000,810727000,628174000,628174000,,-41619000,,,,212402000,895558000,267384000,84831000,-93315000,,322457000,-27156000,54050,ETRN
2016-12-31,,,485316000,3258966000,65153000,75512000,663017000,524814000,524814000,,-18501000,,,,98243000,732272000,207458000,69255000,-39498000,,387073000,65153000,54050,ETRN
2020-06-30,,,9791000,,6350000,181791000,209941000,20845000,20845000,-580000,-8966000,,,,3441000,449487000,428642000,239546000,-11054000,,6350000,6350000,54051,MYTE
2019-06-30,,,5090000,,1651000,151909000,177676000,19780000,19780000,-1699000,-9305000,,,,3439000,379086000,359306000,201410000,-14690000,,1651000,1651000,54051,MYTE
2018-06-30,,,8971000,,5503000,123948000,143051000,13572000,13572000,-1265000,-8657000,,,,3468000,303520000,289948000,160469000,-4601000,,5503000,5503000,54051,MYTE
2019-12-31,92042000,,-115212000,40347000,-102091000,43017000,11598000,-123552000,-123552000,91000,-2606000,,,,0,22990000,146542000,11392000,8340000,,-115212000,-102091000,54054,CLLS
2018-12-31,76567000,,-88333000,40970000,-78693000,47248000,18693000,-105661000,-105661000,539000,-46000,,,,0,21432000,127093000,2739000,17328000,,-88333000,-78693000,54054,CLLS
2017-12-31,79227000,,-103683000,19113000,-99368000,44750000,31095000,-92650000,-92650000,-232000,-4000,,,,0,33715000,126365000,2620000,-11723000,,-103683000,-99368000,54054,CLLS
2016-12-31,78458000,,-67255000,1876000,-67255000,43413000,54667000,-67303000,-67303000,99000,-7000,,,,0,56444000,123747000,1777000,-192000,,-67255000,-67255000,54054,CLLS
2020-03-31,,,1483077,,1483077,230428,2143646,1913218,1913218,,-8586,,,,0,2143646,230428,0,-430141,,1483077,1483077,54055,NXN
2019-03-31,,,2559570,,2559570,219218,2175468,1956250,1956250,,-8619,,,,0,2175468,219218,0,603320,,2559570,2559570,54055,NXN
2018-03-31,,,1665154,,1665154,228603,2264824,2036221,2036221,,-12574,,,,0,2264824,228603,0,-371067,,1665154,1665154,54055,NXN
2017-03-31,,,241844,,241844,237185,2414426,2177241,2177241,,-11641,,,,0,2414426,237185,0,-1935397,,241844,241844,54055,NXN
2019-12-31,,,258000000,134000000,223900000,126300000,437500000,291800000,291800000,-4400000,-32200000,,,,18000000,815100000,523300000,377600000,-33800000,,240000000,223800000,54057,BSIG
2018-12-31,,,135200000,72800000,136400000,124000000,298000000,160900000,160900000,-8000000,-24900000,,,,5000000,920200000,759300000,622200000,-25700000,100000.0,130200000,136000000,54057,BSIG
2017-12-31,,,142000000,95900000,4200000,111400000,282100000,152400000,152400000,-8000000,-24500000,,,,132800000,887400000,735000000,605300000,-10400000,-100000.0,9200000,4000000,54057,BSIG
2016-12-31,,,160800000,6500000,126400000,92200000,292400000,188200000,188200000,-8000000,-11300000,,,,40800000,663500000,475300000,371100000,-27400000,6200000.0,120000000,125500000,54057,BSIG
2020-12-31,,,1256000000,7052000000,195000000,630000000,1899000000,0,1256000000,,,,,,77000000,2218000000,962000000,319000000,0,,1179000000,195000000,54059,IBKR
2019-12-31,,,1157000000,6488000000,161000000,460000000,1721000000,0,1259000000,,,,,,68000000,1997000000,738000000,276000000,-102000000,,1089000000,161000000,54059,IBKR
2018-12-31,,,1196000000,5874000000,169000000,409000000,1596000000,0,1183000000,,,,,,71000000,1890000000,707000000,294000000,13000000,,1125000000,169000000,54059,IBKR
2017-12-31,,,1049000000,5343000000,76000000,357000000,1312000000,0,953000000,,,,,,256000000,1581000000,628000000,269000000,96000000,,793000000,76000000,54059,IBKR
2020-12-31,,,9382000,,6706000,24963000,42434000,0,9359000,8112000,,,,,2676000,42434000,33075000,0,23000,,6706000,6706000,54060,SVBI
2019-12-31,,,11610000,,8374000,26261000,41271000,0,11898000,3112000,,,,,3236000,41271000,29373000,0,-288000,,8374000,8374000,54060,SVBI
2018-12-31,,,11546000,,8569000,23128000,37786000,0,11858000,2800000,,,,,2977000,37786000,25928000,0,-312000,,8569000,8499000,54060,SVBI
2017-12-31,,,7840000,,2818000,18392000,30482000,0,8087000,4003000,,,,,5022000,30482000,22395000,0,-247000,,2818000,2538000,54060,SVBI
2019-12-31,,,932656000,452959000,938089000,473086000,1394494000,921408000,921408000,,-52541000,,,,4437000,2573111000,1651703000,1178617000,11248000,,928219000,902175000,54062,ESGRP
2018-12-31,,,-218396000,470599000,-150221000,407375000,191316000,-216059000,-216059000,,-26217000,,,,-6124000,839134000,1055193000,647818000,-2337000,,-212272000,-162354000,54062,ESGRP
2017-12-31,,,314411000,488870000,311458000,435985000,806480000,370495000,370495000,,-28102000,,,,-6395000,1100952000,730457000,294472000,-56084000,10993000.0,320806000,311458000,54062,ESGRP
2016-12-31,,,327324000,463042000,264807000,423734000,777765000,354031000,354031000,,-20642000,,,,34874000,1136395000,782364000,358630000,-26707000,11963000.0,292450000,264807000,54062,ESGRP
2020-12-31,,,270240000,,206157000,341710000,616361000,274651000,274651000,,,,,,64083000,3161192000,2886541000,2544831000,-4411000,,206157000,206157000,54064,CCS
2019-12-31,,,132635000,,112994000,301525000,456706000,155181000,155181000,,-16000.0,,,,19641000,2535911000,2380730000,2079205000,-22546000,,112994000,112994000,54064,CCS
2018-12-31,,,128530000,,96455000,263981000,379004000,115023000,115023000,,-16000.0,,,,32075000,2147413000,2032390000,1768409000,13507000,,96455000,96455000,54064,CCS
2017-12-31,,,84164000,,50295000,176304000,270885000,94581000,94581000,,-16000.0,,,,33869000,1423799000,1329218000,1152914000,-10417000,,50295000,49911000,54064,CCS
2020-12-31,140367000,,331287000,,270568000,142863000,595032000,311802000,311802000,,-26328000,,,,60719000,2010931000,1699129000,1415899000,19485000,,270568000,270568000,54065,NEU
2019-12-31,144465000,,331590000,,254286000,125208000,629869000,360196000,360196000,,-29241000,,,,77304000,2190295000,1830099000,1560426000,-28606000,,254286000,253845000,54065,NEU
2018-12-31,140289000,,290285000,,234734000,133510000,585363000,311564000,311564000,,-26723000,,,,55551000,2289675000,1978111000,1704312000,-21279000,,234734000,234260000,54065,NEU
2017-12-31,146002000,,315442000,,190509000,153616000,636387000,336769000,336769000,,-21856000,,,,124933000,2198404000,1861635000,1562017000,-21327000,,190509000,190153000,54065,NEU
2019-12-31,,,-41421000,,-39545000,385948000,554998000,50524000,50524000,,-74220000,,,,-1876000,973410000,922886000,418412000,-91945000,,-39545000,-39545000,54066,GDEN
2018-12-31,,,-11275000,,-20914000,332992000,486662000,58043000,58043000,,-64028000,,,,9639000,851794000,793751000,365132000,-69318000,,-20914000,-20914000,54066,GDEN
2017-12-31,,,-5837000,,2084000,243082000,305539000,20196000,20196000,-157000.0,-19598000,,,,-7921000,507138000,486942000,201599000,-26033000,,2084000,2084000,54066,GDEN
2016-12-31,,,11975000,,16300000,66323000,111040000,14740000,14740000,-157000.0,-6454000,,,,-4325000,399998000,385258000,288958000,-2765000,,16300000,16300000,54066,GDEN
2019-12-31,,,48966000,,48466000,27565000,77106000,49541000,49541000,,-17072000,,,,500000,77106000,27565000,0,-575000,,48466000,48466000,54067,FDUS
2018-12-31,,,50172000,,49452000,27988000,76425000,48437000,48437000,,-12659000,,,,720000,76425000,27988000,0,1735000,,49452000,49452000,54067,FDUS
2017-12-31,,,44171000,,43951000,24825000,68615000,43790000,43790000,,-9803000,,,,220000,68615000,24825000,0,381000,,43951000,43951000,54067,FDUS
2016-12-31,,,41995000,,41570000,22609000,60229000,37620000,37620000,,-10594000,,,,425000,60229000,22609000,0,4375000,,41570000,41570000,54067,FDUS
2019-12-31,17672000,,313742000,6000,244115000,199231000,533864000,316961000,316961000,,-35320000,,,,69065000,1894920000,1577959000,1361056000,-3219000,,244677000,244115000,54068,BWXT
2018-12-31,15223000,,280145000,39000,226958000,214784000,504013000,274006000,274006000,,-27823000,,,,52840000,1799889000,1525883000,1295876000,6139000,,227305000,226958000,54068,BWXT
2017-12-31,7190000,,295780000,363000,147844000,193506000,495755000,295059000,295059000,,-14879000,,,,147415000,1687738000,1392679000,1191983000,721000,,148365000,147844000,54068,BWXT
2016-12-31,6407000,,257268000,392000,183057000,204518000,464234000,253309000,253309000,,-8393000,,,,73656000,1550573000,1297264000,1086339000,3959000,,183612000,183057000,54068,BWXT
2019-12-31,21627000,,-426433000,,-442083000,541319000,1042726000,479780000,479780000,,-968693000,,,,15650000,4122405000,3642625000,3079679000,-906213000,,-442083000,-500187000,54069,GDS
2018-12-31,13915000,,-439659000,,-430268000,440171000,622441000,168355000,168355000,,-656186000,,,,-9391000,2792077000,2623722000,2169636000,-608014000,,-430268000,-430268000,54069,GDS
2017-12-31,7261000,,-332976000,,-326900000,318982000,408472000,82229000,82229000,,-412003000,,,,-6076000,1616166000,1533937000,1207694000,-415205000,,-326900000,-326900000,54069,GDS
2016-12-31,9100000,,-284727000,,-276412000,298948000,265674000,-42374000,-42374000,,-265234000,,,,-8315000,1055960000,1098334000,790286000,-242353000,,-276412000,-403402000,54069,GDS
2019-12-31,13351018,,-29417969,,-29417969,15046423,0,-28397441,-28397441,,,,,,0,0,28397441,0,-1020528,,-29417969,-29417969,54070,ACER
2018-12-31,12452424,,-21280891,,-21280891,9261570,0,-21713994,-21713994,,-987.0,,,,0,0,21713994,0,433103,,-21280891,-21280891,54070,ACER
2017-12-31,8725026,,-14194431,,-14194431,5223101,0,-13948127,-13948127,,-242982.0,,,,0,0,13948127,0,-246304,,-14194431,-14194431,54070,ACER
2016-12-31,5308662,,-6699562,,-6699562,1391182,0,-6699844,-6699844,,-242982.0,,,,0,0,6699844,0,282,,-6699562,-6699562,54070,ACER
2019-12-31,,,100000000,895000000,-28000000,290000000,1798000000,595000000,595000000,413000000,-383000000,,,,1000000,2693000000,2098000000,895000000,-495000000,,99000000,-28000000,54072,CRC
2018-12-31,,,429000000,870000000,328000000,299000000,2150000000,544000000,544000000,771000000,-379000000,,,,0,3062000000,2518000000,912000000,-115000000,,429000000,321000000,54072,CRC
2017-12-31,,,-262000000,94000000,-266000000,259000000,1220000000,141000000,141000000,254000000,-343000000,,,,0,2096000000,1955000000,876000000,-403000000,,-262000000,-266000000,54072,CRC
2016-12-31,,,201000000,94000000,279000000,248000000,953000000,-41000000,-41000000,164000000,-328000000,,,,-78000000,1753000000,1794000000,800000000,242000000,,279000000,273000000,54072,CRC
2019-12-31,1002000,,-3939000,,-3790000,22278000,20270000,-3010000,-3010000,,-515000,,,,-149000,31586000,34596000,11316000,-929000,,-3790000,-3790000,54074,SSKN
2018-12-31,1065000,,-4297000,,-4033000,19421000,17400000,-3086000,-3086000,,-1142000,,,,-264000,29855000,32941000,12455000,-1211000,,-4033000,-4033000,54074,SSKN
2017-12-31,1711000,,-21385000,,-21514000,18853000,18984000,-1580000,-1580000,,-3196000,,,,129000,31763000,33343000,12779000,-19805000,,-21514000,-21514000,54074,SSKN
2016-12-31,1929000,,-3080000,,-3335000,19739000,18071000,-3597000,-3597000,,-4900000,,,,255000,30707000,34304000,12636000,517000,,-3335000,-3335000,54074,SSKN
2019-12-31,,,79879633,,79879633,4307722,4941288,633566,633566,,,,,,0,4941288,4307722,0,79246067,,79879633,79879633,54077,BME
2018-12-31,,,22441758,,22441758,3879542,4534861,655319,655319,,,,,,0,4534861,3879542,0,21786439,,22441758,22441758,54077,BME
2017-12-31,,,60339534,,60339534,3487401,3671453,184052,184052,,,,,,0,3671453,3487401,0,60155482,,60339534,60339534,54077,BME
2016-12-31,,,-16268463,,-16268463,3165351,3353887,188536,188536,,,,,,0,3353887,3165351,0,-16456999,,-16268463,-16268463,54077,BME
2020-04-30,,,-870951,,-870951,3901145,23178077,19276932,19276932,,1190560,,,,0,23178077,3901145,0,-20147883,,-870951,-4742453,54081,PMO
2019-04-30,,,34049716,,34049716,4004443,26929886,22925443,22925443,,-715085,,,,0,26929886,4004443,0,11124273,,34049716,30350725,54081,PMO
2018-04-30,,,18807144,,18807144,4623477,29705002,25081525,25081525,,-613013,,,,0,29705002,4623477,0,-6274381,,18807144,16321277,54081,PMO
2017-04-30,,,-453241,,-453241,5205997,31990825,26784828,26784828,,-263630,,,,0,31990825,5205997,0,-27238069,,-453241,-2225083,54081,PMO
2020-12-31,,,17280000,,12725000,35394000,60953000,0,22442000,3117000,,,,,4555000,60953000,38511000,0,-5162000,,12725000,12725000,54084,CZWI
2019-12-31,,,12277000,,9463000,33319000,52668000,0,16519000,2830000,,,,,2814000,52668000,36149000,0,-4242000,,9463000,9463000,54084,CZWI
2018-12-31,,,6208000,,4204000,26846000,38623000,0,9804000,1973000,,,,,2004000,38623000,28819000,0,-3596000,,4204000,4204000,54084,CZWI
2018-09-30,,,6609000,,4283000,24765000,36373000,0,9495000,2113000,,,,,2326000,36373000,26878000,0,-2886000,,4283000,4283000,54084,CZWI
2019-12-31,41230000,,-34995000,,-35194000,163165000,170335000,-34060000,-34060000,,-4111000,,,,199000,230807000,264867000,60472000,-935000,,-35194000,-35194000,54086,ATRC
2018-12-31,34723000,,-20911000,,-21137000,140349000,147120000,-27952000,-27952000,,-4607000,,,,226000,201630000,229582000,54510000,7041000,,-21137000,-21137000,54086,ATRC
2017-12-31,34144000,,-26878000,,-26892000,121076000,126163000,-29057000,-29057000,,-2264000,,,,14000,174716000,203773000,48553000,2179000,,-26892000,-26892000,54086,ATRC
2016-12-31,35824000,,-33298000,,-33338000,105446000,111101000,-30169000,-30169000,,-1801000,,,,40000,155109000,185278000,44008000,-3129000,,-33338000,-33338000,54086,ATRC
2019-12-31,,,830300000,20793000,621085000,4908404000,6316269000,1122672000,1122672000,,-95711000,,,,209215000,19392305000,18269633000,13076036000,-292372000,,621085000,621085000,54089,GPC
2018-12-31,,,1075612000,21540000,810474000,4553000000,5983787000,1172005000,1172005000,,-101925000,,,,265138000,18735073000,17563068000,12751286000,-96393000,,810474000,810474000,54089,GPC
2017-12-31,,,1009268000,52004000,616757000,3705136000,4906398000,1019639000,1019639000,,-41486000,,,,392511000,16308801000,15289162000,11402403000,-10371000,,616757000,616757000,54089,GPC
2016-12-31,,,1074340000,13628000,687240000,3370833000,4599607000,1069772000,1069772000,,-21084000,,,,387100000,15339713000,14269941000,10740106000,4568000,,687240000,687240000,54089,GPC
2019-12-31,8487000,,3645000,,8006000,172148000,196836000,16201000,16201000,,-3713000,,,,-4361000,408830000,392629000,211994000,-12556000,,8006000,8006000,54092,NEO
2018-12-31,3001000,,3824000,,2640000,114224000,127265000,10040000,10040000,,-6230000,,,,1184000,276741000,266701000,149476000,-11027000,,2640000,6088000,54092,NEO
2017-12-31,3636000,,-2650000,,-396000,94360000,101956000,3960000,3960000,,-5540000,,,,-2254000,240251000,236291000,138295000,-6610000,,-396000,-10943000,54092,NEO
2016-12-31,4649000,,-7843000,,-6142000,87836000,98104000,5619000,5619000,,-9998000,,,,-1701000,231808000,226189000,133704000,-13462000,,-6142000,-30816000,54092,NEO
2020-09-30,,,-3774000,84590000,-419000,77776000,102904000,6911000,6911000,,-8926000,,,,-2795000,150134000,143223000,47230000,-10685000,,-979000,-419000,54093,IIIV
2019-09-30,,,386000,62368000,-3045000,61237000,89203000,11402000,11402000,,-6004000,,,,-177000,376307000,364905000,287104000,-11016000,,563000,-3045000,54093,IIIV
2018-09-30,,,-4624000,72897000,-6898000,39318000,68651000,17494000,17494000,,-8498000,,,,337000,323508000,306014000,254857000,-22118000,,-4961000,-6898000,54093,IIIV
2017-09-30,,,1079000,72897000,902000,26726000,44661000,7850000,7850000,,-6936000,,,,177000,262571000,254721000,217910000,-6771000,,902000,902000,54093,IIIV
2019-12-31,,,5289000,,3856000,263290000,298930000,16610000,16610000,,-11289000,,,,1433000,1579040000,1562430000,1280110000,-11321000,,3856000,3856000,54096,ZEUS
2018-12-31,,,46064000,,33759000,267467000,342127000,57052000,57052000,,-10681000,,,,12305000,1715081000,1658029000,1372954000,-10988000,,33759000,33759000,54096,ZEUS
2017-12-31,,,16350000,,18963000,234020000,275484000,23986000,23986000,,-7518000,,,,-2613000,1330696000,1306710000,1055212000,-7636000,,18963000,18963000,54096,ZEUS
2016-12-31,,,420000,,-1078000,210843000,235076000,5748000,5748000,,-5273000,,,,1498000,1055116000,1049368000,820040000,-5328000,,-1078000,-1078000,54096,ZEUS
2019-12-31,2714000,,-5729000,,-8492000,35615000,40456000,2127000,2127000,,-4603000,,,,2763000,224776000,222649000,184320000,-7856000,,-8492000,-8492000,54097,MNTX
2018-12-31,2839000,,-12666000,,-13177000,35707000,44047000,5501000,5501000,,-5508000,,,,511000,242107000,236606000,198060000,-18167000,,-13177000,-13177000,54097,MNTX
2017-12-31,2564000,,-7185000,,-8078000,34547000,36846000,-265000,-265000,,-6498000,,,,-118000,213112000,213377000,176266000,-6920000,-737000.0,-7067000,-8078000,54097,MNTX
2016-12-31,2939000,,-23755000,25164000.0,-37093000,36972000,29937000,-9974000,-9974000,,-7829000,,,,-566000,173197000,183171000,143260000,-13781000,-14478000.0,-23189000,-37093000,54097,MNTX
2020-12-31,,,134981000,,107898000,399676000,621687000,0,149639000,72372000,,,,,27083000,621687000,472048000,0,-14658000,,107898000,97810000,54098,FMBIP
2019-12-31,,,265939000,,199738000,368113000,706455000,0,310226000,28116000,,,,,66201000,706455000,396229000,0,-44287000,,199738000,198057000,54098,FMBIP
2018-12-31,,,197057000,,157870000,338851000,608133000,0,246273000,23009000,,,,,39187000,608133000,361860000,0,-49216000,,157870000,156558000,54098,FMBIP
2017-12-31,,,187954000,,98387000,334595000,603863000,0,229612000,39656000,,,,,89567000,603863000,374251000,0,-41658000,,98387000,97471000,54098,FMBIP
2020-02-01,,,-52587000,,-53265000,135101000,165434000,-33812000,-33812000,57441000,-457000,,,,678000,603880000,637692000,438446000,-18775000,,-53265000,-53265000,54100,KIRK
2019-02-02,,,5811000,,3780000,129072000,203069000,4881000,4881000,61882000,-267000,,,,2031000,647071000,642190000,444002000,930000,,3780000,3780000,54100,KIRK
2018-02-03,,,9816000,,5296000,127395000,207536000,9352000,9352000,63799000,-275000,,,,4520000,634117000,624765000,426581000,291000,,5296000,5296000,54100,KIRK
2017-01-28,,,16975000,,11046000,119577000,202492000,16999000,16999000,59573000,-276000,,,,5929000,594328000,577329000,391836000,-337000,,11046000,11046000,54100,KIRK
2019-12-31,,,59795000000,5578000000,58287000000,41166000000,123789000000,75840000000,75840000000,6783000000,-15654000000,,,,781000000,740017000000,664177000000,616228000000,-16045000000,,59014000000,57893000000,54101,LFC
2018-12-31,,,13921000000,4919000000,11395000000,38301000000,73171000000,29978000000,29978000000,4892000000,-15559000000,,,,1985000000,635023000000,605045000000,561852000000,-16057000000,,11936000000,11011000000,54101,LFC
2017-12-31,,,41671000000,4377000000,32253000000,36738000000,97370000000,56576000000,56576000000,4056000000,-14687000000,,,,8919000000,650356000000,593780000000,552986000000,-14905000000,,32752000000,31873000000,54101,LFC
2016-12-31,,,23842000000,4027000000,19127000000,32628000000,71309000000,35673000000,35673000000,3008000000,-12173000000,,,,4257000000,546533000000,510860000000,475224000000,-11831000000,,19585000000,18741000000,54101,LFC
2020-10-02,141333000,,-41562000,,-46078000,124306000,270166000,4527000,4527000,,-27380000,,,,4516000,530037000,525510000,259871000,-46089000,,-46078000,-46078000,54102,MTSI
2019-09-27,163469000,,-423153000,,-383798000,153286000,220708000,-96047000,-96047000,,-35803000,,,,-39355000,499708000,595755000,279000000,-327106000,,-383798000,-383798000,54102,MTSI
2018-09-28,177713000,,-155235000,,-139977000,161673000,262906000,-76480000,-76480000,,-31338000,,,,-21473000,570398000,646878000,307492000,-78755000,-6215000.0,-133762000,-139977000,54102,MTSI
2017-09-29,147986000,,-49505000,,-169493000,174486000,370906000,48434000,48434000,,-28855000,,,,100911000,698772000,650338000,327866000,-97939000,-19077000.0,-150416000,-169493000,54102,MTSI
2020-12-31,,,14065000000,2695000000,10534000000,39850000000,70443000000,17493000000,17493000000,,-4588000000,,,,3364000000,103564000000,86071000000,33121000000,-3428000000,,10701000000,10534000000,54107,CMCSA
2019-12-31,,,16996000000,2520000000,13057000000,40424000000,74502000000,21125000000,21125000000,,-4567000000,,,,3673000000,108942000000,87817000000,34440000000,-4129000000,,13323000000,13057000000,54107,CMCSA
2018-12-31,,,15242000000,2205000000,11731000000,34791000000,64815000000,19148000000,19148000000,-141000000.0,-3542000000,,,,3380000000,94507000000,75359000000,29692000000,-3906000000,,11862000000,11731000000,54107,CMCSA
2017-12-31,,,15353000000,2200000000,22735000000,31968000000,59674000000,17576000000,17576000000,-141000000.0,-3086000000,,,,-7569000000,85029000000,67453000000,25355000000,-2223000000,,22922000000,22735000000,54107,CMCSA
2020-09-30,64000000,,-503000000,,-508000000,370000000,707000000,193000000,193000000,-5000000,-88000000,,,,-12000000,2326000000,2133000000,1619000000,-696000000,-17000000,-491000000,-508000000,54108,ASH
2019-09-30,66000000,,70000000,,505000000,408000000,767000000,211000000,211000000,-4000000,-114000000,,,,46000000,2493000000,2282000000,1726000000,-141000000,481000000,24000000,505000000,54108,ASH
2018-09-30,73000000,,11000000,,114000000,487000000,863000000,219000000,219000000,-9000000,-116000000,,,,-8000000,2589000000,2370000000,1726000000,-208000000,95000000,19000000,114000000,54108,ASH
2017-09-30,73000000,,-196000000,,1000000,527000000,755000000,159000000,159000000,-4000000,-227000000,,,,-16000000,2309000000,2150000000,1554000000,-355000000,208000000,-180000000,1000000,54108,ASH
2019-12-31,,,619000000,36000000,-12000000,82000000,903000000,628000000,628000000,81000000,-139000000,,,,250000000,3525000000,2897000000,2622000000,-9000000,-376000000,369000000,-12000000,54110,AU
2018-12-31,,,445000000,42000000,133000000,76000000,756000000,493000000,493000000,89000000,-133000000,,,,212000000,3336000000,2843000000,2580000000,-48000000,-83000000,233000000,133000000,54110,AU
2017-12-31,,,328000000,41000000,-191000000,64000000,793000000,542000000,542000000,82000000,-137000000,,,,163000000,3394000000,2852000000,2601000000,-214000000,-336000000,165000000,-191000000,54110,AU
2016-12-31,,,269000000,39000000,63000000,61000000,836000000,544000000,544000000,98000000,-154000000,,,,189000000,4223000000,3679000000,3387000000,-275000000,-336000000,80000000,63000000,54110,AU
2019-12-31,,,478474000,-17640000,421144000,59358000,-76041000,-135399000,-135399000,,-4102000,,,,112409000,9807000,145206000,85848000,613873000,,366065000,421144000,54111,PRTC
2018-12-31,77402000.0,,-68438000,-108535000,-43654000,47365000,-56654000,-104019000,-104019000,,-498000,,,,2221000,20748000,124767000,77402000,35581000,,-70659000,-43654000,54111,PRTC
2017-12-31,77402000.0,,-70711000,-150305000,26472000,46283000,-68500000,-114783000,-114783000,,-10213000,,,,4383000,2535000,117318000,71035000,44072000,,-75094000,26472000,54111,PRTC
2016-12-31,77402000.0,,-83182000,-85255000,-48792000,37155000,-36774000,-73929000,-73929000,,-6808000,,,,-1574000,4431000,78360000,41205000,-9253000,,-81608000,-48792000,54111,PRTC
2019-12-31,,,65661312,,65661312,5445763,28954084,23508321,23508321,,,,,,0,28954084,5445763,0,42152991,,65661312,65661312,54112,PEO
2018-12-31,,,-126041980,,-126041980,5133843,17427114,12293271,12293271,,,,,,0,17427114,5133843,0,-138335251,,-126041980,-126041980,54112,PEO
2017-12-31,,,13704527,,13704527,5071057,18301671,13230614,13230614,,,,,,0,18301671,5071057,0,473913,,13704527,13704527,54112,PEO
2016-12-31,,,125442523,,125442523,5108373,16645327,11536954,11536954,,,,,,0,16645327,5108373,0,113905569,,125442523,125442523,54112,PEO
2019-12-31,109000,,-3042000,,-3042000,2737000,-245000,-3091000,-3091000,,,,,,0,4088000,7179000,4333000,49000,,-3042000,-3042000,54115,AGFY
2018-12-31,17000,,-1014000,,-1014000,1221000,222000,-1016000,-1016000,,,,,,0,1769000,2785000,1547000,2000,,-1014000,-1014000,54115,AGFY
2020-10-31,1279022000,,638159000,4963000,664347000,916540000,2943043000,656200000,656200000,,-5140000,,,,-25288000,3685281000,3029081000,742238000,-18041000,,663447000,664347000,54117,SNPS
2019-10-31,1136932000,,545506000,5863000,532367000,880408000,2667371000,549117000,549117000,,-11659000,,,,13139000,3360694000,2811577000,693323000,-3611000,,532367000,532367000,54117,SNPS
2018-10-31,1084822000,,363543000,5863000,432518000,859538000,2469194000,399170000,399170000,,-15607000,,,,-68975000,3121058000,2721888000,651864000,-35627000,,432518000,432518000,54117,SNPS
2017-10-31,908841000,,383098000,4104000,136563000,738492000,2146805000,391749000,391749000,,-7303000,,,,246535000,2724880000,2333131000,578075000,-8651000,,136563000,136563000,54117,SNPS
2019-12-31,,,45278593,,45278593,4387274,14462925,10075651,10075651,,,,,,0,14462925,4387274,0,35202942,,45278593,45278593,54118,BGR
2018-12-31,,,-85898009,,-85898009,5131414,13534911,8403497,8403497,,,,,,0,13534911,5131414,0,-94301506,,-85898009,-85898009,54118,BGR
2017-12-31,,,11771300,,11771300,5264169,17280198,12016029,12016029,,,,,,0,17280198,5264169,0,-244729,,11771300,11771300,54118,BGR
2016-12-31,,,97788497,,97788497,5462347,13440574,7978227,7978227,,,,,,0,13440574,5462347,0,89810270,,97788497,97788497,54118,BGR
2019-12-31,324000000,,-201000000,390000000,-334000000,993000000,2587000000,612000000,612000000,,-322000000,,,,19000000,17450000000,16838000000,14863000000,-813000000,,-220000000,-334000000,54119,TEN
2018-12-31,200000000,,174000000,328000000,55000000,623000000,1866000000,698000000,698000000,,-148000000,,,,63000000,11763000000,11065000000,9897000000,-524000000,,111000000,55000000,54119,TEN
2017-12-31,158000000,,336000000,88000000,198000000,626000000,1503000000,493000000,493000000,,-77000000,,,,71000000,9274000000,8781000000,7771000000,-157000000,,265000000,198000000,54119,TEN
2016-12-31,152000000,,411000000,87000000,347000000,585000000,1488000000,538000000,538000000,,-68000000,,,,-4000000,8597000000,8059000000,7109000000,-127000000,,415000000,347000000,54119,TEN
2019-12-31,,,-26031000,50548000,301865000,369908000,519443000,95380000,95380000,,-63419000,,,,14742000,1450253000,1354873000,930810000,-121411000,348180000,-40773000,218397000,54121,CODI
2018-12-31,,,-8411000,59970000,-5702000,362063000,477242000,65493000,65493000,,-59225000,,,,10466000,1357320000,1291827000,880078000,-73904000,18392000,-18877000,-25108000,54121,CODI
2017-12-31,,,-9631000,52791000,27991000,293176000,386389000,58548000,58548000,,-31257000,,,,-23741000,1002783000,944235000,616394000,-68179000,22126000,14110000,-26380000,54121,CODI
2016-12-31,,,58731000,38139000,54685000,191813000,267936000,58140000,58140000,,-27020000,,,,13933000,729989000,671849000,462053000,591000,13092000,44798000,28044000,54121,CODI
2020-09-30,,,-70095000,,-68463000,390937000,449235000,27471000,27471000,,-22472000,,,,-1632000,822811000,795340000,373576000,-97566000,,-68463000,-68463000,54122,EZPW
2019-09-30,,,4174000,,2541000,414243000,494448000,51408000,51408000,,-32637000,,,,2406000,847229000,795821000,352781000,-47234000,-457000.0,1768000,2541000,54122,EZPW
2018-09-30,,,55539000,-3331000.0,37282000,388480000,481551000,67587000,67587000,,-27834000,,,,18389000,812156000,744569000,330605000,-12048000,-856000.0,37150000,37282000,54122,EZPW
2017-09-30,,,42678000,-2449000.0,31410000,358448000,435507000,53398000,53398000,,-27803000,,,,11093000,747951000,694553000,312444000,-10720000,-1825000.0,31585000,31410000,54122,EZPW
2019-12-31,4500000,,189702000,,144738000,113804000,306503000,188199000,188199000,,,,,,44964000,745347000,557148000,438844000,1503000,,144738000,144738000,54124,TREX
2018-12-31,4200000,,176861000,,134572000,114025000,294894000,176669000,176669000,,,,,,42289000,684250000,507581000,389356000,192000,,134572000,134572000,54124,TREX
2017-12-31,3800000,,141919000,,95128000,97193000,243373000,142380000,142380000,,-461000.0,,,,46791000,565153000,422773000,321780000,-461000,,95128000,95128000,54124,TREX
2016-12-31,3700000,,102830000,,67847000,79440000,187095000,103955000,103955000,,-1125000.0,,,,34983000,479616000,375661000,292521000,-1125000,,67847000,67847000,54124,TREX
2019-12-31,,,-260699000,,-316319000,78638000,373760000,38254000,38254000,28164000,-66798000,,,,-57557000,2290260000,2252006000,1916500000,-298953000,-113177000,-203142000,-316319000,54127,AMR
2018-12-31,,,137491000,,299165000,56767000,387151000,247720000,247720000,10507000,-38810000,,,,-165363000,2031205000,1783485000,1644054000,-110229000,-3689000,302854000,299165000,54127,AMR
2017-12-31,,,105756000,,154522000,67256000,322672000,150817000,150817000,10682000,-35977000,,,,-67979000,1649969000,1499152000,1327297000,-45061000,-19213000,173735000,154522000,54127,AMR
2016-12-31,,,-115188000,,-78142000,48703000,169721000,-35652000,-35652000,11773000,-20498000,,,,-41801000,917407000,953059000,747686000,-79536000,-4755000,-73387000,-10930000,54127,AMR
2020-03-31,,,20578000,,15748000,33313000,56841000,0,20820000,2708000,,,,,4830000,56841000,36021000,0,-242000,,15748000,15748000,54129,RVSB
2019-03-31,,,22412000,,17266000,32669000,58041000,0,22496000,2876000,,,,,5146000,58041000,35545000,0,-84000,,17266000,17266000,54129,RVSB
2018-03-31,,,17997000,,10242000,31855000,53615000,0,18705000,3055000,,,,,7755000,53615000,34910000,0,-708000,,10242000,10242000,54129,RVSB
2017-03-31,,,10791000,,7404000,28237000,43772000,0,12422000,3113000,,,,,3387000,43772000,31350000,0,-1631000,,7404000,7404000,54129,RVSB
2019-12-31,8710746,,-32022203,-433155,-31513178,25644704,3803156,-31421294,-31421294,,-102084,,,,-70992,18779172,50200466,14976016,-600909,,-31951211,-31513178,54131,LKCO
2018-12-31,3478570,,-11853527,-433155,-11927536,19492783,14104300,-8867053,-8867053,,-80184,,,,74009,21042363,29909416,6938063,-2986474,,-11927536,-11927536,54131,LKCO
2017-12-31,1046198,,-6810454,-433155,-6810454,26359982,20534638,-6871542,-6871542,,-26611,,,,0,26082417,32953959,5547779,61088,,-6810454,-6810454,54131,LKCO
2016-12-31,2882202,,-13049031,-433155,-13049031,8318658,-1082359,-12283219,-12283219,,-4412,,,,0,5233145,17516364,6315504,-765812,,-13049031,-13049031,54131,LKCO
2019-12-31,,,211526000,,224543000,5809000,579481000,357241000,357241000,59955000,-149125000,,,,-13017000,889692000,532451000,310211000,-145715000,,224543000,224543000,54133,WTRG
2018-12-31,,,178319000,,191988000,7831000,529613000,315347000,315347000,59762000,-158833000,,,,-13669000,838091000,522744000,308478000,-137028000,,191988000,191988000,54133,WTRG
2017-12-31,,,256652000,,239738000,4953000,527272000,328967000,328967000,56628000,-88543000,,,,16914000,809525000,480558000,282253000,-72315000,,239738000,239738000,54133,WTRG
2016-12-31,,,255160000,,234182000,4953000,522691000,333298000,333298000,56385000,-83031000,,,,20978000,819875000,486577000,297184000,-78138000,,234182000,234182000,54133,WTRG
2019-12-31,,,-18403000,92007000,-21172000,132448000,621620000,256599000,256599000,,-232077000,,,,1353000,3785063000,3528464000,3163443000,-275002000,,-19756000,-21172000,54135,ADV
2018-12-31,,,-1319557000,76850000,-1157332000,124535000,598977000,249209000,249209000,,-229643000,,,,-168334000,3707628000,3458419000,3108651000,-1568766000,,-1151223000,-1157332000,54135,ADV
2017-12-31,,,29236000,76850000,386405000,82191000,524233000,262052000,262052000,,-179566000,,,,-358806000,2416927000,2154875000,1892694000,-232816000,,388042000,386405000,54135,ADV
2016-12-31,,,53788000,36195000,32149000,91706000,488950000,226984000,226984000,,-167360000,,,,22623000,2100235000,1873251000,1611285000,-173196000,,31165000,32149000,54135,ADV
2019-12-29,,,-9395000,321000,-23992000,43206000,114001000,-1521000,-1521000,50178000,-199000,,,,14190000,409707000,411228000,295706000,-7874000,,-23585000,-23992000,54136,PBPB
2018-12-30,,,-10744000,362000,-8878000,43378000,123804000,6449000,6449000,50363000,-142000,,,,-2195000,422638000,416189000,298834000,-17193000,,-8549000,-8878000,54136,PBPB
2017-12-31,,,-2047000,515000,-6956000,41923000,129786000,11533000,11533000,49209000,-124000,,,,4643000,428111000,416578000,298325000,-13580000,,-6690000,-6956000,54136,PBPB
2016-12-25,,,12879000,751000,8212000,40411000,125823000,17154000,17154000,43738000,-134000,,,,4443000,407131000,389977000,281308000,-4275000,,8436000,8212000,54136,PBPB
2019-12-31,,,-24211000,868000,-57713000,181959000,204009000,8867000,8867000,,-5306000,,,,31732000,822224000,813357000,618215000,-33078000,,-55943000,-57713000,54137,CCRN
2018-12-31,,,-18195000,670000,-16951000,180230000,209563000,15349000,15349000,,-5654000,,,,-2478000,816484000,801135000,606921000,-33544000,,-15717000,-16951000,54137,CCRN
2017-12-31,,,4301000,630000,37513000,187435000,228586000,29149000,29149000,,-4214000,,,,-34501000,865048000,835899000,636462000,-24848000,,38802000,37513000,54137,CCRN
2016-12-31,,,4545000,559000,7967000,179820000,221735000,32140000,32140000,,-6106000,,,,-4186000,833537000,801397000,611802000,-27595000,,8731000,7967000,54137,CCRN
2019-12-31,,,6379000000,70000000,4832000000,5526000000,15411000000,7232000000,7232000000,687000000,-56000000,,,,1492000000,39336000000,32104000000,23925000000,-853000000,,4887000000,4832000000,54138,QIWI
2018-12-31,,,4501000000,60000000,3584000000,5409000000,11909000000,4472000000,4472000000,690000000,-56000000,,,,875000000,30610000000,26138000000,18701000000,29000000,,3626000000,3584000000,54138,QIWI
2017-12-31,,,3840000000,37000000,3114000000,3389000000,8907000000,4095000000,4095000000,407000000,-56000000,,,,698000000,20897000000,16802000000,11990000000,-255000000,,3142000000,3114000000,54138,QIWI
2016-12-31,,,3107000000,21000000,2474000000,3033000000,9234000000,5230000000,5230000000,175000000,-64000000,,,,618000000,17880000000,12650000000,8646000000,-2123000000,,2489000000,2474000000,54138,QIWI
2020-04-30,,,-2866000,288000,-4687000,25558000,23427000,-2131000,-2131000,,-493000,,,,1758000,147540000,149671000,124113000,-735000,,-4624000,-4687000,54140,KEQU
2019-04-30,,,2134000,603000,1529000,23502000,25319000,1817000,1817000,,-367000,,,,446000,146550000,144733000,121231000,317000,,1688000,1529000,54140,KEQU
2018-04-30,,,9619000,462000,5281000,22934000,32159000,9225000,9225000,,-299000,,,,4161000,158050000,148825000,125891000,394000,,5458000,5281000,54140,KEQU
2017-04-30,,,6746000,374000,4515000,20065000,26607000,6542000,6542000,,-292000,,,,2126000,138558000,132016000,111951000,204000,,4620000,4515000,54140,KEQU
2019-12-31,,,382987000,373238000,433016000,165996000,2048785000,837169000,837169000,,-451662000,,,,-56310000,3859312000,3022143000,1810527000,-454182000,,439297000,433016000,54143,VTR
2018-12-31,,,376038000,243878000,409467000,151982000,2010286000,938665000,938665000,,-442497000,,,,-39953000,3701584000,2762919000,1691298000,-562627000,-10000.0,415991000,409467000,54143,VTR
2017-12-31,,,1301423000,224449000,1356470000,135490000,2081091000,1057653000,1057653000,,-448196000,,,,-59799000,3567554000,2509901000,1486463000,243770000,-110000.0,1361222000,1356470000,54143,VTR
2016-12-31,,,621069000,269241000,649231000,126875000,2004931000,979132000,979132000,,-419740000,,,,-31343000,3447004000,2467872000,1442073000,-358063000,-922000.0,652412000,649231000,54143,VTR
2020-10-31,,,25433042,,25433042,15101325,70600928,55499603,55499603,,-21220058,,,,0,70600928,15101325,0,-30066561,,25433042,25433042,54146,FAX
2019-10-31,,,162261381,,162261381,14565159,77811375,63246216,63246216,,-26157022,,,,0,77811375,14565159,0,99015165,,162261381,162261381,54146,FAX
2018-10-31,,,-107178179,,-107178179,15148702,87944716,72796014,72796014,,-13894279,,,,0,87944716,15148702,0,-179974193,,-107178179,-107178179,54146,FAX
2017-10-31,,,40164607,,40164607,15907418,91104957,75197539,75197539,,-14858707,,,,0,91104957,15907418,0,-35032932,,40164607,40164607,54146,FAX
2019-12-31,20018000,,42427000,,31667000,103132000,174811000,51661000,51661000,,-13617000,,,,10760000,347337000,295676000,172526000,-9234000,,31667000,31667000,54147,LNTH
2018-12-31,17071000,,49548000,,40518000,93326000,174885000,64488000,64488000,,-17405000,,,,9030000,343374000,278886000,168489000,-14940000,,40518000,40518000,54147,LNTH
2017-12-31,18125000,,39639000,,123385000,92157000,162135000,51853000,51853000,,-18410000,,,,-83746000,331378000,279525000,169243000,-12214000,,123385000,123385000,54147,LNTH
2016-12-31,12203000,,28294000,,26762000,75374000,137780000,50203000,50203000,,-26618000,,,,1532000,301853000,251650000,164073000,-21909000,,26762000,26762000,54147,LNTH
2019-12-31,,,987000000,,756000000,324000000,4031000000,1806000000,1806000000,132000000,-121000000,,,,231000000,9676000000,7870000000,5645000000,-819000000,,756000000,753000000,54148,PXD
2018-12-31,,,1251000000,,978000000,381000000,4315000000,1756000000,1756000000,530000000,-126000000,,,,276000000,9384000000,7628000000,5069000000,-505000000,,975000000,973000000,54148,PXD
2017-12-31,,,309000000,5000000.0,833000000,326000000,2681000000,502000000,502000000,347000000,-154000000,,,,-524000000,5294000000,4792000000,2613000000,-193000000,,833000000,827000000,54148,PXD
2016-12-31,,,-959000000,7000000.0,-556000000,325000000,1637000000,-761000000,-761000000,474000000,-194000000,,,,-403000000,3509000000,4270000000,1872000000,-198000000,,-556000000,-556000000,54148,PXD
2020-12-31,,,144956000,-2246000,114774000,291577000,513800000,0,156793000,65430000,,,,,31636000,513800000,357007000,0,-11837000,,113320000,114774000,54149,WSFS
2019-12-31,,,194370000,-815000,148809000,267765000,607497000,0,269940000,69792000,,,,,46452000,607497000,337557000,0,-75570000,,147918000,148809000,54149,WSFS
2018-12-31,,,170798000,-815000,134743000,176451000,395845000,0,171306000,48088000,,,,,36055000,395845000,224539000,0,-508000,,134743000,134743000,54149,WSFS
2017-12-31,,,108490000,-815000,50244000,164808000,334951000,0,128943000,41200000,,,,,58246000,334951000,206008000,0,-20453000,,50244000,50244000,54149,WSFS
2019-12-31,22418000,,-25075000,,-25084000,22080000,22080000,-22418000,-22418000,,-1133000,,,,9000,65207000,87625000,43127000,-2657000,,-25084000,-25084000,54150,PSNL
2018-12-31,14304000,,-19879000,,-19886000,11271000,11805000,-13770000,-13770000,,-1894000,,,,7000,37774000,51544000,25969000,-6109000,,-19886000,-19886000,54150,PSNL
2017-12-31,9919000,,-23593000,,-23598000,9901000,-2343000,-22163000,-22163000,,-1303000,,,,5000,9393000,31556000,11736000,-1430000,,-23598000,-23598000,54150,PSNL
2019-12-28,,,16782000,,15419000,639437000,787102000,68343000,68343000,,-47940000,,,,1363000,2559617000,2491274000,1772515000,-51561000,,15419000,15419000,54151,GO
2018-12-29,,,21852000,,15868000,557100000,695397000,82467000,82467000,,-56712000,,,,5984000,2287660000,2205193000,1592263000,-60615000,,15868000,15868000,54151,GO
2017-12-30,,,25772000,,20601000,510136000,631883000,76936000,76936000,,-50829000,,,,5171000,2075465000,1998529000,1443582000,-51164000,,20601000,20601000,54151,GO
2016-12-31,,,16922000,,10198000,457051000,561177000,64069000,64069000,,-48108000,,,,6724000,1831531000,1767462000,1270354000,-47147000,,10198000,10198000,54151,GO
2019-12-31,,,-50422000,,-50422000,13519000,-40313000,-53832000,-53832000,,,,,,0,1193000,55025000,41506000,3410000,,-50422000,-50422000,54153,CRNX
2018-12-31,24479000.0,,-27115000,,-27115000,6659000,-22051000,-28710000,-28710000,,,,,,0,2428000,31138000,24479000,1595000,,-27115000,-27115000,54153,CRNX
2017-12-31,24479000.0,,-9157000,,-9157000,1939000,-7188000,-9127000,-9127000,,,,,,0,2045000,11172000,9233000,-30000,,-9157000,-9157000,54153,CRNX
2016-12-31,24479000.0,,-6019000,,-6019000,1533000,-4511000,-6044000,-6044000,,-11000.0,,,,0,589000,6633000,5100000,25000,,-6019000,-6019000,54153,CRNX
2020-12-31,,,33898000,,29453000,47320000,91984000,0,38205000,6459000,,,,,4445000,91984000,53779000,0,-4307000,,29453000,29453000,54154,INBK
2019-12-31,,,27156000,,25239000,39880000,73790000,0,29059000,4851000,,,,,1917000,73790000,44731000,0,-1903000,,25239000,25239000,54154,INBK
2018-12-31,,,23952000,,21900000,34926000,67135000,0,28331000,3878000,,,,,2052000,67135000,38804000,0,-4379000,,21900000,21900000,54154,INBK
2017-12-31,,,22928000,,15226000,31802000,59651000,0,24338000,3511000,,,,,7702000,59651000,35313000,0,-1410000,,15226000,15226000,54154,INBK
2019-12-31,,,-639000000,37000000,-308000000,315000000,2803000000,35000000,35000000,97000000,-657000000,,,,-331000000,8408000000,8373000000,5605000000,-674000000,,-308000000,-416000000,54155,CHK
2018-12-31,,,218000000,41000000,226000000,335000000,3140000000,841000000,841000000,65000000,-722000000,,,,-10000000,10170000000,9329000000,7030000000,-623000000,,228000000,133000000,54155,CHK
2017-12-31,,,-500000000,124000000,-505000000,333000000,2888000000,288000000,288000000,335000000,-738000000,,,,2000000,9474000000,9186000000,6586000000,-788000000,,-502000000,-631000000,54155,CHK
2016-12-31,,,-4589000000,128000000,-4390000000,240000000,510000000,-896000000,-896000000,59000000,-451000000,,,,-190000000,7798000000,8694000000,7288000000,-3693000000,,-4399000000,-4915000000,54155,CHK
2019-12-31,25385000,,-37589000,,-37589000,11812000,-25385000,-37197000,-37197000,,-523000,,,,0,0,37197000,25385000,-392000,,-37589000,-37589000,54158,ZSAN
2018-12-31,25508000,,-35358000,,-35358000,9357000,-25508000,-34865000,-34865000,,-379000,,,,0,0,34865000,25508000,-493000,,-35358000,-35358000,54158,ZSAN
2017-12-31,25508000,,-29105000,,-29105000,8182000,-20118000,-28300000,-28300000,,-817000,,,,0,0,28300000,20118000,-805000,,-29105000,-29105000,54158,ZSAN
2016-12-31,25508000,,-29832000,,-29832000,8176000,-20457000,-28633000,-28633000,,-1192000,,,,0,0,28633000,20457000,-1199000,,-29832000,-29832000,54158,ZSAN
2020-06-30,57308000,,86122000,,75252000,252960000,420639000,110371000,110371000,,-18765000,,,,10870000,1166044000,1055673000,745405000,-24249000,,75252000,75252000,54160,OSIS
2019-06-30,56509000,,86164000,,64796000,262484000,430594000,111601000,111601000,,-21610000,,,,21368000,1182115000,1070514000,751521000,-25437000,,64796000,64796000,54160,OSIS
2018-06-30,61189000,,36854000,,-29127000,239592000,391652000,90871000,90871000,,-19300000,,,,65981000,1089286000,998415000,697634000,-54017000,,-29127000,-29127000,54160,OSIS
2017-06-30,50951000,,25751000,,21076000,192560000,323501000,79990000,79990000,,-9629000,,,,4675000,960951000,880961000,637450000,-54239000,,21076000,21076000,54160,OSIS
2020-12-31,,,12633000,,9861000,37486000,51539000,14053000,14053000,,-770000,,,,2772000,194101000,180048000,142562000,-1420000,,9861000,9861000,54161,MHH
2019-12-31,,,15219000,,11145000,34500000,47981000,10808000,10808000,-27000.0,-1779000,,,,4074000,193574000,182766000,145593000,4411000,,11145000,11145000,54161,MHH
2018-12-31,,,9414000,,6691000,29600000,42528000,10167000,10167000,-39000.0,-2171000,,,,2723000,177164000,166997000,134636000,-753000,,6691000,6691000,54161,MHH
2017-12-31,,,2948000,,1626000,23829000,31629000,6100000,6100000,-39000.0,-1131000,,,,1322000,147882000,141782000,116253000,-3152000,,1626000,1626000,54161,MHH
2020-06-30,,,-6430141,,-6430141,1895089,-592978,-6057441,-6057441,-634319,-389209,,,,0,0,6057441,592978,-372700,,-6430141,-6430141,54164,PZG
2019-06-30,,,-5970048,,-5970048,2051322,-610018,-5987827,-5987827,-234800,-9481,,,,0,0,5987827,610018,17779,,-5970048,-5970048,54164,PZG
2018-06-30,,,-6068154,,-6068154,1532690,-519582,-6084720,-6084720,-193896,-5610,,,,0,0,6084720,519582,16566,,-6068154,-6068154,54164,PZG
2017-06-30,,,-7555020,,-4339602,1840965,-635931,-7711976,-7711976,-143383,-2404,,,,-3215418,0,7711976,635931,156956,,-4339602,-4339602,54164,PZG
2020-12-31,,,-918195000,13480000,-891163000,239198000,1277739000,0,999433000,39108000,,,,,-28423000,1277739000,278306000,0,-1917628000,,-889772000,-1033199000,54165,NLY
2019-12-31,,,-2173926000,4327000,-2162865000,301634000,-453028000,0,-730962000,-23700000,,,,,-10835000,-453028000,277934000,0,-1442964000,,-2163091000,-2299441000,54165,NLY
2018-12-31,,,51773000,5689000,54408000,329873000,406662000,0,94889000,-18100000,,,,,-2375000,406662000,311773000,0,-43116000,,54148000,-74904000,54165,NLY
2017-12-31,,,1575998000,6100000,1569604000,224124000,1960255000,0,1736131000,15800000,,,,,6982000,1960255000,224124000,0,-160133000,,1569016000,1459969000,54165,NLY
2019-12-31,,,-799742,,-655840,56134138,61216343,-765208,-765208,,-34534,,,,-143902,287820277,288585485,226603934,-34534,,-655840,-1155840,54168,ID
2018-12-31,,,-544108,,-640403,57862726,61664974,-543193,-543193,,-915,,,,96295,288632927,289176120,226967953,-915,,-640403,-1140403,54168,ID
2017-12-31,,,2806971,,2162990,49806362,55746021,3099436,3099436,,-292465,,,,643981,244673955,241574519,188927934,-292465,,2162990,1434789,54168,ID
2020-12-31,,,1411000000,,-401000000,,5258000000,2055000000,2055000000,871000000,-1377000000,,,,83000000,14172000000,12117000000,8914000000,-644000000,-1878000000,1328000000,-465000000,54171,D
2019-12-31,,,1727000000,2039000000.0,1358000000,-141000000.0,7970000000,4416000000,4416000000,1040000000,-1773000000,,,,351000000,16572000000,12156000000,8602000000,-2689000000,-1878000000,1376000000,1341000000,54171,D
2018-12-31,,,3129000000,1941000000.0,2447000000,-260000000.0,6482000000,4039000000,4039000000,703000000,-1493000000,,,,580000000,13366000000,9327000000,6884000000,-910000000,-1878000000,2549000000,2447000000,54171,D
2017-12-31,,,3090000000,2228000000.0,2999000000,-237000000.0,6378000000,4042000000,4042000000,668000000,-1205000000,,,,-30000000,12586000000,8544000000,6208000000,-952000000,-1878000000,3120000000,2999000000,54171,D
2020-05-03,,,-7804000,,-28667000,34424000,40498000,6074000,6074000,,-106000,,,,3354000,256166000,250092000,215668000,-13878000,-17509000,-11158000,-28667000,54172,CULP
2019-04-28,,,12608000,4314000.0,5458000,32415000,48277000,15862000,15862000,,-35000,,,,6537000,281325000,265463000,233048000,-3254000,-613000,6071000,5458000,54172,CULP
2018-04-29,,,26617000,4314000.0,20877000,36833000,64633000,27800000,27800000,,-94000,,,,5740000,323725000,295925000,259092000,-1183000,-613000,20877000,20877000,54172,CULP
2017-04-30,,,29673000,4314000.0,22334000,39157000,69235000,30078000,30078000,,-94000,,,,7339000,309544000,279466000,240309000,-405000,-613000,22334000,22334000,54172,CULP
2020-12-31,,,202577000,,195989000,31644000,333033000,171751000,171751000,,-54721000,,,,2408000,452228000,280477000,119195000,30826000,,200169000,195675000,54173,FR
2019-12-31,,,247287000,33864000.0,238775000,28569000,310818000,161020000,161020000,,-53491000,,,,3406000,427403000,266383000,116585000,86267000,,243881000,238257000,54173,FR
2018-12-31,,,167242000,34397000.0,163239000,26449000,286824000,143916000,143916000,,-54179000,,,,-92000,403678000,259762000,116854000,23326000,,167334000,162726000,54173,FR
2017-12-31,,,209494000,48077000.0,201456000,28079000,282908000,138465000,138465000,,-58465000,,,,1193000,396402000,257937000,113494000,71029000,,208301000,200810000,54173,FR
2019-12-31,,,27187000,,26875000,24065000,38110000,14045000,14045000,,,,,,312000,156700000,142655000,118590000,13142000,,26875000,26875000,54174,XNCR
2018-12-31,,,-70409000,,-70409000,22233000,-56898000,-79131000,-79131000,,,,,,0,40603000,119734000,97501000,8722000,,-70409000,-70409000,54174,XNCR
2017-12-31,71772000.0,,-38949000,,-38486000,17105000,-25622000,-42727000,-42727000,,,,,,-463000,46150000,88877000,71772000,3778000,,-38486000,-38486000,54174,XNCR
2016-12-31,71772000.0,,46116000,,45125000,12752000,57148000,44396000,44396000,,-21000.0,,,,991000,109020000,64624000,51872000,1720000,,45125000,45125000,54174,XNCR
2019-12-31,,,139647000,180700000,122645000,67768000,248346000,0,142067000,,,,,,2646000,300354000,158287000,52008000,-3490000,,137001000,122645000,54175,LADR
2018-12-31,,,228319000,198482000,180015000,60117000,334787000,0,232711000,,,,,,6643000,391337000,158626000,56550000,-8784000,,221676000,180015000,54175,LADR
2017-12-31,,,133591000,253178000,95276000,70463000,244459000,0,133664000,,,,,,7712000,304092000,170428000,59633000,-146000,,125879000,95276000,54175,LADR
2016-12-31,,,120040000,538164000,66727000,64270000,218375000,0,114658000,,,,,,6320000,273175000,158517000,54800000,5382000,,113720000,66727000,54175,LADR
2020-06-30,7104932,,-11856873,,-11856873,3533014,0,-12111757,-12111757,,-25426,,,,0,0,12111757,0,254884,,-11856873,-11856873,54178,INM
2019-06-30,5638619,,-13255042,,-13255042,3797867,0,-13643987,-13643987,,-25426,,,,0,0,13643987,0,388945,,-13255042,-13255042,54178,INM
2018-06-30,1927137,,-8520920,,-8520920,3367698,0,-8609544,-8609544,,-25426,,,,0,0,8609544,0,88624,,-8520920,-8520920,54178,INM
2017-06-30,746162,,-4473849,,-4473849,2320922,0,-4473527,-4473527,,-25426,,,,0,0,4473527,0,-322,,-4473849,-4473849,54178,INM
2019-12-31,63128000,,-85282000,,-85472000,23229000,0,-86357000,-86357000,,-1300000,,,,190000,0,86357000,0,1075000,,-85472000,-85472000,54180,EVLO
2018-12-31,39885000,,-56946000,,-56946000,18218000,0,-58103000,-58103000,,-900000,,,,0,0,58103000,0,1157000,,-56946000,-60883000,54180,EVLO
2017-12-31,19957000,,-28047000,,-28047000,7574000,0,-27531000,-27531000,,-500000,,,,0,0,27531000,0,-516000,,-28047000,-34132000,54180,EVLO
2016-12-31,9134000,,-13332000,,-13332000,3891000,0,-13025000,-13025000,,-300000,,,,0,0,13025000,0,-307000,,-13332000,-14977000,54180,EVLO
2019-12-31,50828000,,165165000,33193000,121070000,629093000,872235000,184836000,184836000,,-20461000,,,,40600000,1681357000,1496521000,809122000,-19671000,,124565000,121070000,54181,GOLF
2018-12-31,51489000,,150304000,32112000,99872000,616299000,842351000,167919000,167919000,,-19647000,,,,47232000,1633721000,1465802000,791370000,-17615000,,103072000,99872000,54181,GOLF
2017-12-31,47241000,,151676000,32664000,98695000,581809000,801857000,166308000,166308000,,-16907000,,,,48475000,1560258000,1393950000,758401000,-14632000,,103201000,98695000,54181,GOLF
2016-12-31,48126000,,89222000,32958000,45012000,601757000,799000000,142509000,142509000,,-51259000,,,,39707000,1572275000,1429766000,773275000,-53287000,,49515000,23189000,54181,GOLF
2020-03-31,171137000,,-2224228000,,-2223638000,741335000,541557000,-687267000,-687267000,-14942000,,,,,-590000,835314000,1522581000,293757000,-1536961000,,-2223638000,-2223638000,54184,MOGU
2019-03-31,236446000,,-503492000,,-486275000,912111000,760490000,-567884000,-567884000,-15057000,,,,,-17217000,1074278000,1642162000,313788000,64392000,,-486275000,-1085255000,54184,MOGU
2018-03-31,289274000,,-646718000,,-558169000,848033000,655482000,-867267000,-867267000,887000,,,,,-88665000,973207000,1840474000,317725000,220549000,,-558053000,-1246409000,54184,MOGU
2017-03-31,418496000,,-1046827000,-3000.0,-939137000,816146000,732112000,-935469000,-935469000,-7833000,,,,,-107687000,1109877000,2045346000,377765000,-111358000,,-939140000,-1541039000,54184,MOGU
2020-12-31,109486000000,,584777000000,965000000,517885000000,35570000000,711130000000,566784000000,566784000000,-710000000,,,,,66619000000,1339255000000,772471000000,628125000000,17993000000,,518158000000,517885000000,54185,TSM
2019-12-31,91418746000,,389845336000,685302000,345263668000,28085836000,492698501000,373349671000,373349671000,-155752000,-3250847000.0,,,,44501527000,1069985448000,696635777000,577286947000,16495665000,,345343809000,345263668000,54185,TSM
2018-12-31,85895569000,,397510263000,678731000,351130884000,26253711000,500582087000,387648682000,387648682000,784125000,-3051223000.0,,,,46325857000,1031473557000,643824875000,530891470000,9861581000,,351184406000,351130884000,54185,TSM
2017-12-31,80732500000,,396161900000,699700000,344998300000,27169200000,494831000000,386670600000,386670600000,258700000,-3330300000.0,,,,51122900000,977447200000,590776600000,482616200000,9491300000,,345039000000,344998300000,54185,TSM
2019-12-31,149826000,,-32501000,,-32578000,62882000,184829000,-27878000,-27878000,-1000,-325000,,,,77000,184829000,212707000,0,-4623000,,-32578000,-32578000,54186,CALT
2018-12-31,99260000,,-132049000,,-132049000,31132000,715000,-130392000,-130392000,-1000,-8000,,,,0,715000,130392000,0,-1657000,,-132049000,-132049000,54186,CALT
2017-12-31,99260000,,-86794000,,-86794000,84603000,0,-84654000,-84654000,-1000,-2244000,,,,0,0,84654000,0,-2140000,,-86794000,-86794000,54186,CALT
2016-12-31,99260000,,-56912000,,-56912000,56405000,0,-56517000,-56517000,-1000,-1008000,,,,0,0,56517000,0,-395000,,-56912000,-56912000,54186,CALT
2020-09-30,,,11155000,,9555000,13889000,27880000,0,12129000,1862000,,,,,1600000,27880000,15751000,0,-974000,,9555000,9555000,54187,PBIP
2019-09-30,,,11680000,,9530000,13227000,27745000,0,12356000,2162000,,,,,2150000,27745000,15389000,0,-676000,,9530000,9530000,54187,PBIP
2018-09-30,,,10765000,,7064000,13056000,26404000,0,11357000,1991000,,,,,3701000,26404000,15047000,0,-592000,,7064000,7064000,54187,PBIP
2017-09-30,,,3719000,,2778000,11609000,20285000,0,6466000,2210000,,,,,941000,20285000,13819000,0,-2747000,,2778000,2778000,54187,PBIP
2020-10-31,,,-1556349,,-1556349,1017218,555328,-461890,-461890,,,,,,0,555328,1017218,0,-1094459,,-1556349,-1556349,54189,IRL
2019-10-31,,,2226141,,2226141,1095598,1203087,107489,107489,,,,,,0,1203087,1095598,0,2118652,,2226141,2226141,54189,IRL
2018-10-31,,,-11010235,,-11147604,1183838,1142113,-41725,-41725,,,,,,137369,1142113,1183838,0,-10968510,,-11147604,-11147604,54189,IRL
2017-10-31,,,17280782,,17204593,1365111,942312,-422799,-422799,,,,,,76189,942312,1365111,76189,17703581,,17204593,17204593,54189,IRL
2019-12-31,,,-75284923,,-75284923,2590482,33864407,31273925,31273925,,-6058711,,,,0,44085374,12811449,10220967,-106558848,,-75284923,-75284923,54190,BROG
2018-12-31,,,16060652,,16060652,2010011,26212659,24202648,24202648,,-8141996,,,,0,35839268,11636620,9626609,-8141996,,16060652,16060652,54190,BROG
2017-12-31,,,-3747408,,-3747408,551394,-2229088,-2780482,-2780482,,-966926,,,,0,89593,2870075,2318681,-966926,,-3747408,-3747408,54190,BROG
2019-12-31,,,-132000000,2981000000,-22000000,895000000,1193000000,129000000,129000000,,-22000000,,,,-16000000,1560000000,1431000000,367000000,-261000000,,-116000000,-22000000,54191,LTRPA
2018-12-31,,,48000000,3400000000,-64000000,966000000,1254000000,128000000,128000000,,-26000000,,,,57000000,1615000000,1487000000,361000000,-80000000,,-9000000,-64000000,54191,LTRPA
2017-12-31,,,-1810000000,3329000000,-397000000,1021000000,1240000000,6000000,6000000,,-25000000,,,,-229000000,1569000000,1563000000,329000000,-1816000000,,-1581000000,-397000000,54191,LTRPA
2016-12-31,,,46000000,4621000000,21000000,918000000,1163000000,23000000,23000000,,-25000000,,,,-1000000,1532000000,1509000000,369000000,23000000,,47000000,21000000,54191,LTRPA
2019-12-31,,,546000000,-3988000000,528000000,60000000,343000000,215000000,215000000,19000000,-92000000,,,,0,503000000,288000000,160000000,331000000,,546000000,381000000,54196,SHLX
2018-12-31,,,483000000,-3518000000,464000000,60000000,331000000,212000000,212000000,13000000,-62000000,,,,1000000,525000000,313000000,194000000,271000000,,482000000,330000000,54196,SHLX
2017-12-31,,,315000000,-2832200000,295000000,58000000,320000000,200000000,200000000,17000000,-32000000,,,,0,470000000,270000000,150000000,115000000,,315000000,231000000,54196,SHLX
2016-12-31,,,275200000,-1852200000,244900000,53400000,336000000,223500000,223500000,16000000,-12300000,,,,0,452900000,229400000,116900000,51700000,,275200000,219900000,54196,SHLX
2019-12-31,,,-36900000,,-37000000,68500000,117300000,-2200000,-2200000,,-27800000,,,,100000,153400000,155600000,36100000,-34700000,,-37000000,-37000000,54197,INSE
2018-12-31,,,-21015000,,-21098000,56066000,109369000,5974000,5974000,,-19862000,,,,83000,140653000,134679000,31284000,-26989000,,-21098000,-21098000,54197,INSE
2018-09-30,,,-20400000,,-20600000,59400000,108700000,-800000,-800000,,-20600000,,,,200000,141400000,142200000,32700000,-19600000,,-20600000,-20600000,54197,INSE
2017-09-30,,,-48930000,,-49114000,56011000,95860000,1804000,1804000,,-29358000,,,,184000,122544000,120740000,26684000,-50734000,,-49114000,-49114000,54197,INSE
2019-12-31,,,1081073,,771895,448522,0,-634066,-634066,185544,,,,,309178,0,634066,0,1715139,,771895,-396058,54198,JIH
2019-12-31,11140000,,-25585000,,-25580000,229154000,256174000,14841000,14841000,,-5762000,,,,-5000,299255000,284414000,43081000,-40426000,,-25580000,-25580000,54199,MDXG
2018-12-31,15765000,,-3397000,,-29979000,289195000,322725000,16731000,16731000,,-5762000,,,,26582000,359111000,342380000,36386000,-20128000,,-29979000,-29979000,54199,MDXG
2017-12-31,17900000,,45088000,,64727000,219529000,285920000,46813000,46813000,,-87000,,,,-19639000,321139000,274326000,35219000,-1725000,,64727000,64727000,54199,MDXG
2016-12-31,14341000,,545000,,390000,172324000,192259000,3457000,3457000,,-87000,,,,155000,221712000,218255000,29453000,-2912000,,390000,390000,54199,MDXG
2020-12-31,,,645200000,-88100000,708700000,398300000,1098000000,671400000,671400000,,-29500000,,,,-20500000,1180700000,509300000,82700000,-26200000,-2300000,665700000,708700000,54203,WTM
2019-12-31,,,405100000,-116800000,414500000,322800000,767600000,424600000,424600000,,-17400000,,,,29300000,893400000,468800000,125800000,-19500000,800000,375800000,409200000,54203,WTM
2018-12-31,,,-178200000,-124900000,-141200000,205500000,46800000,-167200000,-167200000,,-8300000,,,,-4000000,369100000,536300000,322300000,-11000000,-17200000,-174200000,-139600000,54203,WTM
2017-12-31,,,7800000,-131700000,627200000,195300000,204600000,9100000,9100000,,-1300000,,,,-7800000,373800000,364700000,169200000,-1300000,577500000,15600000,619200000,54203,WTM
2020-12-31,,,32250000,,27129000,27952000,71902000,0,33341000,10609000,,,,,5121000,71902000,38561000,0,-1091000,,27129000,27129000,54204,FNLC
2019-12-31,,,30260000,,25525000,26118000,65432000,0,30742000,8572000,,,,,4735000,65432000,34690000,0,-482000,,25525000,25525000,54204,FNLC
2018-12-31,,,27842000,,23536000,25165000,61309000,0,29111000,7033000,,,,,4306000,61309000,32198000,0,-1269000,,23536000,23536000,54204,FNLC
2017-12-31,,,26200000,,19588000,23890000,57851000,0,27251000,6710000,,,,,6612000,57851000,30600000,0,-1051000,,19588000,19588000,54204,FNLC
2020-12-31,,,343491000,,286006000,611265000,1125251000,0,408337000,105649000,,,,,57485000,1125251000,716914000,0,-64846000,,286006000,277965000,54206,FNB
2019-12-31,,,471000000,,387000000,559480000,1169722000,0,511331000,98911000,,,,,84000000,1169722000,658391000,0,-40331000,,387000000,378959000,54206,FNB
2018-12-31,,,452000000,,373000000,550081000,1152677000,0,508881000,93715000,,,,,79000000,1152677000,643796000,0,-56881000,,373000000,364959000,54206,FNB
2017-12-31,,,356000000,,199000000,486000000,1037000000,0,464000000,87000000,,,,,157000000,1037000000,573000000,0,-108000000,,199000000,191000000,54206,FNB
2019-12-31,,,115200000,6000000,82400000,621700000,827900000,191100000,191100000,700000,-93200000,,,,32500000,4501600000,4310500000,3673700000,-75900000,,82700000,82400000,54207,RYI
2018-12-31,,,116700000,2700000,106000000,599200000,758100000,152000000,152000000,700000,-99200000,,,,10300000,4408400000,4256400000,3650300000,-35300000,,106400000,106000000,54207,RYI
2017-12-31,,,16700000,2600000,17100000,465700000,582500000,110700000,110700000,700000,-91000000,,,,-1300000,3364700000,3254000000,2782200000,-94000000,,18000000,17100000,54207,RYI
2016-12-31,,,26100000,1500000,18700000,436600000,570600000,133900000,133900000,100000,-89900000,,,,7200000,2859700000,2725800000,2289100000,-107800000,,18900000,18700000,54207,RYI
2019-12-31,5834000,,-1026000,4877000,-2600000,19305000,24825000,-314000,-314000,,,,,,562000,83256000,83570000,58431000,-712000,,-1588000,-2777000,54208,AXTI
2018-12-31,5897000,,11947000,3697000,9654000,19003000,37047000,12147000,12147000,,,,,,938000,102397000,90250000,65350000,-200000,,11009000,9477000,54208,AXTI
2017-12-31,4827000,,10853000,4497000,10148000,17009000,34475000,12639000,12639000,,,,,,792000,98673000,86034000,64198000,-1786000,,10061000,9971000,54208,AXTI
2016-12-31,5850000,,5699000,4380000,5636000,13880000,26381000,6651000,6651000,,,,,,733000,81349000,74698000,54968000,-952000,,4966000,5459000,54208,AXTI
2021-01-02,156670000,,187915000,,147068000,366245000,672149000,146322000,146322000,,,,,,40847000,1430390000,1284068000,758241000,41593000,,147068000,147068000,54209,IRBT
2019-12-28,141607000,,98833000,,85300000,314651000,555648000,86618000,86618000,,,,,,13533000,1214010000,1127392000,658362000,12215000,,85300000,85300000,54209,IRBT
2018-12-29,140629000,,108622000,,87992000,307912000,573972000,105822000,105822000,,,,,,20630000,1092584000,986762000,518612000,2800000,,87992000,87992000,54209,IRBT
2017-12-30,113149000,,76366000,,50964000,246881000,445797000,72690000,72690000,,,,,,25402000,883911000,811221000,438114000,3676000,,50964000,50964000,54209,IRBT
2019-12-31,,,43005000,,48162000,131294000,478146000,183504000,183504000,,-94408000,,,,-5157000,1783594000,1600090000,1305448000,-140499000,,48162000,48162000,54211,COLD
2018-12-31,,,44366000,,47985000,112035000,406384000,176696000,176696000,,-93312000,,,,-3619000,1602566000,1425870000,1196182000,-132330000,,47985000,46167000,54211,COLD
2017-12-31,,,8785000,,-608000,102478000,370065000,142710000,142710000,8136000.0,-114898000,,,,9393000,1542224000,1399514000,1172159000,-133925000,,-608000,-29927000,54211,COLD
2016-12-31,,,10811000,,4932000,100238000,345517000,126708000,126708000,8136000.0,-119552000,,,,5879000,1489871000,1363163000,1144354000,-115897000,,4932000,-24456000,54211,COLD
2020-09-30,,,80630000,,64540000,90924000,186634000,0,81544000,14166000,,,,,16090000,186634000,105090000,0,-914000,,64540000,64488000,54219,CFFN
2019-09-30,,,120654000,,94243000,91475000,227598000,0,121826000,14297000,,,,,26411000,227598000,105772000,0,-1172000,,94243000,94188000,54219,CFFN
2018-09-30,,,123906000,,98927000,78939000,220808000,0,127183000,14686000,,,,,24979000,220808000,93625000,0,-3277000,,98927000,98887000,54219,CFFN
2017-09-30,,,127920000,,84137000,72187000,217578000,0,131459000,13932000,,,,,43783000,217578000,86119000,0,-3539000,,84137000,84093000,54219,CFFN
2019-12-31,,,20106000,,14925000,,41091000,25106000,25106000,5182000,-7024000,,,,5181000,83595000,58489000,42504000,-5000000,,14925000,14925000,54220,ARTNA
2018-12-31,,,19269000,,14278000,,39202000,23946000,23946000,4968000,-6252000,,,,4991000,80411000,56465000,41209000,-4677000,,14278000,14278000,54220,ARTNA
2017-12-31,,,21278000,,13983000,,41181000,26895000,26895000,4731000,-6177000,,,,7295000,82235000,55340000,41054000,-5617000,,13983000,13983000,54220,ARTNA
2016-12-31,,,21285000,,12954000,,40829000,27150000,27150000,4491000,-6644000,,,,8331000,79089000,51939000,38260000,-5865000,,12954000,12954000,54220,ARTNA
2020-04-30,4344000,,-11247000,,-10352000,6916000,-105000,-11365000,-11365000,,,,,,-895000,1682000,13047000,1787000,118000,,-10352000,-10352000,54221,OPTT
2019-04-30,4984000,,-13096000,,-12246000,7616000,-671000,-13271000,-13271000,,,,,,-850000,632000,13903000,1303000,175000,,-12246000,-12246000,54221,OPTT
2018-04-30,4320000,,-11276000,,-10157000,6988000,-252000,-11560000,-11560000,,,,,,-1119000,511000,12071000,763000,284000,,-10157000,-10157000,54221,OPTT
2017-04-30,5029000,,-10184000,,-9486000,6563000,-95000,-11687000,-11687000,,,,,,-698000,843000,12530000,938000,1503000,,-9486000,-9486000,54221,OPTT
2020-12-31,,,124424000,,96953000,189057000,380206000,0,160546000,30603000,,,,,27471000,380206000,219660000,0,-36122000,,96953000,96953000,54222,SASR
2019-12-31,,,152861000,,116433000,153141000,331346000,0,157779000,20426000,,,,,36428000,331346000,173567000,0,-4918000,,116433000,116433000,54222,SASR
2018-12-31,,,132688000,,100864000,141268000,310871000,0,150111000,19492000,,,,,31824000,310871000,160760000,0,-17423000,,100864000,100864000,54222,SASR
2017-12-31,,,87935000,,53209000,106297000,217034000,0,96868000,13869000,,,,,34726000,217034000,120166000,0,-8933000,,53209000,53209000,54222,SASR
2020-12-31,760700000,,916700000,,823400000,1228400000,3305700000,1316600000,1316600000,,,,,,93300000,4386300000,3069700000,1080600000,-399900000,,823400000,823400000,54224,EW
2019-12-31,752700000,,1166500000,,1046900000,1240400000,3233600000,1240500000,1240500000,,-20700000.0,,,,119600000,4348000000,3107500000,1114400000,-74000000,,1046900000,1046900000,54224,EW
2018-12-31,622200000,,761400000,,722200000,1088400000,2783400000,1072800000,1072800000,,-29900000.0,,,,39200000,3722800000,2650000000,939400000,-311400000,,722200000,722200000,54224,EW
2017-12-31,552600000,,1034900000,,583600000,984300000,2560000000,1022400000,1022400000,700000.0,-23200000.0,,,,451300000,3435300000,2412900000,875300000,12500000,,583600000,583600000,54224,EW
2019-12-31,953185,,-2428185,,-2428185,1475000,0,-2428185,-2428185,,,,,,0,0,2428185,0,0,,-2428185,-2428185,54227,LTRN
2018-12-31,572095,,-1726417,,-1726417,1154322,0,-1726417,-1726417,,,,,,0,0,1726417,0,0,,-1726417,-1726417,54227,LTRN
2020-06-30,,,4764000,,3864000,10342000,16806000,0,5009000,1455000,,,,,900000,16806000,11797000,0,-245000,,3864000,3860000,54228,OFED
2019-06-30,,,4594000,,3720000,10608000,16728000,0,4826000,1294000,,,,,874000,16728000,11902000,0,-232000,,3720000,3714000,54228,OFED
2018-06-30,,,4740000,,3035000,10721000,16790000,0,4911000,1158000,,,,,1705000,16790000,11879000,0,-171000,,3035000,3027000,54228,OFED
2017-06-30,,,7003000,,5525000,9680000,17753000,0,7299000,774000,,,,,1478000,17753000,10454000,0,-296000,,5525000,5506000,54228,OFED
2019-12-31,,,10503000,,8207000,10198000,34639000,7800000,7800000,,-636000,,,,2296000,1811247000,1803447000,1776608000,2703000,,8207000,8207000,54229,AE
2018-12-31,,,3454000,,2945000,10237000,20999000,108000,108000,,-109000,,,,509000,1750213000,1750105000,1729214000,3346000,,2945000,2945000,54229,AE
2017-12-31,,,-3427000,,-482000,8707000,24811000,2502000,2502000,,-27000,,,,-2945000,1322060000,1319558000,1297249000,-5929000,,-482000,-482000,54229,AE
2016-12-31,,,5204000,,2513000,10410000,35569000,6054000,6054000,,-2000,,,,2691000,1099540000,1093486000,1063971000,-850000,,2513000,2513000,54229,AE
2019-12-31,58373000,,-77270000,,-77270000,17528000,0,-75901000,-75901000,,-5958000,,,,0,0,75901000,0,-194000,,-77270000,-77270000,54234,RCKT
2018-12-31,53084000,,-74518000,,-74518000,12586000,0,-65670000,-65670000,,-6039000,,,,0,0,65670000,0,-8047000,,-74518000,-74518000,54234,RCKT
2017-12-31,14725000,,-19578000,,-19578000,4855000,0,-19580000,-19580000,,-6039000,,,,0,0,19580000,0,2000,,-19578000,-19578000,54234,RCKT
2016-12-31,5994000,,-7573000,,-7573000,1580000,0,-7574000,-7574000,,-6039000,,,,0,0,7574000,0,1000,,-7573000,-7573000,54234,RCKT
2019-12-31,6877000,,-2735000,,-3978000,11190000,33062000,5310000,5310000,,-4158000,,,,1243000,33062000,27752000,0,-8045000,,-3978000,-3978000,54235,NGMS
2018-12-31,5782000,,-5389000,,-5975000,10924000,23478000,-987000,-987000,,-2309000,,,,586000,23478000,24465000,0,-4402000,,-5975000,-5975000,54235,NGMS
2017-12-31,4359000,,-6974000,,-7453000,8780000,17149000,-3721000,-3721000,,-2234000,,,,479000,17149000,20870000,0,-3253000,,-7453000,-7453000,54235,NGMS
2019-12-31,,,172477000,-704000,173736000,36366000,211992000,0,175626000,,,,,,-419000,225461000,49835000,13469000,-3149000,,172896000,144835000,54236,NYMTP
2018-12-31,,,103738000,904000,102886000,28234000,132408000,0,104174000,44050000.0,,,,,-1057000,145644000,41470000,13236000,-436000,,104795000,79186000,54236,NYMTP
2017-12-31,,,91922000,4136000,91980000,22874000,114796000,0,91922000,44050000.0,,,,,3355000,132999000,41077000,18203000,0,,88567000,76320000,54236,NYMTP
2016-12-31,,,70655000,3087000,67551000,24507000,95097000,0,70590000,44050000.0,,,,,3095000,105811000,35221000,10714000,65000,,67560000,54651000,54236,NYMTP
2019-12-31,,,-520,,-520,,0,0,,,,,,,0,0,0,0,-520,,-520,-520,54238,CHAQ
2019-12-31,,,11815000,,11815000,846799,12661799,11815000,11815000,,,,,,0,12661799,846799,0,0,,11815000,11815000,54239,VOC
2018-12-31,,,12070000,,12070000,868703,12938703,12070000,12070000,,,,,,0,12938703,868703,0,0,,12070000,12070000,54239,VOC
2017-12-31,,,8415000,,8415000,794023,9209023,8415000,8415000,,,,,,0,9209023,794023,0,0,,8415000,8415000,54239,VOC
2016-12-31,,,4845000,,4845000,904845,5749845,4845000,4845000,,,,,,0,5749845,904845,0,447017,,4845000,4845000,54239,VOC
2019-12-28,380000000,,-149000000,,-236000000,1042000000,1792000000,148000000,148000000,,-295000000,,,,87000000,2635000000,2487000000,843000000,-297000000,,-236000000,-236000000,54241,MCFE
2018-12-29,406000000,,-450000000,,-512000000,1068000000,1569000000,-137000000,-137000000,,-307000000,,,,62000000,2409000000,2546000000,840000000,-313000000,,-512000000,-512000000,54241,MCFE
2017-12-30,450000000,,-645000000,,-686000000,1004000000,1371000000,-290000000,-290000000,,-160000000,,,,41000000,2076000000,2366000000,705000000,-355000000,,-686000000,-607000000,54241,MCFE
2019-12-31,,,-1152000,,-1100000,3555000,3389000,0,-937000,771000,,,,,-52000,3389000,4326000,0,-215000,,-1100000,-1100000,54242,OPHC
2018-12-31,,,796000,,796000,3306000,4884000,0,796000,782000,,,,,0,4884000,4088000,0,-114000,,796000,796000,54242,OPHC
2017-12-31,,,-589000,,-589000,3475000,3572000,0,-387000,484000,,,,,0,3572000,3959000,0,-202000,,-589000,-589000,54242,OPHC
2016-12-31,,,-396000,,-396000,3373400,3541000,0,-266000,433600,,,,,0,3541000,3807000,0,-130000,,-396000,-396000,54242,OPHC
2020-04-30,,,-6091622,,-6091622,3303319,23009666,19706347,19706347,,-4963444,,,,0,23009666,3303319,0,-25797969,,-6091622,-6091622,54245,MEN
2019-04-30,,,25919275,,25919275,3204277,24443524,21239247,21239247,,-5349177,,,,0,24443524,3204277,0,4680028,,25919275,25919275,54245,MEN
2018-04-30,,,9807854,,9807854,3219314,24716075,21496761,21496761,,-4015096,,,,0,24716075,3219314,0,-11688907,,9807854,9807854,54245,MEN
2017-04-30,,,-1729358,,-1729358,3228796,25408073,22179277,22179277,,-3044181,,,,0,25408073,3228796,0,-23908635,,-1729358,-1729358,54245,MEN
2020-12-31,15112000000,,53130000000,,42138000000,36886000000,106014000000,54476000000,54476000000,-460000000,-390000000,,,,10992000000,126946000000,72470000000,20932000000,-1346000000,,42138000000,42138000000,54246,NVO
2019-12-31,13770000000,,48553000000,,38951000000,35830000000,102462000000,53462000000,53462000000,-600000000,-220000000,,,,9602000000,122021000000,68559000000,19559000000,-4909000000,,38951000000,38951000000,54246,NVO
2018-12-31,14805000000,,47615000000,,38628000000,33313000000,94214000000,47248000000,47248000000,-1152000000,-85000000,,,,8987000000,111831000000,64583000000,17617000000,367000000,,38628000000,38628000000,54246,NVO
2017-12-31,14014000000,,48680000000,,38130000000,32124000000,94064000000,48967000000,48967000000,-1041000000,-90000000,,,,10550000000,111696000000,62729000000,17632000000,-287000000,,38130000000,38130000000,54246,NVO
2019-12-31,,,-3644734,,-3644734,586559,-3058019,-3644578,-3644578,,,,,,0,324646,3969223,3382664,-156,,-3644734,-3644734,54249,TMBR
2019-12-31,,,-1739000000,4674000000,-1076000000,1376000000,15000000,-1364000000,-1364000000,3000000,-605000000,,,,20000000,8745000000,10109000000,8730000000,-375000000,-32000000,-1759000000,-1076000000,54250,IEP
2018-12-31,,,223000000,5630000000,2039000000,1386000000,2171000000,777000000,777000000,8000000,-524000000,,,,-14000000,11702000000,10925000000,9531000000,-554000000,1764000000,237000000,2039000000,54250,IEP
2017-12-31,,,1866000000,6027000000,2405000000,1269000000,1687000000,414000000,414000000,4000000,-655000000,,,,-532000000,10433000000,10019000000,8746000000,1452000000,234000000,2398000000,2405000000,54250,IEP
2016-12-31,,,-2373000000,5569000000,-1106000000,1001000000,-83000000,-1088000000,-1088000000,4000000,-692000000,,,,-88000000,7385000000,8473000000,7468000000,-1285000000,65000000,-2285000000,-1106000000,54250,IEP
2019-12-31,,,-10406,,-10406,9566,0,-10406,-10406,840,,,,,0,0,10406,0,0,,-10406,-10406,54253,STPK
2018-12-31,,,-48864,,-48864,20694,0,-48864,-48864,28170,,,,,0,0,48864,0,0,,-48864,-48864,54253,STPK
2020-06-25,,,72711000,,54110000,101059000,175775000,74716000,74716000,,-2005000,,,,18601000,880092000,805376000,704317000,-2005000,,54110000,54110000,54255,JBSS
2019-06-27,,,52428000,,39466000,102782000,158270000,55488000,55488000,,-3060000,,,,12962000,876201000,820713000,717931000,-3060000,,39466000,39466000,54255,JBSS
2018-06-28,,,49350000,,32500000,86086000,138899000,52813000,52813000,,-3463000,,,,16850000,888931000,836118000,750032000,-3463000,,32500000,32500000,54255,JBSS
2017-06-29,,,54138000,,36125000,84875000,141923000,57048000,57048000,,-2910000,,,,18013000,846635000,789587000,704712000,-2910000,,36125000,36125000,54255,JBSS
2019-12-31,,,-55419000,,-55419000,11789000,-42144000,0,-55450000,,,,,,0,-42144000,13306000,0,31000,,-55419000,-64608000,54256,ANH
2018-12-31,,,-6488000,,-6488000,11978000,6961000,0,-6542000,,,,,,0,6961000,13503000,0,54000,,-6488000,-15677000,54256,ANH
2017-12-31,,,54372000,,54372000,11933000,67677000,0,54372000,,,,,,0,67677000,13305000,0,0,,54372000,46199000,54256,ANH
2016-12-31,,,22493000,,22493000,12875000,36712000,0,22493000,,,,,,0,36712000,14219000,0,0,,22493000,15910000,54256,ANH
2019-12-31,,,-2216588000,,-1716297000,181109000,891802000,-1963656000,-1963656000,-226681000,-194285000,,,,-500291000,2600934000,4564590000,1709132000,-254368000,,-1716297000,-1716548000,54258,RRC
2018-12-31,,,-1776970000,,-1746481000,209812000,1544094000,94529000,94529000,51192000,-210209000,,,,-30489000,3333837000,3239308000,1789743000,-1871499000,,-1746481000,-1746726000,54258,RRC
2017-12-31,,,82120000,,333146000,233406000,1239052000,257853000,257853000,-213350000,-195679000,,,,-251026000,2397680000,2139827000,1158628000,-175733000,,333146000,329395000,54258,RRC
2016-12-31,,,-802138000,,-521388000,184772000,504714000,-590145000,-590145000,261391000,-168213000,,,,-280750000,1361330000,1951475000,856616000,-211993000,,-521388000,-521611000,54258,RRC
2019-12-31,,,-126491000,,-142125000,509321000,1014368000,496373000,496373000,8674000,-114129000,,,,15634000,1123375000,627002000,109007000,-622864000,,-142125000,-142125000,54259,OCN
2018-12-31,,,-71476000,,-70772000,607762000,931748000,297706000,297706000,26280000,-103371000,,,,529000,1063045000,765339000,131297000,-369182000,1409000.0,-72005000,-70772000,54259,OCN
2017-12-31,,,-143973000,1834000.0,-127966000,754954000,1053080000,255693000,255693000,42433000,-126927000,,,,-15516000,1194576000,938883000,141496000,-399666000,1409000.0,-128457000,-127966000,54259,OCN
2016-12-31,,,-206361000,2325000.0,-199762000,877450000,1198413000,287938000,287938000,33025000,-412583000,,,,-6986000,1387163000,1099225000,188750000,-494299000,1409000.0,-199375000,-199762000,54259,OCN
2019-12-31,,,3680000,,3000000,13348000,16972000,3022000,3022000,,,,,,680000,46665000,43643000,29693000,658000,,3000000,3000000,54260,APT
2018-12-31,,,4414000,,3625000,13312000,17711000,3874000,3874000,,,,,,789000,46624000,42750000,28913000,540000,,3625000,3625000,54260,APT
2017-12-31,,,3670000,,2633000,13336000,17452000,3545000,3545000,,,,,,1037000,44025000,40480000,26573000,125000,,2633000,2633000,54260,APT
2016-12-31,,,4175000,,3168000,12768000,16984000,3672000,3672000,,,,,,1007000,46176000,42504000,29192000,503000,,3168000,3168000,54260,APT
2020-10-31,17144000,,61601000,157304000,33820000,53582000,134654000,63928000,63928000,,-2367000,,,,21258000,609691000,545763000,475037000,-2327000,,40343000,33820000,54261,PLAB
2019-10-31,16394000,,50701000,141200000,29793000,52326000,120841000,52121000,52121000,,-1425000,,,,10210000,550660000,498539000,429819000,-1420000,,40491000,29793000,54261,PLAB
2018-10-31,14481000,,68571000,144898000,42055000,51395000,131503000,65627000,65627000,,-2262000,,,,7335000,535276000,469649000,403773000,2944000,,61236000,42055000,54261,PLAB
2017-10-29,15862000,,26565000,120731000,13130000,43585000,91315000,31868000,31868000,,-2235000,,,,5276000,450678000,418810000,359363000,-5303000,,21289000,13130000,54261,PLAB
2020-12-31,1150000000,,2616000000,,2197000000,1848000000,5826000000,2828000000,2828000000,,-87000000,,,,419000000,8086000000,5258000000,2260000000,-212000000,,2197000000,2197000000,54263,ATVI
2019-12-31,998000000,,1633000000,,1503000000,1658000000,4400000000,1744000000,1744000000,,-90000000,,,,130000000,6489000000,4745000000,2089000000,-111000000,,1503000000,1503000000,54263,ATVI
2018-12-31,1101000000,,1877000000,,1848000000,1884000000,4983000000,1998000000,1998000000,,-140000000,,,,29000000,7500000000,5502000000,2517000000,-121000000,,1848000000,1848000000,54263,ATVI
2017-12-31,1069000000,,1151000000,,273000000,2123000000,4516000000,1324000000,1324000000,,-162000000,,,,878000000,7017000000,5693000000,2501000000,-173000000,,273000000,273000000,54263,ATVI
2019-12-31,,,129125000,,96806000,124793000,266165000,141372000,141372000,,-12331000,,,,32319000,570230000,428858000,304065000,-12247000,,96806000,96806000,54264,MGRC
2018-12-31,,,104695000,,79406000,115770000,233290000,117520000,117520000,,-12297000,,,,25289000,498330000,380810000,265040000,-12825000,,79406000,79406000,54264,MGRC
2017-12-31,,,83452000,,153920000,111605000,207984000,96379000,96379000,,-11622000,,,,-70468000,462034000,365655000,254050000,-12927000,,153920000,153920000,54264,MGRC
2016-12-31,,,66931000,,38251000,104908000,184167000,79259000,79259000,,-12207000,,,,28680000,424080000,344821000,239913000,-12328000,,38251000,38251000,54264,MGRC
2020-01-25,,,-191263000,,-214435000,300123000,387952000,80203000,80203000,,-31801000,,,,23172000,1365035000,1284832000,977083000,-271466000,,-214435000,-214435000,54265,HOME
2019-01-26,,,48979000,,48996000,255517000,385851000,123971000,123971000,,-27056000,,,,-17000,1165899000,1041928000,780048000,-74992000,,48996000,48996000,54265,HOME
2018-01-27,,,65657000,,31812000,198334000,306958000,102506000,102506000,,-21704000,,,,33845000,950528000,848022000,643570000,-36849000,,31812000,31812000,54265,HOME
2017-01-28,,,42788000,,27066000,164441000,247480000,78792000,78792000,,-27174000,,,,15722000,765635000,686843000,518155000,-36004000,,27066000,27066000,54265,HOME
2019-12-31,,,24034000,7781000,23683000,21661000,83731000,35330000,35330000,,-26285000,,,,400000,120635000,85305000,36904000,-11296000,594000,23634000,23642000,54266,WSR
2018-12-31,,,22328000,8694000,21431000,23281000,84631000,35671000,35671000,,-25177000,,,,347000,122062000,86391000,37431000,-4912000,594000,21981000,21130000,54266,WSR
2017-12-31,,,8974000,10800000,8334000,24227000,83849000,32382000,32382000,,-23651000,,,,386000,125959000,93577000,42110000,-23408000,594000,8588000,7878000,54266,WSR
2016-12-31,,,8402000,11956000,7931000,23937000,70345000,23951000,23951000,,-19239000,,,,289000,104437000,80486000,34092000,-15549000,594000,8113000,7311000,54266,WSR
2019-12-31,,,-2249993,,-2289670,2357264,2724696,362019,362019,,-408039,,,,39677,2724696,2362677,0,-2612012,,-2289670,-2289670,54267,RAND
2018-12-31,,,-412810,,-394498,1882672,2106954,224282,224282,,-311000,,,,-18312,2106954,1882672,0,-637092,,-394498,-394498,54267,RAND
2017-12-31,,,-1247575,,-710678,1700702,1454782,-245920,-245920,,-310275,,,,-536897,1454782,1700702,0,-1001655,,-710678,-710678,54267,RAND
2016-12-31,,,-2018594,,-1202683,3051761,1031858,-2058903,-2058903,,-310276,,,,-815911,1031858,3090761,0,40309,,-1202683,-1202683,54267,RAND
2019-12-31,46220000,,-59954000,,-60096000,78691000,79704000,-54419000,-54419000,,-6261000,,,,142000,154941000,209360000,75237000,-5535000,,-60096000,-240922000,54268,HCAT
2018-12-31,38079000,,-62119000,,-61984000,65549000,53059000,-57981000,-57981000,,-2587000,,,,-135000,112574000,170555000,59515000,-4138000,,-61984000,-114021000,54268,HCAT
2017-12-31,28470000,,-47009000,,-47035000,40617000,29439000,-45540000,-45540000,,-2007000,,,,26000,73081000,118621000,43642000,-2934000,,-47035000,-58780000,54268,HCAT
2019-12-31,,,468085742,,468085742,23454443,52341717,28887274,28887274,,-9778,,,,0,52341717,23454443,0,439198468,,468085742,443252243,54269,GDV
2018-12-31,,,-244991758,,-244991758,22529422,59876138,37346716,37346716,,-241,,,,0,59876138,22529422,0,-282338474,,-244991758,-269974393,54269,GDV
2017-12-31,,,363278612,,363278612,26589887,53145634,26555747,26555747,,-295,,,,0,53145634,26589887,0,336722865,,363278612,340267171,54269,GDV
2016-12-31,,,232157565,,232157565,24126023,53626750,29500727,29500727,,-3910,,,,0,53626750,24126023,0,202656838,,232157565,213692896,54269,GDV
2019-12-31,,,32397000,3596000,32397000,40489000,340043000,131311000,131311000,,-76571000,,,,0,481686000,350375000,141643000,-98914000,,32397000,31992000,54272,RPAI
2018-12-31,,,77640000,418000,77640000,40626000,333929000,117326000,117326000,,-73746000,,,,0,482497000,365171000,148568000,-39686000,,77640000,77301000,54272,RPAI
2017-12-31,,,251491000,418000,251491000,41810000,370828000,125152000,125152000,,-146092000,,,,0,538139000,412987000,167311000,126339000,,251491000,237111000,54272,RPAI
2016-12-31,,,166817000,418000,166817000,43609000,412135000,147435000,147435000,-3339000.0,-109730000,,,,0,579804000,432369000,167669000,19382000,,166817000,156922000,54272,RPAI
2020-02-01,,,36328000,,27344000,298548000,383287000,55416000,55416000,,-1014000,,,,8984000,1184234000,1128818000,800947000,-19088000,,27344000,27344000,54273,HIBB
2019-02-02,,,37558000,,28421000,259554000,330646000,44040000,44040000,,-714000,,,,9137000,1008682000,964642000,678036000,-6482000,,28421000,28421000,54273,HIBB
2018-02-03,,,56447000,,35030000,231832000,312717000,56678000,56678000,,-270000,,,,21417000,968219000,911541000,655502000,-231000,,35030000,35030000,54273,HIBB
2017-01-28,,,96496000,,61075000,222785000,338596000,96764000,96764000,,-292000,,,,35421000,972960000,876196000,634364000,-268000,,61075000,61075000,54273,HIBB
2021-01-02,,,835500000,21700000,627000000,1094900000,2010400000,915500000,915500000,,-53800000,,,,189100000,3942200000,3026700000,1931800000,-80000000,,646400000,627000000,54275,SNA
2019-12-28,,,923000000,21700000,693500000,1128800000,2089600000,960800000,960800000,,-48800000,,,,211800000,4067700000,3106900000,1978100000,-37800000,,711200000,693500000,54275,SNA
2018-12-29,,,910600000,19800000,679900000,1140300000,2099900000,959600000,959600000,,-50100000,,,,214400000,4070400000,3110800000,1970500000,-49000000,,696200000,679900000,54275,SNA
2017-12-30,,,823100000,18400000,557700000,1161900000,2043100000,881200000,881200000,,-52100000,,,,250900000,4000300000,3119100000,1957200000,-104000000,,572200000,557700000,54275,SNA
2020-12-31,,,46523000,,35444000,50020000,122435000,0,46523000,25892000,,,,,11079000,122435000,75912000,0,0,,35444000,35444000,54276,BSRR
2019-12-31,,,47718000,,35961000,48391000,118296000,0,47740000,22165000,,,,,11757000,118296000,70556000,0,-22000,,35961000,35961000,54276,BSRR
2018-12-31,,,39584000,,29677000,49176000,109608000,0,40033000,20399000,,,,,9907000,109608000,69575000,0,-449000,,29677000,29677000,54276,BSRR
2017-12-31,,,33179000,,19539000,43610000,98620000,0,35404000,19606000,,,,,13640000,98620000,63216000,0,-2225000,,19539000,19539000,54276,BSRR
2019-12-31,2320573,,-3960592,,-3357876,1614909,0,-3935482,-3935482,,-36658,,,,-602716,0,3935482,0,-25110,,-3357876,-3864869,54277,PCSA
2018-12-31,3085317,,-4667848,,-3765047,1295623,0,-4380940,-4380940,,-161205,,,,-902801,0,4380940,0,-286908,,-3765047,-3765047,54277,PCSA
2017-12-31,964164,,-1856315,,-1856315,779506,0,-1743670,-1743670,,-59063,,,,0,0,1743670,0,-112645,,-1856315,-1856315,54277,PCSA
2016-12-31,1536996,,-1917066,,-1917066,384524,0,-1921520,-1921520,,-59063,,,,0,0,1921520,0,4454,,-1917066,-1917066,54277,PCSA
2019-12-31,,,86719000,,84290000,61063000,393005000,156706000,156706000,-4352000,-79246000,,,,2429000,726991000,570285000,333986000,-69987000,,84290000,81662000,54279,FISK
2018-12-31,,,121895000,,117253000,52674000,391192000,190857000,190857000,-20847000,-79623000,,,,4642000,710664000,519807000,319472000,-68962000,,117253000,115466000,54279,FISK
2017-12-31,,,124926000,,118253000,50315000,390377000,192903000,192903000,-13551000,-68762000,,,,6673000,695975000,503072000,305598000,-67977000,,118253000,116557000,54279,FISK
2016-12-31,,,113396000,,107250000,49078000,380509000,183896000,183896000,-7676000,-70595000,,,,6146000,669677000,485781000,289168000,-70500000,,107250000,105567000,54279,FISK
2020-03-31,,,-6441419,-1812805,-5813369,31901980,25526430,-6375550,-6375550,,-698518,,,,16258,117327689,123703239,91801259,-65869,,-6457677,-5813369,54281,CJJD
2019-03-31,,,-1183006,-1194039,-926278,25984173,25108043,-876130,-876130,,-698518,,,,134763,107551012,108427142,82442969,-306876,,-1317769,-926278,54281,CJJD
2018-03-31,,,-16983677,-1194039,-17059933,36563153,20125169,-16437984,-16437984,,-698518,,,,76256,96112706,112550690,75987537,-545693,,-17059933,-17059933,54281,CJJD
2017-03-31,,,-5559817,-1194039,-5644204,20608054,16626918,-3981136,-3981136,,-1349,,,,84387,81499045,85480181,64872127,-1578681,,-5644204,-5644204,54281,CJJD
2019-12-31,46690000,,121624000,474694000,38820000,200870000,386049000,138489000,138489000,,-16203000,,,,27201000,1701115000,1562626000,1315066000,-16865000,,94423000,38820000,54286,FORTY
2018-12-31,41223000,,101696000,437767000,32365000,182472000,333312000,109617000,109617000,,-12370000,,,,24301000,1492988000,1383371000,1159676000,-7921000,,77395000,32365000,54286,FORTY
2017-12-31,39853000,,52811000,413720000,10352000,182816000,296823000,74154000,74154000,-308000.0,-10532000,,,,13371000,1355139000,1280985000,1058316000,-21343000,,39440000,10352000,54286,FORTY
2016-12-31,22328000,,77263000,427866000,22445000,147953000,258781000,88500000,88500000,-308000.0,-8020000,,,,21163000,1108621000,1020121000,849840000,-11237000,,56100000,22455000,54286,FORTY
2020-12-31,,,672000000,,539000000,1415000000,2405000000,0,698000000,292000000,,,,,133000000,2405000000,1707000000,0,-26000000,,539000000,505000000,54287,ZIONN
2019-12-31,,,1053000000,,816000000,1450000000,2797000000,0,1113000000,234000000,,,,,237000000,2797000000,1684000000,0,-60000000,,816000000,777000000,54287,ZIONN
2018-12-31,,,1143000000,,884000000,1403000000,2821000000,0,1197000000,221000000,,,,,259000000,2821000000,1624000000,0,-54000000,,884000000,845000000,54287,ZIONN
2017-12-31,,,936000000,,592000000,1344000000,2585000000,0,1000000000,241000000,,,,,344000000,2585000000,1585000000,0,-64000000,,592000000,546000000,54287,ZIONN
2020-03-31,,,7644266,303209,6475442,10318253,17983639,7665386,7665386,,,,,,1174618,93024236,85358850,75040597,-21120,,6469648,6475442,54289,JRSH
2019-03-31,,,6372376,309003,5112269,12428435,18777009,6348574,6348574,,,,,,1260861,84983661,78635087,66206652,23802,,5111515,5112269,54289,JRSH
2018-03-31,,,11803279,309604,10410117,6119030,17953678,11834648,11834648,,,,,,1400000,69295698,57461050,51342020,-31369,,10403279,10410117,54289,JRSH
2017-03-31,,,10647781,316597,10692389,4705498,15403597,10698099,10698099,,,,,,0,62040589,51342490,46636992,-50318,,10647781,10692389,54289,JRSH
2019-12-31,12120318,,-15566003,,-15566003,3757251,0,-15879170,-15879170,1601,-7300,,,,0,0,15879170,0,313167,,-15566003,-15566003,54291,OGEN
2018-12-31,5971833,,-9914141,,-9914141,4022307,0,-9995328,-9995328,1188,-5786,,,,0,0,9995328,0,81187,,-9914141,-11326182,54291,OGEN
2017-12-31,3539656,,-6731525,,-6731525,3178662,0,-6721416,-6721416,3098,-216328,,,,0,0,6721416,0,-10109,,-6731525,-6731525,54291,OGEN
2016-12-31,4754650,,-8497316,,-7013304,3787855,0,-8547303,-8547303,4798,-4116,,,,0,0,8547303,0,49987,1484012.0,-8497316,-7013304,54291,OGEN
2019-12-31,,,-4386000,,-4786000,19390000,21255000,673000,673000,,-117000,,,,400000,75504000,74831000,54249000,-5059000,,-4786000,-4786000,54293,WHLM
2018-12-31,,,1189000,,856000,19888000,22251000,1373000,1373000,,-101000,,,,333000,77851000,76478000,55600000,-184000,,856000,856000,54293,WHLM
2017-12-31,,,-521000,,163000,20314000,20921000,-299000,-299000,,-128000,,,,-684000,73196000,73495000,52275000,-222000,,163000,163000,54293,WHLM
2016-12-31,,,910000,,95000,21935000,23546000,1017000,1017000,,-81000,,,,815000,82228000,81211000,58682000,-107000,,95000,95000,54293,WHLM
2019-12-31,,,-917873,,-936423,8287832,10814468,-901767,-901767,,-764754,,,,18550,18997014,19898781,8182546,662042,,-936423,-936423,54294,SDPI
2018-12-31,,,-54735,,-58375,7107432,11167868,300205,300205,,-773680,,,,3640,18245212,17945007,7077344,-354940,,-58375,-58375,54294,SDPI
2017-12-31,,,-6878243,,-6878243,5734315,9635436,224523,224523,,-905990,,,,0,15595659,15371136,5960223,-7102766,,-6878243,-6878243,54294,SDPI
2016-12-31,,,-9130849,,-9128849,5775760,3083194,-6983815,-6983815,,-1613214,,,,-2000,7153063,14136878,4069869,-2147034,,-9128849,-9128849,54294,SDPI
2020-08-31,4007000,,45320000,,34157000,50247000,99547000,45293000,45293000,,-246000,,,,11163000,261162000,215869000,161615000,27000,,34157000,33884000,54296,CCF
2019-08-31,4021000,,43553000,,32711000,49961000,101188000,47206000,47206000,,-519000,,,,10842000,281351000,234145000,180163000,-3653000,,32711000,32454000,54296,CCF
2018-08-31,3940000,,56965000,,43143000,48357000,110122000,57825000,57825000,,-1172000,,,,13822000,284188000,226363000,174066000,-860000,,43143000,42733000,54296,CCF
2017-08-31,3940000,,60892000,,42014000,47736000,106714000,58978000,58978000,,-839000,,,,18878000,252560000,193582000,145846000,1914000,,42014000,41560000,54296,CCF
2019-12-31,,,208855192,,208855192,12560577,19374683,6814106,6814106,,,,,,0,19374683,12560577,0,202041086,,208855192,208855192,54298,ETV
2018-12-31,,,-34146843,,-34146843,11694557,17238571,5544014,5544014,,,,,,0,17238571,11694557,0,-39690857,,-34146843,-34146843,54298,ETV
2017-12-31,,,147549529,,147549529,10312177,16138573,5826396,5826396,,,,,,0,16138573,10312177,0,141723133,,147549529,147549529,54298,ETV
2016-12-31,,,52250772,,52250772,9715943,17296405,7580462,7580462,,,,,,0,17296405,9715943,0,44670310,,52250772,52250772,54298,ETV
2020-02-29,9172,,15173340,,13580791,1427328,16794547,15174815,15174815,,-54,,,,1592549,16898178,1723363,103631,-1475,,13580791,13580791,54300,TRIT
2019-02-28,741619,,-1895578,,-1895578,1146545,0,-1888164,-1888164,,-1677,,,,0,0,1888164,0,-7413,,-1895578,-1895578,54300,TRIT
2020-12-31,,,3530000000,,3064000000,17205000000,40777000000,9421000000,9421000000,,-2730000000,,,,786000000,68397000000,58976000000,27620000000,-5891000000,320000000,2744000000,3064000000,54302,TMUS
2019-12-31,,,4603000000,,3468000000,13519000000,26477000000,6342000000,6342000000,,-1135000000,,,,1135000000,44998000000,38656000000,18521000000,-1739000000,320000000,3468000000,3468000000,54302,TMUS
2018-12-31,,,3917000000,,2888000000,12965000000,24809000000,5358000000,5358000000,,-1357000000,,,,1029000000,43239000000,37881000000,18430000000,-1441000000,320000000,2888000000,2888000000,54302,TMUS
2017-12-31,,,3161000000,,4536000000,12259000000,22896000000,4653000000,4653000000,,-1671000000,,,,-1375000000,40604000000,35951000000,17708000000,-1492000000,320000000,4536000000,4481000000,54302,TMUS
2020-03-31,,,158485000,,87579000,834105000,1528380000,630169000,630169000,,-138778000,,,,70906000,24209870000,23579701000,22681490000,-471684000,,87579000,87579000,54303,FLEX
2019-03-31,,,182126000,,93399000,953077000,1616780000,589307000,589307000,,-145658000,,,,88727000,26210511000,25621204000,24593731000,-407181000,,93399000,93399000,54303,FLEX
2018-03-31,,,520893000,,428534000,1019399000,1662727000,564688000,564688000,,-123098000,,,,92359000,25441131000,24876443000,23778404000,-43795000,,428534000,428534000,54303,FLEX
2017-03-31,,,370848000,33743000.0,319564000,937339000,1652618000,633883000,633883000,,-107978000,,,,51284000,23862934000,23229051000,22210316000,-263035000,,319564000,319564000,54303,FLEX
2019-12-31,1413000,,1131000,,1038000,11436000,13739000,-360000,-360000,,-831000,,,,93000,31598000,31958000,17859000,1491000,,1038000,1038000,54307,CREX
2018-12-31,1257000,,-11018000,,-10620000,9694000,10223000,-1913000,-1913000,,-2606000,,,,-398000,22475000,24388000,12252000,-9105000,,-10620000,-14897000,54307,CREX
2017-12-31,991000,,-6989000,,-6950000,8947000,7389000,-4054000,-4054000,,-1610000,,,,-39000,17698000,21752000,10309000,-2935000,,-6950000,-7196000,54307,CREX
2016-12-31,893000,,-5063000,,-4698000,7454000,6858000,-3492000,-3492000,,-1636000,,,,-365000,13673000,17165000,6815000,-1571000,,-4698000,-5161000,54307,CREX
2019-12-31,,,9800000,,12000000,104400000,198300000,84100000,84100000,9600000,-29100000,,,,-2200000,1186100000,1102000000,987800000,-74300000,,12000000,-8700000,54308,RCM
2018-12-31,,,-56700000,,-45300000,97900000,97900000,-4100000,-4100000,3900000,-26300000,,,,-11400000,868500000,872600000,770600000,-52600000,,-45300000,-64400000,54308,RCM
2017-12-31,,,-27300000,,-58800000,56300000,33500000,-22800000,-22800000,3900000,-26300000,,,,31500000,449800000,472600000,416300000,-4500000,,-58800000,-76500000,54308,RCM
2016-12-31,,,298200000,,177100000,74100000,392900000,305600000,305600000,13200000,-26300000,,,,121100000,592600000,287000000,199700000,-7400000,,177100000,65400000,54308,RCM
2019-12-31,,,17151000,,13532000,16556000,56731000,26541000,26541000,1452000,-1373000,,,,3619000,97465000,70924000,40734000,-9390000,,13532000,13532000,54309,SII
2018-12-31,,,32657000,,31379000,17066000,60935000,28164000,28164000,1148000,-419000,,,,1278000,101583000,73419000,40648000,4493000,,31379000,31379000,54309,SII
2017-12-31,,,43306000,,37532000,23698000,60632000,21268000,21268000,2547000,-419000,,,,5774000,118273000,97005000,57641000,22038000,,37532000,37532000,54309,SII
2016-12-31,,,37843000,,31538000,29485000,89422000,44876000,44876000,1253000,-419000,,,,6305000,168899000,124023000,79477000,-7033000,,31538000,31538000,54309,SII
2020-01-31,199750000,,-142938000,,-144348000,420409000,480687000,-139472000,-139472000,,-2338000,,,,1410000,696264000,835736000,215577000,-3466000,,-144348000,-144348000,54313,BOX
2019-01-31,163750000,,-133214000,,-134612000,405279000,434792000,-134237000,-134237000,,-316000,,,,1398000,608386000,742623000,173594000,1023000,,-134612000,-134612000,54313,BOX
2018-01-31,136791000,,-154245000,,-154960000,388124000,370894000,-154021000,-154021000,,-1013000,,,,715000,506142000,660163000,135248000,-224000,,-154960000,-154960000,54313,BOX
2017-01-31,115928000,,-150873000,,-151787000,322866000,286475000,-152319000,-152319000,,-896000,,,,914000,398605000,550924000,112130000,1446000,,-151787000,-151787000,54313,BOX
2019-12-31,8085522,,-20242630,,-20242630,6077097,0,-14162619,-14162619,,-1767836,,,,0,0,14162619,0,-6080011,,-20242630,-20242630,54317,OCGN
2018-12-31,10321397,,-18219664,,-18219664,5819111,0,-16140508,-16140508,,-3750630,,,,0,0,16140508,0,-2079156,,-18219664,-18219664,54317,OCGN
2017-12-31,4927511,,-7815480,,-7815480,2862013,0,-7789524,-7789524,,-55827,,,,0,0,7789524,0,-25956,,-7815480,-7815480,54317,OCGN
2019-12-31,,,1071401000,254410000,1241226000,,4269867000,1771524000,1771524000,1018327000,-824594000,,,,-169825000,10878673000,9107149000,6608806000,-700123000,,1241226000,1241226000,54318,ETR
2018-12-31,,,-188165000,219402000,848661000,3300000.0,3844937000,1140686000,1140686000,1331509000,-782543000,,,,-1036826000,11009452000,9868766000,7164515000,-1328851000,,848661000,848661000,54318,ETR
2017-12-31,,,954182000,197803000,411612000,5900000.0,4298997000,2011779000,2011779000,891340000,-720953000,,,,542570000,11074481000,9062702000,6775484000,-1057597000,,411612000,411612000,54318,ETR
2016-12-31,,,-1400877000,203185000,-583618000,5300000.0,4403063000,2036406000,2036406000,1014170000,-719660000,,,,-817259000,10845645000,8809239000,6442582000,-3437283000,,-583618000,-583618000,54318,ETR
2019-12-31,,,-36286457,,-36698957,12740093,-24029154,-36769247,-36769247,,,,,,412500,3458331,40227578,27487485,482790,,-36698957,-36698957,54321,CUE
2018-12-31,,,-38155313,,-38980313,11295211,-27401447,-38696658,-38696658,,,,,,825000,1142604,39839262,28544051,541345,,-38980313,-38980313,54321,CUE
2017-12-31,,,-23233835,,-23233835,4333542,-18900328,-23233870,-23233870,,,,,,0,0,23233870,18900328,35,,-23233835,-23233835,54321,CUE
2016-12-31,4841029.0,,-7658283,,-7658283,2817306,0,-7658335,-7658335,,,,,,0,0,7658335,0,52,,-7658283,-7658283,54321,CUE
2019-12-31,,,203140466,,203140466,9070099,16682970,7612871,7612871,,,,,,0,16682970,9070099,0,195527595,,203140466,203140466,54324,CLM
2018-12-31,,,-58178537,,-58178537,8086273,14033562,5947289,5947289,,,,,,0,14033562,8086273,0,-64125826,,-58178537,-58178537,54324,CLM
2017-12-31,,,99043174,,99043174,5412597,10511443,5098846,5098846,,,,,,0,10511443,5412597,0,93944328,,99043174,99043174,54324,CLM
2016-12-31,,,31480357,,31480357,3925506,9171801,5246295,5246295,,,,,,0,9171801,3925506,0,26234062,,31480357,31480357,54324,CLM
2019-12-31,,,-3000000,-1000000,274000000,1783000000,2007000000,224000000,224000000,,-779000000,,,,-273000000,2007000000,1783000000,0,-227000000,,270000000,272000000,54325,COOP
2018-12-31,,,-328800000,3000000,2121600000,1644000000,1425600000,-218400000,-218400000,,-703200000,,,,-2450400000,1425600000,1644000000,1696800000,-110400000,,2121600000,2102400000,54325,COOP
2017-12-31,,,25882000,3000000,25882000,14457000,7753000,-6723000,-6723000,19000.0,-1788000,,,,0,7890000,14613000,137000,32605000,,25882000,2415000,54325,COOP
2016-12-31,,,201700000,3000000,201700000,7043000,5090000,-1284000,-1284000,-669000.0,-2616000,,,,0,5396000,6680000,306000,202984000,,201700000,66926000,54325,COOP
2020-07-31,4639000,,-552512000,3379000,-546489000,91057000,-57975000,-168445000,-168445000,4763000,-10043000,,,,-6023000,80784000,249229000,138759000,-384067000,,-546489000,-546489000,54327,HEXO
2019-07-31,2822000,,-87821000,1000000,-69608000,105146000,24508000,-86974000,-86974000,4763000,-469000,,,,-18213000,47541000,134515000,23033000,-847000,,-69608000,-69608000,54327,HEXO
2018-07-31,2822000,,-23350000,1000000,-23350000,17709000,6401000,-17966000,-17966000,4763000,-1529000,,,,0,4934000,22900000,-1467000,-5384000,,-23350000,-23350000,54327,HEXO
2017-07-31,2822000,,-12417570,1000000,-12417570,6681397,6448195,-1483474,-1483474,4763000,-522618,,,,0,4096841,5580315,-2351354,-10934096,,-12417570,-12417570,54327,HEXO
2020-12-31,,,121173000,,121173000,98280000,772645000,338782000,338782000,,-199988000,,,,0,1053266000,714484000,280621000,-217609000,,121173000,121173000,54329,BRX
2019-12-31,,,274773000,,274773000,102309000,872394000,437654000,437654000,,-189775000,,,,0,1168258000,730604000,295864000,-162881000,,274773000,274124000,54329,BRX
2018-12-31,,,366284000,,366284000,93596000,920722000,464799000,464799000,,-215025000,,,,0,1234340000,769541000,313618000,-98515000,,366284000,365953000,54329,BRX
2017-12-31,,,300369000,,300293000,92247000,968372000,495774000,495774000,,-226660000,,,,0,1283561000,787787000,315189000,-195405000,,300369000,300217000,54329,BRX
2020-12-31,,,260271000,,207463000,558581000,1046339000,487758000,487758000,,-72070000,,,,53030000,5237443000,4749685000,4191104000,-227487000,,207241000,207463000,54331,SON
2019-12-31,23300000.0,,385937000,13023000.0,291785000,523438000,1057829000,511091000,511091000,,-66845000,,,,93269000,5374207000,4863116000,4316378000,-125154000,,292668000,291785000,54331,SON
2018-12-31,23200000.0,,389747000,13192000.0,313560000,525704000,1041006000,492102000,492102000,,-63147000,,,,75008000,5390938000,4898836000,4349932000,-102355000,,314739000,313560000,54331,SON
2017-12-31,21000000.0,,324036000,22994000.0,175345000,518144000,958652000,419508000,419508000,,-57220000,,,,146589000,5036650000,4617142000,4077998000,-95472000,,177447000,175345000,54331,SON
2019-12-31,45000000,,177000000,14000000,225000000,346000000,1007000000,357000000,357000000,7000000,-115000000,,,,-48000000,7277000000,6920000000,6270000000,-180000000,,225000000,225000000,54334,ARNC
2018-12-31,63000000,,241000000,12000000,170000000,288000000,893000000,263000000,263000000,7000000,-129000000,,,,71000000,7442000000,7179000000,6549000000,-22000000,,170000000,170000000,54334,ARNC
2017-12-31,66000000,,251000000,13000000,209000000,361000000,958000000,269000000,269000000,-4000000,-168000000,,,,42000000,6824000000,6555000000,5866000000,-18000000,,209000000,209000000,54334,ARNC
2016-12-31,83000000,,168000000,13000000,155000000,396000000,1059000000,312000000,312000000,11000000,-97000000,,,,13000000,6661000000,6349000000,5602000000,-144000000,,155000000,155000000,54334,ARNC
2019-12-31,,,58458000,,97330000,117727000,509247000,203436000,203436000,,-104681000,,,,-39145000,965485000,762049000,456238000,-144978000,-273000,97603000,95982000,54335,AROC
2018-12-31,,,35310000,,21063000,101563000,440074000,163565000,163565000,,-93328000,,,,6150000,904441000,740876000,464367000,-128255000,-273000,29160000,20248000,54335,AROC
2017-12-31,,,-42619000,-41431000.0,18953000,109370000,375733000,77800000,77800000,,-88760000,,,,-61083000,794655000,716855000,418922000,-120419000,-54000,18464000,18272000,54335,AROC
2016-12-31,,,-89421000,-34038000.0,-54555000,115870000,427150000,103694000,103694000,-1400000.0,-83899000,,,,-24604000,807069000,703375000,379919000,-193115000,-426000,-64817000,-55185000,54335,AROC
2019-12-31,,,13708000,,9292000,,-524000,-10002000,-10002000,,-253000,,,,4416000,183563000,193565000,184087000,23710000,,9292000,9292000,54336,AHC
2018-12-31,,,-22941000,,-25221000,-3818000.0,4509000,-6192000,-6192000,,-4000,,,,2280000,202287000,208479000,197778000,-16749000,,-25221000,-25363000,54336,AHC
2017-12-31,,,3901000,,10161000,-3818000.0,4478000,-6736000,-6736000,,-4000,,,,-6260000,248626000,255362000,244148000,10637000,,10161000,10041000,54336,AHC
2016-12-31,,,-21452000,3904000.0,-19310000,-3818000.0,10555000,-1064000,-1064000,,-4000,,,,-2272000,259984000,261048000,249429000,-20388000,,-19180000,-19450000,54336,AHC
2020-10-31,,,224045746,,224045746,10946049,57708322,46762273,46762273,,-8230634,,,,0,57708322,10946049,0,177283473,,224045746,224045746,54337,CHY
2019-10-31,,,86037688,,86037688,10585675,63061916,52476241,52476241,,-13060944,,,,0,63061916,10585675,0,33561447,,86037688,86037688,54337,CHY
2018-10-31,,,18140568,,18140568,10971092,65816229,54845137,54845137,,-10785076,,,,0,65816229,10971092,0,-36704569,,18140568,18140568,54337,CHY
2017-10-31,,,132378061,,132378061,10426882,60231559,49804677,49804677,,-5538042,,,,0,60231559,10426882,0,82573384,,132378061,132378061,54337,CHY
2020-09-27,,,122121000,,89764000,80841000,312749000,177238000,177238000,1872000,-67273000,,,,32727000,1021506000,844268000,708757000,-55117000,370000,89394000,89764000,54340,JACK
2019-09-29,,,115772000,,94437000,76357000,343366000,206700000,206700000,5128000,-59719000,,,,24025000,950107000,743407000,606741000,-90928000,2690000,91747000,94437000,54340,JACK
2018-09-30,,,186067000,,121371000,104816000,368106000,199065000,199065000,4803000,-45547000,,,,81728000,869690000,670625000,501584000,-12998000,17032000,104339000,121371000,54340,JACK
2017-10-01,,,203905000,,135332000,117280000,401866000,211452000,211452000,5736000,-38148000,,,,75332000,1097291000,885839000,695425000,-7547000,6759000,128573000,135332000,54340,JACK
2020-12-31,,,1577549000,881555000,1405521000,68492000,2830834000,1818135000,1818135000,875176000,-143456000,,,,111838000,8525275000,6707140000,5694441000,-240586000,,1465711000,1363909000,54341,ACGL
2019-12-31,,,1849110000,818181000,1636319000,65667000,2953803000,2005035000,2005035000,800997000,-120872000,,,,155810000,6928200000,4923165000,3974397000,-155925000,,1693300000,1594707000,54341,ACGL
2018-12-31,,,841772000,997852000,757971000,58608000,1755327000,913240000,913240000,677809000,-120484000,,,,113951000,5450568000,4537328000,3695241000,-71468000,,727821000,713616000,54341,ACGL
2017-12-31,,,757277000,1049333000,619278000,61602000,1884471000,1012640000,1012640000,684451000,-117431000,,,,127568000,5627375000,4614735000,3742904000,-255363000,,629709000,566502000,54341,ACGL
2019-12-31,,,-363737000,,-363737000,180861000,4098000,-177677000,-177677000,363000,-23155000,,,,0,454743000,632420000,450645000,-186060000,,-363737000,-363737000,54342,CLOV
2018-12-31,,,-201928000,,-201928000,187282000,1972000,-185797000,-185797000,363000,-6954000,,,,0,281022000,466819000,279050000,-16131000,,-201928000,-201928000,54342,CLOV
2019-12-31,932000,,-8123000,,-8221000,43779000,42516000,-2253000,-2253000,,-5772000,,,,98000,64682000,66935000,22166000,-5870000,,-8221000,-8221000,54343,XTNT
2018-12-31,1702000,,-70099000,,-70099000,45741000,43486000,-7394000,-7394000,,-10145000,,,,0,72203000,79597000,28717000,-62705000,,-70099000,-70099000,54343,XTNT
2017-12-31,2441000,,-52411000,,-52411000,55842000,50101000,-13667000,-13667000,,-14705000,,,,0,82612000,96279000,32511000,-38744000,,-52411000,-52411000,54343,XTNT
2016-12-31,3410600,,-19443190,,-19493552,60085065,62292722,-6143898,-6143898,,-12262750,,,,50362,90002736,96146634,27710014,-13299292,,-19493552,-19493552,54343,XTNT
2020-03-31,,,-1783512,,-1787512,1878021,374819,-1503202,-1503202,,-283095,,,,4000,5557967,7061169,5183148,-280310,,-1787512,-1787512,54344,QLGN
2019-03-31,,,-1195747,,-1200366,1433590,378390,-1055200,-1055200,,-152036,,,,4619,5803044,6858244,5424654,-140547,,-1200366,-1200366,54344,QLGN
2018-03-31,,,-351361,,-356448,1867331,1664696,-202635,-202635,,-60261,,,,5087,9775640,9978275,8110944,-148726,,-356448,-356448,54344,QLGN
2019-12-31,97501000,,-136923000,,-137165000,43391000,-96379000,-139770000,-139770000,,,,,,242000,1122000,140892000,97501000,2847000,,-137165000,-137165000,54345,ADAP
2018-12-31,97501000,,-95017000,,-95514000,43601000,-38764000,-82365000,-82365000,,,,,,497000,59505000,141870000,98269000,-12652000,,-95514000,-95514000,54345,ADAP
2017-12-31,87388000,,-69687000,,-70138000,31106000,-49555000,-80661000,-80661000,,,,,,451000,37833000,118494000,87388000,10974000,,-70138000,-70138000,54345,ADAP
2016-12-31,63789000,,-70687000,,-71579000,23208000,-49591000,-72799000,-72799000,,,,,,892000,14198000,86997000,63789000,2112000,,-71579000,-71579000,54345,ADAP
2020-06-30,,,3360000,,2490000,2758000,6923000,0,3373000,792000,,,,,870000,6923000,3550000,0,-13000,,2490000,2490000,54348,WVFC
2019-06-30,,,3727000,,2795000,2914000,7517000,0,3824000,779000,,,,,932000,7517000,3693000,0,-97000,,2795000,2795000,54348,WVFC
2018-06-30,,,3253000,,2125000,2804000,6966000,0,3361000,801000,,,,,1128000,6966000,3605000,0,-108000,,2125000,2125000,54348,WVFC
2017-06-30,,,2485000,,1637000,2809000,6224000,0,2596000,819000,,,,,848000,6224000,3628000,0,-111000,,1637000,1637000,54348,WVFC
2020-12-31,,,87350000,,64814000,156989000,269543000,0,93935000,18619000,,,,,22536000,269543000,175608000,0,-6585000,,64814000,64814000,54350,TCBK
2019-12-31,,,126822000,,92072000,126591000,311366000,0,125991000,58784000,,,,,34750000,311366000,185375000,0,831000,,92072000,92072000,54350,TCBK
2018-12-31,,,93352000,,68320000,110659000,261639000,0,98579000,52401000,,,,,25032000,261639000,163060000,0,-5227000,,68320000,68320000,54350,TCBK
2017-12-31,,,77512000,,40554000,97925000,223825000,0,78042000,47858000,,,,,36958000,223825000,145783000,0,-530000,,40554000,40554000,54350,TCBK
2019-12-31,29405000,,-42672000,,-42672000,14676000,0,-44081000,-44081000,,,,,,0,0,44081000,0,1409000,,-42672000,-53697000,54351,DBTX
2018-12-31,26168000,,-36163000,,-36163000,11690000,0,-37858000,-37858000,,,,,,0,0,37858000,0,1695000,,-36163000,-45440000,54351,DBTX
2020-06-26,,,119242000,,113479000,64965000,186105000,121140000,121140000,,-3044000,,,,5763000,1641836000,1520696000,1455731000,-1898000,,113479000,113479000,54353,FN
2019-06-28,,,126233000,,120955000,55067000,179224000,124157000,124157000,,-5381000,,,,5278000,1584335000,1460178000,1405111000,2076000,,120955000,120955000,54353,FN
2018-06-29,,,88029000,,84167000,57812000,153412000,95600000,95600000,,-3606000,,,,3862000,1371925000,1276325000,1218513000,-7571000,,84167000,84167000,54353,FN
2017-06-30,,,103857000,,97115000,63926000,171460000,107534000,107534000,,-3321000,,,,6742000,1420490000,1312956000,1249030000,-3677000,,97115000,97115000,54353,FN
2020-12-31,,,2704000000,1000000,2109000000,2163000000,5199000000,2882000000,2882000000,,-206000000,,,,595000000,12574000000,9692000000,7375000000,-178000000,,2109000000,2109000000,54354,ITW
2019-12-31,,,3288000000,4000000,2521000000,2337000000,5922000000,3426000000,3426000000,,-221000000,,,,767000000,14109000000,10683000000,8187000000,-138000000,,2521000000,2521000000,54354,ITW
2018-12-31,,,3394000000,4000000,2563000000,2371000000,6164000000,3604000000,3604000000,,-257000000,,,,831000000,14768000000,11164000000,8604000000,-210000000,,2563000000,2563000000,54354,ITW
2017-12-31,,,3270000000,4000000,1687000000,2403000000,6008000000,3399000000,3399000000,,-260000000,,,,1583000000,14314000000,10915000000,8306000000,-129000000,,1687000000,1687000000,54354,ITW
2019-12-31,2361859000,,4180746000,5351880000,3379330000,5367272000,8496325000,1020826000,1020826000,-253632000,-294076000,,,,546622000,25576204000,24555378000,17079879000,3159920000,,3634124000,3379330000,54357,YY
2018-12-31,1192052000,,2026355000,2856839000,1641958000,2032541000,5795147000,2639690000,2639690000,-69136000,-502506000,,,,477707000,15763557000,13123867000,9968410000,-613335000,,1548648000,1641958000,54357,YY
2017-12-31,781886000,,2904514000,101704000,2493235000,1235922000,4616750000,2663769000,2663769000,-64827000,-32122000,,,,415811000,11594792000,8931023000,6978042000,240745000,,2488703000,2493235000,54357,YY
2016-12-31,598477000,,1792090000,6060000,1523918000,942630000,3145279000,1689017000,1689017000,-84845000,-81085000,,,,280514000,8204050000,6515033000,5058771000,103073000,,1511576000,1523918000,54357,YY
2020-12-31,,,340244000,,261988000,466690000,938249000,0,361247000,110312000,,,,,78256000,938249000,577002000,0,-21003000,,261988000,261988000,54358,ABCB
2019-12-31,,,211584000,,161441000,321608000,673917000,0,300764000,51545000,,,,,50143000,673917000,373153000,0,-89180000,,161441000,161441000,54358,ABCB
2018-12-31,,,151490000,,121027000,220605000,439604000,0,180409000,38590000,,,,,30463000,439604000,259195000,0,-28919000,,121027000,121027000,54358,ABCB
2017-12-31,,,124282000,,73548000,192207000,354954000,0,132207000,30540000,,,,,50734000,354954000,222747000,0,-7925000,,73548000,73548000,54358,ABCB
2019-12-31,177268000,,226459000,,176724000,630564000,953007000,145175000,145175000,,,,,,49735000,1151637000,1006462000,198630000,81284000,,176724000,126505000,54359,SY
2018-12-31,94726000,,58254000,,55083000,381802000,525663000,49135000,49135000,,,,,,3171000,617226000,568091000,91563000,9119000,,55083000,-49128000,54359,SY
2017-12-31,32557000,,13221000,,17202000,157187000,214506000,24762000,24762000,,,,,,-3981000,259305000,234543000,44799000,-11541000,,17202000,-11319000,54359,SY
2016-12-31,17932000,,-81036000,,-81036000,80249000,23898000,-74283000,-74283000,,,,,,0,49090000,123373000,25192000,-6753000,,-81036000,-102523000,54359,SY
2019-12-31,23194000,,-25908000,,-25908000,3071000,0,-26265000,-26265000,,,,,,0,0,26265000,0,357000,,-25908000,-25908000,54360,ATXI
2018-12-31,17696000,,-21548000,,-21548000,4120000,0,-21816000,-21816000,,,,,,0,0,21816000,0,268000,,-21548000,-21548000,54360,ATXI
2017-12-31,7801000,,-12258000,,-12258000,3620000,0,-11421000,-11421000,,-375000.0,,,,0,0,11421000,0,-837000,,-12258000,-12258000,54360,ATXI
2016-12-31,1380000,,-3177000,,-3177000,997000,0,-2377000,-2377000,,-612000.0,,,,0,0,2377000,0,-800000,,-3177000,-3177000,54360,ATXI
2020-03-31,27555000,,340866000,,276142000,736618000,1103673000,339500000,339500000,,-5046000,,,,64724000,2132689000,1793189000,1029016000,1366000,,276142000,276142000,54362,DECK
2019-03-31,23187000,,328934000,,264308000,689268000,1040250000,327795000,327795000,,-4661000,,,,64626000,2020437000,1692642000,980187000,1139000,,264308000,264308000,54362,DECK
2018-03-31,22372000,,220696000,,114394000,682602000,931642000,226668000,226668000,,-4585000,,,,106302000,1903339000,1676671000,971697000,-5972000,,114394000,114394000,54362,DECK
2017-03-31,21256000,,-6986000,,5710000,659748000,835235000,154231000,154231000,,-7319000,,,,-12696000,1790147000,1635916000,954912000,-161217000,,5710000,5710000,54362,DECK
2020-12-31,,,57918000,,39466000,64724000,132436000,0,58493000,9219000,,,,,18452000,132436000,73943000,0,-575000,,39466000,39466000,54366,MCB
2019-12-31,,,44061000,,30134000,52191000,104016000,0,43810000,8015000,,,,,13927000,104016000,60206000,0,251000,,30134000,29686000,54366,MCB
2018-12-31,,,36775000,,25554000,37630000,80246000,0,36775000,5841000,,,,,11221000,80246000,43471000,0,0,,25554000,25386000,54366,MCB
2017-12-31,,,23578000,,12369000,26095000,56323000,0,23578000,6650000,,,,,11209000,56323000,32745000,0,-1067000,,12369000,12186000,54366,MCB
2019-12-31,44875000,,-62717000,,-62717000,23663000,9636000,-61112000,-61112000,2210000,-5296000,,,,0,9636000,70748000,0,-1605000,,-62717000,-62717000,54370,ALBO
2018-12-31,31332000,,-46091000,,-46111000,18461000,12740000,-37904000,-37904000,851000,-4838000,,,,20000,12740000,50644000,0,-8187000,,-46111000,-46111000,54370,ALBO
2017-12-31,12597000,,-24202000,,-24414000,15640000,1000,-28077000,-28077000,-159000,-4838000,,,,212000,1000,28078000,0,3875000,,-24414000,-24414000,54370,ALBO
2016-12-31,7955000,,-16288000,,-16350000,10288000,11364000,-6674000,-6674000,-205000,-1319000,,,,62000,11364000,18038000,0,-9614000,,-16350000,-16350000,54370,ALBO
2019-12-31,,,19737000,,19498000,14086000,43125000,29039000,29039000,,-8330000,,,,239000,43125000,14086000,0,-9302000,,19498000,19498000,54373,HRZN
2018-12-31,,,13044000,,13010000,10827000,31090000,20263000,20263000,,-6363000,,,,34000,31090000,10827000,0,-7219000,,13010000,13010000,54373,HRZN
2017-12-31,,,9616000,,9591000,8288000,25777000,17489000,17489000,,-5167000,,,,25000,25777000,8288000,0,-7873000,,9591000,9591000,54373,HRZN
2016-12-31,,,-5000000,,-4913000,10094000,32984000,22890000,22890000,,-5878000,,,,-87000,32984000,10094000,0,-27890000,,-4913000,-4913000,54373,HRZN
2020-12-31,,,80945000,,60122000,89929000,181664000,0,84512000,7223000,,,,,20476000,181664000,97152000,0,-3567000,,60469000,60122000,54375,NCBS
2019-12-31,,,71446000,728000.0,54641000,84460000,168245000,0,77918000,5567000,,,,,16458000,168245000,90327000,0,-6472000,,54988000,54641000,54375,NCBS
2018-12-31,,,54799000,743000.0,41036000,78288000,144557000,0,60288000,5781000,,,,,13446000,144557000,84269000,0,-5489000,,41353000,41036000,54375,NCBS
2017-12-31,,,49700000,701000.0,33150000,71181000,131056000,0,54395000,5480000,,,,,16267000,131056000,76661000,0,-5195000,,33433000,33150000,54375,NCBS
2020-12-31,,,6000000,,6200000,324300000,476000000,53400000,53400000,,-44900000,,,,-200000,1454100000,1400700000,978100000,-47400000,,6200000,1300000,54376,DSKE
2019-12-31,,,-362000000,,-307400000,348000000,517600000,3900000,3900000,19200000.0,-52700000,,,,-54600000,1737000000,1733100000,1219400000,-365900000,,-307400000,-312400000,54376,DSKE
2018-12-31,,,-21100000,,-5200000,292500000,476000000,35200000,35200000,17200000.0,-45500000,,,,-15900000,1613100000,1577900000,1137100000,-56300000,,-5200000,-10100000,54376,DSKE
2017-12-31,,,-25300000,,27000000,179700000,277300000,9700000,9700000,11000000.0,-33400000,,,,-52300000,846300000,836600000,569000000,-35000000,,27000000,22000000,54376,DSKE
2019-12-31,,,-55572000,,-55572000,22391000,-35815000,-58206000,-58206000,,,,,,0,5777000,63983000,41592000,2634000,,-55572000,-55572000,54377,HARP
2018-12-31,26368000.0,,-27366000,,-27366000,6106000,-21618000,-27724000,-27724000,,,,,,0,4750000,32474000,26368000,358000,,-27366000,-27366000,54377,HARP
2017-12-31,26368000.0,,-16830000,,-16830000,3614000,-12914000,-16528000,-16528000,,-285000.0,,,,0,708000,17236000,13622000,-302000,,-16830000,-16830000,54377,HARP
2016-12-31,26368000.0,,-11406000,,-11406000,3369000,-7778000,-11147000,-11147000,,-261000.0,,,,0,0,11147000,7778000,-259000,,-11406000,-11406000,54377,HARP
2019-12-31,6400000,,-12884000,7334000,-20892000,182287000,248573000,59886000,59886000,,-14002000,,,,6564000,1213935000,1154049000,965362000,-72770000,,-19448000,-20892000,54378,AEGN
2018-12-31,5600000,,2955000,7450000,2928000,201040000,268807000,62167000,62167000,,-17327000,,,,-132000,1333568000,1271401000,1064761000,-59212000,,3087000,2928000,54378,AEGN
2017-12-31,4200000,,-61577000,10810000,-69401000,211089000,284857000,69568000,69568000,,-16001000,,,,5005000,1359019000,1289451000,1074162000,-131145000,,-66582000,-69401000,54378,AEGN
2016-12-31,4700000,,35234000,7683000,29453000,186719000,257805000,66386000,66386000,,-15029000,,,,6109000,1221920000,1155534000,964115000,-31152000,,29125000,29453000,54378,AEGN
2019-12-31,,,-1125000,,-1147000,2909000,1082000,-1827000,-1827000,,,,,,22000,3526000,5353000,2444000,702000,,-1147000,-1147000,54380,RBCN
2018-12-31,122000.0,,987000,,963000,2626000,16000,-2732000,-2732000,,,,,,24000,3878000,6610000,3862000,3719000,,963000,963000,54380,RBCN
2017-12-31,962000.0,,-17763000,,-17851000,4827000,-5508000,-11297000,-11297000,,,,,,88000,5044000,16341000,10552000,-6466000,,-17851000,-17851000,54380,RBCN
2016-12-31,2550000.0,,-63102000,,-62879000,9139000,-11908000,-23597000,-23597000,,-99000.0,,,,-223000,19630000,43227000,31538000,-39505000,,-62879000,-62879000,54380,RBCN
2019-12-31,,,88000000,1000000,109000000,308000000,691000000,-7000000,-7000000,,-197000000,,,,5000000,1666000000,1673000000,975000000,95000000,26000000,83000000,109000000,54382,MAXR
2018-12-31,,,-921000000,1000000,-1250000000,407000000,716000000,-152000000,-152000000,,-200000000,,,,-48000000,1804000000,1956000000,1088000000,-769000000,-377000000,-873000000,-1250000000,54382,MAXR
2017-12-31,,,-224000000,1000000,60000000,275000000,333000000,-94000000,-94000000,,-74000000,,,,-168000000,1257000000,1351000000,924000000,-130000000,116000000,-56000000,60000000,54382,MAXR
2016-12-31,,,67000000,1000000,68000000,227000000,402000000,103000000,103000000,,-31000000,,,,-1000000,1558000000,1455000000,1156000000,-36000000,116000000,68000000,68000000,54382,MAXR
2020-12-31,74000000,,2251000000,369000000,1985000000,464000000,1293000000,734000000,734000000,-1000000,-109000000,,,,247000000,5655000000,4921000000,4362000000,1517000000,-12000000,2004000000,1985000000,54385,CE
2019-12-31,67000000,,988000000,391000000,852000000,502000000,1606000000,1013000000,1013000000,114000000,-115000000,,,,124000000,6297000000,5284000000,4691000000,-25000000,-6000000,864000000,852000000,54385,CE
2018-12-31,72000000,,1510000000,395000000,1207000000,606000000,1972000000,1270000000,1270000000,114000000,-125000000,,,,292000000,7155000000,5885000000,5183000000,240000000,-5000000,1218000000,1207000000,54385,CE
2017-12-31,73000000,,1075000000,412000000,843000000,451000000,1511000000,967000000,967000000,114000000,-122000000,,,,213000000,6140000000,5173000000,4629000000,108000000,-13000000,862000000,843000000,54385,CE
2019-12-31,38948,,-2522694,,-2522694,2414889,94628,-2359209,-2359209,,-501,,,,0,296677,2655886,202049,-163485,,-2522694,-2522694,54389,UAVS
2018-12-31,38948,,-2079683,,-2079683,2106732,46133,-2060599,-2060599,,-32417,,,,0,107813,2168412,61680,-19084,,-2079683,-2079683,54389,UAVS
2017-12-31,38948,,-797215,,-797215,689539,22676,-666863,-666863,,-142810,,,,0,116035,782898,93359,-130352,,-797215,-797215,54389,UAVS
2016-12-31,7019,,-1812515,,-1812515,1668526,35080,-1640465,-1640465,,-53575,,,,0,373324,2013789,338244,-172050,,-1812515,-1812515,54389,UAVS
2019-12-31,545000,,-188000,,-135000,2961000,3336000,-170000,-170000,,-22000,,,,4000,5193000,5363000,1857000,-18000,57000,-192000,-135000,54390,MTSL
2018-12-31,825000,,-840000,,-1170000,3710000,3712000,-823000,-823000,,-8000,,,,46000,5861000,6684000,2149000,-17000,-284000,-886000,-1170000,54390,MTSL
2017-12-31,1645000,,-411000,,-1768000,3495000,4715000,-425000,-425000,,-69000,,,,-9000,6773000,7198000,2058000,14000,-1366000,-402000,-1768000,54390,MTSL
2016-12-31,1754000,,-881000,,-5221000,3972000,4843000,-883000,-883000,,-8000,,,,63000,7551000,8434000,2708000,2000,-4277000,-944000,-5221000,54390,MTSL
2019-12-27,,,31027000,,23277000,62042000,97616000,35574000,35574000,,-311000,,,,7744000,260837000,225263000,163221000,-4547000,-6000,23283000,23277000,54391,HCKT
2018-12-28,,,32936000,,23909000,64123000,101094000,36971000,36971000,,-638000,,,,5577000,264523000,227552000,163429000,-4035000,-3450000,27359000,23909000,54391,HCKT
2017-12-29,,,28120000,,27354000,62893000,97365000,34472000,34472000,,-584000,,,,2564000,255131000,220659000,157766000,-6352000,1798000,25556000,27354000,54391,HCKT
2016-12-30,,,33130000,,21541000,60079000,94810000,34731000,34731000,,-387000,,,,12455000,252096000,217365000,157286000,-1601000,866000,20675000,21541000,54391,HCKT
2019-12-31,,,39576000,,31816000,69312000,149874000,40175000,40175000,25512000,,,,,7760000,249166000,208991000,99292000,-599000,,31816000,31816000,54394,MCRI
2018-12-31,,,42649000,,34098000,65802000,145557000,42826000,42826000,22312000,-177000.0,,,,8551000,240315000,197489000,94758000,-177000,,34098000,34098000,54394,MCRI
2017-12-31,,,39699000,,25538000,62719000,140121000,40666000,40666000,21604000,-967000.0,,,,14161000,230726000,190060000,90605000,-967000,,25538000,25538000,54394,MCRI
2016-12-31,,,37932000,,24574000,57730000,132090000,39225000,39225000,20300000,-616000.0,,,,13358000,217032000,177807000,84942000,-1293000,,24574000,24574000,54394,MCRI
2020-02-01,,,137707000,,104429000,368008000,499505000,131497000,131497000,,,,,,33278000,900254000,768757000,400749000,6210000,,104429000,104429000,54395,BKE
2019-02-02,,,126644000,,95608000,245145000,366073000,120928000,120928000,,,,,,31036000,885496000,764568000,519423000,7966000,,95608000,95608000,54395,BKE
2018-02-03,,,139485000,,89707000,245945000,380023000,134078000,134078000,,,,,,49778000,913380000,779302000,533357000,7851000,,89707000,89707000,54395,BKE
2017-01-28,,,156271000,,97961000,315847000,468607000,152760000,152760000,,,,,,58310000,974873000,822113000,506266000,3511000,,97961000,97961000,54395,BKE
2019-12-31,,,253778000,,190995000,391658000,681267000,289609000,289609000,,-37823000,,,,62783000,2624121000,2334512000,1942854000,-35831000,,190995000,190995000,54396,BLD
2018-12-31,,,180824000,,134752000,346099000,576152000,230053000,230053000,,-28687000,,,,46072000,2384249000,2154196000,1808097000,-49229000,,134752000,134752000,54396,BLD
2017-12-31,,,128040000,,158133000,294245000,461109000,166864000,166864000,,-8019000,,,,-30093000,1906266000,1739402000,1445157000,-38824000,,158133000,158133000,54396,BLD
2016-12-31,,,116273000,,72606000,278740000,400344000,121604000,121604000,,-5608000,,,,43667000,1742850000,1621246000,1342506000,-5331000,,72606000,72606000,54396,BLD
2019-12-31,,,170274000,171417000,128628000,122102000,351543000,0,189503000,32428000,,,,,15036000,402092000,212589000,50549000,-19229000,,155238000,121074000,54397,ABR
2018-12-31,,,157782000,170328000,115866000,110470000,326505000,0,176515000,32067000,,,,,9731000,374010000,197495000,47505000,-18733000,,148051000,108312000,54397,ABR
2017-12-31,,,110868000,168731000,73389000,98799000,231660000,0,122535000,2941000,,,,,13359000,272880000,150345000,41220000,-11667000,,97509000,65835000,54397,ABR
2016-12-31,,,63306000,159897000,50350000,51247000,140346000,0,48942000,35135000,,,,,825000,171434000,122492000,31088000,14364000,,62481000,42796000,54397,ABR
2020-08-30,,,5367000000,421000000,4002000000,15852000000,21930000000,6023000000,6023000000,,-160000000,,,,1308000000,166761000000,160738000000,144831000000,-656000000,,4059000000,4002000000,54398,COST
2019-09-01,,,4765000000,341000000,3659000000,14994000000,19817000000,4737000000,4737000000,,-150000000,,,,1061000000,152703000000,147966000000,132886000000,28000000,,3704000000,3659000000,54398,COST
2018-09-02,,,4442000000,304000000,3134000000,13876000000,18424000000,4480000000,4480000000,,-159000000,,,,1263000000,141576000000,137096000000,123152000000,-38000000,,3179000000,3134000000,54398,COST
2017-09-03,,,4039000000,301000000,2679000000,12950000000,17143000000,4111000000,4111000000,,-134000000,,,,1325000000,129025000000,124914000000,111882000000,-72000000,,2714000000,2679000000,54398,COST
2019-12-31,51791000,,-70252000,,-70252000,17113000,0,-68904000,-68904000,,-3406000,,,,0,0,68904000,0,-1348000,,-70252000,-70252000,54399,EIGR
2018-12-31,37091000,,-52391000,,-52391000,13956000,0,-51047000,-51047000,,-2329000,,,,0,0,51047000,0,-1344000,,-52391000,-52391000,54399,EIGR
2017-12-31,29519000,,-42448000,,-42448000,12001000,0,-41520000,-41520000,,-1524000,,,,0,0,41520000,0,-928000,,-42448000,-42448000,54399,EIGR
2016-12-31,33014000,,-47087000,,-47087000,13106000,0,-46120000,-46120000,,-690000,,,,0,0,46120000,0,-967000,,-47087000,-47087000,54399,EIGR
2019-12-31,6645417,,-17239777,,-17239777,10620008,0,-17265425,-17265425,,,,,,0,0,17265425,0,25648,,-17239777,-17239777,54400,ATOS
2018-12-31,4209981,,-11404934,,-11404934,7224252,0,-11434233,-11434233,,,,,,0,0,11434233,0,29299,,-11404934,-22884242,54400,ATOS
2017-12-31,2328087,,-8122581,,-8122581,4859369,0,-7187456,-7187456,,,,,,0,0,7187456,0,-935125,,-8122581,-10690713,54400,ATOS
2016-12-31,770427,,-6368885,,-6368885,6479193,0,-7249620,-7249620,,,,,,0,0,7249620,0,880735,,-6368885,-6368885,54400,ATOS
2020-11-30,,,80289990,,80289990,5724769,29615614,23661935,23661935,228910,-2967172,,,,0,29615614,5953679,0,56628055,,80289990,80289990,54401,WIW
2019-11-30,,,74387673,,74387673,5386771,37588986,32202215,32202215,228910,-9700385,,,,0,37588986,5386771,0,42185458,,74387673,74387673,54401,WIW
2018-11-30,,,-24416640,,-24416640,6964217,38874106,31909889,31909889,228910,-6193750,,,,0,38874106,6964217,0,-56326529,,-24416640,-24416640,54401,WIW
2017-11-30,,,51130802,,51130802,7728113,34439458,26711345,26711345,228910,-2869779,,,,0,34439458,7728113,0,24419457,,51130802,51130802,54401,WIW
2020-12-31,,,587804000,,511109000,511190000,1098994000,0,587804000,,,,,,76695000,1098994000,511190000,0,0,,511109000,478281000,54402,NYCB
2019-12-31,,,523307000,,395043000,511218000,1034525000,0,523307000,,,,,,128264000,1034525000,511218000,0,0,,395043000,357882000,54402,NYCB
2018-12-31,,,557669000,,422417000,546628000,1104297000,0,557669000,,,,,,135252000,1104297000,546628000,0,0,,422417000,384718000,54402,NYCB
2017-12-31,,,668215000,,466201000,641218000,1309641000,0,668423000,,,,,,202014000,1309641000,641218000,0,-208000,,466201000,438026000,54402,NYCB
2020-10-31,4797000,,-89061000,,-89107000,28544000,-3208000,-36849000,-36849000,300000,-15594000,,,,46000,70871000,107720000,74079000,-52212000,,-89107000,-92438000,54408,FCEL
2019-10-31,13786000,,-77459000,,-77568000,31674000,-969000,-46629000,-46629000,200000,-11223000,,,,109000,60752000,107381000,61721000,-30830000,,-77568000,-100245000,54408,FCEL
2018-10-31,22817000,,-50349000,,-47334000,24408000,3093000,-44632000,-44632000,500000,-9055000,,,,-3015000,89437000,134069000,86344000,-5717000,,-47334000,-62168000,54408,FCEL
2017-10-31,20398000,,-53859000,,-53903000,25416000,2734000,-43580000,-43580000,500000,-9171000,,,,44000,95666000,139246000,92932000,-10279000,,-53903000,-57103000,54408,FCEL
2019-12-31,,,179628000,1254285000,46281000,7489000,283574000,193185000,193185000,4722000,-21076000,,,,-41582000,283574000,90389000,0,-13557000,,221210000,46281000,54410,VNOM
2018-12-31,,,190512000,694940000,143958000,7955000,275024000,202857000,202857000,5382000,-13849000,,,,-72365000,275024000,72167000,0,-12345000,,262877000,143958000,54410,VNOM
2017-12-31,,,111478000,694940000,111478000,6296000,160636000,113821000,113821000,5382000,-3164000,,,,0,172033000,58212000,11397000,-2343000,,111478000,111478000,54410,VNOM
2016-12-31,,,-10899000,694940000,-10899000,5209000,73187000,38158000,38158000,5382000,-2455000,,,,0,79146000,40988000,5959000,-49057000,,-10899000,-10899000,54410,VNOM
2019-12-31,,,-992700000,1686800000,-1119300000,598800000,1646000000,444600000,444600000,-14400000,-216000000,,,,6900000,6038500000,5593900000,4392500000,-1437300000,,-999600000,-1105800000,54411,ENLC
2018-12-31,,,-14600000,3254600000,-13200000,582600000,1685800000,531100000,531100000,-5200000,-182300000,,,,18200000,7693800000,7162700000,6008000000,-545700000,,-32800000,-13000000,54411,ENLC
2017-12-31,,,123200000,3639100000,212800000,547300000,1382300000,285500000,285500000,4200000,-190400000,,,,-196800000,5743800000,5458300000,4361500000,-162300000,,320000000,210000000,54411,ENLC
2016-12-31,,,-883600000,3389900000,-460000000,516600000,1248000000,216400000,216400000,11100000,-189500000,,,,4600000,4263500000,4047100000,3015500000,-1100000000,,-888200000,-454600000,54411,ENLC
2019-12-31,,,33183000,,24333000,132730000,171312000,38582000,38582000,,-4891000,,,,8968000,515698000,477116000,344386000,-5399000,118000,24215000,24333000,54412,MYE
2018-12-31,,,1389000,,-3349000,139335000,179412000,29754000,29754000,10323000.0,-6159000,,,,3037000,566735000,536981000,387323000,-28365000,-1701000,-1648000,-3349000,54412,MYE
2017-12-31,,,15708000,,-9889000,134503000,164942000,30439000,30439000,10323000.0,-8653000,,,,4864000,547043000,516604000,382101000,-14731000,-20733000,10844000,-9889000,54412,MYE
2016-12-31,,,18719000,,1057000,132579000,161898000,29319000,29319000,10323000.0,-9905000,,,,7395000,534379000,505060000,372481000,-10600000,-10267000,11324000,1057000,54412,MYE
2020-12-31,,,71515000,880685000,64266000,49885000,842077000,150801000,150801000,22762000,-153516000,,,,2545000,1260009000,1109208000,417932000,-79286000,,68970000,60036000,54414,UDR
2019-12-31,,,203417000,1049437000,184965000,58033000,803910000,224022000,224022000,13932000,-170917000,,,,3838000,1159966000,935944000,356056000,-20605000,,199579000,180861000,54414,UDR
2018-12-31,,,222230000,989892000,203106000,60983000,665949000,164487000,164487000,4800000,-134168000,,,,688000,990704000,826217000,324755000,57743000,,221542000,199238000,54414,UDR
2017-12-31,,,132415000,957702000,121558000,60966000,720374000,220086000,220086000,2860000,-128711000,,,,-240000,1027048000,806962000,306674000,-87671000,,132655000,117850000,54414,UDR
2019-12-31,116752000,,116220000,,108318000,275930000,504878000,112196000,112196000,,,,,,7902000,661058000,548862000,156180000,4024000,,108318000,108318000,54415,TTD
2018-12-31,83892000,,105737000,,88140000,171981000,363196000,107323000,107323000,,-1550000.0,,,,17597000,477294000,369971000,114098000,-1586000,,88140000,88140000,54415,TTD
2017-12-31,52806000,,63625000,,50798000,119825000,241987000,69356000,69356000,,-1698000.0,,,,12827000,308217000,238861000,66230000,-5731000,,50798000,50798000,54415,TTD
2016-12-31,27313000,,43834000,,20482000,78219000,163050000,57518000,57518000,,-3075000.0,,,,23352000,202926000,145408000,39876000,-13684000,,20482000,-26727000,54415,TTD
2019-12-31,1345513,,371448,,-75277,7997686,9713691,370492,370492,,,,,,446725,18711923,18341431,8998232,956,,-75277,-75277,54416,VTSI
2018-12-31,1357982,,1128090,,818092,8425144,11049840,1266714,1266714,,,,,,309998,18080126,16813412,7030286,-138624,,818092,818092,54416,VTSI
2017-12-31,1285064,,756990,,3262282,7641765,10233346,1306517,1306517,,,,,,-2505292,16524225,15217708,6290879,-549527,,3262282,3262282,54416,VTSI
2016-12-31,1084590,,2152774,,2050022,6431194,9682110,2166326,2166326,,,,,,102752,15652168,13485842,5970058,-13552,,2050022,2050022,54416,VTSI
2019-12-31,8407000,,-14565000,,-14565000,32036000,26284000,-14159000,-14159000,,-406000,,,,0,139375000,153534000,113091000,-406000,,-14565000,-14565000,54417,ASPN
2018-12-31,6319000,,-34440000,,-34440000,32910000,12669000,-26560000,-26560000,,-524000,,,,0,104361000,130921000,91692000,-7880000,,-34440000,-34440000,54417,ASPN
2017-12-31,6180000,,-19321000,,-19321000,31627000,18671000,-19136000,-19136000,,-185000,,,,0,111631000,130767000,92960000,-185000,,-19321000,-19321000,54417,ASPN
2016-12-31,5306000,,-12023000,,-12023000,29225000,23311000,-11220000,-11220000,,-147000,,,,0,117738000,128958000,94427000,-803000,,-12023000,-12023000,54417,ASPN
2019-12-31,,,15200000,,10013000,138810000,176454000,22048000,22048000,,,,,,5187000,286270000,264222000,109816000,-6848000,,10013000,10013000,54418,APEI
2018-12-31,,,34926000,,25639000,134298000,185207000,33408000,33408000,,,,,,9287000,297687000,264279000,112480000,1518000,,25639000,25639000,54418,APEI
2017-12-31,,,32614000,,21121000,130059000,185787000,36952000,36952000,,,,,,11493000,299248000,262296000,113461000,-4338000,,21121000,21121000,54418,APEI
2016-12-31,,,39095000,,24155000,130289000,198654000,48981000,48981000,,,,,,14940000,313139000,264158000,114485000,-9886000,,24155000,24155000,54418,APEI
2019-12-31,11325000,,-79483000,,-79483000,8242000,-7734000,-26832000,-26832000,-469000,-49708000,,,,0,496000,27328000,8230000,-52651000,,-79483000,-79483000,54419,EOSE
2018-12-31,14574000,,-28498000,,-28498000,7686000,-9180000,-32858000,-32858000,1418000,-144000,,,,0,0,32858000,9180000,4360000,,-28498000,-28498000,54419,EOSE
2020-12-31,,,-221000000,,-127000000,236000000,527000000,75000000,75000000,-7000000,-58000000,,,,-76000000,3652000000,3577000000,3125000000,-296000000,18000000,-145000000,-127000000,54421,UFS
2019-12-31,,,86000000,,84000000,460000000,995000000,241000000,241000000,2000000,-49000000,,,,2000000,5220000000,4979000000,4225000000,-155000000,18000000,84000000,84000000,54421,UFS
2018-12-31,,,340000000,,283000000,427000000,1152000000,411000000,411000000,6000000,-60000000,,,,57000000,5455000000,5044000000,4303000000,-71000000,18000000,283000000,283000000,54421,UFS
2017-12-31,,,-383000000,,-258000000,436000000,1003000000,246000000,246000000,6000000,-63000000,,,,-125000000,5148000000,4902000000,4145000000,-629000000,18000000,-258000000,-258000000,54421,UFS
2019-12-31,,,402255000,,318728000,61088000,469252000,399694000,399694000,-436000,,,,,83527000,490060000,90366000,20808000,2561000,,318728000,318728000,54427,TPL
2018-12-31,,,261750000,,209736000,25515000,288560000,260954000,260954000,-492000,,,,,52014000,299728000,38774000,11168000,796000,,209736000,209736000,54427,TPL
2017-12-31,,,145061000,,97231000,8790000,153640000,144977000,144977000,-503000,,,,,47830000,154131000,9154000,491000,84000,,97231000,97231000,54427,TPL
2016-12-31,,,62896000,,42275000,3199000,65611000,62867000,62867000,-498000,,,,,20621000,65611000,2744000,0,29000,,42275000,42275000,54427,TPL
2020-12-31,3965000,,-39531000,206000,-53169000,145344000,520075000,112907000,112907000,38324000,-37363000,,,,13666000,1800073000,1687166000,1279998000,-152438000,,-53197000,-53169000,54428,CCJ
2019-12-31,6058000,,135018000,238000,74000000,124869000,671298000,227415000,227415000,23521000,-61068000,,,,61077000,1862925000,1635510000,1191627000,-92397000,,73941000,74000000,54428,CCJ
2018-12-31,1757000,,39929000,310000,166323000,127552000,836232000,275370000,275370000,83297000,-71007000,,,,-126306000,2091661000,1816291000,1255429000,-235441000,,166235000,166323000,54428,CCJ
2017-12-31,5660000,,-207237000,371000,-204942000,163095000,804930000,184808000,184808000,43000,-77225000,,,,-2519000,2156852000,1972044000,1351922000,-392045000,,-204718000,-204942000,54428,CCJ
2020-12-31,,,12595000,,10099000,29015000,49818000,0,13252000,7551000,,,,,2496000,49818000,36566000,0,-657000,,10099000,10099000,54430,FCCO
2019-12-31,,,13829000,,10971000,26564000,48728000,0,14860000,7304000,,,,,2858000,48728000,33868000,0,-1031000,,10971000,10971000,54430,FCCO
2018-12-31,,,13923000,,11229000,24327000,45944000,0,14917000,6700000,,,,,2694000,45944000,31027000,0,-994000,,11229000,11229000,54430,FCCO
2017-12-31,,,9145000,,5815000,21789000,38950000,0,11356000,5805000,,,,,3330000,38950000,27594000,0,-2211000,,5815000,5815000,54430,FCCO
2019-12-31,,,-49071000,59324000,-159403000,12900000,57705000,44805000,44805000,,-54760000,,,,-8695000,101576000,56771000,43871000,-93876000,-125063000,-40376000,-159403000,54431,SQBG
2018-12-31,,,-13906000,70726000,-10484000,11800000,84167000,72367000,72367000,,-55464000,,,,-1944000,127290000,54923000,43123000,-86273000,6984000,-11962000,-10484000,54431,SQBG
2017-12-31,,,-330584000,71547000,-185718000,6200000,83928000,77728000,77728000,,-59000000,,,,-44423000,124780000,47052000,40852000,-408312000,104615000,-286161000,-185718000,54431,SQBG
2016-12-31,,,15788000,74813000,-821000,9600000,86736000,77136000,77136000,,-50538000,,,,9157000,155528000,78392000,68792000,-61348000,104615000,6631000,-821000,54431,SQBG
2019-12-31,,,-234383000,,-235259000,325638000,79093000,-246545000,-246545000,,,,,,876000,339076000,585621000,259983000,12162000,,-235259000,-235259000,54432,ACAD
2018-12-31,,,-243936000,,-245192000,265758000,18314000,-247444000,-247444000,,,,,,1256000,223807000,471251000,205493000,3508000,,-245192000,-245192000,54432,ACAD
2017-12-31,,,-288284000,,-289403000,255062000,-37348000,-292410000,-292410000,,,,,,1119000,124901000,417311000,162249000,4126000,,-289403000,-289403000,54432,ACAD
2016-12-31,,,-270052000,,-271393000,186456000,-86359000,-272815000,-272815000,,,,,,1341000,17331000,290146000,103690000,2763000,,-271393000,-271393000,54432,ACAD
2020-05-30,74000000,,-8400000,50400000,-9100000,646600000,910700000,190100000,190100000,,-12500000,,,,6000000,2486600000,2296500000,1575900000,-198500000,,-14400000,-9100000,54436,MLHR
2019-06-01,76900000,,200100000,20600000,160500000,641900000,929900000,211100000,211100000,,-12100000,,,,39600000,2567200000,2356100000,1637300000,-11000000,,160500000,160500000,54436,MLHR
2018-06-02,73100000,,171100000,30700000,128100000,619500000,873000000,180400000,180400000,,-13500000,,,,42400000,2381200000,2200800000,1508200000,-9300000,,128700000,128100000,54436,MLHR
2017-06-03,73100000,,179200000,24800000,123900000,587800000,864200000,203300000,203300000,,-15200000,,,,55100000,2278200000,2074900000,1414000000,-24100000,,124100000,123900000,54436,MLHR
2020-04-30,,,-47813114,,-47813114,8927758,62685325,53757567,53757567,,-6562750,,,,0,62685325,8927758,0,-101570681,,-47813114,-47813114,54438,HIX
2019-04-30,,,38469252,,38469252,7474187,60029364,52555177,52555177,,-7608987,,,,0,60029364,7474187,0,-14085925,,38469252,38469252,54438,HIX
2018-04-30,,,15629522,,15629522,7835604,61153661,53318057,53318057,,-5201993,,,,0,61153661,7835604,0,-37688535,,15629522,15629522,54438,HIX
2017-04-30,,,116709814,,116709814,7850614,67742444,59891830,59891830,,-3376786,,,,0,67742444,7850614,0,56817984,,116709814,116709814,54438,HIX
2019-12-31,,,929300000,7500000,701500000,2097700000,3329400000,1012400000,1012400000,,-85000000,,,,223200000,10973800000,9961400000,7644400000,-83100000,,706100000,701500000,54439,RS
2018-12-31,,,850600000,7900000,633700000,2091400000,3281500000,974900000,974900000,,-86200000,,,,208800000,11534500000,10559600000,8253000000,-124300000,,641800000,633700000,54439,RS
2017-12-31,,,583800000,32800000,613400000,1909600000,2787600000,659600000,659600000,,-73900000,,,,-37200000,9721000000,9061400000,6933400000,-75800000,,621000000,613400000,54439,RS
2016-12-31,,,429200000,30300000,304300000,1800400000,2603100000,580700000,580700000,,-84600000,,,,120100000,8613400000,8032700000,6010300000,-151500000,,309100000,304300000,54439,RS
2019-12-31,,,1762000,2349000,1741000,3967000,34596000,19382000,19382000,-1543000,-18164000,,,,0,40692000,21310000,6096000,-17620000,,1762000,-2499000,54440,LANDO
2018-12-31,,,2766000,4807000,2629000,3026000,30713000,11018000,11018000,7294000,-13963000,,,,0,36687000,25669000,5974000,-8252000,,2766000,2250000,54440,LANDO
2017-12-31,,,-34000,8034000,-31000,3072000,21758000,11503000,11503000,-54000,-11595000,,,,0,25122000,13619000,3364000,-11537000,,-34000,-31000,54440,LANDO
2016-12-31,,,473000,11087000,448000,2499000,14988000,7311000,7311000,-54000,-6692000,,,,0,17317000,10006000,2329000,-6838000,,473000,448000,54440,LANDO
2019-12-31,13446000,,-16117000,,-16117000,3370000,0,-16816000,-16816000,,,,,,0,0,16816000,0,699000,,-16117000,-16117000,54441,KRON
2018-12-31,5033000,,-6721000,,-6721000,1612000,0,-6645000,-6645000,,-76000.0,,,,0,0,6645000,0,-76000,,-6721000,-6721000,54441,KRON
2020-12-31,,,243357000,,180533000,71658000,339781000,0,249157000,18966000,,,,,62824000,339781000,90624000,0,-5800000,,180533000,166060000,54442,MBINO
2019-12-31,,,102134000,,77329000,47651000,165447000,0,104881000,12915000,,,,,24805000,165447000,60566000,0,-2747000,,77329000,68113000,54442,MBINO
2018-12-31,,,84027000,,62874000,39157000,134927000,0,85051000,10719000,,,,,21153000,134927000,49876000,0,-1024000,,62874000,59544000,54442,MBINO
2017-12-31,,,77161000,,54684000,25761000,111805000,0,78091000,7953000,,,,,22477000,111805000,33714000,0,-930000,,54684000,51354000,54442,MBINO
2019-12-31,2359441,,-13227642,,-13227642,7432083,-3387120,-13178644,-13178644,,-62988,,,,0,186738,13365382,3573858,-48998,,-13227642,-13227642,54445,AQB
2018-12-31,3458564,,-10382059,,-10382059,4365397,-2541835,-10365796,-10365796,,-22257,,,,0,84518,10450314,2626353,-16263,,-10382059,-12204932,54445,AQB
2017-12-31,3371767,,-9258647,,-9258647,4720044,-1140288,-9232099,-9232099,,-21537,,,,0,53278,9285377,1193566,-26548,,-9258647,-9258647,54445,AQB
2016-12-31,3429400,,-8470661,,-8470661,4635654,0,-8065054,-8065054,,-402554,,,,0,0,8065054,0,-405607,,-8470661,-8470661,54445,AQB
2020-12-31,,,553000000,,415000000,,1556000000,740000000,740000000,816000000,-170000000,,,,138000000,14596000000,13856000000,13040000000,-187000000,,415000000,415000000,54446,RGA
2019-12-31,,,1132000000,,870000000,,2202000000,1334000000,1334000000,829000000,-173000000,,,,262000000,14300000000,12966000000,12098000000,-202000000,,870000000,870000000,54446,RGA
2018-12-31,,,846000000,,716000000,,1809000000,1023000000,1023000000,756000000,-147000000,,,,130000000,12876000000,11853000000,11067000000,-177000000,,716000000,716000000,54446,RGA
2017-12-31,,,1143000000,,1822000000,,2028000000,1318000000,1318000000,688000000,-146000000,,,,-679000000,12516000000,11198000000,10488000000,-197500000,,1822000000,1822000000,54446,RGA
2019-12-31,,,2967287000,1288000,2501595000,3279708000,7138309000,2893591000,2893591000,734730000,-41707000,,,,465983000,9219847000,6326256000,2081538000,73696000,,2501304000,2501595000,54447,QFIN
2018-12-31,,,1659671000,1288000,1193311000,1882652000,3610871000,1644512000,1644512000,734730000,-41707000,,,,466360000,4447018000,2802506000,836147000,15159000,,1193311000,-1904422000,54447,QFIN
2017-12-31,,,213043000,1288000,164865000,391428000,623207000,210599000,210599000,734730000,-41707000,,,,48178000,788144000,577545000,164937000,2444000,,164865000,164865000,54447,QFIN
2016-12-31,,,-68736000,1288000,-49718400,40836000,-27648000,-68743200,-68743200,734730000,-41707000,,,,-19017600,3979200,72722400,31627200,7200,,-49718400,-49718400,54447,QFIN
2019-12-31,92964000,,2654116000,130560000,2213716000,1942913000,15405001000,1155251000,1155251000,12213927000,-53784000,,,,428963000,100346048000,99190797000,84941047000,1498865000,,2225153000,2213716000,54448,SHI
2018-12-31,37261000,,6748976000,116378000,5277186000,1887793000,19383411000,5382916000,5382916000,12075424000,-79246000,,,,1471903000,107764908000,102381992000,88381497000,1366060000,,5277073000,5277186000,54448,SHI
2017-12-31,36709000,,7851234000,285307000,6141558000,1887721000,21159752000,6491168000,6491168000,12744088000,-54384000,,,,1698739000,92013569000,85522401000,70853817000,1360066000,,6152495000,6141558000,54448,SHI
2016-12-31,36709000,,7765405000,281270000,5955576000,1955017000,20882508000,6991744000,6991744000,11935817000,-53617000,,,,1796822000,77894285000,70902541000,57011777000,773661000,,5968583000,5955576000,54448,SHI
2020-02-01,,,129700000,,105500000,1911100000,2232900000,329500000,329500000,-7700000,-35600000,,,,24200000,6137100000,5807600000,3904200000,-199800000,,105500000,72600000,54449,SIG
2019-02-02,,,-802600000,,-657400000,1974800000,2223000000,266000000,266000000,-17800000,-39700000,,,,-145200000,6247100000,5981100000,4024100000,-1068600000,,-657400000,-690300000,54449,SIG
2018-02-03,,,527200000,,519300000,1866600000,2190000000,326100000,326100000,-2700000,-52700000,,,,7900000,6253000000,5926900000,4063000000,201100000,,519300000,486400000,54449,SIG
2017-01-28,,,713800000,,543200000,1880200000,2643300000,763200000,763200000,-100000,-49400000,,,,170600000,6690900000,5927700000,4047600000,-49400000,,543200000,531300000,54449,SIG
2019-12-31,,,93022000,,69982000,416452000,549159000,123562000,123562000,,-167000,,,,22428000,627704000,504142000,78545000,-30540000,-612000,70594000,69982000,54454,PRDO
2018-12-31,,,74352000,,55181000,401895000,497182000,85893000,85893000,,-681000,,,,18561000,581296000,495403000,84114000,-11541000,-610000,55791000,55181000,54454,PRDO
2017-12-31,,,36250000,,-31897000,452491000,500617000,34136000,34136000,,-451000,,,,67125000,596435000,562299000,95818000,2114000,-1022000,-30875000,-31897000,54454,PRDO
2016-12-31,,,-31366000,,-18712000,548200000,604118000,33171000,33171000,,-584000,,,,-16550000,704392000,671221000,100274000,-64537000,-3896000,-14816000,-18712000,54454,PRDO
2020-12-31,,,13322000,,6623000,100686000,163215000,0,53806000,8723000,,,,,6699000,163215000,109409000,0,-40484000,,6623000,6623000,54455,MOFG
2019-12-31,,,50203000,,43630000,91372000,167738000,0,66509000,9857000,,,,,6573000,167738000,101229000,0,-16306000,,43630000,43630000,54455,MOFG
2018-12-31,,,37968000,,30351000,73743000,121183000,0,42615000,4825000,,,,,7617000,121183000,78568000,0,-4647000,,30351000,30351000,54455,MOFG
2017-12-31,,,29075000,,18699000,70724000,109198000,0,33649000,4825000,,,,,10376000,109198000,75549000,0,-4574000,,18699000,18699000,54455,MOFG
2019-12-31,6574999,,-13305964,,-13305964,4268593,0,-10843592,-10843592,,-2355469,,,,0,0,10843592,0,-2462372,,-13305964,-17525741,54456,NDRA
2018-12-31,4722465,,-9796261,,-9796261,4015176,6174,-8731467,-8731467,,-729241,,,,0,6174,8737641,0,-1064794,,-9796261,-9796261,54456,NDRA
2017-12-31,1931075,,-5376962,,-5376962,2873823,178840,-4626058,-4626058,,-729241,,,,0,351622,4977680,172782,-750904,,-5376962,-5376962,54456,NDRA
2016-12-31,495377,,-2775368,,-2775368,1576085,279704,-1791758,-1791758,,-729241,,,,0,515582,2307340,235878,-983610,,-2775368,-2775368,54456,NDRA
2019-12-31,187700000,,280400000,31400000,197200000,502700000,1000600000,304400000,304400000,5800000,-16000000,,,,82400000,2072600000,1768200000,1072000000,-24000000,,198000000,197200000,54457,BRKR
2018-12-31,173400000,,244700000,31100000,179700000,448600000,902600000,271300000,271300000,9300000,-12600000,,,,63700000,1895600000,1624300000,993000000,-26600000,,181000000,179700000,54457,BRKR
2017-12-31,161600000,,197800000,8100000,78600000,420000000,821600000,235600000,235600000,4400000,-15400000,,,,117500000,1765900000,1530300000,944300000,-37800000,,80300000,78600000,54457,BRKR
2016-12-31,147900000,,177600000,6700000,153600000,394400000,756300000,207800000,207800000,6200000,-13200000,,,,23100000,1611300000,1403500000,855000000,-30200000,,154500000,153600000,54457,BRKR
2020-03-31,,,236300000,2700000,180100000,469200000,820500000,315900000,315900000,,-58600000,,,,54100000,2068300000,1752400000,1247800000,-79600000,-1800000,182200000,165700000,54459,RXN
2019-03-31,,,242400000,2400000,34300000,430800000,788700000,323900000,323900000,,-69900000,,,,53400000,2050900000,1727000000,1262200000,-81500000,-154700000,189000000,11100000,54459,RXN
2018-03-31,,,187100000,100000,75900000,387200000,708800000,289400000,289400000,,-75100000,,,,-19500000,1851600000,1562200000,1142800000,-102300000,-130600000,206600000,52700000,54459,RXN
2017-03-31,,,107300000,100000,74100000,350800000,636000000,244200000,244200000,,-88300000,,,,15600000,1712500000,1468300000,1076500000,-136900000,-17600000,91700000,66800000,54459,RXN
2019-12-31,14991000,,-37510000,,-38150000,70811000,54861000,-30941000,-30941000,,-8696000,,,,640000,89565000,120506000,34704000,-6569000,,-38150000,-38150000,54463,ESTA
2018-12-31,12687000,,-20883000,,-21098000,47295000,36118000,-23864000,-23864000,,-8814000,,,,215000,61208000,85072000,25090000,2981000,,-21098000,-21098000,54463,ESTA
2017-12-31,6864000,,-34792000,,-34897000,30821000,17702000,-19983000,-19983000,,-10420000,,,,105000,34681000,54664000,16979000,-14809000,,-34897000,-34897000,54463,ESTA
2016-12-31,2740000,,-22025000,,-22159000,23189000,10096000,-15833000,-15833000,,-3413000,,,,134000,19801000,35634000,9705000,-6192000,,-22159000,-22159000,54463,ESTA
2020-06-30,,,-22426023,,-22426023,9765372,-13841408,-23606780,-23606780,,-20141,,,,0,117989,23724769,13959397,1180757,,-22426023,-22426023,54467,PTN
2019-06-30,,,35773027,,35773027,9699061,45443381,35744320,35744320,,-417561,,,,0,60300476,24556156,14857095,28707,,35773027,35773027,54467,PTN
2018-06-30,,,24785214,,24702714,8641976,34568541,25926565,25926565,,-1452014,,,,82500,67134758,41208193,32566217,-1141351,,24702714,24702714,54467,PTN
2017-06-30,,,-12831533,,-13331533,9610147,-959347,-10569494,-10569494,,-2288309,,,,500000,44723827,55293321,45683174,-2262039,,-13331533,-13331533,54467,PTN
2020-08-31,44143000,,260738000,14015000,53912000,1094379000,1930813000,736747000,736747000,,-173877000,,,,203959000,27266438000,26529691000,25335625000,-476009000,,56779000,53912000,54469,JBL
2019-08-31,42861000,,450704000,13315000,287111000,1058405000,1913401000,780212000,780212000,,-188730000,,,,161230000,25282320000,24502108000,23368919000,-329508000,,289474000,287111000,54469,JBL
2018-08-31,38531000,,373401000,13123000,86330000,1034104000,1706792000,595667000,595667000,,-149002000,,,,285860000,22095416000,21499749000,20388624000,-222266000,,87541000,86330000,54469,JBL
2017-08-31,29680000,,256233000,14830000,129090000,909701000,1545643000,570738000,570738000,,-138074000,,,,129066000,19063121000,18492383000,17517478000,-314505000,,127167000,129090000,54469,JBL
2019-12-31,,,86719000,,84290000,61063000,393005000,156706000,156706000,-4352000,-79246000,,,,2429000,726991000,570285000,333986000,-69987000,,84290000,81662000,54470,ESBA
2018-12-31,,,121895000,,117253000,52674000,391192000,190857000,190857000,-20847000,-79623000,,,,4642000,710664000,519807000,319472000,-68962000,,117253000,115466000,54470,ESBA
2017-12-31,,,124926000,,118253000,50315000,390377000,192903000,192903000,-13551000,-68762000,,,,6673000,695975000,503072000,305598000,-67977000,,118253000,116557000,54470,ESBA
2016-12-31,,,113396000,,107250000,49078000,380509000,183896000,183896000,-7676000,-70595000,,,,6146000,669677000,485781000,289168000,-70500000,,107250000,105567000,54470,ESBA
2020-12-31,,,42447000,,32888000,80906000,131561000,0,43481000,7174000,,,,,9559000,131561000,88080000,0,-1034000,,32888000,32888000,54473,NRIM
2019-12-31,,,26125000,,20691000,69956000,102052000,0,26106000,5990000,,,,,5434000,102052000,75946000,0,19000,,20691000,20691000,54473,NRIM
2018-12-31,,,24075000,,20004000,60922000,94500000,0,27364000,6214000,,,,,4071000,94500000,67136000,0,-3289000,,20004000,20004000,54473,NRIM
2017-12-31,,,23799000,,13151000,61953000,90507000,0,22268000,6286000,,,,,10321000,90507000,68239000,0,1531000,,13478000,13151000,54473,NRIM
2019-12-31,,,97869000,,92922000,9825000,124149000,0,95337000,18638000,,,,,531000,125768000,30431000,1619000,2532000,-4416000,97338000,76800000,54475,MITT
2018-12-31,,,5004000,,1568000,9544000,14479000,0,-10189000,14885000,,,,,1500000,14912000,25101000,433000,15193000,-1936000,3504000,-11901000,54475,MITT
2017-12-31,,,120058000,,118558000,9835000,128537000,0,107436000,10965000,,,,,1500000,128771000,21335000,234000,12622000,-1936000,118558000,105089000,54475,MITT
2016-12-31,,,65196000,,63683000,9809000,84076000,0,63677000,10291000,,,,,1513000,84480000,20803000,404000,1519000,-1936000,63683000,50214000,54475,MITT
2020-06-30,,,-2380123,3020374,-4876942,4961780,7177978,515783,515783,,-1673563,,,,223173,110551502,110035719,103373524,-2895906,-1796237,-2603296,-4876942,54477,PLIN
2019-06-30,,,5239861,3020374,4363591,1828394,8650240,6077860,6077860,,-730780,,,,213649,99079267,93001407,90429027,-837999,-662621,5026212,4363591,54477,PLIN
2018-06-30,,,4482485,3020374,3768109,1689878,9651471,7042653,7042653,,-1282291,,,,714376,101104224,94061571,91452753,-2560168,-662621,3768109,3768109,54477,PLIN
2017-06-30,,,3330611,3020374,2454874,1370239,5067075,3521519,3521519,,-667748,,,,875737,63276479,59754960,58209404,-190908,-662621,2454874,2454874,54477,PLIN
2020-12-31,,,303000000,,246400000,25400000,726200000,333900000,333900000,366900000,-30800000,,,,56600000,2922300000,2588400000,2196100000,-30900000,,246400000,246400000,54480,SIGIP
2019-12-31,,,336390000,,271623000,41921000,758652000,369683000,369683000,347048000,-33668000,,,,64767000,2846491000,2476808000,2087839000,-33193000,,271623000,271623000,54480,SIGIP
2018-12-31,,,211721000,,178939000,25446000,592904000,236140000,236140000,331318000,-24419000,,,,32782000,2586080000,2349940000,1993176000,-24419000,,178939000,178939000,54480,SIGIP
2017-12-31,,,261968000,,168826000,36255000,655674000,286322000,286322000,333097000,-24354000,,,,93142000,2469984000,2183662000,1814310000,-24354000,,168826000,168826000,54480,SIGIP
2020-06-30,17400000,,8400000,,12500000,118300000,180200000,44500000,44500000,,-2800000,,,,-4100000,260000000,215500000,79800000,-36100000,,12500000,12500000,54481,ABCM
2019-06-30,10700000,,56400000,,45000000,88900000,183200000,83600000,83600000,,-300000,,,,11400000,259900000,176300000,76700000,-27200000,,45000000,45000000,54481,ABCM
2018-06-30,16000000,,69100000,,62200000,77700000,163000000,69300000,69300000,,-300000,,,,6900000,233200000,163900000,70200000,-200000,,62200000,62200000,54481,ABCM
2017-06-30,18600000,,51900000,,42400000,78800000,152100000,54700000,54700000,,-300000,,,,9500000,217100000,162400000,65000000,-2800000,,42400000,42400000,54481,ABCM
2019-12-28,,,30489000,,32798000,744488000,917812000,84269000,84269000,1811000,-33300000,,,,-2309000,1724331000,1640062000,806519000,-53780000,,32798000,32798000,54482,EYE
2018-12-29,,,4868000,,23653000,687476000,823283000,61281000,61281000,187000,-37483000,,,,-18785000,1536854000,1475573000,713571000,-56413000,,23653000,23653000,54482,EYE
2017-12-30,,,4228000,,43138000,600010000,738342000,76408000,76408000,-50000,-60063000,,,,-38910000,1375308000,1298900000,636966000,-72180000,,43138000,43138000,54482,EYE
2016-12-31,,,24977000,,13343000,525869000,651414000,72601000,72601000,267000,-39092000,,,,11634000,1196195000,1123594000,544781000,-47624000,,13343000,13343000,54482,EYE
2020-03-31,3690539,,17301903,,14526642,1317543,20522868,15514786,15514786,,,,,,2775261,25412163,9897377,4889295,1787117,,14526642,14526642,54483,NVEC
2019-03-31,4107692,,17709839,,14507936,1223971,21256225,15924562,15924562,,,,,,3201903,26472337,10547775,5216112,1785277,,14507936,14507936,54483,NVEC
2018-03-31,3702918,,20008824,,13912672,1435592,23589137,18450627,18450627,,,,,,6096152,29863881,11413254,6274744,1558197,,13912672,13912672,54483,NVEC
2017-03-31,3344101,,19096011,,12948869,1458598,22247902,17445203,17445203,,,,,,6147142,28326196,10880993,6078294,1650808,,12948869,12948869,54483,NVEC
2020-12-26,,,248997000,,192106000,508413000,855757000,271026000,271026000,30463000,-3953000,,,,56891000,4136380000,3865354000,3280623000,-22029000,,192106000,192106000,54484,LSTR
2019-12-28,,,295763000,,227720000,501179000,881825000,297888000,297888000,38290000,-3141000,,,,68060000,4089618000,3791730000,3207793000,-2125000,,227703000,227720000,54484,LSTR
2018-12-29,,,328381000,2309000.0,255281000,566214000,973322000,330756000,330756000,32782000,-3354000,,,,73168000,4618960000,4288204000,3645638000,-2375000,,255213000,255281000,54484,LSTR
2017-12-30,,,240802000,3205000.0,177088000,467993000,781208000,243194000,243194000,29461000,-3166000,,,,63806000,3648862000,3405668000,2867654000,-2392000,,176996000,177088000,54484,LSTR
2020-03-31,5869588,,-8277069,,-8277069,2375211,0,-8244799,-8244799,,,,,,0,0,8244799,0,-32270,,-8277069,-8277069,54485,MDNA
2019-03-31,3017997,,-4708031,,-4708031,1709286,0,-4727283,-4727283,,,,,,0,0,4727283,0,19252,,-4708031,-4708031,54485,MDNA
2018-03-31,5090146,,-7465452,,-7465452,2334684,0,-7424830,-7424830,,,,,,0,0,7424830,0,-40622,,-7465452,-7465452,54485,MDNA
2017-03-31,4229110,,-7631265,,-7631265,1684671,0,-5913781,-5913781,,,,,,0,0,5913781,0,-1717484,,-7631265,-7631265,54485,MDNA
2020-05-31,,,5610501,,5610501,1518751,8066896,6548145,6548145,,-1594860,,,,0,8066896,1518751,0,-937644,,5610501,5610501,54489,NKG
2019-05-31,,,9827604,,9827604,1509150,8234709,6725559,6725559,,-1886136,,,,0,8234709,1509150,0,3102045,,9827604,9827604,54489,NKG
2018-05-31,,,290303,,290303,1556343,8344518,6788175,6788175,,-1583106,,,,0,8344518,1556343,0,-6497872,,290303,290303,54489,NKG
2017-05-31,,,85233,,85233,1580629,8891021,7310392,7310392,,-1508395,,,,0,8891021,1580629,0,-7225159,,85233,85233,54489,NKG
2019-12-31,12091797,,-20358090,,-19265644,24467821,17585554,-18974064,-18974064,,-1033661,,,,-1092446,24949473,43923537,7363919,-1384026,,-19265644,-19265644,54491,CTSO
2018-12-31,7723028,,-17830725,,-17211179,22876408,15014508,-15584928,-15584928,,-824045,,,,-619546,22503908,38088836,7489400,-2245797,,-17211179,-17211179,54491,CTSO
2017-12-31,3221233,,-9137538,,-8460799,16253759,9632394,-9842598,-9842598,,-749076,,,,-676739,15150754,24993352,5518360,705060,,-8460799,-8796530,54491,CTSO
2016-12-31,4073093,,-12082006,,-11763456,12993150,5574118,-11492125,-11492125,,-231804,,,,-318550,9527843,21019968,3953725,-589881,,-11763456,-11763456,54491,CTSO
2019-10-31,,,413995,474,175787,1248057,1350727,102670,102670,,-18831,,,,238208,2002217,1899547,651490,311325,,175787,175787,54493,TIRX
2018-10-31,,,1486630,478,1121429,1462444,2921661,1459217,1459217,,-22891,,,,365192,3087708,1628491,166047,27413,,1121438,1121429,54493,TIRX
2017-10-31,,,1131576,478,963324,278361,1394173,1115812,1115812,,-22891,,,,168252,1531223,415411,137050,15764,,963324,963324,54493,TIRX
2020-12-31,,,3203000000,,2714000000,13060000000,18259000000,0,3263000000,1936000000,,,,,486000000,18259000000,14996000000,0,-60000000,-3000000,2717000000,2375000000,54495,COF
2019-12-31,,,6874000000,,5546000000,13287000000,22357000000,0,7335000000,1735000000,,,,,1341000000,22357000000,15022000000,0,-461000000,13000000,5533000000,5192000000,54495,COF
2018-12-31,,,7318000000,,6015000000,12424000000,22220000000,0,7856000000,1940000000,,,,,1293000000,22220000000,14364000000,0,-538000000,-10000000,6025000000,5710000000,54495,COF
2017-12-31,,,5492000000,,1982000000,11782000000,19686000000,0,6071000000,1833000000,,,,,3375000000,19686000000,13615000000,0,-579000000,-135000000,2117000000,1704000000,54495,COF
2020-12-29,,,-89950000,,-57885000,54663000,56420000,-72568000,-72568000,,-7078000,,,,-32065000,778510000,851078000,722090000,-17382000,,-57885000,-57885000,54496,BJRI
2019-12-31,,,46294000,,45238000,62540000,185688000,48250000,48250000,,-4613000,,,,1056000,1161450000,1113200000,975762000,-1956000,,45238000,45238000,54496,BJRI
2019-01-01,,,51997000,,50810000,60449000,194804000,61618000,61618000,,-4838000,,,,1187000,1116948000,1055330000,922144000,-9621000,,50810000,50810000,54496,BJRI
2018-01-02,,,35390000,,44780000,55447000,171992000,44007000,44007000,,-4501000,,,,-9390000,1031782000,987775000,859790000,-8617000,,44780000,44780000,54496,BJRI
2020-07-25,6347000000,,13970000000,,11214000000,11073000000,31683000000,14122000000,14122000000,,-585000000,,,,2756000000,49301000000,35179000000,17618000000,-152000000,,11214000000,11214000000,54498,CSCO
2019-07-27,6577000000,,14571000000,,11621000000,11777000000,32666000000,14162000000,14162000000,,-859000000,,,,2950000000,51904000000,37742000000,19238000000,409000000,,11621000000,11621000000,54498,CSCO
2018-07-28,6332000000,,13039000000,,110000000,11345000000,30733000000,12835000000,12835000000,,-943000000,,,,12929000000,49330000000,36495000000,18597000000,204000000,,110000000,110000000,54498,CSCO
2017-07-29,6059000000,,12287000000,,9609000000,11167000000,30224000000,12739000000,12739000000,,-861000000,,,,2678000000,48005000000,35266000000,17781000000,-452000000,,9609000000,9609000000,54498,CSCO
2020-06-30,,,6100000,,1500000,203800000,358700000,154900000,154900000,,-19800000,,,,4600000,2181100000,2026200000,1822400000,-148800000,,1500000,1100000,54499,CRS
2019-06-30,,,216000000,,167000000,202300000,444800000,242500000,242500000,,-26000000,,,,49000000,2380200000,2137700000,1935400000,-26500000,,167000000,165100000,54499,CRS
2018-06-30,,,160200000,,188500000,195100000,382300000,187200000,187200000,,-28300000,,,,-28300000,2157700000,1970500000,1775400000,-27000000,,188500000,186800000,54499,CRS
2017-06-30,,,70200000,,47000000,199900000,300800000,100900000,100900000,,-29800000,,,,23200000,1797600000,1696700000,1496800000,-30700000,,47000000,46700000,54499,CRS
2020-08-31,1918919,,-4654862,,-4654862,2766356,0,-4685775,-4685775,,,,,,0,0,4685775,0,30913,,-4654862,-4654862,54501,ARTL
2019-08-31,1091992,,-2172176,,-2172176,2117029,0,-3209531,-3209531,,,,,,0,0,3209531,0,1037355,,-2172176,-2172176,54501,ARTL
2018-08-31,1249854,,-2343491,,-2343491,1093347,0,-2343491,-2343491,,,,,,0,0,2343491,0,0,,-2343491,-2343491,54501,ARTL
2017-08-31,1249854,,-234889,,-234889,232789,0,-232789,-232789,,-2100.0,,,,0,0,232789,0,-2100,,-234889,-234889,54501,ARTL
2019-12-31,,,-548,,-548,,0,-548,-548,548,,,,,0,0,548,0,0,,-548,-548,54504,CFAC
2018-12-31,,,-551,,-551,,0,-551,-551,551,,,,,0,0,551,0,0,,-551,-551,54504,CFAC
2020-03-31,,,381948553000,5766413000,272539506000,196864639000,712309108000,0,381948553000,133495916000,,,,,108985900000,712309108000,330360555000,0,0,,272962653000,272539506000,54505,HDB
2019-03-31,,,343181629000,5017945000,223324309000,168591223000,620129233000,0,343181629000,108356381000,,,,,118725500000,620129233000,276947604000,0,0,,224456129000,223324309000,54505,HDB
2018-03-31,,,284644431000,3563322000,185100242000,151373416000,523911430000,0,284639210000,87898804000,,,,,99030800000,523911430000,239272220000,0,5221000,,185613631000,185100242000,54505,HDB
2017-03-31,,,233404108000,2914389000,152255743000,139945913000,441165929000,0,233655222000,67564794000,,,,,80781200000,441165929000,207510707000,0,-251114000,,152622908000,152255743000,54505,HDB
2019-12-31,,,11443693,2903850,6451412,64887534,142452252,45738654,45738654,,-28937680,,,,2792652,247436303,201697649,104984051,-34294961,,8651041,6451412,54506,AKU
2018-12-31,,,6047404,2467200,4999801,51479403,85828365,18794533,18794533,,-5979035,,,,-1526534,154782067,135987534,68953702,-12747129,,7573938,4999801,54506,AKU
2017-12-31,,,-5892988,6340583,-8161994,33627917,50084758,7691276,7691276,700000.0,-4499865,,,,113561,90246428,82555152,40161670,-13584264,,-6006549,-8161994,54506,AKU
2016-09-30,,,-1984901,6340583,-1986369,17214384,25057053,129391,129391,1652360.0,-3152393,,,,1468,46401248,46271857,21344195,-2114292,,-1986369,-1986369,54506,AKU
2020-12-31,,,152836000,,121167000,195775000,425635000,0,159521000,70339000,,,,,31669000,425635000,266114000,0,-6685000,,121167000,121167000,54513,INDB
2019-12-31,,,218108000,,165175000,205291000,497867000,0,248380000,43472000,,,,,52933000,497867000,249487000,0,-30272000,,165175000,165175000,54513,INDB
2018-12-31,,,155926000,,121622000,169586000,380670000,0,172212000,37946000,,,,,34304000,380670000,208458000,0,-16286000,,121622000,121622000,54513,INDB
2017-12-31,,,134545000,,87204000,158944000,338904000,0,143717000,35640000,,,,,47341000,338904000,195187000,0,-9172000,,87204000,87204000,54513,INDB
2019-12-31,250791000,,-83816000,,-86414000,393640000,564181000,-80250000,-80250000,,-20938000,,,,2598000,761088000,841338000,196907000,-3566000,,-86414000,-86414000,54516,WIX
2018-12-31,198912000,,-33913000,,-37120000,308475000,476757000,-30630000,-30630000,,-10004000,,,,3207000,603704000,634334000,126947000,-3283000,,-37120000,-37120000,54516,WIX
2017-12-31,153635000,,-54950000,,-56273000,252621000,356245000,-50011000,-50011000,,-10004000,,,,1323000,425636000,475647000,69391000,-4939000,,-56273000,-56273000,54516,WIX
2016-12-31,105368000,,-43789000,,-46896000,183480000,244816000,-44032000,-44032000,,-10004000,,,,3107000,290103000,334135000,45287000,243000,,-46896000,-46896000,54516,WIX
2020-12-31,260700000,,1526600000,67000000,1203400000,760300000,2664100000,1643100000,1643100000,,-115400000,,,,313300000,8598900000,6955800000,5934800000,-116500000,,1213300000,1203400000,54518,APH
2019-12-31,234200000,,1495900000,65900000,1155000000,742100000,2616000000,1639700000,1639700000,,-117600000,,,,331900000,8225400000,6585700000,5609400000,-143800000,,1164000000,1155000000,54518,APH
2018-12-31,220900000,,1588400000,47200000,1205000000,746000000,2654900000,1688000000,1688000000,,-101700000,,,,371500000,8202000000,6514000000,5547100000,-99600000,,1216900000,1205000000,54518,APH
2017-12-31,193700000,,1352400000,53600000,650500000,699500000,2309900000,1416700000,1416700000,,-92300000,,,,691700000,7011300000,5594600000,4701400000,-64300000,,660700000,650500000,54518,APH
2019-12-31,,,9228000,-321630000,14619000,593672000,2080824000,51284000,51284000,1312709000,-180392000,,,,1754000,4565834000,4514550000,2485010000,-42056000,,7474000,14619000,54519,GEN
2018-12-31,,,-374840000,-705346000,-235231000,279041000,2189742000,209925000,209925000,1479880000,-463738000,,,,-2423000,4976650000,4766725000,2786908000,-584765000,,-372417000,-235231000,54519,GEN
2017-12-31,,,-969599000,-595905000,-578982000,315243000,2336872000,91865000,91865000,1583114000,-499382000,,,,-10427000,5373740000,5281875000,3036868000,-1061464000,-32000.0,-959172000,-578982000,54519,GEN
2016-12-31,,,-135513000,-239865000,-64013000,332306000,2254902000,254498000,254498000,1413639000,-528544000,,,,-17435000,5624615000,5370117000,3369713000,-390011000,27000.0,-118078000,-64013000,54519,GEN
2020-11-30,,,15415183,,15415183,3361252,25549097,22187845,22187845,,-2378505,,,,0,25549097,3361252,0,-6772662,,15415183,14822749,54523,DSM
2019-11-30,,,41282159,,41282159,3414894,27465879,24050985,24050985,,-3641660,,,,0,27465879,3414894,0,17231174,,41282159,40013601,54523,DSM
2018-11-30,,,1481443,,1481443,3599281,29734320,26135039,26135039,,-2907968,,,,0,29734320,3599281,0,-24653596,,1481443,176582,54523,DSM
2017-11-30,,,30884893,,30884893,3831954,29501250,25669296,25669296,,-1455682,,,,0,29501250,3831954,0,5215597,,30884893,29657341,54523,DSM
2019-12-31,,,69289000,,46869000,136824000,205133000,68309000,68309000,,,,,,22420000,706924000,638615000,501791000,980000,,46869000,46869000,54524,HSII
2018-12-31,,,70492000,,49295000,139532000,209674000,70142000,70142000,,,,,,21197000,716023000,645881000,506349000,350000,,49295000,49295000,54524,HSII
2017-12-31,,,-29418000,,-48635000,147316000,187181000,39865000,39865000,,,,,,19217000,621400000,581535000,434219000,-69283000,,-48635000,-48635000,54524,HSII
2016-12-31,,,37766000,,15413000,146452000,182320000,35868000,35868000,,,,,,22353000,582390000,546522000,400070000,1898000,,15413000,15413000,54524,HSII
2020-12-31,,,279974000,,220621000,658242000,1038920000,0,302450000,78228000,,,,,59353000,1038920000,736470000,0,-22476000,,220621000,211474000,54525,WBS
2019-12-31,,,486692000,,382723000,595532000,1202642000,0,510193000,96917000,,,,,103969000,1202642000,692449000,0,-23501000,,382723000,372985000,54525,WBS
2018-12-31,,,441633000,,360418000,575974000,1147249000,0,480229000,91046000,,,,,81215000,1147249000,667020000,0,-38596000,,360418000,351703000,54525,WBS
2017-12-31,,,353790000,,255439000,540738000,1014865000,0,383501000,90626000,,,,,98351000,1014865000,631364000,0,-29711000,,255439000,246831000,54525,WBS
2019-12-31,5278000,,-32532000,-4394000,-34409000,22900000,569000,-25755000,-25755000,-1854000,-4972000,,,,-949000,98958000,124713000,98389000,-6777000,-2821000,-31583000,-34409000,54527,BRQS
2018-12-31,6338000,,-68727000,-296000,-71764000,48725000,-6023000,-62368000,-62368000,-180000,-2578000,,,,331000,128420000,190788000,134443000,-6359000,-2810000,-69058000,-71764000,54527,BRQS
2017-12-31,6194000,,-10448000,-797000,-12569000,22868000,18739000,-8207000,-8207000,-2116000,-1832000,,,,2342000,122233000,130440000,103494000,-2241000,139000,-12790000,-19525000,54527,BRQS
2016-12-31,5395000,,8676000,-1095000,3228000,10131000,20505000,8717000,8717000,-3738000,-852000,,,,3244000,85448000,76731000,64943000,-41000,-2836000,-12790000,-19525000,54527,BRQS
2020-03-28,,,74274000,,58024000,365614000,476658000,111044000,111044000,,-28213000,,,,16250000,1256524000,1145480000,779866000,-36770000,,58024000,57575000,54530,MNRO
2019-03-30,,,100360000,,79752000,337885000,465228000,127343000,127343000,,-27013000,,,,20608000,1200230000,1072887000,735002000,-26983000,,79752000,79344000,54530,MNRO
2018-03-31,,,103454000,,63935000,306328000,435574000,129246000,129246000,,-24296000,,,,39519000,1127815000,998569000,692241000,-25792000,,63935000,63567000,54530,MNRO
2017-03-25,,,97244000,,61526000,280505000,396889000,116384000,116384000,,-19768000,,,,35718000,1021511000,905127000,624622000,-19140000,,61526000,61079000,54530,MNRO
2020-12-31,,,-302000000,27000000,-306000000,253000000,796000000,308000000,308000000,-141000000,-302000000,,,,0,6146000000,5838000000,5350000000,-610000000,,-302000000,-365000000,54531,DCP
2019-12-31,,,20000000,28000000,-101000000,311000000,924000000,188000000,188000000,21000000,-304000000,,,,-1000000,7638000000,7450000000,6714000000,-168000000,,21000000,-160000000,54531,DCP
2018-12-31,,,305000000,136000000,134000000,276000000,1084000000,368000000,368000000,52000000,-269000000,,,,3000000,9863000000,9495000000,8779000000,-63000000,,302000000,87000000,54531,DCP
2017-12-31,,,236000000,184000000,65000000,290000000,956000000,236000000,236000000,51000000,-289000000,,,,2000000,8502000000,8266000000,7546000000,0,,234000000,61000000,54531,DCP
2019-12-31,,,-6104,,-6104,,0,0,,,,,,,0,0,0,0,-6104,,-6104,-6104,54533,NBAC
2020-06-30,1150581,,-16676768,,-16676768,1312930,0,-2692888,-2692888,,-4772429,,,,0,0,2692888,0,-13983880,,-16676768,-33775826,54536,BIVI
2019-06-30,1008100,,-2444287,,-2444287,1259096,0,-2496573,-2496573,,-273,,,,0,0,2496573,0,52286,,-2444287,-2492946,54536,BIVI
2018-06-30,370852,,-2413122,,-2413122,1771937,0,-2372166,-2372166,,-40960,,,,0,0,2372166,0,-40955,,-2413122,-2434117,54536,BIVI
2017-06-30,466354,,-1330673,,-1330673,857883,0,-1553614,-1553614,,-40960,,,,0,0,1553614,0,222941,,-1330673,-1330673,54536,BIVI
2020-12-31,,,40975000,,28951000,39751000,87443000,0,42709000,4983000,,,,,12024000,87443000,44734000,0,-1734000,,28951000,28951000,54537,FCBP
2019-12-31,,,39922000,,27848000,35419000,84362000,0,43569000,5374000,,,,,12074000,84362000,40793000,0,-3647000,,27848000,27570000,54537,FCBP
2018-12-31,,,21565000,,15130000,25955000,58348000,0,28333000,4060000,,,,,6435000,58348000,30015000,0,-6768000,,15130000,14996000,54537,FCBP
2017-12-31,,,15443000,,7354000,19827000,39197000,0,15910000,3460000,,,,,8089000,39197000,23287000,0,-467000,,7354000,7254000,54537,FCBP
2019-12-31,,,185000000,24000000,127000000,1406000000,2238000000,130000000,130000000,,-110000000,,,,52000000,4022000000,3892000000,1784000000,55000000,,133000000,127000000,54543,USM
2018-12-31,,,215000000,21000000,150000000,1388000000,2178000000,150000000,150000000,,-116000000,,,,51000000,3967000000,3817000000,1789000000,65000000,,164000000,150000000,54543,USM
2017-12-31,,,-272000000,11000000,12000000,1412000000,2087000000,60000000,60000000,,-113000000,,,,-287000000,3890000000,3830000000,1803000000,-332000000,,15000000,12000000,54543,USM
2016-12-31,,,82000000,12000000,48000000,1480000000,2149000000,51000000,51000000,,-113000000,,,,33000000,3990000000,3939000000,1841000000,31000000,,49000000,48000000,54543,USM
2020-12-31,,,11836000,,10131000,,34884000,0,11836000,23048000,,,,,1692000,34884000,23048000,0,0,,10144000,10131000,54545,FCAP
2019-12-31,,,12325000,112000.0,10325000,19553000.0,35595000,0,12624000,3418000,,,,,1987000,35595000,22971000,0,-299000,,10338000,10325000,54545,FCAP
2018-12-31,,,10660000,112000.0,9253000,17611000.0,32275000,0,11136000,3528000,,,,,1394000,32275000,21139000,0,-476000,,9266000,9253000,54545,FCAP
2017-12-31,,,10555000,112000.0,7439000,16494000.0,30813000,0,10871000,3448000,,,,,3103000,30813000,19942000,0,-316000,,7452000,7439000,54545,FCAP
2019-12-31,,,166042000,1536502000,108109000,43245000,92276000,35247000,35247000,13784000,-114844000,,,,57933000,92276000,57029000,0,130795000,,108109000,91166000,54546,GWGH
2018-12-31,,,-119451000,1536502000,-119451000,25204000,-390000,-39333000,-39333000,13739000,-80136000,,,,0,-390000,38943000,0,-80118000,,-119451000,-136114000,54546,GWGH
2017-12-31,,,-22729594,1536502000,-20632223,22191392,64133918,31689850,31689850,10252676,-54419444,,,,-2097371,64133918,32444068,0,-54419444,,-20632223,-33334564,54546,GWGH
2016-12-31,,,725312,1536502000,391909,15731672,69477334,43068686,43068686,10676976,-42343374,,,,333403,69477334,26408648,0,-42343374,,391909,-3145378,54546,GWGH
2020-12-31,,,-602831000,,-483775000,113375000,634496000,29967000,29967000,-87510000,-170806000,,,,-174087000,1085684000,1055717000,451188000,-632798000,,-428744000,-483775000,54547,CNX
2019-12-31,,,59684000,801763000.0,-80730000,147550000,1030245000,180873000,180873000,-297850000,-151379000,,,,27736000,1544241000,1363368000,513996000,-121189000,,31948000,-80730000,54547,CNX
2018-12-31,,,1098668000,751785000.0,796533000,138806000,1259644000,517758000,517758000,97624000,-145934000,,,,215557000,1755283000,1237525000,495639000,580910000,,883111000,796533000,54547,CNX
2017-12-31,,,118581000,751785000.0,380747000,93211000,644710000,48085000,48085000,-94561000,-161443000,,,,-176458000,1198371000,1150286000,553661000,70496000,85708000.0,295039000,380747000,54547,CNX
2020-11-29,,,-189783000,,-127141000,2276165000,2422224000,146059000,146059000,,-82190000,,,,-62642000,4452609000,4306550000,2030385000,-335842000,,-127141000,-127141000,54548,LEVI
2019-11-24,,,477584000,8026000.0,394612000,2550652000,3101373000,550723000,550723000,-2000.0,-66248000,,,,82604000,5763087000,5212364000,2661714000,-73139000,,394980000,394612000,54548,LEVI
2018-11-25,,,500022000,7346000.0,283142000,2460951000,2997975000,537060000,537060000,-36000.0,-55296000,,,,214778000,5575440000,5038380000,2577465000,-37038000,,285244000,283142000,54548,LEVI
2017-11-26,,,348781000,5478000.0,281403000,2095560000,2562729000,467169000,467169000,-36000.0,-68603000,,,,64225000,4904030000,4436861000,2341301000,-118388000,,284556000,281403000,54548,LEVI
2019-12-31,22468000,,-157325000,,-154201000,46772000,-4792000,-84333000,-84333000,,-4613000,,,,-3124000,8531000,92864000,13323000,-72992000,,-154201000,-154201000,54554,TRXC
2018-12-31,21823000,,-65154000,,-61777000,39590000,7931000,-64350000,-64350000,,-4208000,,,,-3377000,24102000,88452000,16171000,-804000,,-61777000,-61777000,54554,TRXC
2017-12-31,21989000,,-148096000,,-144796000,29811000,384000,-59274000,-59274000,,-2443000,,,,-3300000,7111000,66385000,6727000,-88822000,,-144796000,-144796000,54554,TRXC
2016-12-31,29273000,,-125503000,,-119980000,19964000,450000,-55754000,-55754000,,-2021000,,,,-5523000,1519000,57273000,1069000,-69749000,,-119980000,-119980000,54554,TRXC
2019-12-31,,,3121000,,311000,2476000,5597000,3121000,3121000,,,,,,738000,5597000,2476000,0,0,-2072000,2383000,-1089000,54556,FGF
2018-12-31,,,-1582000,,804000,1145000,1208000,63000,63000,,-33000.0,,,,-308000,1208000,1145000,42726000,-1645000,2078000,-1274000,-304000,54556,FGF
2017-12-31,,,1492000,,294000,9304000,11168000,1864000,1864000,,-372000.0,,,,1198000,38148000,36284000,26980000,-372000,2078000,294000,294000,54556,FGF
2016-12-31,,,119000,,11000,6918000,7392000,474000,474000,,-355000.0,,,,108000,32256000,31782000,24864000,-355000,2078000,11000,11000,54556,FGF
2020-12-31,,,589071000000,1000000,463108000000,800407000000,1426824000000,0,595588000000,30829000000,,,,,125962000000,1476063000000,880475000000,49239000000,-6517000000,,463109000000,463108000000,54557,BCH
2019-12-31,,,762692000000,1000000,593008000000,821255000000,1615724000000,0,758917000000,35552000000,,,,,169683000000,1667246000000,908329000000,51522000000,3775000000,,593009000000,593008000000,54557,BCH
2018-12-31,,,751404000000,1000000,594872000000,770873000000,1553406000000,0,744604000000,37929000000,,,,,156531000000,1591871000000,847267000000,38465000000,6800000000,,594873000000,594872000000,54557,BCH
2017-12-31,,,691047000000,1000000,576012000000,719890000000,1438452000000,0,685327000000,33235000000,,,,,115034000000,1474287000000,788960000000,35835000000,5720000000,,576013000000,576012000000,54557,BCH
2019-12-31,67187348,,198299112,,190084771,262488075,486550553,186708900,186708900,-29833770,-11396998,,,,8214341,2076289101,1889580201,1589738548,11590212,,190084771,190084771,54559,NIU
2018-12-31,91811892,,-349027476,,-349027476,422615353,198625457,-314406588,-314406588,-1395200,-7721675,,,,0,1477781304,1792187892,1279155847,-31579515,,-349027476,-349027476,54559,NIU
2017-12-31,39492743,,-184662871,,-184662871,157863999,54698283,-141825459,-141825459,-833000,-3153521,,,,0,769368001,911193460,714669718,-40391646,,-184662871,-184662871,54559,NIU
2016-12-31,33089565,,-232720922,,-232720922,180593223,-12777451,-226460239,-226460239,-833000,-2320169,,,,0,354810048,581270287,367587499,-6260683,,-232720922,-232720922,54559,NIU
2020-10-31,,,-7199713,,-7199713,15339347,101187829,85848482,85848482,,-6364899,,,,0,101187829,15339347,0,-93048195,,-7199713,-7199713,54561,ETG
2019-10-31,,,151863894,,151863894,15668401,121579607,105911206,105911206,,-12969821,,,,0,121579607,15668401,0,45952688,,151863894,151863894,54561,ETG
2018-10-31,,,-20577577,,-20577577,16436150,68702398,52266248,52266248,,-10618190,,,,0,68702398,16436150,0,-72843825,,-20577577,-20577577,54561,ETG
2017-10-31,,,278798082,,278798082,15789762,119339124,103549362,103549362,,-7484986,,,,0,119339124,15789762,0,175248720,,278798082,278798082,54561,ETG
2019-12-31,11734590,,191493711,79137265,138807748,153695905,329078378,163647883,163647883,,-557597,,,,28098525,503744922,340097039,174666544,27845828,,163395186,137117229,54566,CBPO
2018-12-31,9524412,,166003295,122653565,128056302,164393170,320090333,146172751,146172751,,-338136,,,,18036180,466877569,320704818,146787236,19830544,,147967115,124984132,54566,CBPO
2017-12-31,6503712,,146407768,66132969,67943035,102527602,244889819,135858505,135858505,,-583432,,,,64171809,370406840,234548335,125517021,10549263,,82235959,65754402,54566,CBPO
2016-12-31,7021992,,153919241,58936234,104779307,66198364,217134978,143914622,143914622,,-254471,,,,25125820,341169426,197254804,124034448,10004619,,128793421,101791878,54566,CBPO
2020-12-31,,,2266405000,,1752302000,3666356000,6085692000,2419336000,2419336000,,-161126000,,,,514103000,11604493000,9185157000,5518801000,-152931000,,1752302000,1752302000,54567,ORLY
2019-12-31,,,1790329000,,1391042000,3204765000,5394691000,1922626000,1922626000,,-139975000,,,,399287000,10149985000,8227359000,4755294000,-132297000,,1391042000,1391042000,54567,ORLY
2018-12-31,,,1694087000,,1324487000,2967382000,5039966000,1826584000,1826584000,,-122129000,,,,369600000,9536428000,7709844000,4496462000,-132497000,,1324487000,1324487000,54567,ORLY
2017-12-31,,,1637804000,,1133804000,2762583000,4720683000,1725400000,1725400000,,-91349000,,,,504000000,8977726000,7252326000,4257043000,-83996000,,1133804000,1133804000,54567,ORLY
2019-12-31,,,72471000,,55784000,148010000,250741000,0,87921000,14810000,,,,,16687000,250741000,162820000,0,-15450000,,55784000,55261000,54568,MSBI
2018-12-31,,,50805000,,39421000,164330000,241490000,0,59994000,17166000,,,,,11384000,241490000,181496000,0,-9189000,,39421000,39018000,54568,MSBI
2017-12-31,,,26471000,,16056000,128664000,177709000,0,34702000,14343000,,,,,10415000,177709000,143007000,0,-8231000,,16056000,15876000,54568,MSBI
2016-12-31,,,50431000,,31542000,102963000,173720000,0,59830000,10927000,,,,,18889000,173720000,113890000,0,-9399000,,31542000,31376000,54568,MSBI
2019-12-31,,,-62134000,,-62134000,89172000,200063000,52668000,52668000,4968000,-39154000,,,,0,219379000,166711000,19316000,-114802000,,-62134000,-62134000,54569,NMM
2018-12-31,,,-13081000,,-13081000,87329000,215157000,64163000,64163000,5331000,-42366000,,,,0,231361000,167198000,16204000,-77244000,,-13081000,-13081000,54569,NMM
2017-12-31,,,-14851000,,-15090000,84473000,200322000,39270000,39270000,3819000,-37725000,,,,0,211652000,172382000,11330000,-54121000,,-14851000,-15090000,54569,NMM
2016-12-31,,,-52549000,,-52549000,71560000,178470000,30796000,30796000,4270000,-31247000,,,,0,190524000,159728000,12054000,-83345000,,-52549000,-52549000,54569,NMM
2019-12-31,1568107000,,4969987000,422541000,4016832000,14075997000,20680228000,5599553000,5599553000,-563429000,-86004000,,,,983554000,92994418000,87394865000,72314190000,-629566000,,3986433000,4016832000,54570,VIPS
2018-12-31,2000894000,,2700076000,-51022000,2128787000,13404022000,17068967000,2320097000,2320097000,-656046000,-159744000,,,,566604000,84523948000,82203851000,67454981000,379979000,,2133472000,2128787000,54570,VIPS
2017-12-31,1808452000,,2518573000,-43943000,1949655000,12325999000,16293842000,2617283000,2617283000,-457892000,-82435000,,,,626140000,72912313000,70295030000,56618471000,-98710000,,1892433000,1949655000,54570,VIPS
2016-12-31,1563582000,,2594595000,49624000,2036817000,9679352000,13596614000,2656840000,2656840000,-303160000,-85195000,,,,601828000,56591302000,53934462000,42994688000,-62245000,,1992767000,2036817000,54570,VIPS
2019-12-31,,,-115902000,,-116484000,14202000,-105197000,-119399000,-119399000,,-156000,,,,582000,2340000,121739000,107537000,3497000,,-116484000,-116484000,54572,ADCT
2018-12-31,,,-122872000,,-123096000,8768000,-116946000,-125714000,-125714000,,-156000,,,,224000,1140000,126854000,118086000,2842000,,-123096000,-123096000,54572,ADCT
2017-12-31,,,-89814000,,-89862000,7943000,-83727000,-91670000,-91670000,,-156000,,,,48000,1803000,93473000,85530000,1856000,,-89862000,-89862000,54572,ADCT
2019-12-31,,,5287000000,1752000000,3348000000,8319000000,15380000000,7061000000,7061000000,,-1417000000,,,,1166000000,49778000000,42717000000,34398000000,-1774000000,48000000,4121000000,3326000000,54573,AIG
2018-12-31,,,257000000,948000000,-6000000,8907000000,10935000000,2028000000,2028000000,,-1309000000,,,,154000000,47487000000,45459000000,36552000000,-1771000000,-42000000,103000000,-6000000,54573,AIG
2017-12-31,,,1466000000,537000000,-6084000000,8694000000,11596000000,2902000000,2902000000,,-1168000000,,,,7526000000,49448000000,46546000000,37852000000,-1436000000,4000000,-6060000000,-6084000000,54573,AIG
2016-12-31,,,-74000000,558000000,-849000000,10295000000,10546000000,251000000,251000000,,-1260000000,,,,185000000,51209000000,50958000000,40663000000,-325000000,-90000000,-259000000,-849000000,54573,AIG
2020-12-31,,,54848000,,44138000,81539000,153368000,0,54848000,16981000,,,,,10710000,153368000,98520000,0,0,,44138000,44138000,54578,MBWM
2019-12-31,,,60460000,,49456000,74158000,149740000,0,60825000,14757000,,,,,11004000,149740000,88915000,0,-365000,,49456000,49456000,54578,MBWM
2018-12-31,,,51822000,,42024000,70296000,137092000,0,51942000,14854000,,,,,9798000,137092000,85150000,0,-120000,,42024000,42024000,54578,MBWM
2017-12-31,,,46083000,,31274000,63581000,124399000,0,45998000,14820000,,,,,14809000,124399000,78401000,0,85000,,31274000,31274000,54578,MBWM
2019-12-31,,,829000000,2293000000,303000000,213000000,2349000000,2136000000,2136000000,,-1050000000,,,,352000000,10189000000,8053000000,7840000000,-1307000000,1000000,477000000,303000000,54580,AES
2018-12-31,,,2057000000,2456000000,1203000000,202000000,2574000000,2372000000,2372000000,,-1056000000,,,,708000000,10736000000,8364000000,8162000000,-315000000,218000000,1349000000,1203000000,54580,AES
2017-12-31,,,842000000,2440000000,-1161000000,216000000,2487000000,2271000000,2271000000,,-1170000000,,,,990000000,10530000000,8259000000,8043000000,-1429000000,-654000000,-148000000,-1161000000,54580,AES
2016-12-31,,,223000000,2966000000,-1130000000,197000000,2383000000,2186000000,2186000000,,-1134000000,,,,32000000,10281000000,8095000000,7898000000,-1963000000,-1110000000,191000000,-1130000000,54580,AES
2020-12-31,,,811000000,,791000000,66000000,696000000,455000000,455000000,40000000,-120000000,,,,3000000,1038000000,583000000,342000000,356000000,,808000000,750000000,54581,PSXP
2019-12-31,,,926000000,,783000000,67000000,721000000,495000000,495000000,39000000,-108000000,,,,3000000,1126000000,631000000,405000000,431000000,,923000000,746000000,54581,PSXP
2018-12-31,,,800000000,-1313000000.0,556000000,64000000,691000000,475000000,475000000,35000000,-115000000,,,,4000000,1045000000,570000000,354000000,325000000,,796000000,519000000,54581,PSXP
2017-12-31,,,465000000,-1345000000.0,301000000,69000000,613000000,395000000,395000000,33000000,-102000000,,,,4000000,934000000,539000000,321000000,70000000,,461000000,292000000,54581,PSXP
2020-12-31,518072000,,-169638000,,-162115000,1029938000,1583422000,35412000,35412000,,-155227000,,,,-7523000,3339817000,3304405000,1756395000,-205050000,,-162115000,-162115000,54582,ZG
2019-12-31,477347000,,-309619000,,-305361000,1080304000,1310816000,-246835000,-246835000,,-101792000,,,,-4258000,2742837000,2989672000,1432021000,-62784000,,-305361000,-305361000,54582,ZG
2018-12-31,410818000,,-150960000,,-119858000,814774000,1179964000,-45628000,-45628000,,-41255000,,,,-31102000,1333554000,1379182000,153590000,-86062000,,-119858000,-119858000,54582,ZG
2017-12-31,319985000,,-184006000,,-94420000,659017000,991591000,12589000,12589000,,-27517000,,,,-89586000,1076794000,1064205000,85203000,-196595000,,-94420000,-94420000,54582,ZG
2019-12-31,,,-46700000,3522100000,-209200000,1073600000,2552600000,519700000,519700000,200000,-339200000,,,,-87900000,8671100000,8151400000,6118500000,-566400000,,41200000,-334000000,54584,TRGP
2018-12-31,,,65900000,1391400000,1600000,978900000,2245800000,447400000,447400000,3600000,-187800000,,,,5500000,10484000000,10036600000,8238200000,-381500000,,60400000,-119300000,54584,TRGP
2017-12-31,,,-292900000,595700000,54000000,826300000,1908800000,271500000,271500000,1500000,-235900000,,,,-397100000,8814900000,8543400000,6906100000,-564400000,,104200000,-63400000,54584,TRGP
2016-12-31,,,-259700000,475800000,-187300000,740900000,1768000000,268900000,268900000,500000,-254200000,,,,-100600000,6690900000,6422000000,4922900000,-528600000,,-159100000,-278100000,54584,TRGP
2020-12-31,43365000,,-7172000,,-9348000,61422000,95840000,-8947000,-8947000,,,,,,2176000,135922000,144869000,40082000,1775000,,-9348000,-9348000,54587,ALLT
2019-12-31,31461000,,-7018000,,-8659000,58621000,76266000,-13816000,-13816000,,,,,,1641000,110100000,123916000,33834000,6798000,,-8659000,-8659000,54587,ALLT
2018-12-31,25418000,,-7987000,,-10415000,51265000,66488000,-10195000,-10195000,,,,,,2428000,95837000,106032000,29349000,2208000,,-10415000,-10415000,54587,ALLT
2017-12-31,21852000,,-16508000,,-18072000,49012000,53462000,-17402000,-17402000,,,,,,1564000,81992000,99394000,28530000,894000,,-18072000,-18072000,54587,ALLT
2019-12-31,,,8524000,738000,5883000,17287000,33582000,0,9932000,6363000,,,,,2631000,33582000,23650000,0,-1408000,,5893000,5883000,54590,PTRS
2018-12-31,,,7841000,738000,5482000,14174000,30129000,0,10282000,5673000,,,,,2359000,30129000,19847000,0,-2441000,,5482000,5482000,54590,PTRS
2017-12-31,,,6629445,738000,3414384,10594940,22211607,0,7395039,4221628,,,,,3215061,22211607,14816568,0,-765594,,3414384,3414384,54590,PTRS
2016-12-31,,,6393085,738000,4017727,9501843,19992275,0,6371688,4118744,,,,,2375358,19992275,13620587,0,21397,,4017727,4017727,54590,PTRS
2019-12-31,,,158333000,,154583000,70352000,251495000,181143000,181143000,,-39875000,,,,3750000,251495000,70352000,0,-22810000,,154583000,154583000,54592,TSLX
2018-12-31,,,122392000,,119017000,71889000,261914000,190025000,190025000,,-44462000,,,,3375000,261914000,71889000,0,-67633000,,119017000,119017000,54592,TSLX
2017-12-31,,,114444000,,111609000,60362000,210897000,150535000,150535000,,-28472000,,,,2835000,210897000,60362000,0,-36091000,,111609000,111609000,54592,TSLX
2016-12-31,,,139232000,,137007000,59744000,192410000,132666000,132666000,,-23441000,,,,2225000,192410000,59744000,0,6566000,,137007000,137007000,54592,TSLX
2019-12-31,,,252554000,709158000,111861000,56235000,200555000,12304000,12304000,,-90569000,,,,0,350254000,337950000,149699000,240250000,-98297000,252554000,85976000,54593,CLI
2018-12-31,,,80267000,540982000,84111000,47265000,211709000,52200000,52200000,,-77346000,,,,0,366490000,314290000,154781000,28067000,23473000,80267000,72686000,54593,CLI
2017-12-31,,,10840000,404636000,23185000,50475000,261185000,68391000,68391000,,-84523000,,,,0,453741000,385350000,192556000,-57551000,20508000,10840000,5234000,54593,CLI
2016-12-31,,,130294000,199516000,117224000,51979000,362525000,123862000,123862000,,-94889000,,,,0,632622000,508760000,270097000,6432000,20508000,130294000,117224000,54593,CLI
2019-12-31,294000000,,194000000,,126000000,854000000,1466000000,189000000,189000000,3000000,-7000000,,,,68000000,1560000000,1371000000,94000000,5000000,,126000000,126000000,54595,TRIP
2018-12-31,275000000,,173000000,,113000000,950000000,1529000000,188000000,188000000,3000000,-12000000,,,,60000000,1615000000,1427000000,86000000,-15000000,,113000000,113000000,54595,TRIP
2017-12-31,243000000,,110000000,,-19000000,1006000000,1484000000,124000000,124000000,3000000,-15000000,,,,129000000,1556000000,1432000000,72000000,-14000000,,-19000000,-19000000,54595,TRIP
2016-12-31,243000000,,151000000,,120000000,899000000,1409000000,166000000,166000000,3000000,-12000000,,,,31000000,1480000000,1314000000,71000000,-16000000,,120000000,120000000,54595,TRIP
2019-12-31,9021403,,-4591284,,-4591284,18571547,22766091,-4826859,-4826859,,,,,,0,28902550,33729409,6136459,235575,,-4591284,-6020684,54596,STXS
2018-12-31,8125905,,116756,,116756,17867090,23629438,-2363557,-2363557,,-16566.0,,,,0,29346617,31710174,5717179,2480313,,116756,-1317244,54596,STXS
2017-12-31,6626422,,-5887410,,-5887410,19605258,20389861,-5841819,-5841819,,-179844.0,,,,0,31144100,36985919,10754239,-45591,,-5887410,-7319669,54596,STXS
2016-12-31,5487609,,-5286720,,-5286720,25573531,24634783,-6426357,-6426357,,-2483384.0,,,,0,32164116,38590473,7529333,1139637,,-5286720,-11800274,54596,STXS
2019-12-31,,,1171504000,531233000,772388000,326664000,2293917000,1457328000,1457328000,,-143321000,,,,299152000,17486578000,16029250000,15192661000,-285824000,,872352000,771354000,54597,HFC
2018-12-31,,,1524467000,540488000,1097960000,283066000,2351741000,1631351000,1631351000,,-131363000,,,,347243000,17714666000,16083315000,15362925000,-106884000,,1177224000,1094246000,54597,HFC
2017-12-31,,,868863000,526111000,805395000,235327000,1595442000,950178000,950178000,,-117597000,,,,-12379000,14251299000,13301121000,12655857000,-81315000,,881242000,800348000,54597,HFC
2016-12-31,,,-171534000,620591000,-260453000,109835000,1040459000,567597000,567597000,,-72192000,,,,19411000,10535700000,9968103000,9495241000,-739131000,,-190945000,-261456000,54597,HFC
2019-12-31,,,25398000,,17292000,19098000,54876000,0,25398000,10380000,,,,,8106000,62272000,36874000,7396000,0,,17292000,17292000,54599,VEL
2018-12-31,,,19249000,,7631000,19465000,44034000,0,19249000,5320000,,,,,11618000,50043000,30794000,6009000,0,,7631000,7631000,54599,VEL
2017-12-31,,,13989000,,13989000,14680000,32233000,0,13989000,3564000,,,,,0,37140000,23151000,4907000,0,,13989000,13989000,54599,VEL
2016-12-31,,,6797000,,6797000,13523000,22829000,0,6797000,2509000,,,,,0,26486000,19689000,3657000,0,,6797000,6797000,54599,VEL
2020-11-30,,,4002142,,4002142,888032,4331397,3443365,3443365,,-525961,,,,0,4331397,888032,0,558777,,4002142,4002142,54600,EVY
2019-11-30,,,9584270,,9584270,865894,4533584,3667690,3667690,,-923085,,,,0,4533584,865894,0,5916580,,9584270,9584270,54600,EVY
2018-11-30,,,-886147,,-886147,898777,5184934,4286157,4286157,,-1169473,,,,0,5184934,898777,0,-5172304,,-886147,-911349,54600,EVY
2017-11-30,,,4204073,,4204073,1082583,5504204,4421621,4421621,,-981833,,,,0,5504204,1082583,0,-217548,,4204073,4149306,54600,EVY
2019-12-29,67515000,,18910000,11336000,22159000,260443000,127572000,-200386000,-200386000,,-53353000,,,,26631000,1864225000,2064611000,1736653000,219296000,,-7721000,22159000,54602,SPWR
2018-12-30,68905000,,-916486000,58810000,-811091000,260111000,67879000,-261137000,-261137000,,-108011000,,,,1010000,1726085000,1987222000,1658206000,-655349000,,-917496000,-811091000,54602,SPWR
2017-12-31,82247000,,-1174812000,119415000,-929121000,278645000,-18645000,-379537000,-379537000,,-90288000,,,,-3944000,1794047000,2173584000,1812692000,-795275000,,-1170868000,-929121000,54602,SPWR
2017-01-01,116889000,,-514097000,183109000,-448635000,332757000,221819000,-227827000,-227827000,,-61273000,,,,7318000,2552637000,2780464000,2330818000,-286270000,,-521415000,-448635000,54602,SPWR
2019-12-31,22725000,,-30704000,,-30704000,8441000,0,-31166000,-31166000,,,,,,0,0,31166000,0,462000,,-30704000,-34991000,54605,ONCR
2018-12-31,11280000,,-18046000,,-18046000,7298000,0,-18578000,-18578000,,,,,,0,0,18578000,0,532000,,-18046000,-18144000,54605,ONCR
2017-12-31,11283000,,-16671000,,-16671000,5390000,0,-16673000,-16673000,,,,,,0,0,16673000,0,2000,,-16671000,-16760000,54605,ONCR
2019-12-31,45973000,,105193000,,96336000,139268000,355010000,165969000,165969000,3613000,-52545000,,,,13975000,1258094000,1092125000,903084000,-60776000,5118000,91218000,96336000,54608,ITGR
2018-12-28,48604000,,61116000,,167964000,142441000,362665000,170112000,170112000,1503000,-99310000,,,,14083000,1215012000,1044900000,852347000,-108996000,120931000,47033000,167964000,54608,ITGR
2017-12-29,48850000,,49259000,,66679000,143073000,354010000,162713000,162713000,-626000,-63972000,,,,-37828000,1136080000,973367000,782070000,-113454000,-20408000,87087000,66679000,54608,ITGR
2016-12-30,47899000,,28165000,,5961000,133404000,337679000,155401000,155401000,-626000,-68331000,,,,3287000,1075502000,920101000,737823000,-127236000,-18917000,24878000,5961000,54608,ITGR
2019-12-31,,,-35424,,-35424,,0,0,,,,,,,0,0,0,0,-35424,,-35424,-35424,54612,BRLI
2020-12-31,,,6238000000,,4572000000,26403000000,33822000000,7058000000,7058000000,,-784000000,,,,1666000000,121867000000,114809000000,88045000000,-820000000,,4572000000,4572000000,54614,ANTM
2019-12-31,,,5985000000,,4807000000,15356000000,22426000000,6732000000,6732000000,,-745000000,,,,1178000000,104212000000,97480000000,81786000000,-747000000,,4807000000,4807000000,54614,ANTM
2018-12-31,,,5068000000,,3750000000,14020000000,20196000000,5818000000,5818000000,,-739000000,,,,1318000000,92091000000,86273000000,71895000000,-750000000,,3750000000,3750000000,54614,ANTM
2017-12-31,,,3964000000,,3843000000,12650000000,17813000000,4994000000,4994000000,,-748000000,,,,121000000,90049000000,85055000000,72236000000,-1030000000,,3843000000,3843000000,54614,ANTM
2020-09-30,,,39743000,,101980000,159490000,275497000,94195000,94195000,,-6730000,,,,14278000,732915000,638720000,457418000,-54452000,76515000,25465000,101980000,54616,ESE
2019-09-30,,,97877000,,81039000,162734000,288046000,106820000,106820000,,-8092000,,,,20388000,726044000,619224000,437998000,-8943000,3550000,77489000,81039000,54616,ESE
2018-09-30,,,81091000,,92136000,153065000,263937000,93610000,93610000,,-8798000,,,,-5170000,683650000,590040000,419713000,-12519000,5875000,86261000,92136000,54616,ESE
2017-09-30,,,80153000,,53703000,148433000,248822000,84051000,84051000,,-4578000,,,,26450000,685740000,601689000,436918000,-2898000,5875000,53703000,53703000,54616,ESE
2019-12-31,104641000,,-86429000,,-86429000,35050000,50000000,-89691000,-89691000,,,,,,0,50000000,139691000,0,3262000,,-86429000,-86429000,54620,VIE
2018-12-31,42414000,,-190270000,,-190270000,6565000,0,-48979000,-48979000,,,,,,0,0,48979000,0,-141291000,,-190270000,-190270000,54620,VIE
2019-12-31,72476000,,59151000,,37506000,118680000,288335000,97179000,97179000,,-4763000,,,,21645000,971684000,874505000,683349000,-38028000,,37506000,37506000,54624,THRM
2018-12-31,79900000,,58119000,,41899000,137398000,304858000,87560000,87560000,,-4942000,,,,16220000,1048505000,960945000,743647000,-29441000,,41899000,41899000,54624,THRM
2017-12-31,82478000,,69255000,,35227000,139619000,319195000,97098000,97098000,,-4885000,,,,34028000,993991000,896893000,674796000,-27843000,,35227000,35227000,54624,THRM
2016-12-31,72923000,,110563000,,76598000,113252000,299037000,112862000,112862000,,-3257000,,,,33965000,917600000,804738000,618563000,-2299000,,76598000,76598000,54624,THRM
2020-12-31,5947000,,7023000,123000,5232000,17511000,29159000,5701000,5701000,,-436000,,,,1692000,107712000,102011000,78553000,1322000,,5331000,5232000,54625,ULBI
2019-12-31,6805000,,6771000,24000,5205000,16992000,31429000,7632000,7632000,,-382000,,,,1457000,106795000,99163000,75366000,-861000,,5314000,5205000,54625,ULBI
2018-12-31,4508000,,6613000,-85000,24930000,14520000,25583000,6555000,6555000,,-63000,,,,-18386000,87190000,80635000,61607000,58000,,24999000,24930000,54625,ULBI
2017-12-31,4737000,,6295000,-154000,7648000,15019000,26232000,6476000,6476000,,-183000,,,,-1369000,85531000,79055000,59299000,-181000,,7664000,7648000,54625,ULBI
2020-12-31,,,6179000,,4980000,23505000,33573000,0,7708000,2360000,,,,,1199000,33573000,25865000,0,-1529000,,4980000,4980000,54629,BOTJ
2019-12-31,,,6934000,,5605000,21749000,31217000,0,7526000,1942000,,,,,1329000,31217000,23691000,0,-592000,,5605000,5605000,54629,BOTJ
2018-12-31,,,6631000,,5302000,18786000,27695000,0,7306000,1603000,,,,,1329000,27695000,20389000,0,-675000,,5302000,5302000,54629,BOTJ
2017-12-31,,,5360000,,2922000,17080000,24406000,0,5823000,1503000,,,,,2438000,24406000,18583000,0,-463000,,2922000,2922000,54629,BOTJ
2020-12-31,8424000,,-14878000,,-14878000,6545000,49000,-14920000,-14920000,,,,,,0,62000,14982000,13000,42000,,-14878000,-14878000,54632,ATOM
2019-12-31,7556000,,-13300000,,-13300000,6349000,280000,-13625000,-13625000,,,,,,0,533000,14158000,253000,325000,,-13300000,-13300000,54632,ATOM
2018-12-31,7318000,,-12897000,,-12897000,5913000,98000,-13133000,-13133000,,,,,,0,246000,13379000,148000,236000,,-12897000,-12897000,54632,ATOM
2017-12-31,5826000,,-13068000,,-13068000,7455000,71000,-13210000,-13210000,,,,,,0,110000,13320000,39000,142000,,-13068000,-13068000,54632,ATOM
2020-12-31,,,1154006000,,880690000,304453000,1718309000,0,1180221000,233635000,,,,,273316000,1718309000,538088000,0,-26215000,,880690000,870956000,54633,SLM
2019-12-31,,,743740000,,578276000,311081000,1317993000,0,743740000,263172000,,,,,165464000,1317993000,574253000,0,0,,578276000,561439000,54633,SLM
2018-12-31,,,559329000,,487476000,285132000,1116305000,0,559329000,271844000,,,,,71853000,1116305000,556976000,0,0,,487476000,471836000,54633,SLM
2017-12-31,,,491465000,,288934000,242269000,940554000,0,491465000,206820000,,,,,202531000,940554000,449089000,0,0,,288934000,273220000,54633,SLM
2020-12-31,,,9611000,,7055000,13056000,26324000,0,9899000,3369000,,,,,2556000,26324000,16425000,0,-288000,,7055000,7055000,54635,AMRB
2019-12-31,,,7391000,,5500000,13480000,24237000,0,7651000,3106000,,,,,1891000,24237000,16586000,0,-260000,,5500000,5500000,54635,AMRB
2018-12-31,,,6474000,,4900000,12367000,21984000,0,6774000,2843000,,,,,1574000,21984000,15210000,0,-300000,,4900000,4900000,54635,AMRB
2017-12-31,,,6450000,,3198000,10787000,20499000,0,6774000,2938000,,,,,3252000,20499000,13725000,0,-324000,,3198000,3198000,54635,AMRB
2020-12-31,,,35407000000,,29131000000,60715000000,102063000000,0,36507000000,4841000000,,,,,6276000000,102063000000,65556000000,0,-1100000000,,29131000000,27410000000,54639,JPM
2019-12-31,,,44545000000,,36431000000,60410000000,110041000000,0,44784000000,4847000000,,,,,8114000000,110041000000,65257000000,0,-239000000,,36431000000,34642000000,54639,JPM
2018-12-31,,,40764000000,,32474000000,57663000000,103984000000,0,40836000000,5485000000,,,,,8290000000,103984000000,63148000000,0,-72000000,,32474000000,30709000000,54639,JPM
2017-12-31,,,35900000000,,24441000000,53436000000,94745000000,0,35220000000,6089000000,,,,,11459000000,94745000000,59525000000,0,680000000,,24441000000,22567000000,54639,JPM
2020-12-31,,,6140700000,,4730500000,2245000000,9752100000,7213700000,7213700000,-7200000,-1218100000,,,,1410200000,19207800000,11994100000,9455700000,-1073000000,,4730500000,4730500000,54641,MCD
2019-12-31,,,8018100000,,6025400000,2229400000,11115300000,8890700000,8890700000,-4800000,-1121900000,,,,1992700000,21076500000,12185800000,9961200000,-872600000,,6025400000,6025400000,54641,MCD
2018-12-31,,,7816100000,,5924300000,2200200000,10786000000,8579100000,8579100000,6700000,-981200000,,,,1891800000,21025200000,12446100000,10239200000,-763000000,,5924300000,5924300000,54641,MCD
2017-12-31,,,8573500000,,5192300000,2231300000,10620800000,8392300000,8392300000,-2800000,-921300000,,,,3381200000,22820400000,14428100000,12199600000,181200000,,5192300000,5192300000,54641,MCD
2019-12-31,,,24177000,,-13507000,96435000,128552000,30740000,30740000,,-2975000,,,,9084000,611786000,581046000,483234000,-6563000,-28600000,15093000,-13507000,54642,HBB
2018-12-31,,,30485000,,17698000,103434000,139052000,34237000,34237000,,-2916000,,,,7426000,630082000,595845000,491030000,-3752000,-5361000,23059000,17698000,54642,HBB
2017-12-31,,,37076000,,15884000,90617000,136117000,44119000,44119000,,-1572000,,,,18967000,612056000,567937000,475939000,-7043000,-2225000,18109000,15884000,54642,HBB
2016-12-31,,,41163000,,26179000,149016000,193771000,43374000,43374000,,-1374000,,,,14984000,745357000,701983000,551586000,-2211000,-2225000,26179000,26179000,54642,HBB
2019-12-31,,,-20720000,2037000,-19029000,31086000,39636000,-6651000,-6651000,634000,-5157000,,,,253000,114288000,120939000,74652000,-14069000,,-20973000,-19029000,54644,RLH
2018-12-31,,,14396000,21164000,1338000,33762000,43298000,-8086000,-8086000,619000,-6209000,,,,-71000,135849000,143935000,92551000,22482000,,14467000,1338000,54644,RLH
2017-12-31,,,-6331000,27381000,581000,29653000,50760000,2283000,2283000,-9000,-8252000,,,,-4662000,171926000,169643000,121166000,-8614000,181000.0,-1669000,581000,54644,RLH
2016-12-31,,,-6572000,32507000,-4677000,18007000,34259000,157000,157000,42000,-6752000,,,,-478000,148351000,148194000,114092000,-6729000,1254000.0,-6094000,-4677000,54644,RLH
2019-12-31,5904000,,-12236000,399000,-12154000,8139000,1484000,-12559000,-12559000,,,,,,148000,1728000,14287000,244000,323000,,-12384000,-12154000,54645,AGE
2018-12-31,5830000,,-7731000,784000,-7502000,5647000,1032000,-10445000,-10445000,,,,,,0,1396000,11841000,364000,2714000,,-7731000,-7502000,54645,AGE
2017-12-31,5784000,,-6637000,1039000,-6580000,3869000,1236000,-8417000,-8417000,,-12000.0,,,,0,1404000,9821000,168000,1780000,,-6637000,-6580000,54645,AGE
2016-12-31,8479000,,-17355000,1044000,-15492000,5622000,1362000,-12739000,-12739000,,-25000.0,,,,0,1666000,14405000,304000,-4616000,,-17355000,-15492000,54645,AGE
2020-01-31,159150000,,-210332000,,-208913000,449799000,426685000,-182264000,-182264000,,-27017000,,,,-1419000,586067000,768331000,159382000,-28068000,,-208913000,-208913000,54646,OKTA
2019-01-31,102385000,,-125514000,,-125497000,301970000,285833000,-118522000,-118522000,,-15072000,,,,-17000,399254000,517776000,113421000,-6992000,,-125497000,-125497000,54646,OKTA
2018-01-31,69707000,,-110170000,,-109849000,216823000,175792000,-110738000,-110738000,,-15072000,,,,-321000,256547000,367285000,80755000,568000,,-109849000,-109849000,54646,OKTA
2017-01-31,38659000,,-74631000,,-75056000,140868000,104857000,-74670000,-74670000,,-15072000,,,,425000,160806000,235476000,55949000,78000,,-75056000,-75056000,54646,OKTA
2020-12-31,27000000,,173000000,1704000000,-170000000,206000000,1317000000,431000000,431000000,,-146000000,,,,187000000,9286000000,8855000000,7969000000,-258000000,,-14000000,-170000000,54648,AA
2019-12-31,27000000,,-438000000,1774000000,-1125000000,395000000,1921000000,748000000,748000000,38000000.0,-121000000,,,,415000000,10433000000,9685000000,8512000000,-1186000000,,-853000000,-1125000000,54648,AA
2018-12-31,31000000,,1625000000,1970000000,250000000,387000000,3353000000,2077000000,2077000000,125000000.0,-122000000,,,,732000000,13403000000,11326000000,10050000000,-452000000,,893000000,250000000,54648,AA
2017-12-31,32000000,,1200000000,2275000000,279000000,365000000,2757000000,1592000000,1592000000,18000000.0,-104000000,,,,592000000,11652000000,10060000000,8895000000,-392000000,,608000000,279000000,54648,AA
2019-12-31,,,-7290120,,-7290120,15199248,10434319,-6515558,-6515558,,-233654,,,,0,18955672,25471230,8521353,-774562,,-7290120,-7290120,54650,IZEA
2018-12-31,,,-5718407,,-5718407,14668231,11057540,-4909050,-4909050,,-269473,,,,0,20099695,25008745,9042155,-809357,,-5718407,-5718407,54650,IZEA
2017-12-31,,,-5467699,,-5467699,16577197,12852333,-5241671,-5241671,,-64950,,,,0,24437649,29679320,11585316,-226028,,-5467699,-5467699,54650,IZEA
2016-12-31,,,-7560200,,-7560200,16789356,10759528,-7329679,-7329679,,-82944,,,,0,21234297,28563976,10474769,-230521,,-7560200,-7560200,54650,IZEA
2019-12-31,,,-8608000,,-10178000,8502000,39521000,-5367000,-5367000,,-2406000,,,,1570000,44732000,50099000,5211000,-3241000,,-10178000,-10178000,54652,MMX
2018-12-31,,,4027000,,2711000,5722000,30669000,7487000,7487000,,-669000,,,,1316000,34051000,26564000,3382000,-3460000,,2711000,2711000,54652,MMX
2017-12-31,,,3478000,,2683000,4819000,17541000,3703000,3703000,,-645000,,,,795000,19523000,15820000,1982000,-225000,,2683000,2683000,54652,MMX
2016-12-31,,,-8251000,,-8323000,1994000,1831000,-1276000,-1276000,,-645000,,,,72000,2349000,3625000,518000,-6975000,,-8323000,-8323000,54652,MMX
2019-12-31,,,65863000,3859000,56106000,45244000,113711000,71082000,71082000,-2615000,-3242000,,,,9101000,146054000,74972000,32343000,-5219000,,56762000,56106000,54654,KUKE
2018-12-31,,,50611000,3236000,38612000,66479000,118127000,55273000,55273000,-3625000,-1910000,,,,10147000,152241000,96968000,34114000,-4662000,,40464000,38612000,54654,KUKE
2019-12-31,,,12666000,,16196000,45745000,66558000,0,14972000,5841000,,,,,2129000,66558000,51586000,0,-2306000,,10537000,16196000,54655,RBNC
2018-12-31,,,11879000,,14085000,41368000,62440000,0,15446000,5626000,,,,,1372000,62440000,46994000,0,-3567000,,10507000,14085000,54655,RBNC
2017-12-31,,,8105000,,7246000,26272000,39181000,0,9930000,2979000,,,,,1942000,39181000,29251000,0,-1825000,,6163000,7246000,54655,RBNC
2016-12-31,,,10110000,,8936000,25905000,40484000,0,10618000,3961000,,,,,2213000,40484000,29866000,0,-590000,,7897000,8936000,54655,RBNC
2020-12-31,,,51667000,,37467000,131751000,221089000,0,61110000,28228000,,,,,14200000,221089000,159979000,0,-9443000,,37467000,36684000,54657,BY
2019-12-31,,,77295000,,57002000,145627000,251070000,0,86964000,18479000,,,,,20293000,251070000,164106000,0,-9669000,,57002000,56219000,54657,BY
2018-12-31,,,55440000,,41193000,119775000,210336000,0,75579000,14982000,,,,,14247000,210336000,134757000,0,-20139000,,41193000,40410000,54657,BY
2017-12-31,,,40794000,,21695000,103013000,159289000,0,45718000,10558000,,,,,19099000,159289000,113571000,0,-4924000,,21695000,10418000,54657,BY
2020-06-30,,,-117411000000,4941000000,-91109000000,39580000000,89765000000,13069000000,13069000000,13976000000,-7352000000,,,,-26139000000,190367000000,177298000000,100602000000,-130480000000,,-91272000000,-91109000000,54659,SSL
2019-06-30,,,9231000000,5885000000,4298000000,39609000000,102760000000,28491000000,28491000000,15995000000,-3190000000,,,,3157000000,203576000000,175085000000,100816000000,-19260000000,,6074000000,4298000000,54659,SSL
2018-06-30,,,15704000000,5623000000,8729000000,36025000000,95692000000,27713000000,27713000000,14865000000,-3468000000,,,,5558000000,181461000000,153748000000,85769000000,-12009000000,,10146000000,8729000000,54659,SSL
2017-06-30,,,30008000000,5523000000,20374000000,32189000000,92317000000,32950000000,32950000000,10483000000,-2887000000,,,,8495000000,172407000000,139457000000,80090000000,-2942000000,,21513000000,20374000000,54659,SSL
2020-06-30,,,-290000,,-1140000,601000,5088000,-329000,-329000,3366000,-29000,,,,296000,47813000,48142000,42725000,39000,-554000,-586000,-1140000,54660,SSY
2019-06-30,,,-2078000,,-1754000,609000,3737000,-2185000,-2185000,3827000,-241000,,,,-82000,45618000,47803000,41881000,107000,242000,-1996000,-1754000,54660,SSY
2018-06-30,,,-571000,,-1593000,615000,4670000,-1112000,-1112000,3636000,-359000,,,,-345000,45209000,46321000,40539000,541000,-1367000,-226000,-1593000,54660,SSY
2017-06-30,,,-2471000,,2688000,561000,4944000,-3083000,-3083000,5552000,-635000,,,,-512000,52850000,55933000,47906000,612000,4647000,-1959000,2688000,54660,SSY
2020-07-31,25096817,,-43126011,,-42253426,18312268,0,-43409085,-43409085,,-5114,,,,-872585,0,43409085,0,283074,,-42253426,-42253426,54662,ONCS
2019-07-31,18445199,,-30274756,,-30276053,11971479,0,-30416678,-30416678,,-3805,,,,1297,0,30416678,0,141922,,-30276053,-30276053,54662,ONCS
2018-07-31,17415520,,-39135686,,-39136366,18689839,0,-36105359,-36105359,,-3805,,,,680,0,36105359,0,-3030327,,-39136366,-39136366,54662,ONCS
2017-07-31,11952748,,-21448407,,-21449798,9669481,0,-21622229,-21622229,,-3805,,,,1391,0,21622229,0,173822,,-21449798,-21449798,54662,ONCS
2020-12-31,,,24456000,,19444000,29244000,53605000,24361000,24361000,,,,,,5012000,239825000,215464000,186220000,95000,,19444000,19444000,54664,MPX
2019-12-31,730000.0,,34458000,,28239000,30676000,65394000,34135000,34135000,-147000.0,,,,,6219000,292136000,258001000,226742000,323000,,28239000,28239000,54664,MPX
2018-12-31,822000.0,,35655000,,28488000,30114000,66323000,35387000,35387000,-147000.0,,,,,7167000,298616000,263229000,232293000,268000,,28488000,28488000,54664,MPX
2017-12-31,960000.0,,29988000,,19300000,28301000,59020000,29759000,29759000,-147000.0,,,,,10688000,267316000,237557000,208296000,229000,,19300000,19300000,54664,MPX
2019-12-31,,,-21653049,,-21653049,6243156,0,-21280249,-21280249,1238099,-88466,,,,0,0,21280249,0,-372800,,-21653049,-21653049,54665,ITRG
2018-12-31,,,-14807839,,-14807839,5406210,0,-16614297,-16614297,1380172,-95545,,,,0,0,16614297,0,1806458,,-14807839,-14807839,54665,ITRG
2017-12-31,,,-5523877,,-5523877,2171696,0,-4833540,-4833540,2383552,-95545,,,,0,0,4833540,0,-690337,,-5523877,-5523877,54665,ITRG
2016-12-31,,,342026,,342026,73738,0,-73738,-73738,2383552,-95545,,,,0,0,73738,0,415764,,342026,342026,54665,ITRG
2019-12-31,45944000,,-51263000,1710000,-51283000,9874000,0,-55818000,-55818000,,-94000,,,,0,0,55818000,0,4555000,,-51263000,-51283000,54667,QS
2018-12-31,33134000,,-44144000,1690000,-44149000,9268000,0,-42453000,-42453000,,-1520000,,,,0,0,42453000,0,-1691000,,-44144000,-44149000,54667,QS
2020-12-31,547851000,,130837000,,111781000,293355000,953966000,112760000,112760000,,,,,,19056000,987538000,874778000,33572000,18077000,,111781000,111781000,54673,EXEL
2019-12-31,336964000,,398109000,,321012000,228244000,935978000,370770000,370770000,,,,,,77097000,967775000,597005000,31797000,27339000,,321012000,321012000,54673,EXEL
2018-12-31,182257000,,452092000,,690070000,206366000,828578000,439955000,439955000,,,,,,-237978000,853826000,413871000,25248000,12137000,,690070000,690070000,54673,EXEL
2017-12-31,112171000,,158577000,,154227000,159330000,438611000,167110000,167110000,,-8679000.0,,,,4350000,452477000,285367000,13866000,-8533000,,154227000,153860000,54673,EXEL
2020-07-31,52180000,,9310000,,7020000,117130000,226833000,35928000,35928000,,-6054000,,,,2290000,616715000,580787000,389882000,-26618000,,7020000,7020000,54675,CMTL
2019-07-31,56407000,,28910000,,25041000,127266000,247440000,45447000,45447000,,-12462000,,,,3869000,671797000,626350000,424357000,-16537000,,25041000,25041000,54675,CMTL
2018-07-31,53869000,,24626000,,29769000,113922000,223941000,35075000,35075000,,-10195000,,,,-5143000,570589000,535514000,346648000,-10449000,,29769000,29769000,54675,CMTL
2017-07-31,54260000,,25481000,,15827000,116080000,218185000,25022000,25022000,,-11629000,,,,9654000,550368000,525346000,332183000,459000,,15827000,15827000,54675,CMTL
2020-08-29,,,334250000,5628000,251117000,906853000,1343322000,367769000,367769000,,-16673000,,,,82492000,3192399000,2824630000,1849077000,-33519000,,251758000,251117000,54678,MSM
2019-08-31,,,383129000,5329000,288865000,935822000,1432043000,431221000,431221000,,-16890000,,,,94332000,3363817000,2932596000,1931774000,-48092000,,288797000,288745000,54678,MSM
2018-09-01,,,406189000,5329000,329223000,965208000,1392961000,427753000,427753000,,-14463000,,,,76966000,3203878000,2776125000,1810917000,-21564000,,329223000,328843000,54678,MSM
2017-09-02,,,367992000,5329000,231431000,907247000,1286247000,379000000,379000000,,-12370000,,,,136561000,2887744000,2508744000,1601497000,-11008000,,231431000,230815000,54678,MSM
2019-12-31,8350000,,-16740000,,-16740000,4085000,0,-12435000,-12435000,,-2256000,,,,0,0,12435000,0,-4305000,,-16740000,-20544000,54679,SNSE
2018-12-31,8227000,,-13039000,,-13039000,4513000,0,-12740000,-12740000,,-327000,,,,0,0,12740000,0,-299000,,-13039000,-16843000,54679,SNSE
2019-12-31,12458000,,-25478000,31556000,-24121000,25337000,15024000,-24604000,-24604000,-228000,-657000,,,,563000,33256000,57860000,18232000,-874000,,-26041000,-28216000,54681,ORGS
2018-12-31,17172000,,-35880000,24869000,-32928000,23808000,7572000,-35556000,-35556000,-228000,-480000,,,,-996000,22224000,57780000,14652000,-324000,,-34884000,-35088000,54681,ORGS
2018-11-30,6464000,,-17767000,24452000,-18291000,16303000,7831000,-13919000,-13919000,-2930000,-2753000,,,,1337000,18655000,32574000,10824000,-3848000,,-19104000,-19175000,54681,ORGS
2017-11-30,2478000,,-13677000,3606000,-12367000,9189000,3282000,-10016000,-10016000,-2930000,-1233000,,,,-1310000,10089000,20105000,6807000,-3661000,,-12367000,-12367000,54681,ORGS
2020-09-30,13000000,,451000000,,317000000,370000000,863000000,533000000,533000000,-53000000,-74000000,,,,134000000,2353000000,1820000000,1490000000,-82000000,,317000000,317000000,54683,VVV
2019-09-30,13000000,,265000000,,208000000,482000000,816000000,341000000,341000000,-20000000,-73000000,,,,57000000,2390000000,2049000000,1574000000,-76000000,,208000000,208000000,54683,VVV
2018-09-30,14000000,,332000000,,166000000,416000000,806000000,379000000,379000000,-3000000,-63000000,,,,166000000,2285000000,1906000000,1479000000,-47000000,,166000000,166000000,54683,VVV
2017-09-30,14000000,,490000000,,304000000,258000000,776000000,520000000,520000000,-2000000,-42000000,,,,186000000,2084000000,1564000000,1308000000,-35000000,,304000000,304000000,54683,VVV
2019-12-31,25172000,,2148000,,41000,57719000,68252000,-22417000,-22417000,,-7265000,,,,1960000,305338000,327755000,237086000,24565000,-147000,188000,41000,54690,WPRT
2018-12-31,30619000,,-38658000,,-31492000,66998000,64224000,-42217000,-42217000,,-9133000,,,,2112000,270283000,312500000,206059000,3559000,9278000,-40770000,-31492000,54690,WPRT
2017-12-31,50133000,,-67284000,,-9979000,63216000,60281000,-62894000,-62894000,,-14487000,,,,-4424000,229833000,292727000,169552000,-4390000,52881000,-62860000,-9979000,54690,WPRT
2016-12-31,55452000,,-96722000,,-97573000,62961000,34126000,-95531000,-95531000,,-10773000,,,,3950000,167181000,262712000,133055000,-1191000,3099000,-100672000,-97573000,54690,WPRT
2020-12-31,,,18572000,,15347000,22707000,47487000,0,18572000,6208000,,,,,3225000,47487000,28915000,0,0,,15347000,15347000,54691,FNCB
2019-12-31,,,13401000,,11075000,23692000,43083000,0,13707000,5684000,,,,,2326000,43083000,29376000,0,-306000,,11075000,11075000,54691,FNCB
2018-12-31,,,16420000,,13349000,22751000,39720000,0,11254000,5715000,,,,,3071000,39720000,28466000,0,5166000,,13349000,13349000,54691,FNCB
2017-12-31,,,11435000,,147000,22202000,39504000,0,12609000,4693000,,,,,11288000,39504000,26895000,0,-1174000,,147000,147000,54691,FNCB
2019-12-31,,,-367246000,,-340129000,1015136000,1819835000,-951286000,-951286000,-460210000,-228111000,,,,-74110000,3944718000,4896004000,2124883000,584040000,,-293136000,-340129000,54692,AR
2018-12-31,,,-174558000,821669000.0,-397517000,240344000,1845099000,81563000,81563000,-3668000,-286743000,,,,-128857000,4133139000,4051576000,2288040000,-256121000,,-45701000,-397517000,54692,AR
2017-12-31,,,490086000,726955000.0,615070000,251196000,1373187000,763524000,763524000,-634279000,-268701000,,,,-295051000,3018685000,2255161000,1645498000,-273438000,,785137000,615070000,54692,AR
2016-12-31,,,-1245824000,1465953000.0,-848816000,239324000,662212000,-1073436000,-1073436000,516654000,-253552000,,,,-496376000,2161071000,3234507000,1498859000,-172388000,,-749448000,-848816000,54692,AR
2019-12-31,,,-1597471000,,-1221695000,253006000,1893313000,646457000,646457000,-616634000,-199851000,,,,-375776000,3715349000,3068892000,1822036000,-2243928000,,-1221695000,-1221695000,54695,EQT
2018-12-31,,,-3077431000,,-2244568000,284220000,2843683000,763702000,763702000,178591000,-228958000,,,,-696511000,4635815000,3872113000,1792132000,-3841133000,136352000.0,-2380920000,-2244568000,54695,EQT
2017-12-31,,,198613000,5094995000.0,1508529000,208986000,1354867000,541952000,541952000,-390021000,-167971000,,,,-1188416000,2700999000,2159047000,1346132000,-343339000,121500000.0,1387029000,1508529000,54695,EQT
2016-12-31,,,-894262000,3258966000.0,-452983000,218946000,581684000,-747367000,-747367000,248991000,-131159000,,,,-362769000,1636045000,2383412000,1054361000,-146895000,78510000.0,-531493000,-452983000,54695,EQT
2019-12-31,,,-204749000,,-204749000,127661000,-83033000,-210694000,-210694000,,-1472000,,,,0,145968000,356662000,229001000,5945000,,-204749000,-204749000,54697,HRTX
2018-12-31,,,-178840000,,-178840000,93367000,-88270000,-181637000,-181637000,,-2672000,,,,0,77474000,259111000,165744000,2797000,,-178840000,-178840000,54697,HRTX
2017-12-31,138582000.0,,-197484000,,-197484000,82155000,-112403000,-194558000,-194558000,,-3937000,,,,0,30767000,225325000,143170000,-2926000,,-197484000,-197484000,54697,HRTX
2016-12-31,138582000.0,,-173143000,,-173143000,69034000,-101881000,-170915000,-170915000,,-2664000,,,,0,1279000,172194000,103160000,-2228000,,-173143000,-173143000,54697,HRTX
2020-12-31,,,672000000,,539000000,1415000000,2405000000,0,698000000,292000000,,,,,133000000,2405000000,1707000000,0,-26000000,,539000000,505000000,54698,ZION
2019-12-31,,,1053000000,,816000000,1450000000,2797000000,0,1113000000,234000000,,,,,237000000,2797000000,1684000000,0,-60000000,,816000000,777000000,54698,ZION
2018-12-31,,,1143000000,,884000000,1403000000,2821000000,0,1197000000,221000000,,,,,259000000,2821000000,1624000000,0,-54000000,,884000000,845000000,54698,ZION
2017-12-31,,,936000000,,592000000,1344000000,2585000000,0,1000000000,241000000,,,,,344000000,2585000000,1585000000,0,-64000000,,592000000,546000000,54698,ZION
2019-12-31,,,97716000,-5042000,63669000,23631000,176178000,125812000,125812000,34000,-47328000,,,,967000,583992000,458180000,407814000,-28096000,,96749000,63669000,54699,DKL
2018-12-31,,,90716000,-6486000,64639000,19986000,172624000,125757000,125757000,891000,-41263000,,,,534000,657609000,531852000,484985000,-35041000,,90182000,64639000,54699,DKL
2017-12-31,,,69187000,-6397000,50980000,14960000,125031000,88177000,88177000,-20000,-23944000,,,,-222000,538075000,449898000,413044000,-18990000,,69409000,50980000,54699,DKL
2016-12-31,,,62885000,-6221000,50611000,12558000,111005000,77634000,77634000,-20000,-13587000,,,,81000,448059000,370425000,337054000,-14749000,,62804000,50611000,54699,DKL
2020-12-31,,,2773000000,189000000,1808000000,10763000000,18016000000,4214000000,4214000000,2320000000,-728000000,,,,979000000,104280000000,100066000000,86264000000,-1441000000,,1794000000,1808000000,54701,CNC
2019-12-31,,,1782000000,141000000,1321000000,6448000000,11929000000,2564000000,2564000000,2659000000,-412000000,,,,473000000,70791000000,68227000000,58862000000,-782000000,,1309000000,1321000000,54701,CNC
2018-12-31,,,1368000000,106000000,900000000,6331000000,10631000000,2132000000,2132000000,1957000000,-343000000,,,,474000000,56688000000,54556000000,46057000000,-764000000,,894000000,900000000,54701,CNC
2017-12-31,,,1134000000,26000000,828000000,4370000000,7959000000,1465000000,1465000000,1968000000,-255000000,,,,326000000,45810000000,44345000000,37851000000,-328000000,,808000000,828000000,54701,CNC
2020-03-31,9565000,,-16901000,,-17096000,22669000,9445000,-23129000,-23129000,,,,,,195000,63838000,86967000,54393000,6228000,,-17096000,-17096000,54703,AMSC
2019-03-31,9874000,,33141000,,26761000,22028000,14017000,-18225000,-18225000,,,,,,6380000,56207000,74432000,42190000,51366000,,26761000,26761000,54703,AMSC
2018-03-31,11594000,,-32937000,,-32776000,22577000,8695000,-25659000,-25659000,,,,,,-161000,48403000,74062000,39708000,-7278000,,-32776000,-32776000,54703,AMSC
2017-03-31,12540000,,-26231000,,-27373000,25688000,10843000,-27542000,-27542000,,-383000.0,,,,1142000,75195000,102737000,64352000,1311000,,-27373000,-27373000,54703,AMSC
2012-12-31,,,-391321000,,-260416000,1238610000,1419796000,97999000,97999000,,-134962000,,,,-130905000,2370450000,2272451000,950654000,-489320000,,-260416000,-260416000,54705,APR
2011-12-31,,,-722640000,,-747324000,1225400000,1391381000,67117000,67117000,,-132579000,,,,24684000,2231828000,2164711000,840447000,-789757000,,-747324000,-747324000,54705,APR
2010-12-31,,,-25344000,,-17432000,1066953000,1270809000,104591000,104591000,,-130849000,,,,-7912000,2009859000,1905268000,739050000,-129935000,,-17432000,-17432000,54705,APR
2009-12-31,,,-12258000,,-3820000,1050134000,1314864000,115333000,115333000,,-129200000,,,,-8438000,2036642000,1921309000,721778000,-127591000,,-3820000,-3820000,54705,APR
2020-10-31,,,16393045,,16393045,3246484,22407791,19161307,19161307,,-1262034,,,,0,22407791,3246484,0,-2768262,,16393045,16393045,54706,MMT
2019-10-31,,,50799584,,50799584,3423878,24708363,21284485,21284485,,-2888098,,,,0,24708363,3423878,0,29515099,,50799584,50799584,54706,MMT
2018-10-31,,,-8373249,,-8373249,3500322,23330243,19829921,19829921,,-2331960,,,,0,23330243,3500322,0,-28203170,,-8373249,-8373249,54706,MMT
2017-10-31,,,31423666,,31423666,3750516,26710075,22959559,22959559,,-1551848,,,,0,26710075,3750516,0,8464107,,31423666,31423666,54706,MMT
2020-06-30,,,579500000,,462500000,639000000,1263900000,624900000,624900000,,-62500000,,,,117000000,4529000000,3904100000,3265100000,-45400000,,462500000,462500000,54707,BR
2019-06-30,,,607300000,,482100000,577500000,1230300000,652800000,652800000,,-45900000,,,,125200000,4362200000,3709400000,3131900000,-45500000,,482100000,482100000,54707,BR
2018-06-30,,,561000000,,427900000,564500000,1162500000,598000000,598000000,,-42400000,,,,133100000,4329900000,3731900000,3167400000,-37000000,,427900000,427900000,54707,BR
2017-06-30,,,488200000,,326800000,500700000,1034700000,534000000,534000000,,-44700000,,,,161400000,4142600000,3608600000,3107900000,-45800000,,326800000,326800000,54707,BR
2020-10-31,,,301489000,,249539000,703599000,1130468000,426869000,426869000,,-32160000,,,,51950000,2121100000,1694231000,990632000,-125380000,,249539000,249539000,54709,NDSN
2019-10-31,,,431104000,,337091000,712535000,1192103000,479568000,479568000,,-47145000,,,,94013000,2194226000,1714658000,1002123000,-48464000,,337091000,337091000,54709,NDSN
2018-10-31,,,448519000,,377375000,738234000,1236328000,498094000,498094000,,-49576000,,,,71144000,2254668000,1756574000,1018340000,-49575000,,377375000,377375000,54709,NDSN
2017-10-31,,,420291000,,295802000,681558000,1139290000,457732000,457732000,,-36601000,,,,124489000,2066982000,1609250000,927692000,-37441000,,295802000,295802000,54709,NDSN
2019-12-31,,,1083784000,861493000,829151000,627838000,1781042000,914966000,914966000,107515000,-430000,,,,220025000,3391812000,2476846000,1610770000,168818000,,863759000,829151000,54712,NOAH
2018-12-31,,,1026066000,337677000,811297000,692795000,1725416000,926524000,926524000,106785000,-10028000,,,,222320000,3289608000,2363084000,1564192000,99542000,,803746000,811297000,54712,NOAH
2017-12-31,,,960947000,78486000,762923000,567247000,1419536000,777034000,777034000,73162000,-24128000,,,,199085000,2826908000,2049874000,1407372000,183913000,,761862000,762923000,54712,NOAH
2016-12-31,,,755888000,389799000,643829000,557155000,1213167000,667289000,667289000,-11277000,-19289000,,,,157997000,2513572000,1846283000,1300405000,88599000,,597891000,643829000,54712,NOAH
2019-12-31,109450000,,-140729000,,-140729000,36550000,0,-146000000,-146000000,,,,,,0,0,146000000,0,5271000,,-140729000,-140729000,54715,RYTM
2018-12-31,50337000,,-74064000,,-74064000,28080000,0,-78417000,-78417000,,,,,,0,0,78417000,0,4353000,,-74064000,-74064000,54715,RYTM
2017-12-31,22894000,,-33709000,,-33709000,9518000,0,-32412000,-32412000,,,,,,0,0,32412000,0,-1297000,,-33709000,-37582000,54715,RYTM
2016-12-31,19594000,,-25872000,,-25872000,6311000,0,-25905000,-25905000,,,,,,0,0,25905000,0,33000,,-25872000,-29074000,54715,RYTM
2019-12-31,,,93500000,15800000,29000000,649700000,851100000,209000000,209000000,-7600000,-90600000,,,,61000000,3683200000,3474200000,2832100000,-115500000,700000,32500000,29000000,54716,BCO
2018-12-31,,,42500000,12900000,-33300000,542200000,785600000,248500000,248500000,-5100000,-66700000,,,,70000000,3488900000,3240400000,2703300000,-206000000,700000,-27500000,-33300000,54716,BCO
2017-12-31,,,181500000,20800000,16700000,512400000,738800000,231300000,231300000,-4900000,-32200000,,,,157700000,3347000000,3115700000,2608200000,-49800000,-200000,23800000,16700000,54716,BCO
2016-12-31,,,125000000,17700000,34500000,464600000,628900000,168500000,168500000,-4200000,-20400000,,,,78500000,3020600000,2852100000,2391700000,-43500000,-1700000,46500000,34500000,54716,BCO
2019-12-31,26925000,,-7302000,,-8743000,76793000,110697000,6979000,6979000,,-5448000,,,,1441000,492412000,485433000,381715000,-14281000,,-8743000,-8743000,54717,BELFA
2018-12-31,29487000,,23616000,,20709000,83707000,139257000,26063000,26063000,,-5317000,,,,2907000,548184000,522121000,408927000,-2447000,,20709000,20709000,54717,BELFA
2017-12-31,29487000,,9643000,,-11897000,82903000,102349000,19446000,19446000,,-6802000,,,,21540000,491611000,472165000,389262000,-9803000,,-11897000,-11897000,54717,BELFA
2016-12-31,29487000,,-82552000,,-64834000,79305000,99908000,25803000,25803000,-5200000.0,-6662000,,,,-17718000,500153000,474350000,400245000,-108355000,,-64834000,-64834000,54717,BELFA
2020-09-30,12145968,,-23734017,,-23445370,11373952,0,-23519920,-23519920,,-224071,,,,-288647,0,23519920,0,-214097,,-23445370,-23445370,54719,EPIX
2019-09-30,6696234,,-12718912,,-12756832,5455189,0,-12151423,-12151423,,-602744,,,,37920,0,12151423,0,-567489,,-12756832,-12756832,54719,EPIX
2018-09-30,4873335,,-11602411,,-11629440,5928671,0,-10802006,-10802006,,-911959,,,,27029,0,10802006,0,-800405,,-11629440,-11629440,54719,EPIX
2017-09-30,5726366,,-4382621,,-4499012,5140921,0,-10867287,-10867287,,-784583,,,,116391,0,10867287,0,6484666,,-4499012,-4499012,54719,EPIX
2019-12-31,2120120,,-7704636,,-7704636,5056300,0,-7714997,-7714997,538577,,,,,0,0,7714997,0,10361,,-7704636,-7704636,54725,HOTH
2018-12-31,1015967,,-2495525,,-2495525,1220848,0,-2495525,-2495525,258710,,,,,0,0,2495525,0,0,,-2495525,-2495525,54725,HOTH
2017-12-31,880265,,-3023222,,-3023222,1860863,0,-2807222,-2807222,66095,-216000.0,,,,0,0,2807222,0,-216000,,-3023222,-3023222,54725,HOTH
2021-01-02,14093000,,2767000,,1056000,23897000,40545000,2555000,2555000,,,,,,1711000,97824000,95269000,57279000,212000,,1056000,1056000,54727,IVAC
2019-12-28,14309000,,4507000,,1148000,22627000,40868000,3932000,3932000,,,,,,3359000,108885000,104953000,68017000,575000,,1148000,1148000,54727,IVAC
2018-12-29,16862000,,-3595000,,3581000,20188000,32755000,-4295000,-4295000,,,,,,-7176000,95114000,99409000,62359000,700000,,3581000,3581000,54727,IVAC
2017-12-30,17724000,,5221000,,4118000,23314000,45663000,4625000,4625000,,,,,,1103000,112847000,108222000,67184000,596000,,4118000,4118000,54727,IVAC
2020-12-31,,,1314000000,,1094000000,2824000000,4955000000,0,1396000000,735000000,,,,,220000000,4955000000,3559000000,0,-82000000,,1094000000,991000000,54731,RF
2019-12-31,,,1985000000,,1582000000,2697000000,5516000000,0,2030000000,789000000,,,,,403000000,5516000000,3486000000,0,-45000000,,1582000000,1503000000,54731,RF
2018-12-31,,,1955000000,,1759000000,2694000000,5533000000,0,1979000000,860000000,,,,,387000000,5533000000,3554000000,0,-24000000,191000000.0,1568000000,1695000000,54731,RF
2017-12-31,,,1860000000,,1263000000,2697000000,5425000000,0,1891000000,837000000,,,,,619000000,5425000000,3534000000,0,-31000000,22000000.0,1241000000,1199000000,54731,RF
2020-12-31,5153000,,10629000,,8161000,3998000,20446000,11295000,11295000,,,,,,2468000,35873000,24578000,15427000,-666000,,8161000,8161000,54732,INS
2019-12-31,5393000,,13515000,,10969000,3999000,22774000,13382000,13382000,,,,,,2546000,34303000,20921000,11529000,133000,,10969000,10969000,54732,INS
2018-12-31,3353000,,6248000,,6244000,2081000,11576000,6142000,6142000,,,,,,4000,20100000,13958000,8524000,106000,,6244000,6244000,54732,INS
2017-12-31,4367000,,402000,,374000,1843000,4708000,-1502000,-1502000,,,,,,28000,9179000,10681000,4471000,1904000,,374000,374000,54732,INS
2020-02-29,4717175,,-14505455,,-14505455,7215420,0,-12763027,-12763027,,-2408216,,,,0,0,12763027,0,-1742428,,-14505455,-14505455,54733,LOOP
2019-02-28,3448547,,-17536411,,-17536411,8811237,0,-12762781,-12762781,,-467082,,,,0,0,12762781,0,-4773630,,-17536411,-17536411,54733,LOOP
2018-02-28,6694778,,-14037378,,-14037378,6860623,0,-13922577,-13922577,,-5125,,,,0,0,13922577,0,-114801,,-14037378,-14037378,54733,LOOP
2017-02-28,1454440,,-4114001,,-4114001,2280281,0,-4132166,-4132166,,-5125,,,,0,0,4132166,0,18165,,-4114001,-4114001,54733,LOOP
2019-12-31,40491358,,-47583455,,-47583455,13597119,7264928,-46823549,-46823549,,-1373622,,,,0,8072120,54895669,807192,-759906,,-47583455,-47583455,54735,LQDA
2018-12-31,28699576,,-53135859,,-53135859,8754088,2585590,-34868074,-34868074,,-18988176,,,,0,2706981,37575055,121391,-18267785,,-53135859,-53135859,54735,LQDA
2017-12-31,24753876,,-29154240,,-29154240,10212774,6938364,-28028286,-28028286,,-13010475,,,,0,7258123,35286409,319759,-1125954,,-29154240,-29154240,54735,LQDA
2016-12-31,23319886,,-15933762,,-15933762,4841128,12298211,-15862803,-15862803,,-85865,,,,0,13216989,29079792,918778,-70959,,-15933762,-15933762,54735,LQDA
2019-12-31,,,-141461000,70374000,-113635000,21507000,410262000,119752000,119752000,,-264401000,,,,1218000,1500280000,1380528000,1090018000,-261213000,,-142679000,-157488000,54737,AHT
2018-12-31,,,-153527000,81359000,-126966000,19431000,393585000,115696000,115696000,,-239686000,,,,2782000,1428655000,1312959000,1035070000,-269223000,,-156309000,-170437000,54737,AHT
2017-12-31,,,-90978000,116768000,-67008000,20788000,406199000,138680000,138680000,,-222631000,,,,-2218000,1432792000,1294112000,1026593000,-229658000,,-88760000,-123920000,54737,AHT
2016-12-31,,,-57250000,133524000,-46285000,14766000,426039000,167410000,167410000,,-236669000,,,,1532000,1485933000,1318523000,1059894000,-224660000,,-58782000,-89585000,54737,AHT
2019-12-31,,,104288000,,86847000,4293000,279533000,130587000,130587000,66567000,-31411000,,,,17441000,919503000,788916000,639970000,-26299000,,86847000,86847000,54740,OTTR
2018-12-31,,,96933000,,82345000,5509000,271184000,123880000,123880000,67129000,-30408000,,,,14588000,916447000,792567000,645263000,-26947000,,82345000,82345000,54740,OTTR
2017-12-31,,,99695000,,72439000,5620000,261377000,126667000,126667000,56545000,-29604000,,,,27256000,849350000,722683000,587973000,-26972000,,72439000,72439000,54740,OTTR
2016-12-31,,,82540000,,62321000,5110000,243025000,111521000,111521000,52949000,-31886000,,,,20219000,803539000,692018000,560514000,-28981000,,62321000,62321000,54740,OTTR
2019-12-31,,,43027000,,32291000,60119000,99511000,39392000,39392000,,-192000,,,,10736000,410506000,371114000,310995000,3635000,,32291000,32291000,54742,RGR
2018-12-31,,,68714000,,50933000,67359000,135089000,67730000,67730000,,-330000,,,,17781000,495635000,427905000,360546000,984000,,50933000,50933000,54742,RGR
2017-12-31,,,77646000,,52142000,77628000,153531000,75903000,75903000,,-152000,,,,25504000,522256000,446353000,368725000,1743000,,52142000,52142000,54742,RGR
2016-12-31,,,135921000,,87472000,85150000,220775000,135625000,135625000,,-186000,,,,48449000,664328000,528703000,443553000,296000,,87472000,87472000,54742,RGR
2019-12-31,24524000,,-37179000,,-37183000,7994000,0,-32518000,-32518000,,,,,,4000,0,32518000,0,-4661000,,-37183000,-38278000,54744,ANNX
2018-12-31,15528000,,-18303000,,-18304000,3619000,0,-19147000,-19147000,,,,,,1000,0,19147000,0,844000,,-18304000,-18480000,54744,ANNX
2017-12-31,17853000,,-18707000,,-18708000,2624000,0,-20477000,-20477000,,,,,,1000,0,20477000,0,1770000,,-18708000,-18795000,54744,ANNX
2019-12-31,,,8564000,6672000,3015000,107260000,125169000,14768000,14768000,,-5226000,,,,5724000,382415000,367647000,257246000,-6204000,,2840000,3015000,54747,ARC
2018-12-31,,,12061000,7033000,8873000,109122000,130850000,17860000,17860000,,-5880000,,,,3334000,400784000,382924000,269934000,-5799000,,8727000,8873000,54747,ARC
2017-12-31,,,-6111000,7374000,-21511000,101889000,124023000,17854000,17854000,,-6179000,,,,15244000,394579000,376725000,270556000,-23965000,,-21355000,-21511000,54747,ARC
2016-12-31,,,-51863000,6905000,-47865000,100214000,133243000,28196000,28196000,,-5996000,,,,-4364000,406321000,378125000,273078000,-80059000,,-47499000,-47865000,54747,ARC
2020-12-31,119710000,,-57492000,,-49183000,299732000,357474000,-61968000,-61968000,,,,,,-8309000,500569000,562537000,143095000,4476000,,-49183000,-49183000,54748,AVLR
2019-12-31,82442000,,-49259000,,-50214000,240552000,267122000,-55872000,-55872000,5400000.0,-289000.0,,,,955000,382421000,438293000,115299000,6613000,,-50214000,-50214000,54748,AVLR
2018-12-31,51909000,,-76526000,,-75550000,208420000,193449000,-66880000,-66880000,5400000.0,-2608000.0,,,,-976000,272098000,338978000,78649000,-9646000,,-75550000,-75550000,54748,AVLR
2017-12-31,41264000,,-65345000,,-64126000,168080000,155182000,-54162000,-54162000,5400000.0,-2585000.0,,,,-1219000,213159000,267321000,57977000,-11183000,,-64126000,-64126000,54748,AVLR
2019-12-31,,,1599000,20010000,-1993000,3047000,13196000,5828000,5828000,,-2546000,,,,1472000,16144000,10316000,2948000,-4229000,,127000,-1993000,54751,OBAS
2018-12-31,,,760000,19834000,-2781000,3500000,13617000,5800000,5800000,,-2827000,,,,1464000,16608000,10808000,2991000,-5040000,,-704000,-2781000,54751,OBAS
2017-12-31,,,2774000,20031000,-1123000,2698000,13530000,6623000,6623000,,-3143000,,,,1602000,16587000,9964000,3057000,-3514000,,1172000,-1123000,54751,OBAS
2016-12-31,,,3747000,18994000,195000,2615000,13179000,6320000,6320000,,-3170000,,,,1627000,16338000,10018000,3159000,-2573000,,2120000,195000,54751,OBAS
2020-06-30,,,488522000,10797000,370832000,104435000,499424000,468456000,468456000,-73467000,-4363000,,,,121924000,1482599000,1014143000,983175000,20066000,,366598000,370832000,54752,HLG
2019-06-30,,,424493000,37439000,293421000,97664000,472122000,399900000,399900000,-25442000,-4363000,,,,108713000,1499025000,1099125000,1026903000,24593000,,315780000,293421000,54752,HLG
2018-06-30,,,297190000,13154000,222588000,87913000,364674000,280821000,280821000,-4060000,-4363000,,,,66288000,1169348000,888527000,804674000,16369000,,230902000,222588000,54752,HLG
2017-06-30,,,167743000,13154000,167743000,50287000,204813000,160810000,160810000,-6284000,-4363000,,,,0,853295000,692485000,648482000,6933000,,167743000,167743000,54752,HLG
2019-12-31,25196000,,-28640000,,-28632000,9070000,6000,-29494000,-29494000,-4766000,-343000,,,,-8000,6000,29500000,0,854000,,-28632000,-28632000,54753,CYAD
2018-12-31,23577000,,-37427000,,-37427000,10387000,3115000,-32384000,-32384000,1535000,-62000,,,,0,3115000,35499000,0,-5043000,,-37427000,-37427000,54753,CYAD
2017-12-31,22908000,,-56396000,,-56395000,9310000,3025000,-26797000,-26797000,-2396000,-144000,,,,-1000,3540000,30337000,515000,-29599000,,-56395000,-56395000,54753,CYAD
2016-12-31,27675000,,-23612000,,-23606000,9744000,8470000,-25609000,-25609000,-3340000,-109000,,,,-6000,10012000,35621000,1542000,1997000,,-23606000,-23606000,54753,CYAD
2019-12-31,28059000,,-46741000,,-46807000,93762000,74553000,-47268000,-47268000,,-270000,,,,66000,102707000,149975000,28154000,527000,,-46807000,-46807000,54754,SPT
2018-12-31,25426000,,-20912000,,-20934000,53165000,57819000,-20772000,-20772000,,-617000,,,,22000,78813000,99585000,20994000,-140000,,-20934000,-20934000,54754,SPT
2017-12-31,16664000,,-21910000,,-21910000,40159000,34820000,-22003000,-22003000,,-24000,,,,0,44815000,66818000,9995000,93000,,-21910000,-21910000,54754,SPT
2019-12-31,,,1811000,,714000,108373000,132179000,12993000,12993000,,-10328000,,,,1097000,644912000,631919000,512733000,-11182000,,714000,-5196000,54758,LAZY
2018-12-31,,,2752000,,-284000,105582000,131666000,16668000,16668000,,-10020000,,,,3036000,608194000,591526000,476528000,-13916000,,-284000,-9857000,54758,LAZY
2017-12-31,,,13387000,,8302000,96753000,127137000,24354000,24354000,,-8752000,,,,5085000,614838000,590484000,487701000,-10967000,,8302000,8302000,54758,LAZY
2017-11-30,,,-722113,,-722113,1001068,0,-1001068,-1001068,,-8752000,,,,0,0,1001068,0,278955,,-722113,-722113,54758,LAZY
2020-06-30,77200000,,-223300000,,-199500000,510100000,452500000,-134800000,-134800000,,-10800000,,,,-23700000,638600000,773400000,186100000,-88500000,,-199600000,-199500000,54762,MYGN
2019-06-30,85900000,,-223300000,,4600000,534700000,650100000,29500000,29500000,,-12000000,,,,-4400000,851100000,821600000,201000000,-29500000,,4400000,4600000,54762,MYGN
2018-06-30,70800000,,120100000,,133300000,435000000,566500000,60700000,60700000,,-3200000,,,,-13000000,743700000,683000000,177200000,59400000,,133100000,133300000,54762,MYGN
2017-06-30,74400000,,36200000,-400000.0,17400000,439900000,557500000,43200000,43200000,,-6000000,,,,19000000,728700000,685500000,171200000,-7000000,,17200000,17400000,54762,MYGN
2020-03-31,,,-99478,,-99478,1006531,1823891,-63676,-63676,27235,-37656,,,,0,2738540,2802216,914649,-35802,,-99478,-99478,54763,MXC
2019-03-31,,,-12946,,-12946,911927,1750473,8346,8346,27775,-21931,,,,0,2686873,2678527,936400,-21292,,-12946,-12946,54763,MXC
2018-03-31,,,-321489,,-321489,955147,1634788,-232238,-232238,31460,-89537,,,,0,2705235,2937473,1070447,-89251,,-321489,-321489,54763,MXC
2017-03-31,,,-694553,,-694553,976392,1498291,-691266,-691266,35743,-152126,,,,0,2376749,3068015,878458,-3287,,-694553,-694553,54763,MXC
2020-12-31,,,186294000,,158228000,299248000,599643000,0,245978000,54417000,,,,,28066000,599643000,353665000,0,-59684000,,158228000,152570000,54767,AUBAP
2019-12-31,,,231255000,,193528000,297947000,649595000,0,305579000,46069000,,,,,37557000,649595000,344016000,0,-74324000,-170000.0,193698000,193528000,54767,AUBAP
2018-12-31,,,179429000,,146248000,244369000,497230000,0,222805000,30056000,,,,,30016000,497230000,274425000,0,-43376000,-3165000.0,149413000,146248000,54767,AUBAP
2017-12-31,,,104966000,,72923000,185011000,330634000,0,124259000,21364000,,,,,32790000,330634000,206375000,0,-19293000,747000.0,72176000,72923000,54767,AUBAP
2019-12-31,,,323615000,177845000,315435000,35857000,331192000,159661000,159661000,,-57928000,,,,1040000,486625000,326964000,155433000,163954000,,322575000,315435000,54771,WRI
2018-12-31,,,346721000,176793000,327601000,24597000,371325000,184890000,184890000,,-67507000,,,,1378000,531147000,346257000,159822000,161831000,,345343000,327601000,54771,WRI
2017-12-31,,,350698000,177114000,335274000,28435000,388217000,192681000,192681000,,-80326000,,,,-17000,573163000,380482000,184946000,158017000,,350715000,335274000,54771,WRI
2016-12-31,,,283687000,181718000,238933000,27266000,384342000,194541000,194541000,,-85993000,,,,6856000,549555000,355014000,165213000,89146000,,276831000,238933000,54771,WRI
2020-10-31,,,53300000,,300000,574000000,898500000,276100000,276100000,,-44600000,,,,53100000,5987600000,5711500000,5089100000,-222800000,100000,200000,300000,54774,ABM
2019-10-31,,,160200000,,127400000,452900000,731100000,219700000,219700000,,-51100000,,,,32700000,6498600000,6278900000,5767500000,-59500000,-100000,127500000,127400000,54774,ABM
2018-10-31,,,87800000,,97800000,438000000,694800000,190800000,190800000,,-54100000,,,,-8200000,6442200000,6251400000,5747400000,-103000000,1800000,96000000,97800000,54774,ABM
2017-10-31,,,86900000,,3800000,412400000,572400000,128400000,128400000,,-19200000,,,,8800000,5453600000,5325200000,4881200000,-41500000,-74300000,78100000,3800000,54774,ABM
2020-12-31,,,553768000,4866650000,156614000,1444725000,2220780000,0,776055000,,,,,,86966000,2220780000,1444725000,0,-222287000,,466802000,101002000,54779,APO
2019-12-31,,,1407849000,1185905000,843193000,1549829000,2833480000,0,1283651000,,,,,,-128994000,2833480000,1549829000,0,124198000,,1536843000,771306000,54779,APO
2018-12-31,,,105272000,1075644000,-10376000,854731000,1033691000,0,178960000,,,,,,86021000,1033691000,854731000,0,-73688000,,19251000,-60157000,54779,APO
2017-12-31,,,1769584000,1434870000,629104000,1297260000,2718930000,0,1421670000,,,,,,325945000,2718930000,1297260000,0,347914000,,1443639000,594916000,54779,APO
2019-12-31,,,-495697,,-495697,384184,380141,21440,21440,-25483,-143486,,,,0,380141,358701,0,-517137,,-495697,-495697,54780,DXR
2018-12-31,,,-1218327,,-885775,256757,429956,173199,173199,-25483,-121255,,,,-332552,429956,256757,0,-1391526,,-885775,-885775,54780,DXR
2017-12-31,,,-1215276,,-1239890,124596,551420,426824,426824,-25483,-72974,,,,24614,551420,124596,0,-1642100,,-1239890,-1239890,54780,DXR
2016-12-31,,,1467376,,1455763,304873,533619,228746,228746,-25483,-37329,,,,11613,533619,304873,0,1238630,,1455763,1455763,54780,DXR
2019-12-31,,,11119000000,4710000000,8010000000,343000000,16201000000,13443000000,13443000000,452000000,-550000000,,,,4147000000,43165000000,29722000000,26964000000,-2324000000,,6972000000,8010000000,54781,RIO
2018-12-31,,,18167000000,6137000000,13638000000,787000000,14194000000,12482000000,12482000000,434000000,-481000000,,,,4242000000,40522000000,28040000000,26328000000,5685000000,,13925000000,13638000000,54781,RIO
2017-12-31,,,12816000000,6404000000,8762000000,555000000,13602000000,12252000000,12252000000,350000000,-598000000,,,,3965000000,40030000000,27778000000,26428000000,564000000,,8851000000,8762000000,54781,RIO
2016-12-31,,,6343000000,6440000000,4617000000,555000000,6982000000,6123000000,6123000000,362000000,-787000000,,,,1567000000,33781000000,27658000000,26799000000,220000000,,4776000000,4617000000,54781,RIO
2020-12-31,1181000000,,7225000000,,6375000000,5774000000,16509000000,7887000000,7887000000,,-553000000,,,,850000000,32218000000,24331000000,15709000000,-662000000,,6375000000,6375000000,54782,TMO
2019-12-31,1003000000,,4070000000,,3696000000,6080000000,11344000000,4261000000,4261000000,,-676000000,,,,374000000,25542000000,21281000000,14198000000,-191000000,,3696000000,3696000000,54782,TMO
2018-12-31,967000000,,3262000000,,2938000000,6023000000,10869000000,3879000000,3879000000,,-667000000,,,,324000000,24358000000,20479000000,13489000000,-617000000,,2938000000,2938000000,54782,TMO
2017-12-31,887000000,,2429000000,,2225000000,5428000000,9536000000,3221000000,3221000000,6000000.0,-592000000,,,,201000000,20918000000,17697000000,11382000000,-792000000,-3000000.0,2228000000,2225000000,54782,TMO
2019-12-31,391355000,,-362216000,,-307063000,571547000,609021000,-353985000,-353985000,104000,-25779000,,,,-55153000,1134468000,1488453000,525447000,-8231000,,-307063000,-307063000,54783,TWLO
2018-12-31,171358000,,-121158000,,-121949000,289993000,349226000,-112125000,-112125000,104000,-14905000,,,,791000,650067000,762192000,300841000,-9033000,,-121949000,-121949000,54783,TWLO
2017-12-31,120739000,,-63003000,,-63708000,161150000,216125000,-65764000,-65764000,2950000,-14905000,,,,705000,399020000,464784000,182895000,2761000,,-63708000,-63708000,54783,TWLO
2016-12-31,77926000,,-40998000,,-41324000,115845000,156815000,-36956000,-36956000,2950000,-14905000,,,,326000,277335000,314291000,120520000,-4042000,,-41324000,-41324000,54783,TWLO
2020-09-30,,,-22143000,,-22143000,8932000,137556000,81954000,81954000,,-36376000,,,,0,167817000,85863000,30261000,-104097000,,-22143000,-48617000,54786,MNR
2019-09-30,,,29800000,,29800000,9081000,128325000,76224000,76224000,,-36912000,,,,0,154821000,78597000,26496000,-46424000,,29800000,11026000,54786,MNR
2018-09-30,,,56006000,,56006000,8776000,112381000,67639000,67639000,-210000.0,-32350000,,,,0,135485000,67846000,23104000,-11633000,,56006000,38815000,54786,MNR
2017-09-30,,,40271000,,40271000,7809000,94406000,56962000,56962000,-210000.0,-25754000,,,,0,116385000,59423000,21979000,-16691000,,40271000,22942000,54786,MNR
2020-02-01,,,19968000,,16503000,258729000,297185000,19921000,19921000,,-158000,,,,3465000,781925000,762004000,484740000,47000,,16503000,16503000,54790,CTRN
2019-02-02,,,26328000,,21374000,247938000,293227000,26403000,26403000,,-154000,,,,4954000,769553000,743150000,476326000,-75000,,21374000,21374000,54790,CTRN
2018-02-03,,,23500000,,14574000,247062000,289219000,23274000,23274000,,-150000,,,,8926000,755241000,731967000,466022000,226000,,14574000,14574000,54790,CTRN
2017-01-28,,,19351000,,13331000,230666000,267008000,19252000,19252000,,-159000,,,,6020000,695175000,675923000,428167000,99000,,13331000,13331000,54790,CTRN
2020-12-31,,,3627000000,9000000,2765000000,,5795000000,4412000000,4412000000,,-754000000,,,,862000000,10583000000,6171000000,4788000000,-785000000,,2765000000,2765000000,54792,CSX
2019-12-31,,,4316000000,15000000,3331000000,,6379000000,5030000000,5030000000,,-737000000,,,,985000000,11937000000,6907000000,5558000000,-714000000,,3331000000,3331000000,54792,CSX
2018-12-31,,,4304000000,17000000,3309000000,,6262000000,4931000000,4931000000,,-639000000,,,,995000000,12250000000,7319000000,5988000000,-627000000,,3309000000,3308000000,54792,CSX
2017-12-31,,,3142000000,16000000,5471000000,,5113000000,3798000000,3798000000,,-546000000,,,,-2329000000,11408000000,7610000000,6295000000,-656000000,,5471000000,5470000000,54792,CSX
2021-01-02,,,733600000,,555900000,1060500000,1923300000,862800000,862800000,,-70000000,,,,177700000,6971500000,6108700000,5048200000,-129200000,,555900000,555900000,54793,AVY
2019-12-28,92600000.0,,246900000,,303600000,994400000,1904100000,817100000,817100000,,-75800000,,,,-56700000,7070100000,6253000000,5166000000,-570200000,,303600000,303600000,54793,AVY
2018-12-29,98200000.0,,552800000,,467400000,1015200000,1915500000,802100000,802100000,,-58500000,,,,85400000,7159000000,6356900000,5243500000,-249300000,,467400000,467400000,54793,AVY
2017-12-30,93400000.0,,589500000,,281800000,988600000,1812200000,730200000,730200000,,-63000000,,,,307700000,6613800000,5883600000,4801600000,-140700000,,281800000,281800000,54793,AVY
2019-12-31,,,-2694664,5039878,-2646987,1817830,-543006,-2360836,-2360836,,-404722,,,,0,1113421,3474257,1656427,-333828,,-2694664,-2646987,54794,CBLI
2018-12-31,,,-3707447,5065972,-3611973,2318990,-2480916,-4799906,-4799906,,-404722,,,,0,1138187,5938093,3619103,1092459,,-3707447,-3611973,54794,CBLI
2017-12-31,,,-9842672,5208644,-9706456,2500749,-3100061,-5600810,-5600810,,-404722,,,,0,1948362,7549172,5048423,-4241862,,-9842672,-9706456,54794,CBLI
2016-12-31,,,-2590059,5322811,-2658865,3378130,-2977720,-6355850,-6355850,,-404722,,,,0,3518402,9874252,6496122,3765791,,-2590059,-2658865,54794,CBLI
2019-12-31,104034000,,-111825000,,-111825000,10896000,0,-114930000,-114930000,,,,,,0,0,114930000,0,3105000,,-111825000,-111825000,54796,ODT
2018-12-31,79948000,,-88960000,,-88960000,10816000,0,-90764000,-90764000,,,,,,0,0,90764000,0,1804000,,-88960000,-88960000,54796,ODT
2017-12-31,27902000,,-32744000,,-32744000,4842000,0,-32744000,-32744000,,,,,,0,0,32744000,0,0,,-32744000,-32744000,54796,ODT
2016-12-31,2622000,,-3085000,,-3085000,463000,0,-3085000,-3085000,,,,,,0,0,3085000,0,0,,-3085000,-3085000,54796,ODT
2020-03-31,99334000,,256825000,,203009000,341600000,689578000,248644000,248644000,,,,,,53816000,840883000,592239000,151305000,8181000,,203009000,203009000,54797,ABMD
2019-03-31,94418000,,263360000,,259016000,321550000,639865000,223897000,223897000,,,,,,4344000,769432000,545535000,129567000,39463000,,259016000,259016000,54797,ABMD
2018-03-31,73960000,,160437000,,112170000,262734000,495168000,158474000,158474000,,,,,,48267000,593749000,435275000,98581000,1963000,,112170000,112170000,54797,ABMD
2017-03-31,64796000,,91343000,,52116000,218153000,374677000,91728000,91728000,,,,,,39227000,445304000,353576000,70627000,-385000,,52116000,52116000,54797,ABMD
2020-12-31,,,624100000,,480500000,,1169700000,668900000,668900000,366000000,-59000000,,,,143600000,2606100000,1937200000,1436400000,-44800000,,480500000,480500000,54800,BRO
2019-12-31,,,525929000,,398514000,,1076572000,627268000,627268000,320589000,-63660000,,,,127415000,2384737000,1757469000,1308165000,-101339000,,398514000,398514000,54800,BRO
2018-12-31,,,462462000,,344255000,,940943000,499447000,499447000,332118000,-40580000,,,,118207000,2009857000,1510410000,1068914000,-36985000,,344255000,344255000,54800,BRO
2017-12-31,,,449722000,,399630000,,862618000,471004000,471004000,283470000,-38316000,,,,50092000,1857270000,1386266000,994652000,-21282000,,399630000,399630000,54800,BRO
2020-12-31,2642000000,,5065000000,44000000,4202000000,3931000000,10001000000,3428000000,3428000000,,-209000000,,,,863000000,21454000000,18026000000,11453000000,1637000000,,4202000000,4202000000,54801,PYPL
2019-12-31,2085000000,,2998000000,44000000,2459000000,3112000000,7987000000,2797000000,2797000000,-7000000.0,-115000000,,,,539000000,17772000000,14975000000,9785000000,201000000,,2459000000,2459000000,54801,PYPL
2018-12-31,1831000000,,2376000000,44000000,2057000000,2855000000,7189000000,2219000000,2219000000,284000000.0,-77000000,,,,319000000,15451000000,13232000000,8262000000,157000000,,2057000000,2057000000,54801,PYPL
2017-12-31,1740000000,,2200000000,44000000,1795000000,2370000000,6399000000,2197000000,2197000000,92000000.0,-7000000,,,,405000000,13094000000,10897000000,6695000000,3000000,,1795000000,1795000000,54801,PYPL
2020-01-31,149033000,,-176178000,,-175522000,294597000,296364000,-147266000,-147266000,,-20983000,,,,-656000,421720000,568986000,125356000,-28912000,,-175522000,-175522000,54802,MDB
2019-01-31,89854000,,-102329000,,-99011000,201359000,193448000,-97765000,-97765000,,-10290000,,,,-3318000,267016000,364781000,73568000,-5064000,,-99011000,-99011000,54802,MDB
2018-01-31,62202000,,-82686000,,-83973000,145848000,123169000,-84881000,-84881000,,-8000,,,,1287000,166028000,250909000,42859000,2195000,,-83973000,-83973000,54802,MDB
2017-01-31,51772000,,-69344000,,-70063000,102495000,84938000,-69329000,-69329000,,-9000,,,,719000,114805000,184134000,29867000,-15000,,-70063000,-70063000,54802,MDB
2019-12-31,,,-50535000,-82513000,-67434000,19091000,78765000,-22550000,-22550000,551000,-15003000,,,,27439000,264737000,287287000,185972000,-27985000,,-77974000,-67434000,54803,GSS
2018-12-31,,,-11721000,-71973000,-18123000,16428000,64146000,13209000,13209000,-2389000,-18031000,,,,12350000,273017000,259808000,208871000,-24930000,,-24071000,-18123000,54803,GSS
2017-12-31,,,28015000,-66025000,38771000,25090000,98247000,38249000,38249000,1245000,-6039000,,,,-12944000,315497000,277248000,217250000,-10234000,,40959000,38771000,54803,GSS
2016-12-31,,,-41763000,-68213000,-39647000,25754000,48603000,-1497000,-1497000,1368000,-6167000,,,,0,221290000,222787000,172687000,-40266000,,-41763000,-39647000,54803,GSS
2019-12-31,,,-140300000,,-97300000,131700000,874100000,28900000,28900000,173400000,-128100000,,,,-43000000,1206200000,1177300000,332100000,-169200000,,-97300000,-97300000,54804,QEP
2018-12-31,,,-1329000000,,-1011600000,167400000,1354600000,-1140700000,-1140700000,-90400000,-149400000,,,,-317400000,1932600000,3073300000,578000000,-188300000,,-1011600000,-1011600000,54804,QEP
2017-12-31,,,-42900000,,269300000,154900000,896900000,-77100000,-77100000,-24500000,-137800000,,,,-312200000,1622900000,1700000000,726000000,34200000,,269300000,269300000,54804,QEP
2016-12-31,,,-1953200000,,-1245000000,195700000,657900000,-1834200000,-1834200000,233000000,-143200000,,,,-708200000,1377100000,3211300000,719200000,-119000000,,-1245000000,-1245000000,54804,QEP
2019-12-31,9748000,,-45362000,20670000,-46032000,30439000,196000,-39991000,-39991000,,,,,,0,4131000,44122000,3935000,-5371000,,-45362000,-46032000,54805,CASI
2018-12-31,8507000,,-27471000,20670000,-27471000,17997000,0,-26504000,-26504000,,,,,,0,0,26504000,0,-967000,,-27471000,-27471000,54805,CASI
2017-12-31,7110182,,-10770202,20670000,-10770202,3641138,0,-10751320,-10751320,,-14976.0,,,,0,0,10751320,0,-18882,,-10770202,-10770202,54805,CASI
2016-12-31,4317560,,-9453488,20670000,-9453488,5103050,0,-9420610,-9420610,,-33808.0,,,,0,0,9420610,0,-32878,,-9453488,-9453488,54805,CASI
2020-12-31,,,1414000000,,1085000000,2227000000,6199000000,0,1566000000,2406000000,,,,,328000000,6199000000,4633000000,0,-152000000,-1000000,1086000000,1085000000,54806,ALLY
2019-12-31,,,1967000000,,1715000000,2440000000,6377000000,0,1967000000,1970000000,,,,,246000000,6377000000,4410000000,0,0,-6000000,1721000000,1715000000,54806,ALLY
2018-12-31,,,1622000000,,1263000000,2402000000,5911000000,0,1622000000,1887000000,,,,,359000000,5911000000,4289000000,0,0,-6000000,1263000000,1263000000,54806,ALLY
2017-12-31,,,1507000000,,929000000,2521000000,5861000000,0,1507000000,1833000000,,,,,581000000,5861000000,4354000000,0,0,3000000,926000000,929000000,54806,ALLY
2019-12-31,,,-9627605,-6024450,-6869121,5969504,664922,-9001642,-9001642,,-329718,,,,0,664922,9666564,0,-625963,,-9627605,-6869121,54808,VS
2018-12-31,,,-9373171,-5893609,-4631477,5379002,1450,-9023545,-9023545,,-77669,,,,0,1620,9025165,170,-349626,,-9373171,-4631477,54808,VS
2017-12-31,,,-6982356,-1151915,-4227038,3150138,0,-6963253,-6963253,,-2928,,,,0,0,6963253,0,-19103,,-6982356,-4227038,54808,VS
2016-12-31,,,-4997392,1615397,-3612918,1595920,0,-4799998,-4799998,,-2928,,,,0,0,4799998,0,-197394,,-4997392,-3612918,54808,VS
2019-12-31,,,4580000,,4067000,9698000,17913000,5745000,5745000,2470000,-1165000,,,,513000,67399000,61654000,49486000,-1165000,,4067000,4067000,54811,NSEC
2018-12-31,,,1065000,,779000,8839000,13296000,2300000,2300000,2157000,-1235000,,,,286000,64857000,62557000,51561000,-1235000,,779000,779000,54811,NSEC
2017-12-31,,,-1114000,,-1203000,8821000,11459000,193000,193000,2445000,-1307000,,,,89000,65640000,65447000,54181000,-1307000,,-1203000,-1203000,54811,NSEC
2016-12-31,,,4094000,,3063000,8996000,16646000,5446000,5446000,2204000,-1352000,,,,1031000,66893000,61447000,50247000,-1352000,,3063000,3063000,54811,NSEC
2019-12-31,,,320200000,426200000,285100000,239400000,637000000,201800000,201800000,,-115400000,,,,300000,3181900000,2980100000,2544900000,118400000,,319900000,225000000,54812,CEQP
2018-12-31,,,67100000,181300000,50800000,213900000,524700000,142100000,142100000,,-99200000,,,,100000,3654100000,3512000000,3129400000,-75000000,,67000000,-9300000,54812,CEQP
2017-12-31,,,-167400000,175000000,-191900000,232500000,506200000,82000000,82000000,,-99400000,,,,-800000,3880900000,3798900000,3374700000,-249400000,,-166600000,-254400000,54812,CEQP
2016-12-31,,,-191800000,192500000,-216300000,243400000,595400000,122400000,122400000,,-125100000,,,,300000,2520500000,2398100000,1925100000,-314200000,,-192100000,-245000000,54812,CEQP
2019-12-31,,,128900000,,96100000,19800000,327700000,126000000,126000000,1000000,-2500000,,,,32800000,683100000,557100000,355400000,2900000,,96100000,96100000,54813,AGI
2018-12-31,,,-38400000,,-72600000,17400000,180200000,-22600000,-22600000,1200000,-3000000,,,,34200000,651800000,674400000,471600000,-15800000,,-72600000,-72600000,54813,AGI
2017-12-31,,,22200000,,26600000,15500000,212600000,56000000,56000000,1000000,-6600000,,,,-4400000,542800000,486800000,330200000,-33800000,,26600000,26600000,54813,AGI
2016-12-31,,,-7600000,,-17900000,16300000,172800000,21300000,21300000,900000,-24000000,,,,10300000,482200000,460900000,309400000,-28900000,,-17900000,-17900000,54813,AGI
2019-12-31,,,-268000,,-79000,11507000,13037000,0,563000,967000,,,,,-189000,13037000,12474000,0,-831000,,-79000,-79000,54814,FSEA
2018-12-31,,,1312000,,1080000,10299000,12669000,0,1550000,820000,,,,,232000,12669000,11119000,0,-238000,,1080000,1080000,54814,FSEA
2017-12-31,,,1613000,,912000,9769000,12435000,0,1808000,858000,,,,,701000,12435000,10627000,0,-195000,,912000,912000,54814,FSEA
2020-12-31,,,-140037000,129812000,-108775000,84932000,85431000,-77745000,-77745000,,-39993000,,,,-50383000,1923719000,2001464000,1838288000,-62292000,,-89654000,-108775000,54816,GPRE
2019-12-31,,,-170145000,113381000,-166860000,77077000,6634000,-142570000,-142570000,,-40200000,,,,-21316000,2417238000,2559808000,2410604000,-27575000,829000.0,-148829000,-166860000,54816,GPRE
2018-12-31,,,5048000,116170000,15923000,104459000,146520000,-56197000,-56197000,,-87449000,,,,-20147000,2983932000,3040129000,2837412000,61245000,11539000.0,25195000,15923000,54816,GPRE
2017-12-31,,,-55428000,116954000,61061000,107515000,234845000,23748000,23748000,,-83700000,,,,-132061000,3289475000,3265727000,3054630000,-79176000,4998000.0,76633000,61061000,54816,GPRE
2019-12-31,4697022,,-25138039,,-25138039,12910963,-5448954,-23056939,-23056939,,-249984,,,,0,5528566,28585505,10977520,-2081100,,-25138039,-25259611,54818,BIOC
2018-12-31,4468572,,-24569715,,-24571601,12988730,-6801437,-24258739,-24258739,,-310976,,,,1886,3250298,27509037,10051735,-310976,,-24571601,-25207971,54818,BIOC
2017-12-31,3364747,,-21606113,,-21613737,13533500,-4276459,-21174706,-21174706,,-482623,,,,7624,5068663,26243369,9345122,-431407,,-21613737,-21613737,54818,BIOC
2016-12-31,2713367,,-18397269,,-18399322,11614655,-3697015,-18025037,-18025037,,-525880,,,,2053,3223096,21248133,6920111,-372232,,-18399322,-18399322,54818,BIOC
2020-07-31,,,-30792000,,-30792000,4800000,60758000,55958000,55958000,,455000,,,,0,60758000,4800000,0,-86750000,,-30792000,-31200000,54821,PCN
2019-07-31,,,55279000,,55279000,5451000,57330000,51879000,51879000,,3145000,,,,0,57330000,5451000,0,3400000,,55279000,53400000,54821,PCN
2018-07-31,,,37542000,,37542000,5530000,55201000,49671000,49671000,,-9977000,,,,0,55201000,5530000,0,-12129000,,37542000,36337000,54821,PCN
2017-07-31,,,110052000,,110052000,5366000,50447000,45081000,45081000,,339000,,,,0,50447000,5366000,0,64971000,,110052000,109485000,54821,PCN
2019-12-31,7496012,,3688195,,5342545,23371349,35182382,4315021,4315021,,-15878,,,,-1654350,70515715,66200694,35333333,-626826,,5342545,5057095,54822,LUNA
2018-12-31,3766160,,1285628,,11004241,14794205,19437900,877535,877535,,-124344,,,,47818,42917245,42039710,23479345,-391907,9766431.0,1237810,10746939,54822,LUNA
2017-12-31,2653337,,-2399394,,14614905,12923841,13369030,-2208148,-2208148,,-218004,,,,-1148579,33081865,35290013,19712835,-191246,15865720.0,-1250815,14468016,54822,LUNA
2016-12-31,3540227,,-2805499,,-2369492,14763709,15804700,-2499236,-2499236,,-319334,,,,-135567,41867769,44367005,26063069,-306263,300440.0,-2669932,-2474750,54822,LUNA
2019-12-31,20181000,,-79934000,,-79935000,67748000,7330000,-80599000,-80599000,,-2309000,,,,1000,13820000,94419000,6490000,665000,,-79935000,-79935000,54824,AXNX
2018-12-31,19402000,,-32482000,,-32483000,13086000,351000,-32137000,-32137000,,-1343000,,,,1000,707000,32844000,356000,-345000,,-32483000,-32483000,54824,AXNX
2017-12-31,12332000,,-18060000,31066000.0,-18061000,5852000,10000,-18174000,-18174000,,-22000,,,,1000,128000,18302000,118000,114000,,-18061000,-18061000,54824,AXNX
2016-12-31,12510280,,-17399902,13150330.0,-17400702,4973351,0,-17483631,-17483631,,-22000,,,,800,0,17483631,0,83729,,-17400702,-17400702,54824,AXNX
2019-12-31,,,-65441000,,-65441000,129437000,247295000,49966000,49966000,,-91442000,,,,0,280117000,230151000,32822000,-115407000,,-65441000,-65707000,54825,NNA
2018-12-31,,,-86373000,,-86373000,110413000,148697000,-18023000,-18023000,,-77975000,,,,0,187946000,205969000,39249000,-68350000,,-86373000,-82233000,54825,NNA
2017-12-31,,,-78899000,,-78899000,108942000,201171000,35349000,35349000,,-76438000,,,,0,227288000,191939000,26117000,-114248000,,-78899000,-75153000,54825,NNA
2016-12-31,,,62878000,,62878000,114923000,281698000,109158000,109158000,,-75987000,,,,0,290245000,181087000,8547000,-46280000,,62878000,59715000,54825,NNA
2019-12-31,112345000,,-83057000,-2811000,-62530000,118261000,271607000,-58945000,-58945000,,-23377000,,,,-19024000,280067000,339012000,8460000,-24112000,,-64033000,-62530000,54826,XPER
2018-12-31,106347000,,6910000,-1295000,-289000,125455000,392842000,52590000,52590000,,-25665000,,,,8673000,406133000,353543000,13291000,-45680000,,-1763000,-289000,54826,XPER
2017-12-31,105849000,,-58343000,-1295000,-56558000,144649000,367424000,4996000,4996000,,-28292000,,,,-1785000,373732000,368736000,6308000,-63339000,,-56558000,-56558000,54826,XPER
2016-12-31,44738000,,90715000,-1295000,56089000,72065000,259014000,110341000,110341000,,-2409000,,,,34626000,259565000,149224000,551000,-19626000,,56089000,56089000,54826,XPER
2019-12-31,,,9806000,,8376000,7719000,48614000,18670000,18670000,,-9301000,,,,1430000,60849000,42179000,12235000,-8864000,,8376000,6965000,54827,CHCT
2018-12-31,,,2856000,,4403000,5634000,38613000,13440000,13440000,,-6299000,,,,-1547000,48557000,35117000,9944000,-10584000,,4403000,3342000,54827,CHCT
2017-12-31,,,3032000,,3510000,3953000,28594000,6909000,6909000,,-3948000,,,,-478000,37276000,30367000,8682000,-3877000,,3510000,2779000,54827,CHCT
2016-12-31,,,2721000,,2721000,3383000,19174000,2590000,2590000,,-1178000,,,,0,25197000,22607000,6023000,131000,,2721000,2721000,54827,CHCT
2019-12-31,5048000,,-4298000,,-4298000,7251000,6728000,-5571000,-5571000,,-201000,,,,0,26726000,32297000,19998000,1273000,,-4298000,-4298000,54828,EMAN
2018-12-31,6694000,,-9542000,,-9542000,8967000,6760000,-8901000,-8901000,,-69000,,,,0,26235000,35136000,19475000,-641000,,-9542000,-9542000,54828,EMAN
2017-12-31,5175000,,-7995000,,-7783000,8682000,5124000,-8733000,-8733000,,-363000,,,,-212000,22031000,30764000,16907000,738000,,-7783000,-7783000,54828,EMAN
2016-12-31,6362000,,-8048000,,-8049000,8411000,6442000,-8331000,-8331000,,-30000,,,,1000,21397000,29728000,14955000,283000,,-8049000,-8049000,54828,EMAN
2019-12-31,,,73204000,5691000,72616000,13934000,139022000,98776000,98776000,,-26516000,,,,265000,160233000,61457000,21211000,-25572000,,72939000,72616000,54830,FCPT
2018-12-31,,,83191000,7867000,82398000,13206000,124188000,88628000,88628000,,-19959000,,,,262000,143635000,55007000,19447000,-5437000,,82929000,82398000,54830,FCPT
2017-12-31,,,71874000,7781000,71394000,11976000,114274000,80715000,80715000,,-19469000,,,,-18000,133209000,52494000,18935000,-8841000,,71892000,71394000,54830,FCPT
2016-12-31,,,76503000,5097000,156809000,10977000,106165000,74611000,74611000,,-14828000,,,,-80347000,124018000,49407000,17853000,1892000,,156850000,156809000,54830,FCPT
2019-12-31,,,52306000,,42220000,25462000,71925000,46380000,46380000,,,,,,11766000,308510000,262130000,236585000,5926000,1680000,40540000,42220000,54833,NPK
2018-12-31,,,52339000,,39940000,23286000,75883000,50430000,50430000,,,,,,12450000,323317000,272887000,247434000,1909000,51000,39889000,39940000,54833,NPK
2017-12-31,,,65285000,,52959000,22900000,87234000,61704000,61704000,,,,,,21971000,333633000,271929000,246399000,3581000,9645000,43314000,52959000,54833,NPK
2016-12-31,,,63322000,,44564000,22429000,85662000,62512000,62512000,,,,,,21407000,341905000,279393000,256243000,1267000,2649000,41915000,44564000,54833,NPK
2019-12-31,,,-20196000,,-19324000,76953000,56840000,-20196000,-20196000,83000,,,,,-872000,135300000,155496000,78460000,0,,-19324000,-19324000,54834,VERY
2018-12-31,,,-16197000,,-13847000,68353000,52320000,-16197000,-16197000,164000,,,,,-2350000,123980000,140177000,71660000,0,,-13847000,-13847000,54834,VERY
2017-12-31,,,-10942000,,-8241000,55912000,45133000,-10942000,-10942000,163000,,,,,-2701000,115870000,126812000,70737000,0,,-8241000,-8241000,54834,VERY
2016-12-31,,,-22171000,,-15338000,58538000,36531000,-22171000,-22171000,164000,,,,,-6833000,112999000,135170000,76468000,0,,-15338000,-15338000,54834,VERY
2019-12-31,,,911365000,,930228000,968714000,2799115000,1184213000,1184213000,,-256191000,,,,-18863000,6462376000,5278163000,3663261000,-272848000,,930228000,930228000,54835,NCLH
2018-12-31,,,969310000,,954843000,898355000,2678050000,1218635000,1218635000,,-264058000,,,,14467000,6055126000,4836491000,3377076000,-249325000,,954843000,954843000,54835,NCLH
2017-12-31,,,770614000,,759872000,773755000,2332531000,1048819000,1048819000,,-243904000,,,,10742000,5396175000,4347356000,3063644000,-278205000,,759872000,759872000,54835,NCLH
2016-12-31,,,640303000,,633085000,652508000,2024115000,940614000,940614000,,-237659000,,,,7218000,4874340000,3933726000,2850225000,-300311000,,633085000,633085000,54835,NCLH
2020-10-30,,,5130000,,7323000,54334000,58500000,4166000,4166000,,,,,,-2193000,197970000,193804000,139470000,964000,,7323000,7323000,54837,BRID
2019-11-01,,,8537000,,6484000,52708000,60869000,8161000,8161000,,,,,,2053000,188785000,180624000,127916000,376000,,6484000,6484000,54837,BRID
2018-11-02,,,12813000,,6517000,50336000,55939000,5603000,5603000,,,,,,6296000,174257000,168654000,118318000,7210000,,6517000,6517000,54837,BRID
2017-11-03,,,12828000,,8829000,49631000,61050000,11419000,11419000,,,,,,3999000,167223000,155804000,106173000,1409000,,8829000,8829000,54837,BRID
2019-12-31,,,229601000,,186749000,5895000,535630000,289363000,289363000,59977000,-62681000,,,,42852000,1652730000,1363367000,1117100000,-59762000,,186749000,186749000,54838,OGS
2018-12-31,,,225765000,,172234000,8824000,507393000,279605000,279605000,58878000,-51305000,,,,53531000,1633731000,1354126000,1126338000,-53840000,,172234000,172234000,54838,OGS
2017-12-31,,,256138000,,162995000,17252000,525842000,299476000,299476000,57225000,-46065000,,,,93143000,1539633000,1240157000,1013791000,-43338000,,162995000,162995000,54838,OGS
2016-12-31,,,225338000,,140095000,19827000,488120000,269120000,269120000,55344000,-43739000,,,,85243000,1427232000,1158112000,939112000,-43782000,,140095000,140095000,54838,OGS
2020-06-30,,,-7883000,-22370000,-3781000,3046000,12809000,4891000,4891000,,-9773000,,,,-2794000,58017000,53126000,45208000,-12774000,,-5089000,-3781000,54842,INTG
2019-06-30,,,2513000,-24697000,1457000,2628000,22759000,15196000,15196000,,-10364000,,,,-301000,74753000,59557000,51994000,-12683000,,2814000,1457000,54842,INTG
2018-06-30,,,8869000,-26037000,4081000,3355000,21474000,13065000,13065000,,-10399000,,,,3056000,71579000,58514000,50105000,-4196000,,5813000,4081000,54842,INTG
2017-06-30,,,-1155000,-27773000,-1653000,3115000,21416000,12996000,12996000,,-10256000,,,,521000,69005000,56009000,47589000,-14151000,,-1676000,-1653000,54842,INTG
2019-12-31,,,-10759000,,-1439000,9712000,1165000,-8784000,-8784000,,-396000,,,,1278000,20582000,29366000,19417000,-1975000,10598000,-12037000,-1439000,54845,PPSI
2018-12-31,,,-10105000,,-5664000,9494000,1894000,-9125000,-9125000,,-916000,,,,-796000,20127000,29252000,18233000,-980000,3645000,-9309000,-5664000,54845,PPSI
2017-12-31,,,-6186000,,-9225000,18907000,18612000,-2550000,-2550000,,-2462000,,,,3039000,114391000,116941000,95779000,-3636000,3645000,-9225000,-9225000,54845,PPSI
2016-12-31,,,2379000,,-1063000,14829000,22146000,5404000,5404000,,-1739000,,,,925000,99632000,94228000,77486000,-3025000,-2517000,1454000,-1063000,54845,PPSI
2019-12-31,53507619,,-68345186,,-68345186,13598030,0,-67105649,-67105649,,-1239537,,,,0,0,67105649,0,-1239537,,-68345186,-68345186,54846,AXSM
2018-12-31,23277637,,-30965464,,-30965464,9351522,0,-32629159,-32629159,,-1127305,,,,0,0,32629159,0,1663695,,-30965464,-30965464,54846,AXSM
2017-12-31,19750502,,-28943392,,-28943392,7206691,0,-26957193,-26957193,,-1340199,,,,0,0,26957193,0,-1986199,,-28943392,-28943392,54846,AXSM
2016-12-31,20725581,,-27201653,,-27201653,6343648,0,-27069229,-27069229,,-132424,,,,0,0,27069229,0,-132424,,-27201653,-27201653,54846,AXSM
2019-12-31,,,464000000,13000000,402000000,171000000,829000000,542000000,542000000,116000000,-89000000,,,,63000000,940000000,398000000,111000000,-78000000,,401000000,401000000,54847,AGO
2018-12-31,,,580000000,13000000,521000000,152000000,992000000,744000000,744000000,96000000,-94000000,,,,59000000,1072000000,328000000,80000000,-164000000,,521000000,520000000,54847,AGO
2017-12-31,,,991000000,13000000,730000000,143000000,1223000000,986000000,986000000,94000000,-97000000,,,,261000000,1630000000,644000000,407000000,5000000,,730000000,729000000,54847,AGO
2016-12-31,,,1017000000,13000000,881000000,143000000,1074000000,837000000,837000000,237000000,-102000000,,,,136000000,1387000000,550000000,313000000,180000000,,881000000,880000000,54847,AGO
2019-12-31,75579000,,91021000,-7824000,90048000,67376000,229671000,86716000,86716000,,-10122000,,,,2948000,1234003000,1147287000,1004332000,4305000,,88073000,90048000,54848,TSEM
2018-12-31,73053000,,139317000,-6761000,135579000,64951000,292947000,154943000,154943000,,-19209000,,,,5938000,1304034000,1149091000,1011087000,-15626000,,133379000,135579000,54848,TSEM
2017-12-31,67664000,,201768000,-6354000,298011000,66799000,354305000,219842000,219842000,,-19591000,,,,-99888000,1387310000,1167468000,1033005000,-18074000,,301656000,298011000,54848,TSEM
2016-12-31,63134000,,210598000,-7418000,203924000,65439000,303100000,174527000,174527000,,-18618000,,,,1432000,1249634000,1075107000,946534000,36071000,,209166000,203924000,54848,TSEM
2019-12-31,5684562,,-8027162,,-8027162,2325719,0,-8010281,-8010281,,,,,,0,0,8010281,0,-16881,,-8027162,-8027162,54850,PHVS
2018-12-31,3645413,,-4313914,,-4313914,668121,0,-4313534,-4313534,,,,,,0,0,4313534,0,-380,,-4313914,-4313914,54850,PHVS
2019-12-29,,,196168000,,149629000,1557907000,1903018000,222660000,222660000,1960000,-20994000,,,,46539000,5634835000,5412175000,3731817000,-26492000,,149629000,149629000,54851,SFM
2018-12-30,,,195796000,,158536000,1404443000,1747475000,234511000,234511000,476000,-27574000,,,,37260000,5207336000,4972825000,3459861000,-38715000,,158536000,158536000,54851,SFM
2017-12-31,,,205518000,,158440000,1245640000,1567030000,226770000,226770000,426000,-20561000,,,,47078000,4664612000,4437842000,3097582000,-21252000,,158440000,158440000,54851,SFM
2017-01-01,,,198592000,,124306000,1068995000,1363448000,215932000,215932000,228000,-14794000,,,,74286000,4046385000,3830453000,2682937000,-17340000,,124306000,124306000,54851,SFM
2019-12-31,136000,,-1279000,,-1279000,553000,0,-689000,-689000,,-541000,,,,0,0,689000,0,-590000,,-1279000,-2409000,54855,PRFX
2018-12-31,223000,,-828000,,-828000,277000,0,-500000,-500000,,-324000,,,,0,0,500000,0,-328000,,-828000,-1874000,54855,PRFX
2017-12-31,504000,,-1122000,,-1122000,376000,0,-880000,-880000,,-245000,,,,0,0,880000,0,-242000,,-1122000,-2090000,54855,PRFX
2020-12-31,,,1020000000,,904000000,1040000000,2687000000,1658000000,1658000000,-11000000,-543000000,,,,116000000,5652000000,3994000000,2965000000,-638000000,,904000000,904000000,54856,YUM
2019-12-31,,,1373000000,,1294000000,921000000,2827000000,1931000000,1931000000,-25000000,-519000000,,,,79000000,5597000000,3666000000,2770000000,-558000000,,1294000000,1294000000,54856,YUM
2018-12-31,,,1839000000,,1542000000,904000000,2666000000,1762000000,1762000000,7000000,-496000000,,,,297000000,5688000000,3926000000,3022000000,77000000,,1542000000,1542000000,54856,YUM
2017-12-31,,,2274000000,,1340000000,971000000,2717000000,1746000000,1746000000,7000000,-473000000,,,,934000000,5878000000,4132000000,3161000000,528000000,,1340000000,1340000000,54856,YUM
2019-12-31,,,-3495481,,-3495481,3525975,1428538,-2825416,-2825416,,,,,,0,4450785,7276201,3022247,-670065,,-3495481,-3495481,54858,RELI
2018-12-31,,,-1096965,,-1096965,832752,340962,-519019,-519019,,,,,,0,1018761,1537780,677799,-577946,,-1096965,-1155286,54858,RELI
2017-08-31,49000.0,,-2578429,,-2578429,128149,35993,-465323,-465323,,-179659.0,,,,0,39068,504391,3075,-2113106,,-2578429,-2578429,54858,RELI
2016-08-31,49000.0,,-833546,,-833546,120430,-141,-833546,-833546,,-179659.0,,,,0,18900,852446,19041,0,,-833546,-833546,54858,RELI
2019-12-31,,,178900000,103700000,185600000,-7700000,435100000,187500000,187500000,53300000,-64900000,,,,-6600000,1240500000,1053000000,805400000,-8600000,,185500000,185600000,54859,ALE
2018-12-31,,,158600000,103700000,174100000,-4600000,464600000,205700000,205700000,57900000,-67900000,,,,-15500000,1498600000,1292900000,1034000000,-47100000,,174100000,174100000,54859,ALE
2017-12-31,,,186900000,103700000,172200000,-3900000,459600000,229100000,229100000,56900000,-67800000,,,,14700000,1419300000,1190200000,959700000,-42200000,,172200000,172200000,54859,ALE
2016-12-31,,,175600000,103700000,155300000,-7400000,456300000,214100000,214100000,53800000,-70300000,,,,19800000,1339700000,1125600000,883400000,-38500000,,155800000,155300000,54859,ALE
2020-12-31,,,7301000,,5904000,36651000,50114000,0,10892000,2571000,,,,,1397000,50114000,39222000,0,-3591000,,5904000,5904000,54862,BWFG
2019-12-31,,,22942000,,18216000,32786000,58568000,0,23091000,2691000,,,,,4726000,58568000,35477000,0,-149000,,18216000,18004000,54862,BWFG
2018-12-31,,,21153000,,17433000,32530000,56786000,0,22024000,2232000,,,,,3720000,56786000,34762000,0,-871000,,17433000,17204000,54862,BWFG
2017-12-31,,,25129000,,13830000,28492000,57652000,0,26363000,2797000,,,,,11299000,57652000,31289000,0,-1234000,,13830000,13651000,54862,BWFG
2020-12-31,,,3072000000,243000000,2352000000,3512000000,7105000000,3599000000,3599000000,-6000000,-252000000,,,,676000000,19140000000,15541000000,12035000000,-527000000,,2396000000,2352000000,54864,KMB
2019-12-31,,,2773000000,227000000,2157000000,3199000000,6451000000,3254000000,3254000000,-2000000,-261000000,,,,576000000,18450000000,15196000000,11999000000,-481000000,,2197000000,2157000000,54864,KMB
2018-12-31,,,1916000000,241000000,1410000000,3151000000,6138000000,3026000000,3026000000,-39000000,-263000000,,,,471000000,18486000000,15460000000,12348000000,-1110000000,,1445000000,1410000000,54864,KMB
2017-12-31,,,3095000000,253000000,2278000000,3261000000,6587000000,3286000000,3286000000,40000000,-318000000,,,,776000000,18348000000,15062000000,11761000000,-191000000,,2319000000,2278000000,54864,KMB
2020-08-31,,,115945000,1013000,78109000,430148000,554410000,122717000,122717000,,-7625000,,,,37764000,3329188000,3206471000,2774778000,-6772000,,78181000,77267000,54868,PSMT
2019-08-31,,,111049000,928000,73191000,405609000,525127000,116792000,116792000,,-3939000,,,,37560000,3220818000,3104026000,2695691000,-5743000,,73489000,72470000,54868,PSMT
2018-08-31,,,122580000,636000,74328000,380078000,510182000,129191000,129191000,,-5071000,,,,48177000,3166702000,3037511000,2656520000,-6611000,,74403000,73431000,54868,PSMT
2017-08-31,,,132742000,636000,90724000,338732000,476876000,138100000,138100000,,-6777000,,,,42018000,2996628000,2858528000,2519752000,-5358000,,90724000,89403000,54868,PSMT
2019-12-31,,,8673000,,7347000,,5420000,8673000,8673000,-3253000,,,,,1326000,495597000,486924000,490177000,0,,7347000,7347000,54870,PTVCA
2018-12-31,,,-43872000,,-34075000,,-31438000,-40720000,-40720000,9282000,,,,,-9797000,439169000,479889000,470607000,-3152000,,-34075000,-34075000,54870,PTVCA
2017-12-31,,,10122000,,18323000,,15912000,10122000,10122000,5790000,,,,,-8201000,371234000,361112000,355322000,0,,18323000,18323000,54870,PTVCA
2016-12-31,,,43054000,,28945000,,39227000,43054000,43054000,-3827000,,,,,14109000,318997000,275943000,279770000,0,,28945000,28945000,54870,PTVCA
2019-12-31,3090000,,-3404000,3014000,-3420000,6119000,6084000,-3311000,-3311000,,-195000,,,,-225000,10334000,13645000,4250000,-93000,,-3179000,-3420000,54872,NEPH
2018-12-31,1539000,,-3418000,3000000,-3402000,4484000,3203000,-2983000,-2983000,,-172000,,,,-93000,5687000,8670000,2484000,-435000,,-3325000,-3402000,54872,NEPH
2017-12-31,1002000,,-2598000,3000000,-809000,3298000,2292000,-2226000,-2226000,,-302000,,,,-1789000,3809000,6035000,1517000,-372000,,-809000,-809000,54872,NEPH
2016-12-31,1079000,,-3032000,3000000,-3032000,2854000,1294000,-2869000,-2869000,,-172000,,,,0,2320000,5189000,1026000,-163000,,-3032000,-3032000,54872,NEPH
2020-12-31,,,23967000000,1430000000,17801000000,31573000000,77091000000,28798000000,28798000000,,-4247000000,,,,5619000000,128292000000,99494000000,51201000000,-4831000000,,18348000000,17801000000,54874,VZ
2019-12-31,,,22733000000,1440000000,19265000000,28939000000,77142000000,31521000000,31521000000,,-4730000000,,,,2945000000,131868000000,100347000000,54726000000,-8788000000,,19788000000,19265000000,54874,VZ
2018-12-31,,,19623000000,1565000000,15528000000,27287000000,75658000000,30991000000,30991000000,,-4833000000,,,,3584000000,130863000000,99872000000,55205000000,-11368000000,,16039000000,15528000000,54874,VZ
2017-12-31,,,20594000000,1591000000,30101000000,27344000000,72971000000,28673000000,28673000000,,-4733000000,,,,-9956000000,126034000000,97361000000,53063000000,-8079000000,,30550000000,30101000000,54874,VZ
2019-12-31,,,93865000,20015000,91511000,30472000,173067000,54818000,54818000,9130000,-40057000,,,,179000,234284000,179466000,61217000,39047000,,93686000,84277000,54875,RPT
2018-12-31,,,18234000,19581000,17619000,22045000,192188000,76692000,76692000,6124000,-43439000,,,,198000,260904000,184212000,68716000,-58458000,,18036000,10458000,54875,RPT
2017-12-31,,,70862000,20847000,69060000,23726000,195019000,73076000,73076000,6882000,-44866000,,,,143000,265355000,192279000,70336000,-2214000,,70719000,61930000,54875,RPT
2016-12-31,,,61411000,20897000,59664000,22241000,189722000,72313000,72313000,3375000,-44514000,,,,299000,261358000,189045000,71636000,-10902000,,61112000,52609000,54875,RPT
2019-12-31,,,23987522,,23953697,8540397,1495724,-7044673,-7044673,,-2372570,,,,33825,1495724,8540397,0,31032195,,23953697,23953697,54876,SSSS
2018-12-31,,,1374737,,891743,9223948,1617836,-7606112,-7606112,,-4545471,,,,482994,1617836,9223948,0,8980849,,891743,891743,54876,SSSS
2017-12-31,,,17620834,,17567933,16981863,852768,-16129095,-16129095,,-4696819,,,,52901,852768,16981863,0,33749929,,17567933,17567933,54876,SSSS
2016-12-31,,,-74994895,,-74994895,-2731784,736283,3468067,3468067,,-4731430,,,,0,736283,-2731784,0,-78462962,,-74994895,-74994895,54876,SSSS
2019-12-31,96059000,,-159429000,,-159429000,68813000,413000,-164459000,-164459000,,,,,,0,413000,164872000,0,5030000,,-159429000,-159429000,54877,RVNC
2018-12-31,92500000,,-139568000,,-142568000,53863000,3729000,-142634000,-142634000,,-44000.0,,,,3000000,3729000,146363000,0,3066000,,-142568000,-142568000,54877,RVNC
2017-12-31,80361000,,-120587000,,-120587000,37398000,262000,-117497000,-117497000,,-457000.0,,,,0,262000,117759000,0,-3090000,,-120587000,-120587000,54877,RVNC
2016-12-31,45081000,,-89270000,,-89270000,34375000,300000,-79156000,-79156000,,-1082000.0,,,,0,300000,79456000,0,-10114000,,-89270000,-89270000,54877,RVNC
2020-12-31,,,109397000,,88591000,171589000,315574000,0,112890000,31095000,,,,,20806000,315574000,202684000,0,-3493000,,88591000,88591000,54880,NBHC
2019-12-31,,,96194000,,80365000,165975000,277068000,0,92260000,18833000,,,,,15829000,277068000,184808000,0,3934000,,80365000,80271000,54880,NBHC
2018-12-31,,,73681000,,61451000,164102000,263236000,0,77859000,21275000,,,,,12230000,263236000,185377000,0,-4178000,,61451000,61381000,54880,NBHC
2017-12-31,,,35862000,,14579000,114383000,172339000,0,39816000,18140000,,,,,21283000,172339000,132523000,0,-3954000,,14579000,14523000,54880,NBHC
2019-12-31,,,715000000,2449000000,648000000,310000000,3061000000,2359000000,2359000000,-402000000,-1566000000,,,,-517000000,9303000000,6944000000,6242000000,-1644000000,,1232000000,648000000,54884,LNG
2018-12-31,,,1227000000,2455000000,471000000,289000000,2777000000,2014000000,2014000000,25000000,-818000000,,,,27000000,7994000000,5980000000,5217000000,-787000000,,1200000000,471000000,54884,LNG
2017-12-31,,,566000000,3004000000,-393000000,256000000,2070000000,1414000000,1414000000,44000000,-740000000,,,,3000000,5646000000,4232000000,3576000000,-848000000,,563000000,-393000000,54884,LNG
2016-12-31,,,-663000000,2235000000,-610000000,260000000,482000000,44000000,44000000,4000000,-498000000,,,,2000000,1287000000,1243000000,805000000,-707000000,,-665000000,-610000000,54884,LNG
2019-12-31,,,141125000,,32799000,58976000,1013673000,209412000,209412000,5875000,-81377000,,,,108326000,1526197000,1316785000,512524000,-68287000,,32799000,32799000,54886,VET
2018-12-31,,,354698000,,271650000,51929000,1117049000,362167000,362167000,33151000,-72759000,,,,83048000,1525950000,1163783000,408901000,-7469000,,271650000,271650000,54886,VET
2017-12-31,,,124482000,,62258000,54373000,738647000,107700000,107700000,23312000,-57313000,,,,62224000,1024362000,916662000,285715000,16782000,,62258000,62258000,54886,VET
2016-12-31,,,-223228000,,-160051000,52829000,566811000,-195417000,-195417000,97400000,-56957000,,,,-63177000,828507000,1023924000,261696000,-27811000,,-160051000,-160051000,54886,VET
2020-12-31,,,79730000,,52373000,44833000,136080000,0,79730000,11517000,,,,,27357000,469351000,389621000,333271000,0,,52373000,27435000,54888,PMT
2019-12-31,,,190641000,,226357000,48945000,644864000,0,190641000,405278000,,,,,-35716000,879073000,688432000,234209000,0,,226357000,200853000,54888,PMT
2018-12-31,,,157988000,,152798000,37626000,323106000,0,157988000,127492000,,,,,5190000,462720000,304732000,139614000,0,,152798000,127110000,54888,PMT
2017-12-31,,,124546000,,117749000,35811000,309007000,0,124546000,148650000,,,,,6797000,448932000,324386000,139925000,0,,117749000,101491000,54888,PMT
2020-03-31,,,-42632000,,-39667000,76782000,82974000,-8454000,-8454000,,-2385000,,,,-2965000,279007000,287461000,196033000,-34178000,,-39667000,-39667000,54894,ALYA
2019-03-31,,,-15326000,,-12475000,52615000,54276000,-7411000,-7411000,,-2244000,,,,-2851000,209478000,216889000,155202000,-7915000,,-12475000,-12207000,54894,ALYA
2018-03-31,,,-7538000,,-7224000,31403000,34693000,-3304000,-3304000,,-2111000,,,,-314000,159290000,162594000,124597000,-4234000,,-7224000,-6867000,54894,ALYA
2017-03-31,,,-3489000,,-2868000,19048000,22919000,-1757000,-1757000,,-1631000,,,,-621000,115818000,117575000,92899000,-1732000,,-2868000,-3011000,54894,ALYA
2020-03-28,,,85054000,,58160000,183265000,278975000,90280000,90280000,,-4632000,,,,26894000,1369730000,1279450000,1090755000,-5226000,,58160000,57990000,54895,SKY
2019-03-30,,,-41303000,,-58208000,260552000,245359000,-20013000,-20013000,,-5333000,,,,16905000,1360043000,1380056000,1114684000,-21290000,,-58208000,-58208000,54895,SKY
2018-03-31,,,43116000,,15800000,122176000,177111000,54448000,54448000,,-5133000,,,,27316000,1064722000,1010274000,887611000,-11332000,,15800000,14804000,54895,SKY
2017-04-01,,,28006000,,51910000,105175000,143955000,38338000,38338000,,-4646000,,,,-23321000,861319000,822981000,717364000,-10332000,583000.0,51327000,48537000,54895,SKY
2020-12-31,,,67393000000,,46853000000,212136000000,546460000000,165355000000,165355000000,4725000000,-33600000000,,,,16366000000,1016887000000,851532000000,470427000000,-97962000000,,51027000000,46853000000,54897,AMOV
2019-12-31,,,121346988000,48996906000.0,67730891000,227370919000,535611712000,143582753000,143582753000,5742830000,-36194503000,,,,51033533000,1007347869000,863765116000,471736157000,-22235765000,,70313455000,67730891000,54897,AMOV
2018-12-31,,,100993902000,49876777000.0,52566197000,237161004000,529385251000,130253422000,130253422000,6258245000,-30307066000,,,,46477079000,1038207681000,907954259000,508822430000,-29259520000,,54516823000,52566197000,54897,AMOV
2017-12-31,,,57096844000,66469205000.0,29325921000,249357042000,525297789000,91565917000,91565917000,24199888000,-28929728000,,,,24941511000,1021633535000,930067618000,496335746000,-34469073000,,32155333000,29325921000,54897,AMOV
2019-12-31,,,-40658000,,-40658000,9601000,-28990000,-38591000,-38591000,,,,,,0,1487000,40078000,30477000,-2067000,,-40658000,-40658000,54898,ANGN
2018-12-31,,,-20025000,,-20025000,5391000,-8951000,-14342000,-14342000,,,,,,0,4029000,18371000,12980000,-5683000,,-20025000,-25005000,54898,ANGN
2013-12-31,196008.0,,1732434,2116684.0,632241,3609386,3407594,-397800,-397800,,-300432.0,,,,452778,6581072,6978872,3173478,2130234,,1279656,632241,54898,ANGN
2012-12-31,196008.0,,1193973,2527548.0,307303,4043234,3624017,-419217,-419217,,-307450.0,,,,201858,7297701,7716918,3673684,1613190,,992115,307303,54898,ANGN
2019-12-31,,,-93000000,,-97000000,541000000,586000000,45000000,45000000,,-4000000,,,,4000000,2951000000,2906000000,2365000000,-138000000,,-97000000,-97000000,54900,DNOW
2018-12-31,,,58000000,,52000000,557000000,630000000,73000000,73000000,,-8000000,,,,6000000,3127000000,3054000000,2497000000,-15000000,,52000000,51000000,54900,DNOW
2017-12-31,,,-52000000,,-52000000,542000000,501000000,-41000000,-41000000,,-6000000,,,,0,2648000000,2689000000,2147000000,-11000000,,-52000000,-52000000,54900,DNOW
2016-12-31,,,-230000000,,-234000000,567000000,345000000,-222000000,-222000000,,-3000000,,,,4000000,2107000000,2329000000,1762000000,-8000000,,-234000000,-234000000,54900,DNOW
2019-12-31,,,31654000,,30841000,21596000,67073000,45477000,45477000,,-13468000,,,,813000,67073000,21596000,0,-13823000,,30841000,30841000,54901,WHF
2018-12-31,,,58243000,,57301000,25705000,63246000,37541000,37541000,,-11599000,,,,942000,63246000,25705000,0,20702000,,57301000,57301000,54901,WHF
2017-12-31,,,34448000,,34448000,18781000,54804000,36023000,36023000,,-9811000,,,,0,54804000,18781000,0,-1575000,,34448000,34448000,54901,WHF
2016-12-31,,,31329000,,31329000,18650000,53849000,35199000,35199000,,-8188000,,,,0,53849000,18650000,0,-3870000,,31329000,31329000,54901,WHF
2020-02-29,,,163306999,,163306999,18143994,80093994,61950000,61950000,,-11880521,,,,0,80093994,18143994,0,101356999,,163306999,163306999,54903,NRK
2019-02-28,,,56114035,,56114035,18300964,80430949,62129985,62129985,,-12091601,,,,0,80430949,18300964,0,-6015950,,56114035,56114035,54903,NRK
2018-02-28,,,36701723,,36701723,18664709,80863015,62198306,62198306,,-7123841,,,,0,80863015,18664709,0,-25496583,,36701723,36701723,54903,NRK
2017-02-28,,,-145457078,,-145457078,18614350,82503946,63889596,63889596,,-6651763,,,,0,82503946,18614350,0,-209346674,,-145457078,-145457078,54903,NRK
2020-12-31,,,31119000,,23644000,34252000,70381000,0,32008000,4121000,,,,,7475000,70381000,38373000,0,-889000,,23644000,23644000,54904,UNTY
2019-12-31,,,30315000,,23653000,32226000,64266000,0,29891000,2149000,,,,,6662000,64266000,34375000,0,424000,,23653000,23653000,54904,UNTY
2018-12-31,,,27307000,,21919000,31010000,60437000,0,27437000,1990000,,,,,5388000,60437000,33000000,0,-130000,,21919000,21919000,54904,UNTY
2017-12-31,,,22433000,,12893000,26966000,52477000,0,23442000,2069000,,,,,9540000,52477000,29035000,0,-1009000,,12893000,12893000,54904,UNTY
2020-12-31,,,-3230000000,,-2379000000,292000000,1179000000,-2528000000,-2528000000,365000000,-479000000,,,,-851000000,13227000000,15755000000,12048000000,-702000000,,-2379000000,-2379000000,54909,CVE
2019-12-31,,,1397000000,,2194000000,331000000,4481000000,1618000000,1618000000,214000000,-489000000,,,,-797000000,20180000000,18562000000,15699000000,-221000000,,2194000000,2194000000,54909,CVE
2018-12-31,,,-3926000000,,-2669000000,1020000000,3973000000,-1668000000,-1668000000,367000000,-516000000,,,,-1010000000,20843000000,22511000000,16870000000,-2258000000,247000000.0,-2916000000,-2669000000,54909,CVE
2017-12-31,36000000.0,,2216000000,,3366000000,260000000,3312000000,-641000000,-641000000,952000000,-571000000,,,,-52000000,17043000000,17684000000,13731000000,2857000000,1098000000.0,2268000000,3366000000,54909,CVE
2019-12-31,,,-10754319,,-10754319,18483248,8657243,-10577233,-10577233,,-137876,,,,0,11393277,21970510,2736034,-177086,,-10754319,-11754319,54910,VVOS
2018-12-31,,,-8439156,,-8439156,10436129,2710620,-8336182,-8336182,,-102974,,,,0,3792261,12128443,1081641,-102974,,-8439156,-9439156,54910,VVOS
2019-12-31,,,14008000,20923000,15126000,27696000,280595000,113475000,113475000,,-73933000,,,,0,597452000,483977000,316857000,-99467000,,14008000,-28024000,54913,TNP
2018-12-31,,,-101042000,12041000,-99203000,27032000,212014000,38184000,38184000,,-76017000,,,,0,529879000,491695000,317865000,-139226000,,-101042000,-132966000,54913,TNP
2017-12-31,,,9185000,13880000,7612000,26324000,241604000,76260000,76260000,,-66050000,,,,0,529182000,452922000,287578000,-67075000,,9185000,-16164000,54913,TNP
2016-12-31,,,56495000,12307000,55783000,25611000,228841000,89966000,89966000,,-40420000,,,,0,481790000,391824000,252949000,-33471000,,56495000,39908000,54913,TNP
2019-12-31,,,28614000,22707000,25844000,31263000,38963000,7720000,7720000,-20000,-681000,,,,579000,124243000,116523000,85280000,20894000,,28035000,25844000,54914,NL
2018-12-31,,,-54374000,19443000,-41017000,32794000,38271000,6121000,6121000,-644000,-37000,,,,-15361000,118217000,112096000,79946000,-60495000,,-39013000,-41017000,54914,NL
2017-12-31,,,112192000,17756000,116100000,30703000,34825000,4292000,4292000,-170000,-30000,,,,-5634000,112035000,107743000,77210000,107900000,,117826000,116100000,54914,NL
2016-12-31,,,13916000,16350000,15325000,33102000,35167000,2074000,2074000,-9000,-4000,,,,-2777000,108920000,106846000,73753000,11842000,,16693000,15325000,54914,NL
2019-12-31,1826346,,5775292,,4311547,8321693,15889367,5741328,5741328,,-1087051,,,,1463745,37573992,31832664,21684625,33964,,4311547,4311547,54916,NEWA
2018-12-31,2654513,,8868708,,7211429,9371411,20897380,8871456,8871456,,-658290,,,,1657279,47040704,38169248,26143324,-2748,,7211429,7211429,54916,NEWA
2017-12-31,1355648,,3066749,,2590931,4096701,8139631,2687282,2687282,,-242707,,,,475818,25339497,22652215,17199866,379467,,2590931,2590931,54916,NEWA
2016-12-31,622051,,2982157,,2433720,2524470,4540948,1394427,1394427,,-155553,,,,548437,12279721,10885294,7738773,1587730,,2433720,2433720,54916,NEWA
2020-12-31,,,30600000,,8800000,841600000,1060000000,218400000,218400000,,-23100000,,,,21700000,1790800000,1572400000,730800000,-187800000,,8900000,8800000,54917,DLX
2019-12-31,,,-185630000,,-199897000,883890000,1199342000,315452000,315452000,,-34682000,,,,14267000,2008715000,1693263000,809373000,-501082000,,-199897000,-199998000,54917,DLX
2018-12-31,,,212631000,,149630000,836032000,1207743000,371711000,371711000,,-27112000,,,,63001000,1998025000,1626314000,790282000,-159080000,,149630000,149013000,54917,DLX
2017-12-31,,,312827000,,230155000,830105000,1223417000,393312000,393312000,,-21359000,,,,82672000,1965556000,1572244000,742139000,-80485000,,230155000,228698000,54917,DLX
2019-12-31,,,797194000,6014000,620363000,684000,1219265000,693693000,693693000,524888000,,,,,165417000,4070143000,3376450000,2850878000,103501000,,631777000,620363000,54919,ANAT
2018-12-31,,,161867000,14267000,158995000,572000,638169000,140586000,140586000,497011000,,,,,1445000,3326382000,3185796000,2688213000,21281000,,160422000,158995000,54919,ANAT
2017-12-31,,,402612000,9012000,493651000,12408000,813686000,315938000,315938000,485340000,,,,,-92995000,3411000000,3095062000,2597314000,74174000,,495607000,493651000,54919,ANAT
2016-12-31,,,260373000,9317000,181003000,7421000,687056000,203173000,203173000,476462000,,,,,77706000,3227951000,3024778000,2540895000,57200000,,182667000,181003000,54919,ANAT
2020-12-31,,,4162000000,,3533000000,2979000000,7011000000,3742000000,3742000000,,-516000000,,,,629000000,36052000000,32310000000,29041000000,420000000,,3533000000,3533000000,54920,CB
2019-12-31,,,5249000000,,4454000000,3139000000,8716000000,5207000000,5207000000,65000000.0,-552000000,,,,795000000,34230000000,29023000000,25514000000,42000000,,4454000000,4454000000,54920,CB
2018-12-31,,,4657000000,,3962000000,3000000000,8224000000,4843000000,4843000000,42000000.0,-641000000,,,,695000000,32679000000,27836000000,24455000000,-186000000,,3962000000,3962000000,54920,CB
2017-12-31,,,3722000000,,3861000000,2949000000,7545000000,4271000000,4271000000,65000000.0,-607000000,,,,-139000000,32340000000,28069000000,24795000000,-549000000,,3861000000,3861000000,54920,CB
2019-12-31,67193830,,-70292227,,-70292227,27307162,42976478,-51524514,-51524514,,-85569,,,,0,42976478,94500992,0,-18767713,,-70292227,-70292227,54921,ARVN
2018-12-31,45193830,,-41480466,,-41480466,12932168,14323920,-43802078,-43802078,,-57440,,,,0,14323920,58125998,0,2321612,,-41480466,-239847222,54921,ARVN
2017-12-31,28792902,,-24049206,,-24049206,3546241,7578876,-24760267,-24760267,,-50357,,,,0,7578876,32339143,0,711061,,-24049206,-28619637,54921,ARVN
2016-12-31,19942194,,-14438051,,-14350643,3196250,6669024,-16469420,-16469420,,-67404,,,,-87408,6669024,23138444,0,2031369,,-14350643,-12353623,54921,ARVN
2019-12-31,,,419467760,,419467760,19301486,439138191,419466993,419466993,369712,,,,,0,439138191,19671198,0,767,,419467760,419467760,54922,CEF
2018-12-31,,,-256982762,,-256999604,19102232,-235496065,-257076651,-257076651,2478354,,,,,16842,-235496065,21580586,0,93889,,-256999604,-256999604,54922,CEF
2017-10-31,,,-89349467,,-89349467,15093419,42543,-8919313,-8919313,-6131563,,,,,0,42543,8961856,0,-80430154,,-89349467,-89349467,54922,CEF
2016-10-31,,,370372829,,370372829,11830017,119828,4048322,4048322,-15758511,,,,,0,119828,-3928494,0,366324507,,370372829,370372829,54922,CEF
2020-07-31,,,25586490,,25586490,3918309,17982518,14064209,14064209,,-3126362,,,,0,17982518,3918309,0,11522281,,25586490,25586490,54923,MYC
2019-07-31,,,26980304,,26980304,3153371,20367329,17213958,17213958,,-5291594,,,,0,20367329,3153371,0,9766346,,26980304,26980304,54923,MYC
2018-07-31,,,5428171,,5428171,3093891,21627945,18534054,18534054,,-4337547,,,,0,21627945,3093891,0,-13105883,,5428171,5428171,54923,MYC
2017-07-31,,,-7505768,,-7505768,3249243,22786016,19536773,19536773,,-3747889,,,,0,22786016,3249243,0,-27042541,,-7505768,-7505768,54923,MYC
2020-12-31,,,848000000,,732000000,,1366000000,936000000,936000000,430000000,-88000000,,,,127000000,7760000000,6824000000,6394000000,-88000000,,721000000,732000000,54924,AFG
2019-12-31,,,1108000000,,897000000,,1675000000,1286000000,1286000000,389000000,-68000000,,,,239000000,8017000000,6731000000,6342000000,-178000000,,869000000,897000000,54924,AFG
2018-12-31,,,639000000,2000000.0,530000000,,1072000000,728000000,728000000,344000000,-62000000,,,,122000000,6939000000,6211000000,5867000000,-89000000,,517000000,530000000,54924,AFG
2017-12-31,,,724000000,4000000.0,475000000,,1302000000,955000000,955000000,347000000,-85000000,,,,247000000,6684000000,5729000000,5382000000,-231000000,,477000000,475000000,54924,AFG
2020-02-01,,,92430000,,68493000,555922000,638126000,97061000,97061000,-14857000,-1245000,,,,23937000,1122790000,1025729000,484664000,-4631000,,68493000,68493000,54925,OXM
2019-02-02,,,88309000,,66291000,550332000,631742000,95386000,95386000,-13976000,-2283000,,,,22018000,1107466000,1012080000,475724000,-7077000,,66291000,66291000,54925,OXM
2018-02-03,,,82891000,,65090000,533516000,606632000,87001000,87001000,-13885000,-3109000,,,,18190000,1086211000,999210000,479579000,-4110000,389000.0,64701000,65090000,54925,OXM
2017-01-28,,,86463000,,52461000,496684000,578171000,95667000,95667000,-14180000,-3421000,,,,31964000,1022588000,926921000,444417000,-9204000,-2038000.0,54499000,52461000,54925,OXM
2020-12-31,,,-7304569,,-7304569,44392105,36343524,-8048581,-8048581,,-253505,,,,0,44640007,52688588,8296483,744012,,-7304569,-7304569,54926,INUV
2019-12-31,,,-4822501,,-4488107,45562534,38824341,-6738193,-6738193,,-482210,,,,-334394,61525214,68263407,22700873,1915692,,-4488107,-4488107,54926,INUV
2018-12-31,,,-5890832,,-5890832,48879540,43409160,-5470380,-5470380,,-420452,,,,0,73330642,78801022,29921482,-420452,,-5890832,-5890832,54926,INUV
2017-12-31,,,-4554667,,-3057700,46771424,42884950,-3886474,-3886474,,-318193,,,,-1498076,79554493,83440967,36669543,-668193,-1109.0,-3056591,-3057700,54926,INUV
2019-12-31,,,271087000,12000,207187000,354743000,643900000,289157000,289157000,,,,,,63900000,3083015000,2793858000,2439115000,-18070000,,207187000,207187000,54927,TPH
2018-12-31,,,362065000,13000,269911000,342297000,727759000,385462000,385462000,,,,,,90552000,3262747000,2877285000,2534988000,-23397000,,271513000,269911000,54927,TPH
2017-12-31,,,339818000,605000,187191000,274830000,627983000,353153000,353153000,,,,,,152267000,2810272000,2457119000,2182289000,-13335000,,187551000,187191000,54927,TPH
2016-12-31,,,302227000,19063000,195171000,252022000,555228000,303206000,303206000,,,,,,106094000,2405142000,2101936000,1849914000,-979000,,196133000,195171000,54927,TPH
2019-12-31,13489000,,-20563000,,-20563000,8718000,0,-22207000,-22207000,,,,,,0,0,22207000,0,1644000,,-20563000,-20563000,54928,PHGE
2018-12-31,9135000,,-12720000,,-12720000,3360000,0,-12495000,-12495000,,-225000.0,,,,0,0,12495000,0,-225000,,-12720000,-15253000,54928,PHGE
2017-12-31,4176000,,-6433000,,-6433000,2536000,0,-6712000,-6712000,,-225000.0,,,,0,0,6712000,0,279000,,-6433000,-7394000,54928,PHGE
2016-12-31,1149000,,-1900000,,-1900000,620000,0,-1769000,-1769000,,-225000.0,,,,0,0,1769000,0,-131000,,-1900000,-1977000,54928,PHGE
2019-12-31,,,1275982,,907713,5860702,8052701,0,1407512,784487,,,,,368269,8052701,6645189,0,-131530,,907713,907713,54929,CBMB
2018-12-31,,,896127,,673122,5082593,6735217,0,1025695,626929,,,,,223005,6735217,5709522,0,-129568,,673122,673122,54929,CBMB
2017-12-31,,,507772,,986,4402714,5918782,0,890092,625976,,,,,506786,5918782,5028690,0,-382320,,986,986,54929,CBMB
2016-12-31,,,602410,,373656,4248228,6109184,0,1195920,665036,,,,,228754,6109184,4913264,0,-593510,,373656,373656,54929,CBMB
2020-10-31,,,105569535,,105569535,2940787,3616066,675279,675279,,,,,,0,3616066,2940787,0,104894256,,105569535,105569535,54930,CHN
2019-10-31,,,57154466,,57154466,3626225,5187995,1561770,1561770,,,,,,0,5187995,3626225,0,55592696,,57154466,57154466,54930,CHN
2018-10-31,,,-59435494,,-59435494,7003680,9274327,2270647,2270647,,,,,,0,9274327,7003680,0,-61706141,,-59435494,-59435494,54930,CHN
2017-10-31,,,78643974,,78643974,4670865,7565231,2881848,2881848,12518.0,,,,,0,7565231,4683383,0,75762126,,78643974,78643974,54930,CHN
2019-12-31,,,847977000,,673763000,,900633000,900633000,900633000,,-52656000,,,,174214000,1213977000,313344000,313344000,-52656000,,673763000,673763000,54931,MTG
2018-12-31,,,844150000,,670097000,,897143000,897143000,897143000,,-52993000,,,,174053000,1123848000,226705000,226705000,-52993000,,670097000,670097000,54931,MTG
2017-12-31,,,784496000,,355761000,,841596000,841596000,841596000,,-57035000,,,,428735000,1066054000,224458000,224458000,-57100000,,355761000,355761000,54931,MTG
2016-12-31,,,514714000,,342517000,,657917000,657917000,657917000,,-56672000,,,,172197000,1058483000,400566000,400566000,-143203000,,342517000,342517000,54931,MTG
2020-08-26,,,-29064000,,-29450000,25071000,50793000,-21894000,-21894000,36088000,-6388000,,,,357000,214022000,235916000,163229000,-7170000,-29000,-29421000,-29450000,54932,LUB
2019-08-28,,,-14750000,,-15226000,34785000,87162000,-12463000,-12463000,50786000,-5977000,,,,469000,323470000,335933000,236308000,-2287000,-7000,-15219000,-15226000,54932,LUB
2018-08-29,,,-25224000,,-33568000,39325000,100392000,-18626000,-18626000,61686000,-2648000,,,,7730000,365196000,383822000,264804000,-6598000,-614000,-32954000,-33568000,54932,LUB
2017-08-30,,,-20358000,,-23262000,38478000,112026000,-8706000,-8706000,61324000,-2709000,,,,2438000,376031000,384737000,264005000,-11652000,-466000,-22796000,-23262000,54932,LUB
2019-12-31,,,-94811000,,-23848000,680924000,629575000,-104845000,-104845000,,-23460000,,,,-70963000,1704048000,1808893000,1074473000,10034000,,-23848000,-23848000,54934,BMRN
2018-12-31,696328000.0,,-142705000,,-77211000,604353000,479620000,-155024000,-155024000,,-43664000,,,,-65494000,1491212000,1646236000,1011592000,12319000,,-77211000,-77211000,54934,BMRN
2017-12-31,696328000.0,,-35875000,,-117042000,554336000,461107000,-123558000,-123558000,,-42707000,,,,81167000,1313646000,1437204000,852539000,87683000,,-117042000,-117042000,54934,BMRN
2016-12-31,696328000.0,,-831050000,,-630210000,476593000,245329000,-261472000,-261472000,,-39499000,,,,-200840000,1116854000,1378326000,871525000,-569578000,,-630210000,-630210000,54934,BMRN
2020-09-30,88899000,,-26140000,,-20631000,82784000,230132000,37568000,37568000,,-22737000,,,,-5509000,329646000,292078000,99514000,-63708000,,-20631000,-20631000,54935,CRNC
2019-09-30,93061000,,11184000,,100268000,62187000,212470000,36200000,36200000,,-22737000,,,,-89084000,303315000,267115000,90845000,-25016000,,100268000,100268000,54935,CRNC
2018-09-30,80957000,,36798000,,5881000,50426000,201786000,53797000,53797000,,-22737000,,,,30917000,276984000,223187000,75198000,-16999000,,5881000,5881000,54935,CRNC
2017-09-30,56755000,,63202000,,47276000,47394000,183093000,66283000,66283000,,-22737000,,,,15926000,244729000,178446000,61636000,-3081000,,47276000,47276000,54935,CRNC
2020-12-31,,,-24888000000,14318000000,-20305000000,10430000000,25328000000,-10271000000,-10271000000,,-1808000000,,,,-4159000000,179671000000,189942000000,154343000000,-14617000000,,-20729000000,-20306000000,54937,BP
2019-12-31,,,8154000000,2296000000,4026000000,11120000000,45682000000,15255000000,15255000000,563000000.0,-2415000000,,,,3964000000,276850000000,261595000000,231168000000,-7101000000,,4190000000,4025000000,54937,BP
2018-12-31,,,16723000000,2104000000,9383000000,12306000000,45051000000,15914000000,15914000000,270000000.0,-1779000000,,,,7145000000,297220000000,281306000000,252169000000,809000000,,9578000000,9382000000,54937,BP
2017-12-31,,,7180000000,1913000000,3389000000,10728000000,37175000000,8623000000,8623000000,160000000.0,-1421000000,,,,3712000000,238433000000,229810000000,201258000000,-1443000000,,3468000000,3388000000,54937,BP
2020-12-31,,,8095000000,4647000000,6427000000,5943000000,14502000000,8559000000,8559000000,,-1098000000,,,,1774000000,122485000000,113926000000,107983000000,-464000000,,6321000000,6247000000,54938,GM
2019-12-31,,,7436000000,4165000000,6732000000,7694000000,12778000000,5084000000,5084000000,,-782000000,,,,769000000,137237000000,132153000000,124459000000,2352000000,,6667000000,6581000000,54938,GM
2018-12-31,,,8549000000,3917000000,8014000000,7985000000,14278000000,6293000000,6293000000,,-655000000,,,,474000000,147049000000,140756000000,132771000000,2256000000,-70000000.0,8075000000,7916000000,54938,GM
2017-12-31,,,11863000000,1199000000,-3864000000,8254000000,18404000000,10150000000,10150000000,,-575000000,,,,11533000000,145588000000,135438000000,127184000000,1713000000,-4212000000.0,330000000,-3880000000,54938,GM
2020-12-31,320700000,,1507700000,8500000,1613300000,1748400000,2608500000,539400000,539400000,,-148500000,,,,55500000,4634400000,4095000000,2025900000,968300000,161100000,1452200000,1544300000,54939,FTV
2019-12-31,456700000,,874500000,13200000,738900000,2079600000,3696100000,1159800000,1159800000,,-164200000,,,,149100000,7320000000,6160200000,3623900000,-285300000,13500000,725400000,669900000,54939,FTV
2018-12-31,414300000,,1078400000,17400000,2913800000,1701900000,3323300000,1207100000,1207100000,,-97000000,,,,160100000,6452700000,5245600000,3129400000,-128700000,1995500000,918300000,2878900000,54939,FTV
2017-12-31,369300000,,1073600000,17900000,1044500000,1377800000,2923400000,1176300000,1176300000,,-88700000,,,,189300000,5756100000,4579800000,2832700000,-102700000,160200000,884300000,1044500000,54939,FTV
2019-12-31,,,-4130000,49000,-5048000,5700000,22473000,7205000,7205000,,-7976000,,,,937000,61242000,54037000,38769000,-11335000,,-5067000,-5664000,54941,CDOR
2018-12-31,,,5505000,848000,5365000,6217000,23831000,8139000,8139000,,-8326000,,,,335000,64839000,56700000,41008000,-2634000,,5170000,4720000,54941,CDOR
2017-12-31,,,2306000,1408000,2881000,6552000,17259000,3809000,3809000,,-5174000,,,,-595000,55643000,51834000,38384000,-1503000,,2901000,-9418000,54941,CDOR
2016-12-31,,,22969000,2827000,22795000,5792000,12761000,1779000,1779000,,-4710000,,,,125000,50403000,48624000,37642000,21190000,678000.0,22844000,2047000,54941,CDOR
2019-12-31,,,88269000,148379000,84969000,31081000,503284000,197157000,197157000,,-116299000,,,,1507000,943042000,745885000,439758000,-108888000,,86762000,83067000,54942,ACC
2018-12-31,,,121553000,250196000,117095000,34537000,465373000,167633000,167633000,-2648000.0,-105044000,,,,2429000,880810000,713177000,415437000,-36912000,,119124000,115573000,54942,ACC
2017-12-31,,,71110000,146142000,69038000,26871000,424196000,162370000,162370000,-2648000.0,-75741000,,,,989000,796447000,634077000,372251000,-91260000,,70121000,67502000,54942,ACC
2016-12-31,,,101773000,60580000,99061000,22493000,411918000,178038000,178038000,-2648000.0,-85207000,,,,1150000,786361000,608323000,374443000,-76265000,,100623000,97723000,54942,ACC
2019-12-31,,,39823000,,31458000,55312000,107144000,39777000,39777000,12055000,,,,,8365000,183456000,143679000,76312000,46000,,31458000,31458000,54944,ITIC
2018-12-31,,,27069000,,21892000,52365000,90828000,27081000,27081000,11382000,,,,,5210000,156271000,129190000,65443000,-12000,,21859000,21892000,54944,ITIC
2017-12-31,,,30271000,85000.0,25707000,48109000,89650000,30248000,30248000,11293000,,,,,4570000,161604000,131356000,71954000,23000,,25701000,25707000,54944,ITIC
2016-12-31,,,28131000,90885.0,19523000,37925000,74590000,28119000,28119000,8546000,,,,,8616000,138476000,110357000,63886000,12000,,19515000,19523000,54944,ITIC
2019-12-31,4715000,,22854000,194000,17286000,43850000,70487000,21922000,21922000,,,,,,5429000,111360000,89438000,40873000,932000,,17425000,17286000,54945,OFLX
2018-12-31,4813000,,26728000,252000,20139000,34917000,66096000,26366000,26366000,81585000.0,,,,,6451000,108313000,81947000,42217000,362000,,20277000,20139000,54945,OFLX
2017-12-31,3293000,,24296000,611000,15662000,34256000,61766000,24217000,24217000,81585000.0,,,,,8450000,101799000,77582000,40033000,79000,,15846000,15662000,54945,OFLX
2016-12-31,3185000,,21521000,382000,14377000,32802000,57884000,21897000,21897000,81585000.0,,,,,6975000,94051000,72154000,36167000,-307000,,14546000,14377000,54945,OFLX
2019-12-31,,,1106000,74581000,-1632000,25051000,24787000,-191000,-191000,-73000,-845000,,,,2057000,338160000,338351000,313373000,1297000,,-951000,-1632000,54948,APWC
2018-12-31,,,11332000,71788000,2928000,26924000,36248000,8602000,8602000,722000,-1200000,,,,3886000,425940000,417338000,389692000,2730000,,7446000,2928000,54948,APWC
2017-12-31,,,18668000,69498000,8720000,27248000,39688000,12214000,12214000,226000,-966000,,,,5140000,425215000,413001000,385527000,6454000,,13528000,8720000,54948,APWC
2016-12-31,,,6535000,61225000,2853000,26325000,31608000,5307000,5307000,-24000,-962000,,,,510000,384565000,379258000,352957000,1228000,,6025000,2853000,54948,APWC
2019-12-31,,,182512000,4747000,110738000,31752000,459079000,110616000,110616000,11524000,-16879000,,,,71268000,1350759000,1240143000,891680000,71896000,,111244000,110738000,54951,PAAS
2018-12-31,,,33188000,5137000,10294000,22649000,248186000,34600000,34600000,5253000,-16879000,,,,21147000,784495000,749895000,536309000,-1412000,,12041000,10294000,54951,PAAS
2017-12-31,,,182485000,4201000,120991000,21397000,295157000,154668000,154668000,10872000,-16879000,,,,59034000,816828000,662160000,521671000,27817000,,123451000,120991000,54951,PAAS
2016-12-31,,,176271000,2706000,100085000,23663000,314834000,156117000,156117000,7765000,-2115000,,,,74446000,774775000,618658000,459941000,20154000,,101825000,100085000,54951,PAAS
2019-12-31,,,8224000,137220000,7207000,20184000,149800000,37177000,37177000,,-33460000,,,,0,221722000,184545000,71922000,-28953000,,8224000,7088000,54953,DEA
2018-12-31,,,6659000,131090000,5704000,14824000,112368000,31141000,31141000,,-22903000,,,,0,160591000,129450000,48223000,-24482000,,6659000,4581000,54953,DEA
2017-12-31,,,5389000,123283000,4448000,12900000,92036000,24263000,24263000,,-17071000,,,,0,130673000,106410000,38637000,-18874000,,5389000,4338000,54953,DEA
2016-12-31,,,5497000,137844000,3963000,12289000,73644000,15472000,15472000,,-8177000,,,,0,104618000,89146000,30974000,-9975000,,5497000,3861000,54953,DEA
2020-06-30,,,-94558000,,-78358000,75256000,41991000,-37912000,-37912000,,-7641000,,,,2656000,150997000,188909000,109006000,-56646000,18856000,-97214000,-76827000,54954,UEPS
2019-06-30,,,-318185000,,-311007000,124351000,56240000,-80214000,-80214000,,-9860000,,,,-5072000,185936000,266150000,129696000,-237971000,754000,-313113000,-306640000,54954,UEPS
2018-06-30,,,96368000,95911000.0,62087000,130322000,216021000,75226000,75226000,,-8569000,,,,45106000,459575000,384349000,243554000,21142000,9945000,51262000,61052000,54954,UEPS
2017-06-30,,,117270000,2766000.0,73070000,171262000,317683000,105043000,105043000,,-3484000,,,,42506000,610066000,505023000,292383000,12227000,9945000,74764000,73070000,54954,UEPS
2019-12-31,,,5762000,7186000,4526000,7454000,13710000,6256000,6256000,,-494000,,,,154000,84919000,78663000,71209000,-494000,,5608000,4526000,54956,TTCF
2018-12-31,,,-365000,-102000,-121000,3237000,3187000,-50000,-50000,,-315000,,,,-29000,47295000,47345000,44108000,-315000,,-336000,-121000,54956,TTCF
2020-02-01,,,901000000,,691000000,5705000000,7834000000,1212000000,1212000000,,-207000000,,,,210000000,19974000000,18762000000,12140000000,-311000000,,691000000,691000000,54957,KSS
2019-02-02,,,1042000000,,801000000,5601000000,8030000000,1433000000,1433000000,32000000.0,-256000000,,,,241000000,20229000000,18796000000,12199000000,-391000000,,801000000,801000000,54957,KSS
2018-02-03,,,1117000000,,859000000,5501000000,7908000000,1438000000,1438000000,32000000.0,-299000000,,,,258000000,20084000000,18646000000,12176000000,-321000000,,859000000,859000000,54957,KSS
2017-01-28,,,875000000,,556000000,5430000000,7737000000,1369000000,1369000000,32000000.0,-308000000,,,,319000000,19681000000,18312000000,11944000000,-494000000,,556000000,556000000,54957,KSS
2019-12-31,,,19000000,,19000000,450000000,527000000,87000000,87000000,-28000000,-60000000,,,,0,3234000000,3147000000,2707000000,-68000000,,19000000,19000000,54958,PTNR
2018-12-31,,,63000000,,57000000,441000000,559000000,116000000,116000000,-28000000,-38000000,,,,7000000,3259000000,3143000000,2700000000,-53000000,,56000000,57000000,54958,PTNR
2017-12-31,,,135000000,,114000000,413000000,641000000,207000000,207000000,-31000000,-77000000,,,,21000000,3268000000,3061000000,2627000000,-72000000,,114000000,114000000,54958,PTNR
2016-12-31,,,88000000,,52000000,607000000,620000000,-24000000,-24000000,-45000000,-105000000,,,,36000000,3544000000,3568000000,2924000000,112000000,,52000000,52000000,54958,PTNR
2019-12-31,43000000,,270000000,,212000000,327000000,684000000,268000000,268000000,,-21000000,,,,58000000,3856000000,3588000000,3172000000,2000000,,212000000,212000000,54960,TNET
2018-12-31,49000000,,241000000,,192000000,324000000,664000000,251000000,251000000,,-22000000,,,,49000000,3503000000,3252000000,2839000000,-10000000,,192000000,192000000,54960,TNET
2017-12-31,45000000,,200000000,,178000000,301000000,596000000,217000000,217000000,,-20000000,,,,22000000,3275000000,3058000000,2679000000,-17000000,,178000000,178000000,54960,TNET
2016-12-31,31000000,,104000000,,61000000,266000000,456000000,124000000,124000000,,-20000000,,,,43000000,3060000000,2936000000,2604000000,-19249000,,61000000,61000000,54960,TNET
2020-06-27,,,-222200000,,-114100000,2505300000,2923700000,158500000,158500000,,-116900000,,,,-108100000,25086300000,24927800000,22162600000,-380700000,,-114100000,-114100000,54961,PFGC
2019-06-29,,,218300000,,166800000,2074700000,2513000000,283300000,283300000,,-65400000,,,,51500000,19743500000,19460200000,17230500000,-65000000,,166800000,166800000,54961,PFGC
2018-06-30,,,193600000,,198700000,1939000000,2292800000,253500000,253500000,,-60400000,,,,-5100000,17619900000,17366400000,15327100000,-59900000,,198700000,198700000,54961,PFGC
2017-07-01,,,157700000,,96300000,1822300000,2124800000,211000000,211000000,,-54900000,,,,61400000,16761800000,16550800000,14637000000,-58500000,,96300000,96300000,54961,PFGC
2020-07-31,,,6333364,,6333364,1557994,9634881,8076887,8076887,,-1301305,,,,0,9634881,1557994,0,-1743523,,6333364,6333364,54962,BBF
2019-07-31,,,9972395,,9972395,1629327,10921712,9292385,9292385,,-1991842,,,,0,10921712,1629327,0,680010,,9972395,9972395,54962,BBF
2018-07-31,,,2051406,,2051406,1659372,11802692,10143320,10143320,,-2006714,,,,0,11802692,1659372,0,-8091914,,2051406,2051406,54962,BBF
2017-07-31,,,-1260167,,-1260167,1688091,11768915,10080824,10080824,,-1536275,,,,0,11768915,1688091,0,-11340991,,-1260167,-1260167,54962,BBF
2020-06-30,,,-1738000,,-1645000,15098000,18871000,491000,491000,,-67000,,,,-93000,118876000,118385000,100005000,-2229000,,-1645000,-1645000,54963,NAII
2019-06-30,,,7953000,,6541000,15214000,23575000,8361000,8361000,,-29000,,,,1412000,138290000,129929000,114715000,-408000,,6541000,6541000,54963,NAII
2018-06-30,,,10613000,,5051000,13887000,26320000,12433000,12433000,,-9000,,,,5562000,132437000,120004000,106117000,-1820000,,5051000,5051000,54963,NAII
2017-06-30,,,10111000,,7235000,12302000,26204000,13902000,13902000,,-3000,,,,2876000,121946000,108044000,95742000,-3791000,,7235000,7235000,54963,NAII
2019-12-31,,,-3888249,,-3888249,3966550,478747,-3527811,-3527811,,,,,,0,1577033,5104844,1098286,-360438,,-3888249,-3888249,54966,AKER
2018-12-31,1063253.0,,-10849034,,-10849034,7448333,127285,-7492156,-7492156,,,,,,0,1665570,9157726,1538285,-3356878,,-10849034,-10849034,54966,AKER
2017-12-31,1260378.0,,-7366310,,-7366310,6130884,948580,-6613790,-6613790,,,,,,0,3354712,9968502,2406132,-752520,,-7366310,-7366310,54966,AKER
2016-12-31,1188868.0,,-3303538,,-3303538,4992239,1877825,-4474390,-4474390,,,,,,0,2960912,7435302,1083087,1170852,,-3303538,-3303538,54966,AKER
2019-12-31,10624000,,-2027000,,-2027000,61773000,73389000,992000,992000,,-3549000,,,,0,123864000,122872000,50475000,-3019000,,-2027000,-2027000,54967,ATRS
2018-12-31,12328000,,-6515000,,-6515000,36762000,32489000,-16601000,-16601000,,-2675000,,,,0,63554000,80155000,31065000,10086000,,-6515000,-6515000,54967,ATRS
2017-12-31,11854000,,-16743000,,-16743000,31646000,27049000,-16451000,-16451000,,-1423000,,,,0,54515000,70966000,27466000,-292000,,-16743000,-16743000,54967,ATRS
2016-12-31,19592000,,-24239000,,-24339000,27930000,23405000,-24117000,-24117000,,-1423000,,,,100000,52222000,76339000,28817000,-122000,,-24339000,-24339000,54967,ATRS
2020-06-28,,,-155000,,-4233000,5503000,6538000,796000,796000,,-95000,,,,4078000,10028000,9232000,3490000,-951000,,-4233000,-4233000,54969,RAVE
2019-06-30,,,-801000,,-750000,5274000,7421000,1332000,1332000,,-104000,,,,-51000,12319000,10987000,4898000,-2133000,,-750000,-750000,54969,RAVE
2018-06-24,,,-1048000,,1912000,7597000,8821000,-115000,-115000,,-183000,,,,-3322000,15120000,15235000,6299000,-933000,-362000.0,2274000,1912000,54969,RAVE
2017-06-25,,,-11190000,,-12491000,10801000,9414000,-4325000,-4325000,,-106000,,,,53000,26077000,30402000,16663000,-6865000,-1248000.0,-11243000,-12491000,54969,RAVE
2019-12-31,,,-240000000,1000000,1458000000,329000000,1065000000,503000000,503000000,,-407000000,,,,44000000,6660000000,6157000000,5595000000,-743000000,1742000000,-284000000,1458000000,54970,ARD
2018-12-31,,,-274000000,1000000,-94000000,316000000,1053000000,500000000,500000000,,-443000000,,,,18000000,6676000000,6176000000,5623000000,-774000000,198000000,-292000000,-94000000,54970,ARD
2017-12-31,,,-203000000,1000000,63000000,304000000,1081000000,540000000,540000000,,-441000000,,,,-77000000,6390000000,5850000000,5309000000,-743000000,189000000,-126000000,63000000,54970,ARD
2016-12-31,,,-19000000,3000000,-74000000,360000000,1243000000,692000000,692000000,,-497000000,,,,55000000,7014000000,6322000000,5771000000,-711000000,189000000,-74000000,-74000000,54970,ARD
2020-02-29,,,78367634,,78367634,5903980,40454471,34550491,34550491,,-8541063,,,,0,40454471,5903980,0,43817143,,78367634,78367634,54971,VCV
2019-02-28,,,19967926,,19967926,5962145,41142332,35107960,35107960,72227.0,-7276775,,,,0,41142332,6034372,0,-15140034,,19967926,19967926,54971,VCV
2018-02-28,,,17767299,,17767299,6241453,44762501,38388988,38388988,132060.0,-7478849,,,,0,44762501,6373513,0,-20621689,,17767299,17767299,54971,VCV
2017-02-28,,,752436,,752436,5447212,44275685,38828473,38828473,132060.0,-5468733,,,,0,44275685,5447212,0,-38076037,,752436,752436,54971,VCV
2020-12-31,,,135888000,222310000,131706000,41680000,545332000,248625000,248625000,,-136289000,,,,0,835494000,586869000,290162000,-112737000,,135888000,123664000,54973,FRT
2019-12-31,,,360542000,240549000,353866000,50181000,642445000,352506000,352506000,,-109623000,,,,0,933776000,581270000,291331000,8036000,,360542000,344817000,54973,FRT
2018-12-31,,,249026000,257647000,241907000,41535000,632103000,346323000,346323000,,-110154000,,,,0,912038000,565715000,279935000,-97297000,,249026000,232935000,54973,FRT
2017-12-31,,,297870000,265965000,289914000,45288000,593209000,331871000,331871000,,-100125000,,,,0,856931000,525060000,263722000,-34001000,,297870000,286514000,54973,FRT
2020-12-31,,,3976000,,3156000,,15821000,0,3976000,11845000,,,,,820000,15821000,11845000,0,0,,3156000,3156000,54975,CNNB
2019-12-31,,,886168,,798474,6330469.0,8553606,0,836745,1386392,,,,,87694,8553606,7716861,0,49423,,798474,791102,54975,CNNB
2018-12-31,,,2492600,,2301322,5450024.0,7549048,0,929110,1169914,,,,,191278,7549048,6619938,0,1563490,,2301322,2274138,54975,CNNB
2017-12-31,,,908836,,875241,4847656.0,6818079,0,946563,1023860,,,,,33595,6818079,5871516,0,-37727,,875241,864395,54975,CNNB
2019-12-31,16397000,,-92493000,,-92493000,76445000,3173000,-89669000,-89669000,,-249000,,,,0,5652000,95321000,2479000,-2824000,,-92493000,-92493000,54976,PTE
2018-12-31,20748000,,-110508000,,-110508000,91842000,1752000,-110838000,-110838000,,-60000,,,,0,4038000,114876000,2286000,330000,,-110508000,-110508000,54976,PTE
2018-10-31,19376000,,-65743000,,-65441000,50559000,561000,-69374000,-69374000,,-35000,,,,-302000,1563000,70937000,1002000,3631000,,-65441000,-74161000,54976,PTE
2017-10-31,111800000,,-130480000,,-130829000,18812000,0,-130612000,-130612000,,-35000,,,,0,0,130612000,0,132000,-349000.0,-130480000,-131322000,54976,PTE
2020-12-31,,,1411000000,,-401000000,,5258000000,2055000000,2055000000,871000000,-1377000000,,,,83000000,14172000000,12117000000,8914000000,-644000000,-1878000000,1328000000,-465000000,54977,DCUE
2019-12-31,,,1727000000,2039000000.0,1358000000,-141000000.0,7970000000,4416000000,4416000000,1040000000,-1773000000,,,,351000000,16572000000,12156000000,8602000000,-2689000000,-1878000000,1376000000,1341000000,54977,DCUE
2018-12-31,,,3129000000,1941000000.0,2447000000,-260000000.0,6482000000,4039000000,4039000000,703000000,-1493000000,,,,580000000,13366000000,9327000000,6884000000,-910000000,-1878000000,2549000000,2447000000,54977,DCUE
2017-12-31,,,3090000000,2228000000.0,2999000000,-237000000.0,6378000000,4042000000,4042000000,668000000,-1205000000,,,,-30000000,12586000000,8544000000,6208000000,-952000000,-1878000000,3120000000,2999000000,54977,DCUE
2020-10-31,,,5182980,,5182980,3368149,24792667,21424518,21424518,,-1544906,,,,0,24792667,3368149,0,-16241538,,5182980,5182980,54979,DHY
2019-10-31,,,19976506,,19976506,3606627,27141609,23534982,23534982,,-3509677,,,,0,27141609,3606627,0,-3558476,,19976506,19976506,54979,DHY
2018-10-31,,,2532734,,2532734,3952776,29125960,25173184,25173184,,-3300558,,,,0,29125960,3952776,0,-22640450,,2532734,2532734,54979,DHY
2017-10-31,,,45148252,,45148252,3810689,28541824,24731135,24731135,,-2096609,,,,0,28541824,3810689,0,20417117,,45148252,45148252,54979,DHY
2019-12-31,1208536,,-2700989,,-11789455,8982479,12768806,2577791,2577791,,-3020012,,,,-332571,17137301,14559510,4368495,-5278780,-9421037,-2368418,-11939455,54981,NXTD
2018-12-31,761722,,-1294293,,-7089962,10963509,12312720,587489,587489,,-2967211,,,,34323,17116511,16529022,4803791,-1881782,-5761346,-1328616,-7189962,54981,NXTD
2017-12-31,761009,,-8388725,,-8264873,12369572,10978868,-2151713,-2151713,,-7697165,,,,160404,16043060,18194773,5064192,-6237012,284256,-8549129,-8994687,54981,NXTD
2016-12-31,888187,,-12556893,,-12752928,8518125,3301452,-6104860,-6104860,,-3275059,,,,196035,7736320,13841180,4434868,-6452033,284256,-12752928,-13833669,54981,NXTD
2019-12-31,,,-16908104,,-16908104,18738939,5456961,-13281978,-13281978,,-523391,,,,0,15596624,28878602,10139663,-3626126,,-16908104,-16908104,54982,EAST
2018-12-31,,,-9047669,,-9047669,10571208,2310201,-8261007,-8261007,,-789362,,,,0,6123510,14384517,3813309,-786662,,-9047669,-9047669,54982,EAST
2017-12-31,,,-5277917,15585.0,-5277316,5765827,976927,-4788900,-4788900,,-235053,,,,0,2610996,7399896,1634069,-489017,,-5277917,-5277316,54982,EAST
2016-12-31,,,-5199619,15585.0,-5199619,5125923,827962,-4297961,-4297961,,-862468,,,,0,2108306,6406267,1280344,-901658,,-5199619,-5251293,54982,EAST
2019-12-31,4889340,,-12775025,,-12775025,3631176,17066,-8503450,-8503450,,,,,,0,17066,8520516,0,-4271575,,-12775025,-18059404,54984,XBIO
2018-12-31,2883952,,-7300458,,-7300458,4392375,0,-7276327,-7276327,,,,,,0,0,7276327,0,-24131,,-7300458,-7300458,54984,XBIO
2017-12-31,3960000,,-3595132,,-3595132,6437643,7428881,-2968762,-2968762,,-1818.0,,,,0,7585000,10553762,156119,-626370,,-3595132,-3595132,54984,XBIO
2016-12-31,4137814,,-54206106,,-54206106,6792786,3000000,-7930600,-7930600,,-729572.0,,,,0,3000000,10930600,0,-46275506,,-54206106,-58241366,54984,XBIO
2019-12-31,,,2773987,,2773987,526001,0,-526001,-526001,,,,,,0,0,526001,0,3299988,,2773987,-359681,54985,SSPK
2020-10-31,,,-3676942,,-3676942,4329932,11070549,6740617,6740617,,-1632085,,,,0,11070549,4329932,0,-10417559,,-3676942,-3676942,54987,OCCI
2019-10-31,,,-7858509,,-7858509,3546936,8857672,5310736,5310736,,-982195,,,,0,8857672,3546936,0,-13169245,,-7858509,-7858509,54987,OCCI
2018-10-31,,,3438084,,3438084,1605540,4209984,2604444,2604444,,-982195,,,,0,4209984,1605540,0,833640,,3438084,3438084,54987,OCCI
2020-12-31,,,530066000,,390606000,503236000,1162879000,0,587768000,71875000,,,,,139460000,1162879000,575111000,0,-57702000,,390606000,377918000,54989,VLY
2019-12-31,,,456795000,,309793000,454807000,1070886000,0,553016000,63063000,,,,,147002000,1070886000,517870000,0,-96221000,,309793000,297105000,54989,VLY
2018-12-31,,,329693000,,261428000,462483000,934554000,0,408314000,63757000,,,,,68265000,934554000,526240000,0,-78621000,,261428000,248740000,54989,VLY
2017-12-31,,,252738000,,161907000,391335000,720064000,0,282575000,46154000,,,,,90831000,720064000,437489000,0,-29837000,,161907000,152458000,54989,VLY
2019-12-31,24279000,,-27570000,,-27570000,3830000,0,-28109000,-28109000,,,,,,0,0,28109000,0,539000,,-27570000,-27570000,54990,PRLD
2018-12-31,12621000,,-14680000,,-14680000,2354000,0,-14975000,-14975000,,,,,,0,0,14975000,0,295000,,-14680000,-14680000,54990,PRLD
2019-12-31,,,253000000,,246000000,192000000,779000000,587000000,587000000,,-170000000,,,,7000000,779000000,192000000,0,-334000000,,246000000,246000000,54991,FSK
2018-12-31,,,576000000,,569000000,98000000,394000000,296000000,296000000,,-84000000,,,,7000000,394000000,98000000,0,280000000,,569000000,569000000,54991,FSK
2017-12-31,,,187000000,,182000000,131000000,419000000,288000000,288000000,,-79000000,,,,5000000,419000000,131000000,0,-101000000,,182000000,182000000,54991,FSK
2016-12-31,,,300000000,,294000000,136000000,423000000,287000000,287000000,,-74000000,,,,6000000,423000000,136000000,0,13000000,,294000000,294000000,54991,FSK
2019-12-31,,,-330821000,6063000,-348444000,214891000,98244000,-116647000,-116647000,,-42711000,,,,17623000,2048124000,2164771000,1949880000,-214174000,,-348444000,-348444000,54992,OII
2018-12-31,,,-185833000,6063000,-212327000,198259000,129226000,-69033000,-69033000,,-37742000,,,,26494000,1909482000,1978515000,1780256000,-116800000,,-212327000,-212327000,54992,OII
2017-12-31,,,-17844000,5354000,166398000,183954000,194610000,10656000,10656000,,-27817000,,,,-184242000,1921507000,1910851000,1726897000,-28500000,,166398000,166398000,54992,OII
2016-12-31,,,43346000,5354000,24586000,203463000,288127000,79664000,79664000,,-25318000,,,,18760000,2271603000,2191939000,1983476000,-36318000,,24586000,24586000,54992,OII
2019-12-31,2954000,,-10016000,,-10040000,7618000,756000,-9816000,-9816000,,-200000,,,,24000,3721000,13537000,2965000,-200000,,-10040000,-10040000,54995,NSPR
2018-12-31,1535000,,-7240000,,-7240000,7071000,995000,-7611000,-7611000,,-67000,,,,0,3601000,11212000,2606000,371000,,-7240000,-7696000,54995,NSPR
2017-12-31,1276000,,-8411000,,-8438000,7541000,585000,-8232000,-8232000,,-119000,,,,27000,2761000,10993000,2176000,-179000,,-8438000,-13028000,54995,NSPR
2016-12-31,1291000,,-8460000,,-8461000,6459000,102000,-7648000,-7648000,,-721000,,,,1000,1894000,9542000,1792000,-812000,,-8461000,-8461000,54995,NSPR
2020-12-31,,,1728694000,,1406839000,1001142000,2786067000,1775020000,1775020000,9905000,-4248000,,,,321855000,11036082000,9261062000,8250015000,-46326000,,1406839000,1394385000,54997,PHM
2019-12-31,,,1339576000,,1016700000,1044337000,2411374000,1354702000,1354702000,12335000,-584000,,,,322876000,10212957000,8858255000,7801583000,-15126000,,1016700000,1006329000,54997,PHM
2018-12-31,,,1347540000,,1022023000,1012023000,2455866000,1437397000,1437397000,6446000,-618000,,,,325517000,10188331000,8750934000,7732465000,-89857000,,1022023000,1010831000,54997,PHM
2017-12-31,,,938828000,,447221000,891581000,2035324000,1122674000,1122674000,21069000,-503000,,,,491607000,8577686000,7455012000,6542362000,-183846000,,447221000,442649000,54997,PHM
2019-12-31,,,155158000,,117216000,32811000,5409000,-29277000,-29277000,,-25166000,,,,37942000,14859000,44136000,9450000,184435000,,117216000,117216000,54999,LBRDP
2018-12-31,,,91877000,,69953000,23497000,14262000,-12014000,-12014000,,-23302000,,,,21924000,22256000,34270000,7994000,103891000,,69953000,69953000,54999,LBRDP
2017-12-31,,,2450600000,,2033667000,24065000,2357000,-25478000,-25478000,,-19570000,,,,416933000,13092000,38570000,10735000,2476078000,,2033667000,2033667000,54999,LBRDP
2016-12-31,10240000.0,,1475672000,,917303000,34703000,27788000,-21160000,-21160000,,-14956000,,,,558369000,30586000,51746000,2798000,1496832000,,917303000,917303000,54999,LBRDP
2020-06-30,,,-241200000,,-234300000,1268500000,1810000000,321600000,321600000,,-145800000,,,,-32200000,2857600000,2536000000,1047600000,-562800000,-25300000,-209000000,-476000000,55000,MDP
2019-06-30,,,140600000,,46300000,1339500000,2027300000,440200000,440200000,,-159700000,,,,11500000,3188500000,2748300000,1161200000,-299600000,-82800000,129100000,-32000000,55000,MDP
2018-06-30,,,-9600000,,99400000,978900000,1396200000,288300000,288300000,,-95000000,,,,-123600000,2264200000,1975900000,868000000,-297900000,-14600000,114000000,66400000,55000,MDP
2017-06-30,,,290300000,,188900000,745000000,1104900000,306100000,306100000,,-18800000,,,,101400000,1713300000,1407200000,608400000,-15800000,-14600000,188900000,188900000,55000,MDP
2019-12-31,24632000,,-32996000,,-32996000,8273000,0,-32905000,-32905000,,-1767000,,,,0,0,32905000,0,-91000,,-32996000,-32996000,55002,SCPH
2018-12-31,15948000,,-29443000,,-29443000,13719000,0,-29667000,-29667000,,-1432000,,,,0,0,29667000,0,224000,,-29443000,-29443000,55002,SCPH
2017-12-31,14331000,,-23817000,,-23817000,9105000,0,-23436000,-23436000,,-797000,,,,0,0,23436000,0,-381000,,-23817000,-23817000,55002,SCPH
2016-12-31,11856000,,-24377000,,-24377000,6054000,0,-17910000,-17910000,,-6512000,,,,0,0,17910000,0,-6467000,,-24377000,-24377000,55002,SCPH
2020-12-31,,,31194000,,26038000,56574000,89874000,0,31441000,1859000,,,,,5156000,89874000,58433000,0,-247000,,26038000,26038000,55003,SI
2019-12-31,,,34672000,,24846000,50290000,87150000,0,35257000,1603000,,,,,9826000,87150000,51893000,0,-585000,,24846000,24846000,55003,SI
2018-12-31,,,30399000,,22333000,45475000,78713000,0,31656000,1582000,,,,,8066000,78713000,47057000,0,-1257000,,22333000,22333000,55003,SI
2017-12-31,,,14431000,,7643000,28631000,45137000,0,15136000,1370000,,,,,6788000,45137000,30001000,0,-705000,,7643000,7643000,55003,SI
2019-12-31,101515000,,-138325000,,-130778000,21177000,0,-122692000,-122692000,,,,,,-7547000,0,122692000,0,-15633000,,-130778000,-130778000,55005,SANA
2018-12-31,18080000,,-26494000,,-26494000,8412000,0,-26492000,-26492000,,,,,,0,0,26492000,0,-2000,,-26494000,-26494000,55005,SANA
2019-12-31,19258000,,-102808000,,-102808000,19238000,-64579000,-103075000,-103075000,,,,,,0,0,103075000,64579000,267000,,-102808000,-102808000,55006,CBAY
2018-12-31,14377000,,-72548000,,-72548000,14381000,-43747000,-72505000,-72505000,,-336000.0,,,,0,0,72505000,43747000,-43000,,-72548000,-72548000,55006,CBAY
2017-12-31,6934000,,-27557000,,-27557000,12387000,-2004000,-21325000,-21325000,,-1080000.0,,,,0,10000000,31325000,12004000,-8832000,,-27557000,-27557000,55006,CBAY
2016-12-31,6193000,,-26671000,,-26671000,9645000,-9748000,-25586000,-25586000,,-1337000.0,,,,0,0,25586000,9748000,-1085000,,-26671000,-26671000,55006,CBAY
2020-12-31,,,1435000000,,1141000000,3383000000,5414000000,0,1435000000,596000000,,,,,294000000,7900000000,6465000000,2486000000,0,,1141000000,1104000000,55007,DFS
2019-12-31,,,3835000000,,2957000000,3481000000,7819000000,0,3931000000,407000000,,,,,878000000,8228000000,4297000000,409000000,-96000000,,2957000000,2908000000,55007,DFS
2018-12-31,,,3597000000,,2742000000,3258000000,7324000000,0,3680000000,386000000,,,,,855000000,7674000000,3994000000,350000000,-83000000,,2742000000,2689000000,55007,DFS
2017-12-31,,,3537000000,,2099000000,3042000000,7003000000,0,3626000000,335000000,,,,,1438000000,7318000000,3692000000,315000000,-89000000,,2099000000,2031000000,55007,DFS
2020-08-31,46838000,,-3518000,,-9540000,91493000,151200000,-2510000,-2510000,,-956000,,,,6022000,265583000,268093000,114383000,-1008000,,-9540000,-9540000,55009,EXFO
2019-08-31,48047000,,2866000,,-2480000,98151000,168517000,7838000,7838000,,-718000,,,,5346000,286890000,279052000,118373000,-4972000,,-2480000,-2480000,55009,EXFO
2018-08-31,53935000,,-6576000,,-11902000,96021000,165059000,-668000,-668000,,-1228000,,,,5678000,269546000,270214000,104487000,-5908000,,-12254000,-11902000,55009,EXFO
2017-08-31,44936000,,7459000,,851000,84006000,150669000,14536000,14536000,,-303000,,,,6608000,243301000,228765000,92632000,-7077000,,851000,851000,55009,EXFO
2020-12-31,295600000,,141400000,300000,124800000,903500000,1818100000,619000000,619000000,,-66700000,,,,16500000,7108300000,6489300000,5290200000,-477600000,,124900000,124800000,55010,PII
2019-12-31,292935000,,407800000,203000,323960000,953037000,1729643000,483671000,483671000,,-77589000,,,,83916000,6863379000,6379708000,5133736000,-98612000,,323884000,323960000,55010,PII
2018-12-31,259682000,,429249000,279000,335257000,841536000,1588630000,487412000,487412000,,-56967000,,,,93992000,6165970000,5678558000,4577340000,-58163000,,335257000,335257000,55010,PII
2017-12-31,238299000,,318791000,279000,172492000,803001000,1400957000,359657000,359657000,,-32155000,,,,146299000,5504783000,5145126000,4103826000,-40866000,,172492000,172492000,55010,PII
2019-12-31,22407000,,10911000,,10167000,52071000,82076000,7598000,7598000,,,,,,744000,179866000,172268000,97790000,3313000,,10167000,10167000,55012,KRNT
2018-12-31,21912000,,7037000,,12429000,42032000,69869000,5925000,5925000,,,,,,-5392000,142373000,136448000,72504000,1112000,,12429000,12429000,55012,KRNT
2017-12-31,20834000,,-1631000,,-2015000,34857000,54111000,-1580000,-1580000,,,,,,384000,114088000,115668000,59977000,-51000,,-2015000,-2015000,55012,KRNT
2016-12-31,17383000,,1476000,,828000,30104000,49410000,1923000,1923000,,,,,,648000,108694000,106771000,59284000,-447000,,828000,828000,55012,KRNT
2019-12-31,,,568400000,,449900000,475500000,1630300000,831100000,831100000,,-126800000,,,,118500000,2607100000,1776000000,976800000,-262700000,,449900000,449900000,55014,VRSK
2018-12-31,,,719700000,,598700000,377200000,1508900000,835600000,835600000,,-129700000,,,,121000000,2395100000,1559500000,886200000,-115900000,,598700000,598700000,55014,VRSK
2017-12-31,,,691000000,,555100000,316000000,1361400000,808000000,808000000,,-119400000,,,,135900000,2145200000,1337200000,783800000,-117000000,,555100000,555100000,55014,VRSK
2016-12-31,,,653700000,,591200000,300000000,1295300000,783700000,783700000,,-120000000,,,,202200000,1995200000,1211500000,699900000,-130000000,139700000.0,451500000,591200000,55014,VRSK
2020-08-29,,,77276000,,61442000,167253000,314578000,125221000,125221000,,-37461000,,,,15834000,2355533000,2230312000,2040955000,-47945000,,61442000,61442000,55015,WGO
2019-08-31,,,138909000,,111798000,142076000,308921000,157210000,157210000,,-17939000,,,,27111000,1985674000,1828464000,1676753000,-18301000,,111798000,111798000,55015,WGO
2018-08-25,,,142640000,,102357000,130116000,299836000,160392000,160392000,,-18246000,,,,40283000,2016829000,1856437000,1716993000,-17752000,,102357000,102357000,55015,WGO
2017-08-26,,,108599000,,71330000,97607000,222577000,100310000,100310000,,-16837000,,,,37269000,1547119000,1446809000,1324542000,8289000,,71330000,71330000,55015,WGO
2019-12-31,6631928,,-13044772,,-13044772,5951106,0,-12583034,-12583034,,-752051,,,,0,0,12583034,0,-461738,,-13044772,-13044772,55017,CWBR
2018-12-31,10034613,,-15705865,,-15705865,5299717,0,-15334330,-15334330,,-557149,,,,0,0,15334330,0,-371535,,-15705865,-15705865,55017,CWBR
2017-12-31,6675080,,-9833152,,-9833152,3184166,0,-9859246,-9859246,,-3646,,,,0,0,9859246,0,26094,,-9833152,-9833152,55017,CWBR
2016-12-31,3606515,,-6074999,,-6074999,2470062,0,-6076577,-6076577,,-7790,,,,0,0,6076577,0,1578,,-6074999,-6074999,55017,CWBR
2020-06-30,3001000,,-8274000,,-8274000,5567000,287000,-8281000,-8281000,,,,,,0,102000,8383000,-185000,7000,,-8274000,-8274000,55018,BNTC
2019-06-30,4567000,,2609000,,2609000,4614000,11764000,2583000,2583000,,,,,,0,12199000,9616000,435000,26000,,2609000,2609000,55018,BNTC
2018-06-30,6890000,,-11640000,,-11640000,8726000,3927000,-11883000,-11883000,,,,,,0,4378000,16261000,451000,243000,,-11640000,-11640000,55018,BNTC
2017-06-30,6925000,,-5690000,,-5690000,9096000,10821000,-5417000,-5417000,,,,,,0,11093000,16510000,272000,-273000,,-5690000,-5690000,55018,BNTC
2020-03-31,,,-116064000,,-116064000,58244000,276916000,218672000,218672000,,-73398000,,,,0,276916000,58244000,0,-334736000,,-116064000,-116064000,55019,AINV
2019-03-31,,,71946000,,71946000,69008000,255076000,186068000,186068000,,-58319000,,,,0,255076000,69008000,0,-114122000,,71946000,71946000,55019,AINV
2018-03-31,,,87029000,,87029000,72861000,259287000,186426000,186426000,,-53039000,,,,0,259287000,72861000,0,-99397000,,87029000,87029000,55019,AINV
2017-03-31,,,18370000,,18370000,70854000,279862000,209008000,209008000,,-59765000,,,,0,279862000,70854000,0,-190638000,,18370000,18370000,55019,AINV
2019-12-31,511661000,,-1439458000,32172000,-1450515000,262576000,79821000,-694416000,-694416000,23073400,-27813000,,,,12586000,92359000,786775000,12538000,-745042000,,-1452044000,-1450515000,55022,ASLN
2018-12-31,959099000,,-1270524000,32172000,-1270959000,316755000,0,-1275854000,-1275854000,23073400,-14820000,,,,435000,0,1275854000,0,5330000,,-1270959000,-1270959000,55022,ASLN
2017-12-31,920311000,,-1208420000,32172000,-1208420000,265321000,0,-1185632000,-1185632000,23073400,-12623000,,,,0,0,1185632000,0,-22788000,,-1208420000,-1208420000,55022,ASLN
2016-12-31,425296000,,-292325000,32172000,-292325000,224721000,368980000,-281037000,-281037000,23073400,-16932000,,,,0,373018000,654055000,4038000,-11288000,,-292325000,-292325000,55022,ASLN
2019-12-31,,,1108000000,,897000000,,1675000000,1286000000,1286000000,389000000,-68000000,,,,239000000,8017000000,6731000000,6342000000,-178000000,,869000000,897000000,55023,AFGD
2018-12-31,,,639000000,2000000.0,530000000,,1072000000,728000000,728000000,344000000,-62000000,,,,122000000,6939000000,6211000000,5867000000,-89000000,,517000000,530000000,55023,AFGD
2017-12-31,,,724000000,4000000.0,475000000,,1302000000,955000000,955000000,347000000,-85000000,,,,247000000,6684000000,5729000000,5382000000,-231000000,,477000000,475000000,55023,AFGD
2016-12-31,,,787000000,3000000.0,649000000,,1316000000,968000000,968000000,348000000,-77000000,,,,119000000,6345000000,5377000000,5029000000,-181000000,,668000000,649000000,55023,AFGD
2019-12-31,,,24265000,,24265000,8008000,32273000,0,24265000,,,,,,0,34650000,10385000,2377000,0,,24265000,24265000,55025,ORC
2018-12-31,,,-44387000,,-44387000,8764000,-35623000,0,-44387000,,,,,,0,-32425000,11962000,3198000,0,,-44387000,-44387000,55025,ORC
2017-12-31,,,2007000,,2007000,8466000,10473000,0,2007000,,,,,,0,13173000,11166000,2700000,0,,2007000,2007000,55025,ORC
2016-12-31,,,1979000,,1979000,7141000,9120000,0,1979000,,,,,,0,11072000,9093000,1952000,0,,1979000,1979000,55025,ORC
2020-06-30,3206310,,-16353119,4704252,-15534345,19711195,6363552,-17869851,-17869851,,,,,,30985,12573276,30443127,6209724,1516732,,-16384104,-15534345,55026,KERN
2019-06-30,5565097,,-12403215,4704252,-12403215,13136522,6189273,-12512346,-12512346,,,,,,0,10823117,23335463,4633844,109131,,-12403215,-12403215,55026,KERN
2018-06-30,2645093,,-2488309,4704252,-2488309,6872887,6114820,-3403160,-3403160,,,,,,0,10476783,13879943,4361963,914851,,-2488309,-2488309,55026,KERN
2017-06-30,1898221,,-7019095,4704252,-7019095,9439759,4346476,-6991504,-6991504,,,,,,0,5596294,12587798,1249818,-27591,,-7019095,-7019095,55026,KERN
2020-06-30,,,23527259000,4088994000,17089537000,1621149000,8175289000,5731501000,5731501000,822639000,-3271208000,,,,5373999000,11850247000,6118746000,3674958000,17795758000,,18153260000,17089537000,55027,IRCP
2019-06-30,,,-32061005000,3113233000,-25772658000,1569063000,9650196000,6986642000,6986642000,1094491000,-2928593000,,,,-6138041000,13958185000,6971543000,4307989000,-39047647000,,-25922964000,-25772658000,55027,IRCP
2018-06-30,,,13814163000,2244444000,19624143000,1409600000,11592049000,9114289000,9114289000,1068160000,-2140484000,,,,-6534323000,16458335000,7344046000,4866286000,4699874000,,20348486000,19624143000,55027,IRCP
2017-06-30,,,-823458000,871169000,-365758000,940966000,7731155000,6025182000,6025182000,765007000,-1479775000,,,,-410455000,11541115000,5515933000,3809960000,-6848640000,,-413003000,-365758000,55027,IRCP
2020-12-31,,,106803000,,80413000,84236000,205369000,0,107090000,14043000,,,,,26390000,205369000,98279000,0,-287000,,80413000,80413000,55029,WABC
2019-12-31,,,105216000,,80389000,85108000,203769000,0,105874000,12787000,,,,,24827000,203769000,97895000,0,-658000,,80389000,80389000,55029,WABC
2018-12-31,,,90997000,,71564000,86536000,197328000,0,95833000,14959000,,,,,19433000,197328000,101495000,0,-4836000,,71564000,71564000,55029,WABC
2017-12-31,,,87172000,,50025000,83877000,194315000,0,95791000,14647000,,,,,37147000,194315000,98524000,0,-8619000,,50025000,50025000,55029,WABC
2020-03-31,,,111841258,,111841258,23355768,247607163,161068831,161068831,-3079966,-48446629,,,,0,332190353,171121522,84583190,-49227573,,111841258,111841258,55030,LPG
2019-03-31,,,-50945905,,-50945905,34456993,88926009,-7962036,-7962036,-2770099,-43802500,,,,0,157741985,165704021,68815976,-42983869,,-50945905,-50945905,55030,LPG
2018-03-31,,,-20400686,,-20400686,26186332,92676816,3841385,3841385,-2680852,-27836557,,,,0,159203233,155361848,66526417,-24242071,,-20400686,-20400686,55030,LPG
2017-03-31,,,-1441815,,-1441815,21732864,97450575,13993322,13993322,-3333098,-14711240,,,,0,166524615,152531293,69074040,-15435137,,-1441815,-1441815,55030,LPG
2019-12-31,,,170410000,1063000,126833000,607926000,805296000,178942000,178942000,,-14515000,,,,42503000,1955633000,1776691000,1150337000,-8532000,,127907000,126833000,55032,AMED
2018-12-31,,,158988000,1051000,119346000,501306000,669715000,155148000,155148000,,-7370000,,,,38859000,1662578000,1507430000,992863000,3840000,,120129000,119346000,55032,AMED
2017-12-31,,,80801000,1105000,30301000,479613000,607895000,111159000,111159000,,-5031000,,,,50118000,1511272000,1400113000,903377000,-30358000,,30683000,30301000,55032,AMED
2016-12-31,,,61566000,939000,37261000,503430000,584880000,61772000,61772000,,-5164000,,,,23935000,1419261000,1357489000,834381000,-206000,,37631000,37261000,55032,AMED
2019-12-31,,,112657000,,112563000,74963000,276507000,201544000,201544000,,-83026000,,,,94000,276507000,74963000,0,-88887000,,112563000,112563000,55034,NMFCL
2018-12-31,,,72644000,,72353000,68092000,231465000,163373000,163373000,,-56139000,,,,291000,231465000,68092000,0,-90729000,,72353000,72353000,55034,NMFCL
2017-12-31,,,109954000,,109398000,57952000,197806000,139854000,139854000,,-35941000,,,,556000,197806000,57952000,0,-29900000,,109398000,109398000,55034,NMFCL
2016-12-31,,,111830000,,111678000,51372000,168084000,116712000,116712000,,-27302000,,,,152000,168084000,51372000,0,-4882000,,111678000,111678000,55034,NMFCL
2019-12-31,131300000,,345400000,2400000,262900000,1492000000,2190400000,526300000,526300000,5300000,-29400000,,,,82300000,4029200000,3502900000,1838800000,-180900000,,263100000,262900000,55036,XRAY
2018-12-31,160500000,,-958400000,11900000,-1011000000,1538300000,2067800000,341900000,341900000,5300000,-37300000,,,,52500000,3986300000,3644400000,1918500000,-1300300000,,-1010900000,-1011000000,55036,XRAY
2017-12-31,151700000,,-1603500000,11600000,-1550000000,1532200000,2188500000,504600000,504600000,5300000,-38300000,,,,-53200000,3993400000,3488800000,1804900000,-2108100000,,-1550300000,-1550000000,55036,XRAY
2016-12-31,128500000,,440900000,11600000,429900000,1373600000,2000900000,498800000,498800000,5300000,-35900000,,,,9500000,3745300000,3246500000,1744400000,-57900000,,431400000,429900000,55036,XRAY
2020-12-31,,,359740000,,289023000,408915000,966957000,0,436425000,121617000,,,,,70717000,966957000,530532000,0,-76685000,,289023000,289023000,55037,UBSI
2019-12-31,,,324439000,,260099000,286081000,704813000,0,341259000,77473000,,,,,64340000,704813000,363554000,0,-16820000,,260099000,259504000,55037,UBSI
2018-12-31,,,327165000,,256342000,279391000,692581000,0,339310000,73880000,,,,,70823000,692581000,353271000,0,-12145000,,256342000,255878000,55037,UBSI
2017-12-31,,,284827000,,150581000,276523000,652236000,0,297881000,77832000,,,,,134246000,652236000,354355000,0,-13054000,,150581000,150343000,55037,UBSI
2019-12-31,,,-14709000,,-14709000,6003000,-8210000,-14213000,-14213000,,-112000,,,,0,710000,14923000,8920000,-496000,,-14709000,-14709000,55039,BCDA
2018-12-31,,,-13987000,,-13987000,5757000,-8345000,-14102000,-14102000,,-112000,,,,0,625000,14727000,8970000,115000,,-13987000,-13987000,55039,BCDA
2017-12-31,,,-12308000,,-12308000,6395000,-6010000,-12405000,-12405000,,-112000,,,,0,479000,12884000,6489000,97000,,-12308000,-12308000,55039,BCDA
2016-12-31,,,-10310000,,-10310000,4108000,-3500000,-7608000,-7608000,,-1736000,,,,0,576000,8184000,4076000,-2702000,,-10310000,-10310000,55039,BCDA
2019-12-31,22512000,,-34933000,,-34933000,14520000,0,-37032000,-37032000,,,,,,0,0,37032000,0,2099000,,-34933000,-34933000,55040,IMUX
2018-12-31,9595000,,-11542000,,-11542000,2402000,0,-11997000,-11997000,,-1000.0,,,,0,0,11997000,0,455000,,-11542000,-11542000,55040,IMUX
2017-12-31,8753000,,-9962000,,-9962000,1252000,0,-10005000,-10005000,,-4000.0,,,,0,0,10005000,0,43000,,-9962000,-9962000,55040,IMUX
2016-12-31,787562,,-1311157,,-1311157,498499,5794,-1311157,-1311157,30890.0,-4000.0,,,,0,6000,1317157,206,0,,-1311157,-1311157,55040,IMUX
2019-12-31,61313000,,-40427000,,-40696000,102917000,81529000,-82701000,-82701000,,-8487000,,,,269000,125568000,208269000,44039000,42274000,,-40696000,-40696000,55041,NSTG
2018-12-31,55873000,,-77151000,,-77400000,83921000,70401000,-69393000,-69393000,,-7431000,,,,249000,106732000,176125000,36331000,-7758000,,-77400000,-77400000,55041,NSTG
2017-12-31,41800000,,-43358000,,-43562000,79422000,83025000,-38197000,-38197000,,-6153000,,,,204000,114905000,153102000,31880000,-5161000,,-43562000,-43562000,55041,NSTG
2016-12-31,30951000,,-46973000,,-47089000,66469000,56244000,-41176000,-41176000,,-5672000,,,,116000,86489000,127665000,30245000,-5797000,,-47089000,-47089000,55041,NSTG
2020-02-01,,,2164288000,,1660928000,3170687000,5316869000,2146182000,2146182000,,-9740000,,,,503360000,16039073000,13892891000,10722204000,18106000,,1660928000,1660928000,55042,ROST
2019-02-02,,,2050876000,,1587457000,2786350000,4827064000,2040714000,2040714000,,-16407000,,,,463419000,14983541000,12942827000,10156477000,10162000,,1587457000,1587457000,55042,ROST
2018-02-03,,,2040720000,,1362753000,2576098000,4624494000,2048396000,2048396000,,-18847000,,,,677967000,14134732000,12086336000,9510238000,-7676000,,1362753000,1362753000,55042,ROST
2017-01-28,,,1786156000,,1117654000,2395608000,4198252000,1802644000,1802644000,,-19569000,,,,668502000,12866757000,11064113000,8668505000,-16488000,,1117654000,1117654000,55042,ROST
2019-12-31,,,104362000,,87224000,112565000,234680000,105116000,105116000,,-11013000,,,,17138000,626395000,521279000,391715000,-754000,,87224000,87224000,55044,HMSY
2018-12-31,,,53017000,,54989000,113442000,229655000,83238000,83238000,,-11310000,,,,-1972000,598290000,515052000,368635000,-30221000,,54989000,54989000,55044,HMSY
2017-12-31,,,39855000,,40054000,101154000,186478000,54931000,54931000,,-10871000,,,,-199000,521212000,466281000,334734000,-15076000,,40054000,40054000,55044,HMSY
2016-12-31,,,49471000,,37636000,89381000,175080000,57669000,57669000,,-8519000,,,,11835000,489720000,432051000,314640000,-9761000,,37636000,37636000,55044,HMSY
2019-12-31,,,1090655000,626000,803232000,646400000,674880000,-29211000,-29211000,57691000,-353451000,,,,286460000,1101841000,1131052000,426961000,1119866000,,804195000,803232000,55047,STNE
2018-12-31,,,442339000,-334000,301232000,443029000,405242000,-128492000,-128492000,90705000,-301065000,,,,137112000,728281000,856773000,323039000,570831000,,305227000,301358000,55047,STNE
2017-12-31,,,-95665000,15205000,-108731000,266619000,105058000,-295712000,-295712000,134151000,-237094000,,,,9304000,329167000,624879000,224109000,200047000,,-104969000,-106686000,55047,STNE
2016-12-31,,,-149221000,58118000,-119827000,155631000,42618000,-166892000,-166892000,53879000,-244676000,,,,-27030000,175805000,342697000,133187000,17671000,,-122191000,-116889000,55047,STNE
2020-12-31,,,243357000,,180533000,71658000,339781000,0,249157000,18966000,,,,,62824000,339781000,90624000,0,-5800000,,180533000,166060000,55049,MBINP
2019-12-31,,,102134000,,77329000,47651000,165447000,0,104881000,12915000,,,,,24805000,165447000,60566000,0,-2747000,,77329000,68113000,55049,MBINP
2018-12-31,,,84027000,,62874000,39157000,134927000,0,85051000,10719000,,,,,21153000,134927000,49876000,0,-1024000,,62874000,59544000,55049,MBINP
2017-12-31,,,77161000,,54684000,25761000,111805000,0,78091000,7953000,,,,,22477000,111805000,33714000,0,-930000,,54684000,51354000,55049,MBINP
2019-12-31,,,1216000000,1000000,928000000,874000000,4537000000,2023000000,2023000000,,-818000000,,,,290000000,11809000000,9786000000,7272000000,-807000000,,926000000,928000000,55051,VST
2018-12-31,,,-101000000,4000000,-54000000,926000000,2811000000,491000000,491000000,,-545000000,,,,-45000000,9144000000,8653000000,6333000000,-592000000,,-56000000,-54000000,55051,VST
2017-12-31,,,250000000,4000000,-254000000,600000000,1703000000,404000000,404000000,,-193000000,,,,504000000,5430000000,5026000000,3727000000,-154000000,,-254000000,-254000000,55051,VST
2016-12-31,,,21351000000,4000000,22688000000,690000000,1490000000,407000000,407000000,-282000000.0,-1107000000,,,,-1337000000,5164000000,4757000000,3674000000,20944000000,,22688000000,-163000000,55051,VST
2019-12-31,,,-12336000,,-12336000,3184000,-7379000,-10563000,-10563000,,-8000,,,,0,10000000,20563000,17379000,-1773000,,-12336000,-14136000,55053,KROS
2018-12-31,,,-1078000,,-1335000,1580000,-111000,-1691000,-1691000,,-8000,,,,257000,10000000,11691000,10111000,613000,,-1335000,-2346000,55053,KROS
2019-12-31,101477000,,193097000,37320000,154423000,872797000,1196947000,222673000,222673000,,-118867000,,,,31426000,6845580000,6622907000,5648633000,-29576000,,161671000,154423000,55054,SECO
2018-12-31,80398000,,196274000,28148000,151833000,660060000,959733000,219275000,219275000,,-55403000,,,,40728000,5387577000,5168302000,4427844000,-23001000,,155546000,151833000,55054,SECO
2017-12-31,62081000,,101884000,7336000,133258000,455112000,612014000,94821000,94821000,,-8901000,,,,-31525000,3740455000,3645634000,3128441000,7063000,,133409000,-69421000,55054,SECO
2016-12-31,54262000,,-44573000,7119000,-44617000,375116000,400146000,-29232000,-29232000,,-3923000,,,,0,2593822000,2623054000,2193676000,-15341000,,-44573000,-640359000,55054,SECO
2019-12-31,8324000,,-19479000,,-19479000,9665000,0,-17989000,-17989000,,-931000,,,,0,0,17989000,0,-1490000,,-19479000,-19479000,55055,ARMP
2018-12-31,6972000,,-16702000,,-16702000,3919000,0,-10891000,-10891000,,-1013000,,,,0,0,10891000,0,-5811000,,-16702000,-16702000,55055,ARMP
2017-12-31,11381000,,-15128000,,-15128000,4077000,0,-15458000,-15458000,,-1013000,,,,0,0,15458000,0,330000,,-15128000,-15128000,55055,ARMP
2019-12-31,,,-42802000,,-43487000,28412000,68504000,-8691000,-8691000,805000,-11916000,,,,685000,331046000,339737000,262542000,-34111000,,-43487000,-43487000,55056,GRIN
2018-12-31,,,-19251000,,-20640000,31599000,25187000,-22213000,-22213000,1707000,-6517000,,,,1389000,319018000,341231000,293831000,2962000,,-20640000,-20640000,55056,GRIN
2017-12-31,,,-57586000,,-60812000,32868000,40089000,-11035000,-11035000,281000,-6548000,,,,3226000,409522000,420557000,369433000,-46551000,,-60812000,-60812000,55056,GRIN
2016-12-31,,,-39860000,,-43709000,30140000,25603000,-24000000,-24000000,-343000,-4899000,,,,3849000,371532000,395532000,345929000,-15860000,,-43709000,-43709000,55056,GRIN
2019-12-31,,,25117000,,-55777000,110010000,1049522000,110524000,110524000,84172000,-128606000,,,,80894000,1499381000,1388857000,449859000,-85407000,,-55777000,-55777000,55060,KOS
2018-12-31,,,-50860000,,-93991000,99856000,619821000,-83184000,-83184000,-28178000,-95182000,,,,43131000,894703000,977887000,274882000,32324000,,-93991000,-93991000,55060,KOS
2017-12-31,,,-177855000,,-222792000,68302000,435009000,-165304000,-165304000,60758000,-75186000,,,,44937000,578139000,743443000,143130000,-12551000,,-222792000,-222792000,55060,KOS
2016-12-31,,,-294564000,,-283780000,87623000,176049000,-318099000,-318099000,63841000,-39430000,,,,-10784000,310377000,628476000,134328000,23535000,,-283780000,-283780000,55060,KOS
2020-02-02,,,21927000,,17083000,89339000,113958000,22235000,22235000,,-1238000,,,,4844000,610824000,588589000,496866000,-308000,,17083000,16998000,55061,HOFT
2019-02-03,,,51590000,,39873000,92631000,147487000,52472000,52472000,,-1454000,,,,11717000,683501000,631029000,536014000,-882000,,39873000,39794000,55061,HOFT
2018-01-28,,,45772000,,28250000,86449000,134817000,46284000,46284000,,-1248000,,,,17522000,620632000,574348000,485815000,-512000,,28250000,28190000,55061,HOFT
2017-01-29,,,39196000,,25287000,82567000,126121000,40420000,40420000,,-954000,,,,13909000,577219000,536799000,451098000,-1224000,,25287000,25220000,55061,HOFT
2020-12-31,,,622500000,,506600000,425200000,1114100000,0,643000000,45900000,,,,,115900000,1114100000,471100000,0,-20500000,,506600000,506600000,55063,WAL
2019-12-31,,,604226000,,499171000,390609000,1087007000,0,629086000,67312000,,,,,105055000,1087007000,457921000,0,-24860000,,499171000,499171000,55063,WAL
2018-12-31,,,510328000,,435788000,343810000,935995000,0,538114000,54071000,,,,,74540000,935995000,397881000,0,-27786000,,435788000,435788000,55063,WAL
2017-12-31,,,451817000,,325492000,301175000,812758000,0,472470000,39113000,,,,,126325000,812758000,340288000,0,-20653000,,325492000,325492000,55063,WAL
2019-12-31,,,17044000,,11889000,36045000,65455000,16748000,16748000,7994000,-211000,,,,5155000,401177000,384429000,335722000,296000,,11889000,11889000,55064,PCOM
2018-12-31,,,10896000,,7792000,31560000,53904000,10194000,10194000,8786000,-211000,,,,3104000,376245000,366051000,322341000,702000,,7792000,7792000,55064,PCOM
2017-12-31,,,4841000,,3380000,37992000,46550000,4570000,4570000,8786000,-211000,,,,1461000,348644000,344074000,302094000,271000,,3380000,3380000,55064,PCOM
2016-12-31,,,30000,,-1515000,33549000,43129000,5051000,5051000,8786000,-211000,,,,1545000,321612000,316561000,278483000,-5021000,,-1515000,-1515000,55064,PCOM
2020-12-31,,,1797000000,,1385000000,3038000000,5852000000,0,2172000000,642000000,,,,,412000000,5852000000,3680000000,0,-375000000,,1385000000,1343000000,55065,SYF
2019-12-31,,,4887000000,,3747000000,3356000000,9132000000,0,5160000000,616000000,,,,,1140000000,9132000000,3972000000,0,-273000000,,3747000000,3747000000,55065,SYF
2018-12-31,,,3644000000,,2790000000,3187000000,7739000000,0,3883000000,669000000,,,,,854000000,7739000000,3856000000,0,-239000000,,2790000000,2790000000,55065,SYF
2017-12-31,,,3324000000,,1935000000,2804000000,7071000000,0,3637000000,630000000,,,,,1389000000,7071000000,3434000000,0,-313000000,,1935000000,1935000000,55065,SYF
2020-10-31,,,14840637,,14840637,2948978,12387381,9438403,9438403,,-1744203,,,,0,12387381,2948978,0,5402234,,14840637,14840637,55066,DUC
2019-10-31,,,25443904,,25443904,2513978,13139785,10625807,10625807,,-3548546,,,,0,13139785,2513978,0,14818097,,25443904,25443904,55066,DUC
2018-10-31,,,-6227191,,-6227191,2556267,14182101,11625834,11625834,,-3436575,,,,0,14182101,2556267,0,-17853025,,-6227191,-6227191,55066,DUC
2017-10-31,,,3493911,,3493911,2741622,15000495,12258873,12258873,,-2937375,,,,0,15000495,2741622,0,-8764962,,3493911,3493911,55066,DUC
2019-12-31,,,315565000,,246090000,,1968109000,359914000,359914000,1608195000,-42348000,,,,69475000,3467405000,3107491000,1499296000,-44349000,,246090000,246090000,55067,AEL
2018-12-31,,,565742000,,458016000,,-654328000,605862000,605862000,-1260190000,-40120000,,,,107726000,1546229000,940367000,2200557000,-40120000,,458016000,458016000,55067,AEL
2017-12-31,,,316271000,,174645000,,1410751000,379325000,379325000,1031426000,-44237000,,,,141626000,3910214000,3530889000,2499463000,-63054000,,174645000,174645000,55067,AEL
2016-12-31,,,130247000,,83243000,,817631000,166835000,166835000,650796000,-41688000,,,,47004000,2220764000,2053929000,1403133000,-36588000,,83243000,83243000,55067,AEL
2020-12-31,,,1131000000,226000000,1224000000,1327000000,2587000000,1260000000,1260000000,,-144000000,,,,269000000,7188000000,5928000000,4601000000,-129000000,414000000,862000000,1215000000,55068,MAS
2019-12-31,,,914000000,179000000,935000000,1295000000,2371000000,1076000000,1076000000,,-159000000,,,,230000000,6707000000,5631000000,4336000000,-162000000,296000000,684000000,929000000,55068,MAS
2018-12-31,,,907000000,180000000,734000000,1264000000,2367000000,1103000000,1103000000,,-156000000,,,,221000000,6654000000,5551000000,4287000000,-196000000,98000000,686000000,727000000,55068,MAS
2017-12-31,,,718000000,236000000,533000000,1217000000,2220000000,1003000000,1003000000,,-279000000,,,,245000000,6014000000,5011000000,3794000000,-285000000,107000000,473000000,528000000,55068,MAS
2020-02-01,,,-426800000,,-470900000,1893600000,1908700000,15100000,15100000,,-38500000,,,,37600000,6466000000,6450900000,4557300000,-441900000,-6500000,-464400000,-470900000,55071,GME
2019-02-02,,,-753100000,,-673000000,1997200000,2308100000,310900000,310900000,,-56800000,,,,41700000,8285300000,7974400000,5977200000,-1064000000,121800000,-794800000,-673000000,55071,GME
2018-02-03,,,383900000,,34700000,2040700000,2484900000,444200000,444200000,,-56800000,,,,153500000,8547100000,8102900000,6062200000,-60300000,-195700000,230400000,34700000,55071,GME
2017-01-28,,,428700000,,353200000,1861900000,2499900000,501300000,501300000,,-53800000,,,,124200000,7965000000,7463700000,5465100000,-72600000,48700000,304500000,353200000,55071,GME
2019-12-31,,,67067000,,67067000,37817000,233677000,70264000,70264000,37145000,-2650000,,,,0,313220000,242956000,79543000,-3197000,,67067000,67067000,55073,BCEI
2018-12-31,,,168186000,,168186000,42174000,197179000,137831000,137831000,-30271000,-2603000,,,,0,276657000,138826000,79478000,30355000,,168186000,168186000,55073,BCEI
2017-12-31,,,-2736000,,-2360000,57768000,125991000,-3963000,-3963000,15365000,-6429000,,,,-376000,192124000,196087000,66133000,1227000,,-2360000,-2480000,55073,BCEI
2016-12-31,,,-198950000,,-198950000,77065000,123494000,-111658000,-111658000,11234000,-62058000,,,,0,195295000,306953000,71801000,-87292000,,-198950000,-198950000,55073,BCEI
2020-04-30,446280,,-5293154,,-4947426,8241995,7953681,-4095047,-4095047,,-703165,,,,-345728,14057927,18152974,6104246,-1198107,,-4947426,-4947426,55074,IPA
2019-04-30,485845,,-7612679,,-7617467,8005000,5255831,-6226870,-6226870,,-841182,,,,4788,10926268,17153138,5670437,-1385809,,-7617467,-7617467,55074,IPA
2018-04-30,509248,,-5061388,,-5171103,5224367,2428041,-4777073,-4777073,,-83797,,,,109715,5441349,10218422,3013308,-284315,,-5171103,-5171103,55074,IPA
2017-04-30,660408,,-5466198,,-5383820,1834755,1420809,-1341480,-1341480,,-16216,,,,-82378,2630515,3971995,1209706,-4124718,,-5383820,-5383820,55074,IPA
2020-12-31,,,-7327000,,-8515000,,461067000,-236689000,-236689000,222797000,-123173000,,,,1188000,2127106000,2363795000,1666039000,229362000,,-8515000,-8515000,55075,SKYW
2019-12-31,,,446305000,,340099000,,1145954000,534127000,534127000,243729000,-127755000,,,,106206000,2971963000,2437836000,1826009000,-87822000,,340099000,340099000,55075,SKYW
2018-12-31,,,366314000,,280372000,,1081695000,474280000,474280000,272826000,-120409000,,,,85942000,3221679000,2747399000,2139984000,-107966000,,280372000,280372000,55075,SKYW
2017-12-31,,,288183000,,428907000,,931745000,388199000,388199000,250778000,-104925000,,,,-140724000,3122592000,2734393000,2190847000,-100016000,,428907000,428907000,55075,SKYW
2019-12-31,,,22416000,,14533000,25288000,92906000,53832000,53832000,,-25763000,,,,7883000,274107000,220275000,181201000,-31416000,,14533000,14471000,55076,CSV
2018-12-31,,,18266000,,11645000,26737000,89096000,48531000,48531000,,-23301000,,,,6621000,267992000,219461000,178896000,-30265000,,11645000,11588000,55076,CSV
2017-12-31,,,32782000,,37193000,26253000,87823000,48941000,48941000,,-17277000,,,,-4411000,258139000,209198000,170316000,-16159000,,37193000,37058000,55076,CSV
2016-12-31,,,32241000,,19581000,27944000,89664000,50204000,50204000,,-15608000,,,,12660000,248200000,197996000,158536000,-17963000,,19581000,19492000,55076,CSV
2020-09-30,2798000,,-1062000,,-1446000,15793000,17167000,-1424000,-1424000,,-228000,,,,384000,61793000,63217000,44626000,362000,,-1446000,-1446000,55077,CSPI
2019-09-30,2800000,,-442000,,-371000,16052000,18026000,-826000,-826000,,-99000,,,,-71000,79061000,79887000,61035000,384000,,-371000,-371000,55077,CSPI
2018-09-30,3277000,,-1106000,,14440000,16723000,18399000,-1601000,-1601000,,-85000,,,,882000,72916000,74517000,54517000,495000,16428000.0,-1988000,13842000,55077,CSPI
2017-09-30,2362000,,3405000,,2506000,15666000,21423000,3395000,3395000,,-73000,,,,1162000,88492000,85097000,67069000,10000,263000.0,2243000,2398000,55077,CSPI
2020-10-31,,,-16311000,,28274000,193044000,217856000,24812000,24812000,,-5207000,,,,-44585000,3564267000,3539455000,3346411000,-41123000,,28274000,27902000,55078,SAFM
2019-10-31,,,63847000,,53294000,211141000,279135000,67994000,67994000,,-4156000,,,,10553000,3440258000,3372264000,3161123000,-4147000,,53294000,52516000,55078,SAFM
2018-10-31,,,30557000,,61431000,221965000,251665000,29700000,29700000,,-2066000,,,,-30874000,3236004000,3206304000,2984339000,857000,,61431000,60553000,55078,SAFM
2017-10-31,,,424530000,,279745000,216303000,641542000,425239000,425239000,,-1886000,,,,144785000,3342226000,2916987000,2700684000,-709000,,279745000,275460000,55078,SAFM
2020-03-31,,,3589191,,3589191,1509617,8673687,7164070,7164070,,-1845446,,,,0,8673687,1509617,0,-3574879,,3589191,3589191,55083,VMM
2019-03-31,,,7524301,,7524301,1389856,8956366,7566510,7566510,,-2031473,,,,0,8956366,1389856,0,-42209,,7524301,7524301,55083,VMM
2018-03-31,,,4536043,,4536043,1360874,8822575,7461701,7461701,,-1628619,,,,0,8822575,1360874,0,-2925658,,4536043,4536043,55083,VMM
2017-03-31,,,-518963,,-518963,1397651,9031710,7634059,7634059,,-1324819,,,,0,9031710,1397651,0,-8153022,,-518963,-518963,55083,VMM
2019-12-29,,,3314000,,6215000,29236000,71154000,18230000,18230000,,-122000,,,,-2901000,426357000,408127000,355203000,-14916000,,6215000,6215000,55084,CHUY
2018-12-30,,,3185000,,5539000,24654000,64444000,15604000,15604000,,-83000,,,,-2354000,398200000,382596000,333756000,-12419000,,5539000,5539000,55084,CHUY
2017-12-31,,,23456000,,28956000,21417000,67369000,22159000,22159000,,-65000,,,,-5500000,369589000,347430000,302220000,1297000,,28956000,28956000,55084,CHUY
2016-12-25,,,24278000,,17244000,19950000,66237000,25858000,25858000,,-63000,,,,7034000,330613000,304755000,264376000,-1580000,,17244000,17244000,55084,CHUY
2019-12-31,187400000,,171000000,300000,146100000,1148500000,1773300000,444200000,444200000,-6800000,-128400000,,,,24900000,4837400000,4393200000,3064100000,-273200000,,146100000,146100000,55085,PRGO
2018-12-31,218600000,,290600000,100000,131000000,1123800000,1831500000,483900000,483900000,5200000,-122100000,,,,159600000,4731700000,4247800000,2900200000,-193300000,,131000000,131000000,55085,PRGO
2017-12-31,167700000,,280100000,100000,119600000,1145700000,1979500000,692500000,692500000,-26400000,-166100000,,,,160500000,4946200000,4253700000,2966700000,-412400000,,119600000,119600000,55085,PRGO
2016-12-31,184000000,,-4848300000,-500000,-4012800000,1205900000,2051800000,661900000,661900000,-26400000,-212800000,,,,-835500000,5280600000,4618700000,3228800000,-5510200000,,-4012800000,-4012800000,55085,PRGO
2019-12-31,491266000,,-963750000,,-963750000,741611000,232769000,-1000108000,-1000108000,,-485000,,,,0,406245000,1406353000,173476000,36358000,,-963750000,-1564285000,55087,YQ
2018-12-31,398627000,,-656071000,,-656071000,506621000,205739000,-699509000,-699509000,,-485000,,,,0,310706000,1010215000,104967000,43438000,,-656071000,-900442000,55087,YQ
2020-06-28,184200000,,-190400000,6100000,-191700000,211400000,256800000,-153300000,-153300000,,-34900000,,,,200000,903900000,1057200000,647100000,-37100000,,-190600000,-191700000,55090,CREE
2019-06-30,157900000,,-45200000,5000000,-375100000,200700000,391000000,16800000,16800000,,-26000000,,,,12700000,1080000000,1063200000,689000000,-62000000,-317200000.0,-57900000,-375100000,55090,CREE
2018-06-24,127300000,,-17600000,5000000,-280000000,170300000,307400000,2600000,2600000,,-7300000,,,,-1200000,924900000,922300000,617500000,-20200000,-263500000.0,-16400000,-280000000,55090,CREE
2017-06-25,113800000,,-7100000,5000000,-98100000,145700000,244000000,-18900000,-18900000,,-7300000,,,,81000000,771500000,790400000,527500000,11800000,-10000000.0,-88100000,-98100000,55090,CREE
2020-04-30,,,-7625000,,-5903000,3003000,-2027000,-5030000,-5030000,,,,,,-1722000,18783000,23813000,20810000,-2595000,,-5903000,-5903000,55091,AXR
2019-04-30,,,-3173000,,1527000,4214000,989000,-3225000,-3225000,,-25000.0,,,,-708000,12754000,15979000,11765000,52000,3992000.0,-2465000,1527000,55091,AXR
2018-04-30,,,-2843000,,238000,4052000,1214000,-2838000,-2838000,,-5000.0,,,,-279000,8927000,11765000,7713000,1805000,2802000.0,-2564000,238000,55091,AXR
2017-04-30,,,982000,,-15000,6560000,6379000,-181000,-181000,,-333000.0,,,,997000,40872000,41053000,34493000,1163000,2802000.0,-15000,-15000,55091,AXR
2019-12-31,,,333623000,432049000,60981000,29278000,379428000,350150000,350150000,,-19623000,,,,728000,1091871000,741721000,712443000,-16527000,,332895000,60981000,55092,WLKP
2018-12-31,,,330593000,475699000,49347000,27590000,377159000,349569000,349569000,,-21433000,,,,22000,1285622000,936053000,908463000,-18976000,,330571000,48614000,55092,WLKP
2017-12-31,,,354338000,536977000,48670000,29260000,403667000,374407000,374407000,,-21861000,,,,1280000,1172981000,798574000,769314000,-20069000,,353058000,47004000,55092,WLKP
2016-12-31,,,354438000,576049000,40940000,24887000,391331000,366444000,366444000,,-12607000,,,,1035000,986736000,620292000,595405000,-12006000,,353403000,40659000,55092,WLKP
2020-12-31,,,549500000,,421000000,325600000,882500000,0,556900000,,,,,,128500000,920400000,363500000,37900000,-7400000,,421000000,421000000,55093,CACC
2019-12-31,,,855900000,,656100000,328600000,1186300000,0,857700000,,,,,,199800000,1216400000,358700000,30100000,-3600000,,656100000,656100000,55093,CACC
2018-12-31,,,755100000,,574000000,291200000,1046300000,0,755100000,,,,,,181100000,1072300000,317200000,26000000,0,,574000000,574000000,55093,CACC
2017-12-31,,,583800000,,470200000,254000000,837800000,0,583800000,,,,,,113600000,860500000,276700000,22700000,0,,470200000,470200000,55093,CACC
2020-06-30,,,-11156078,,-11156078,1263916,647689,-616227,-616227,,,,,,0,647689,1263916,0,-10539851,,-11156078,-11156078,55096,CUBA
2019-06-30,,,-635225,,-635225,1286985,800409,-486576,-486576,,,,,,0,800409,1286985,0,-148649,,-635225,-635225,55096,CUBA
2018-06-30,,,-1275974,,-1275974,1395059,734130,-660929,-660929,,,,,,0,734130,1395059,0,-615045,,-1275974,-1275974,55096,CUBA
2017-06-30,,,12206154,,12206154,1536758,683796,-852962,-852962,,,,,,0,683796,1536758,0,13059116,,12206154,12206154,55096,CUBA
2019-12-31,,,1384197,17440394,-610206,5268315,18206268,5573265,5573265,,-10649646,,,,611263,28641111,23067846,10434843,-4189068,,772934,-610206,55097,SQFT
2018-12-31,,,4971290,15725650,3384294,4532703,21431117,7796809,7796809,,-13041016,,,,518567,32344013,24547204,10912896,-2825519,,4452723,3384294,55097,SQFT
2017-12-31,,,-2633399,14396349,-3484416,5200592,22577781,7666924,7666924,,-12954079,,,,208681,33374142,25707218,10796361,-10300323,,-2842080,-3484416,55097,SQFT
2016-12-31,,,-5357223,12658777,-5812485,5065579,22171727,6849963,6849963,,-13531337,,,,213860,32452112,25602149,10280385,-12207186,,-5571083,-5812485,55097,SQFT
2020-11-30,,,4365218,,4365218,1130228,5936293,4806065,4806065,,-966637,,,,0,5936293,1130228,0,-440847,,4365218,4365218,55098,CXH
2019-11-30,,,9416072,,9416072,1130750,6664267,5533517,5533517,,-1455716,,,,0,6664267,1130750,0,3882555,,9416072,9416072,55098,CXH
2018-11-30,,,1039650,,1039650,1306711,7187098,5880387,5880387,,-1441926,,,,0,7187098,1306711,0,-4840737,,1039650,1039650,55098,CXH
2017-11-30,,,9123582,,9123582,1628720,8052627,6423907,6423907,,-1103515,,,,0,8052627,1628720,0,2699675,,9123582,9123582,55098,CXH
2020-12-31,,,243357000,,180533000,71658000,339781000,0,249157000,18966000,,,,,62824000,339781000,90624000,0,-5800000,,180533000,166060000,55099,MBIN
2019-12-31,,,102134000,,77329000,47651000,165447000,0,104881000,12915000,,,,,24805000,165447000,60566000,0,-2747000,,77329000,68113000,55099,MBIN
2018-12-31,,,84027000,,62874000,39157000,134927000,0,85051000,10719000,,,,,21153000,134927000,49876000,0,-1024000,,62874000,59544000,55099,MBIN
2017-12-31,,,77161000,,54684000,25761000,111805000,0,78091000,7953000,,,,,22477000,111805000,33714000,0,-930000,,54684000,51354000,55099,MBIN
2020-02-01,,,1993000000,,1541000000,7923000000,10048000000,2053000000,2053000000,,-64000000,,,,452000000,43638000000,41585000000,33590000000,-60000000,,1541000000,1541000000,55100,BBY
2019-02-02,,,1888000000,,1464000000,7979000000,9961000000,1959000000,1959000000,,-73000000,,,,424000000,42879000000,40920000000,32918000000,-67000000,,1464000000,1464000000,55100,BBY
2018-02-03,,,1817000000,,1000000000,8023000000,9876000000,1853000000,1853000000,,-75000000,,,,818000000,42151000000,40298000000,32275000000,-39000000,1000000.0,999000000,1000000000,55100,BBY
2017-01-28,,,1816000000,,1228000000,7524000000,9440000000,1916000000,1916000000,,-72000000,,,,609000000,39403000000,37487000000,29963000000,-103000000,21000000.0,1207000000,1228000000,55100,BBY
2019-12-31,,,61465000,,41362000,36404000,289833000,129427000,129427000,,-67789000,,,,20103000,943917000,814490000,654084000,-67962000,,41362000,41362000,55103,TNK
2018-12-31,,,-43136000,,-52548000,39775000,166518000,8229000,8229000,,-55701000,,,,9412000,776493000,768264000,609975000,-51365000,,-52548000,-52548000,55103,TNK
2017-12-31,,,-52693000,,-58023000,32879000,147760000,14400000,14400000,,-30189000,,,,5330000,431178000,416778000,283418000,-67093000,,-58023000,-58023000,55103,TNK
2016-12-31,,,67823000,,67823000,33199000,254694000,109835000,109835000,7511000.0,-28900000,,,,0,550543000,440708000,295849000,-42012000,,67823000,67823000,55103,TNK
2020-06-30,19392000,,-45809000,,-45892000,13617000,-13933000,-46942000,-46942000,,,,,,83000,2453000,49395000,16386000,1133000,,-45892000,-45892000,55104,AGTC
2019-06-30,17460000,,-1930000,,-2006000,12859000,25969000,-4350000,-4350000,,,,,,76000,41692000,46042000,15723000,2420000,,-2006000,-2006000,55104,AGTC
2018-06-30,17460000,,-21228000,,-21300000,14389000,-7995000,-22384000,-22384000,,,,,,72000,24186000,46570000,32181000,1156000,,-21300000,-21300000,55104,AGTC
2017-06-30,14991000,,2807000,,407000,11354000,28247000,1902000,1902000,,,,,,2400000,39473000,37571000,11226000,905000,,407000,407000,55104,AGTC
2019-12-31,,,-2241000,4514000,-6401000,47319000,52344000,5025000,5025000,,-7467000,,,,-104000,159218000,154193000,106874000,-7266000,,-2137000,-6401000,55105,TLS
2018-12-31,,,1768000,2621000,-1640000,44048000,53062000,9014000,9014000,,-7258000,,,,31000,138016000,129002000,84954000,-7246000,,1737000,-1640000,55105,TLS
2017-12-31,,,-6265000,913000,-5833000,40152000,40566000,414000,414000,,-6690000,,,,-2767000,107727000,107313000,67161000,-6679000,,-3498000,-5833000,55105,TLS
2016-12-31,,,-3335000,2229000,-7175000,41334000,43446000,2112000,2112000,,-5465000,,,,334000,134868000,132756000,91422000,-5447000,,-3669000,-7175000,55105,TLS
2020-12-31,4678000000,,6968000000,6221000000,5749000000,10795000000,23209000000,8054000000,8054000000,-318000000,-888000000,,,,580000000,34099000000,26045000000,10890000000,-1086000000,,6388000000,5749000000,55106,GSK
2019-12-31,4405000000,,6221000000,6952000000,4645000000,10560000000,22966000000,8607000000,8607000000,-606000000,-877000000,,,,953000000,33754000000,25147000000,10788000000,-2386000000,,5268000000,4645000000,55106,GSK
2018-12-31,3798000000,,4800000000,-109000000,3623000000,9366000000,21107000000,7630000000,7630000000,313000000,-756000000,,,,754000000,30821000000,23191000000,9714000000,-2830000000,,4046000000,3623000000,55106,GSK
2017-12-31,3925000000,,3525000000,3557000000,1532000000,9424000000,20869000000,6721000000,6721000000,799000000,-721000000,,,,1356000000,30186000000,23465000000,9317000000,-3196000000,,2169000000,1532000000,55106,GSK
2019-12-31,220968770,,-304706613,,-304706613,67046483,0,-288015253,-288015253,,-5284610,,,,0,0,288015253,0,-16691360,,-304706613,-304706613,55107,APLS
2018-12-31,105285576,,-127502194,,-127502194,22639184,0,-127924760,-127924760,,-2512956,,,,0,0,127924760,0,422566,,-127502194,-127502194,55107,APLS
2017-12-31,40303878,,-51006094,,-51006094,10463151,0,-50767029,-50767029,,-374749,,,,0,0,50767029,0,-239065,,-51006094,-51006094,55107,APLS
2016-12-31,22978599,,-27124637,,-27124637,4303743,0,-27282342,-27282342,,-374749,,,,0,0,27282342,0,157705,,-27124637,-27124637,55107,APLS
2019-12-29,,,11783000,,8445000,296873000,312022000,15149000,15149000,,-3046000,,,,3338000,996495000,981346000,684473000,-3366000,,8445000,8445000,55109,BGFV
2018-12-30,,,-4601000,,-3531000,301228000,300849000,-379000,-379000,,-3374000,,,,-1070000,987581000,987960000,686732000,-4222000,,-3531000,-3531000,55109,BGFV
2017-12-31,,,14698000,,1104000,301955000,323332000,21377000,21377000,,-1644000,,,,13594000,1009635000,988258000,686303000,-6679000,,1104000,1104000,55109,BGFV
2017-01-01,,,27936000,,16886000,294971000,324458000,29487000,29487000,,-1551000,,,,11050000,1021235000,991748000,696777000,-1551000,,16886000,16886000,55109,BGFV
2019-12-31,,,93000000,,92000000,115000000,460000000,345000000,345000000,,-106000000,,,,1000000,460000000,115000000,0,-252000000,,92000000,92000000,55111,FSKR
2018-12-31,,,-35000000,,-38000000,113000000,455000000,342000000,342000000,,-103000000,,,,3000000,455000000,113000000,0,-377000000,,-38000000,-38000000,55111,FSKR
2017-12-31,,,192000000,,190000000,164000000,524000000,360000000,360000000,,-87000000,,,,2000000,524000000,164000000,0,-168000000,,190000000,190000000,55111,FSKR
2016-12-31,,,419283000,,417315000,161147000,488051000,326904000,326904000,,-70408000,,,,1968000,488051000,161147000,0,92379000,,417315000,417315000,55111,FSKR
2019-12-31,19806000,,3157000,,6094000,55843000,143393000,16426000,16426000,6706000,-13668000,,,,-2937000,206547000,190121000,63154000,-13269000,,6094000,5997000,55112,ANIP
2018-12-31,15388000,,20051000,,15494000,44063000,134152000,40959000,40959000,6706000,-14911000,,,,4557000,201576000,160617000,67424000,-20908000,,15494000,15340000,55112,ANIP
2017-12-31,9070000,,16349000,,-1076000,31580000,97810000,29232000,29232000,6706000,-11324000,,,,17425000,176842000,147610000,79032000,-12883000,,-1076000,-1076000,55112,ANIP
2016-12-31,2906000,,8678000,,3934000,26529000,85742000,33964000,33964000,6706000,-11294000,,,,4744000,128622000,94658000,42880000,-25286000,,3934000,3913000,55112,ANIP
2019-12-31,9884000,,-15502000,,-15095000,22592000,17428000,-15048000,-15048000,,-343000,,,,-407000,53276000,68324000,35848000,-454000,,-15095000,-15095000,55114,XONE
2018-12-31,10744000,,-12507000,,-12667000,22473000,21164000,-12053000,-12053000,,-254000,,,,160000,64644000,76697000,43480000,-454000,,-12667000,-12667000,55114,XONE
2017-12-31,9909000,,-19979000,,-20017000,23833000,14843000,-18899000,-18899000,,-94000,,,,38000,57744000,76643000,42901000,-1080000,,-20017000,-20017000,55114,XONE
2016-12-31,7812000,,-14531000,,-14598000,20683000,14291000,-14204000,-14204000,,-298000,,,,67000,47788000,61992000,33497000,-327000,,-14598000,-14598000,55114,XONE
2019-12-31,3966000,,15449000,,10807000,27163000,49262000,18133000,18133000,,,,,,4642000,118326000,100193000,69064000,-2684000,,10807000,10430000,55115,GDYN
2018-12-31,2263000,,13083000,,9228000,21732000,40332000,16337000,16337000,,,,,,3855000,91865000,75528000,51533000,-3254000,,9228000,9228000,55115,GDYN
2017-12-31,1712000,,13108000,,13184000,14055000,30749000,14982000,14982000,,,,,,-76000,70684000,55702000,39935000,-1874000,,13184000,7682000,55115,GDYN
2019-12-31,,,-2269001,-170050,-4438565,1566938,38169,-1528769,-1528769,,-6340,,,,0,157978,1686747,119809,-740232,-2183278,-2269001,-4438565,55116,BIMI
2018-12-31,,,-212582,-150311,-16786509,212582,0,-212582,-212582,,-6340,,,,0,0,212582,0,0,-16787212,-212582,-16786509,55116,BIMI
2017-12-31,,,-1575671,49044,-1569817,2111585,916514,-1195071,-1195071,,-353745,,,,2744,8508173,9703244,7591659,-380600,-16787212,-1578415,-1569817,55116,BIMI
2016-12-31,,,-1817333,49044,-1817579,1628819,148769,-1480050,-1480050,,-354422,,,,246,6041261,7521311,5892492,-337283,-16787212,-1817579,-1817579,55116,BIMI
2020-12-31,,,43056000,4050000,33041000,126552000,189636000,63084000,63084000,,-20226000,,,,10015000,382114000,319030000,192478000,-20028000,,33041000,33041000,55117,TPB
2019-12-31,2500000.0,,15818000,4050000,13774000,103826000,159746000,53420000,53420000,,-17342000,,,,2044000,361989000,308569000,202243000,-37602000,,13774000,13774000,55117,TPB
2018-12-31,2500000.0,,31574000,4050000,25289000,77906000,145459000,65053000,65053000,,-14819000,,,,6285000,332683000,267630000,187224000,-33479000,,25289000,25289000,55117,TPB
2017-12-31,2300000.0,,26933000,4050000,20209000,73070000,125470000,50100000,50100000,,-16889000,,,,7280000,285777000,235677000,160307000,-23167000,,19653000,20209000,55117,TPB
2019-12-28,,,511000000,,385000000,3752000000,4587000000,759000000,759000000,,-184000000,,,,126000000,25939000000,25180000000,21352000000,-248000000,,385000000,385000000,55118,USFD
2018-12-29,,,496000000,,407000000,3605000000,4306000000,701000000,701000000,,-175000000,,,,89000000,24175000000,23474000000,19869000000,-205000000,,407000000,407000000,55118,USFD
2017-12-30,,,404000000,,444000000,3645000000,4218000000,573000000,573000000,,-170000000,,,,-40000000,24147000000,23574000000,19929000000,-169000000,,444000000,444000000,55118,USFD
2016-12-31,,,131000000,,210000000,3586000000,4053000000,467000000,467000000,,-229000000,,,,-79000000,22919000000,22452000000,18866000000,-336000000,,210000000,210000000,55118,USFD
2020-06-30,14450000,,-20333000,,-20333000,5971000,0,-20421000,-20421000,,,,,,0,0,20421000,0,88000,,-20333000,-20333000,55120,RZLT
2019-06-30,19079000,,-30446000,,-30446000,6820000,0,-25899000,-25899000,,-4958000.0,,,,0,0,25899000,0,-4547000,,-30446000,-32719000,55120,RZLT
2018-06-30,17280000,,-29862000,,-29862000,8783000,0,-26063000,-26063000,,-689000.0,,,,0,0,26063000,0,-3799000,,-29862000,-29862000,55120,RZLT
2017-06-30,12094734,,-20277132,,-20277132,7901758,0,-19996492,-19996492,,-1595.0,,,,0,0,19996492,0,-280640,,-20277132,-23684064,55120,RZLT
2019-12-29,,,141690000,7139000,130573000,274131000,673429000,202487000,202487000,,-49257000,,,,7573000,4139389000,3936902000,3465960000,-60797000,,134117000,130573000,55121,BLMN
2018-12-30,,,100305000,9087000,107098000,282150000,667413000,183670000,183670000,,-44937000,,,,-9233000,4126413000,3942743000,3459000000,-83365000,,109538000,107098000,55121,BLMN
2017-12-31,,,111137000,10889000,101293000,303590000,686698000,190826000,190826000,,-41392000,,,,7529000,4223136000,4032310000,3536438000,-79689000,,103608000,101293000,55121,BLMN
2016-12-25,,,52635000,13201000,39388000,267380000,687515000,226297000,226297000,,-45726000,,,,8648000,4260673000,4034376000,3573158000,-173662000,,43987000,39388000,55121,BLMN
2019-12-31,,,150059000,,149845000,98278000,468570000,370292000,370292000,,-1302000,,,,214000,895890000,525598000,427320000,-220233000,,149845000,149845000,55122,GLPG
2018-12-31,188829000.0,,-29209000,,-29259000,39777000,-5030000,-44807000,-44807000,,-780000,,,,50000,317845000,362652000,322875000,15598000,,-29259000,-29259000,55122,GLPG
2017-12-31,95839000.0,,-115506000,,-115704000,27218000,-62584000,-89802000,-89802000,,-936000,,,,198000,155918000,245720000,218502000,-25704000,,-115704000,-115704000,55122,GLPG
2016-12-31,67593000.0,,54247000,,54012000,23529000,79632000,-11490000,-11490000,,-47000,,,,235000,151612000,163102000,71980000,65737000,,54012000,54012000,55122,GLPG
2019-12-31,3731000,,-19836000,,-19706000,36232000,19094000,-20869000,-20869000,,-8000,,,,-130000,28235000,49104000,9141000,1033000,,-19706000,-19706000,55123,APYX
2018-12-31,2549000,,-14691000,,62719000,21812000,10826000,-13535000,-13535000,,-104000,,,,-3907000,16605000,30140000,5779000,-1156000,73503000.0,-10784000,62719000,55123,APYX
2017-12-31,1941000,,-13838000,,-5062000,17378000,6958000,-12361000,-12361000,,-136000,,,,-156000,10234000,22595000,3276000,-1477000,8620000.0,-13682000,-5062000,55123,APYX
2016-12-31,1033000,,-11486000,,-3950000,15475000,5116000,-11392000,-11392000,,-158000,,,,64000,8819000,20211000,3703000,-94000,7600000.0,-11550000,-3950000,55123,APYX
2019-12-31,,,-38710000,,-29210000,194372000,217958000,13372000,13372000,4296000,-57942000,,,,-9500000,254508000,241136000,36550000,-52082000,,-29210000,-29210000,55124,HMPT
2018-12-31,,,-41839000,,-24197000,159263000,175217000,4282000,4282000,4060000,-47486000,,,,-10485000,210587000,206305000,35370000,-46121000,7157000.0,-31354000,-24197000,55124,HMPT
2020-06-30,,,14649000,504000,7954000,80780000,176110000,60176000,60176000,,-26386000,,,,6695000,356479000,296303000,180369000,-45527000,,7954000,4286000,55125,GFNCP
2019-06-30,,,-1646000,504000,-7466000,81566000,185259000,61989000,61989000,,-35344000,,,,5820000,378206000,316217000,192947000,-63635000,,-7466000,-11124000,55125,GFNCP
2018-06-30,,,-9786000,504000,-8306000,77487000,161110000,43862000,43862000,,-33991000,,,,-679000,347302000,303440000,186192000,-53648000,,-9107000,-11964000,55125,GFNCP
2017-06-30,,,-872000,88102000,-2962000,67661000,126071000,19110000,19110000,,-19653000,,,,-25000,276928000,257818000,150857000,-19982000,,-847000,-6620000,55125,GFNCP
2020-10-31,529888000,,455961000,,361291000,585973000,1652891000,513647000,513647000,,-35774000,,,,94670000,3532157000,3018510000,1879266000,-57686000,,361291000,361291000,55126,CIEN
2019-11-02,548139000,,313190000,,253434000,597445000,1542066000,374674000,374674000,,-36297000,,,,59756000,3572131000,3197457000,2030065000,-61484000,,253434000,253434000,55126,CIEN
2018-11-03,491564000,,148781000,,-344690000,554193000,1314690000,253196000,253196000,,-55437000,,,,493471000,3094286000,2841090000,1779596000,-104415000,,-344690000,-344690000,55126,CIEN
2017-10-31,475329000,,156126000,,1261953000,498773000,1245786000,224955000,224955000,,-58368000,,,,-1105827000,2801687000,2576732000,1555901000,-68829000,,1261953000,1261953000,55126,CIEN
2019-12-31,,,163842,,-55240,16815767,18725968,595470,595470,,-431628,,,,219082,98979140,98383670,80253172,-431628,,-55240,-55240,55127,QRHC
2018-12-31,,,-2438981,,-2438981,16163153,16862714,-2001248,-2001248,,-437733,,,,0,103805432,105806680,86942718,-437733,,-2438981,-2438981,55127,QRHC
2017-12-31,,,-5820276,,-5820276,17078033,15712512,-5352246,-5352246,,-468030,,,,0,138346327,143698573,122633815,-468030,,-5820276,-5820276,55127,QRHC
2016-12-31,,,-8045586,,-8045586,18170371,14409680,-7804788,-7804788,,-240798,,,,0,183811398,191616186,169401718,-240798,,-8045586,-8045586,55127,QRHC
2019-12-31,,,77186000,99936000,74483000,33099000,290434000,110899000,110899000,,-65022000,,,,0,415253000,304354000,124819000,-33713000,,77186000,73274000,55128,DOC
2018-12-31,,,58321000,92902000,56230000,28816000,297545000,112540000,112540000,-2200000.0,-66183000,,,,0,420165000,307625000,122620000,-54219000,,58321000,54890000,55128,DOC
2017-12-31,,,39773000,86809000,38146000,22957000,246732000,98616000,98616000,-2200000.0,-47008000,,,,0,343767000,245151000,97035000,-58660000,,39773000,37415000,55128,DOC
2016-12-31,,,31522000,70344000,29981000,18397000,174910000,69924000,69924000,-2200000.0,-23624000,,,,0,240909000,170985000,65999000,-38402000,,31522000,28124000,55128,DOC
2019-12-31,,,-52037000,,-47664000,12406000,-41714000,-54120000,-54120000,,-106000,,,,-4373000,50041000,104161000,91755000,2083000,,-47664000,-61902000,55130,RVMD
2018-12-31,,,-41789000,,-41789000,9010000,-30919000,-39929000,-39929000,,-116000,,,,0,20165000,60094000,51084000,-1860000,,-41789000,-48820000,55130,RVMD
2017-12-31,,,-31127000,,-31127000,4543000,-26586000,-31129000,-31129000,,-103000,,,,0,0,31129000,26586000,2000,,-31127000,-34890000,55130,RVMD
2019-12-31,16000,,1870000,,1793000,4604000,6007000,1387000,1387000,,-19000,,,,77000,34794000,33407000,28787000,483000,,1793000,1793000,55131,ELTK
2018-12-31,16000,,-2544000,,-2607000,4669000,2597000,-2072000,-2072000,,-152000,,,,63000,33939000,36011000,31342000,-472000,,-2607000,-2607000,55131,ELTK
2017-12-31,41000,,-3701000,,-3775000,4704000,1327000,-3418000,-3418000,,-54000,,,,74000,32754000,36172000,31427000,-283000,,-3775000,-3775000,55131,ELTK
2016-12-31,117000,,-2567000,,-3624000,4699000,2817000,-1999000,-1999000,,-67000,,,,1158000,37065000,39064000,34248000,-568000,,-3725000,-3624000,55131,ELTK
2020-12-31,,,-18876000,,-12967000,74076000,55236000,0,-17108000,-1732000,,,,,-5909000,55236000,72344000,0,-1768000,,-12967000,-12967000,55132,SBT
2019-12-31,,,44891000,,29248000,47072000,132564000,0,70327000,15165000,,,,,15643000,132564000,62237000,0,-25436000,,29248000,29248000,55132,SBT
2018-12-31,,,88572000,,63468000,41669000,138908000,0,90019000,7220000,,,,,25104000,138908000,48889000,0,-1447000,,63468000,63468000,55132,SBT
2017-12-31,,,70448000,,37977000,33521000,111209000,0,71744000,5944000,,,,,32471000,111209000,39465000,0,-1296000,,37977000,37977000,55132,SBT
2020-07-03,19284000,,3709000,,257000,57985000,84696000,7427000,7427000,,-54000,,,,3452000,238642000,231215000,153946000,-3718000,,257000,257000,55136,AVNW
2019-06-28,21111000,,1550000,,9738000,56055000,79270000,2104000,2104000,,-102000,,,,-8188000,243858000,241754000,164588000,-554000,,9738000,9738000,55136,AVNW
2018-06-29,19750000,,1266000,,1845000,58157000,80503000,2596000,2596000,,-29000,,,,-1036000,242506000,239910000,162003000,-1330000,,2302000,1845000,55136,AVNW
2017-06-30,18684000,,-605000,543000.0,-823000,57184000,75472000,-396000,-396000,,-50000,,,,16000,241874000,242270000,166402000,-209000,,-621000,-823000,55136,AVNW
2019-12-31,91697000,,-676034000,,-676034000,370727000,144990000,-306589000,-306589000,-10845000,-5401000,,,,0,323425000,630014000,178435000,-369445000,,-676034000,-676034000,55138,GTH
2018-12-31,71411000,,-464993000,,-464993000,270707000,92726000,-239464000,-239464000,-9928000,-5401000,,,,0,225176000,464640000,132450000,-225529000,,-464993000,-464993000,55138,GTH
2017-12-31,45777000,,-420639000,,-420639000,140055000,26822000,-154184000,-154184000,-4826000,-669000,,,,0,101033000,255217000,74211000,-266455000,,-420639000,-420639000,55138,GTH
2020-12-31,,,617882000,,491723000,,1806567000,0,617882000,1188685000,,,,,126159000,1806567000,1188685000,0,0,,491723000,477661000,55139,FCNCP
2019-12-31,,,592048000,,457371000,936071000.0,1696011000,0,632094000,127846000,,,,,134677000,1696011000,1063917000,0,-40046000,,457371000,457371000,55139,FCNCP
2018-12-31,,,503610000,,400313000,899639000.0,1554028000,0,518976000,135413000,,,,,103297000,1554028000,1035052000,0,-15366000,,400313000,400313000,55139,FCNCP
2017-12-31,,,543698000,,323752000,835653000.0,1408935000,0,442079000,131203000,,,,,219946000,1408935000,966856000,0,101619000,,323752000,323752000,55139,FCNCP
2019-12-31,,,37900000,,36400000,180400000,568500000,181900000,181900000,,-142100000,,,,1500000,1145800000,963900000,577300000,-144000000,,36400000,36400000,55142,WOW
2018-12-31,,,-152400000,,-87300000,154100000,534800000,193800000,193800000,,-132500000,,,,-65100000,1153800000,960000000,619000000,-346200000,,-87300000,-87300000,55142,WOW
2017-12-31,,,27000000,,185300000,139500000,561600000,224000000,224000000,,-151600000,,,,-158300000,1188100000,964100000,626500000,-197000000,,185300000,185300000,55142,WOW
2016-12-31,,,-1000000,,-33600000,118100000,568700000,244400000,244400000,,-211100000,,,,32600000,1237000000,992600000,668300000,-245400000,,-33600000,-33600000,55142,WOW
2019-12-31,,,-1984927000,19598000,-2151600000,22593628000,28052997000,0,-1857797000,7317166000,,,,,168695000,28052997000,29910794000,0,-127130000,,-2153622000,-2151600000,55145,SUPV
2018-12-31,,,-3147043000,21670000,-4658050000,21786992000,26049560000,0,-3368024000,7630592000,,,,,1555074000,26049560000,29417584000,0,220981000,,-4702117000,-4658050000,55145,SUPV
2017-12-31,,,641035000,222301000,-1160465000,20941359000,29025508000,0,668688000,7415461000,,,,,1802869000,29025508000,28356820000,0,-222372000,1549000.0,-1161834000,-1160465000,55145,SUPV
2016-12-31,,,1834073000,103397000,1311304000,4657438000,8163346000,0,2048747000,1457161000,,,,,500603000,8163346000,6114599000,0,-214674000,1549000.0,1333470000,1311304000,55145,SUPV
2020-12-31,6085700000,,7229900000,,6193700000,6121200000,19056500000,6849600000,6849600000,,-326600000,,,,1036200000,24539800000,17690200000,5483300000,380300000,,6193700000,6193700000,55147,LLY
2019-12-31,5595000000,,5265900000,92200000.0,8318400000,6003900000,17598300000,5999400000,5999400000,,-400600000,,,,628000000,22319500000,16320100000,4721200000,-733500000,3680500000.0,4637900000,8318400000,55147,LLY
2018-12-31,5051200000,,3680100000,1080400000.0,3232000000,5734600000,16811600000,6025800000,6025800000,,-242500000,,,,529500000,21493300000,15467500000,4681700000,-2345700000,81400000.0,3150600000,3232000000,55147,LLY
2017-12-31,5096200000,,2304800000,75700000.0,-204100000,5733400000,15526100000,4696500000,4696500000,,-225000000,,,,2391200000,19973800000,15277300000,4447700000,-2391700000,-117700000.0,-86400000,-204100000,55147,LLY
2020-03-31,77790000,,-171536000,,-172368000,325238000,245009000,-158019000,-158019000,,-15618000,,,,832000,446237000,604256000,201228000,-13517000,,-172368000,-172368000,55148,EGHT
2019-03-31,62063000,,-88170000,,-88739000,250184000,222614000,-89633000,-89633000,,-1510000,,,,569000,352586000,442219000,129972000,1463000,,-88739000,-88739000,55148,EGHT
2018-03-31,36405000,,-38203000,,-104497000,185796000,189774000,-32427000,-32427000,,-1510000,,,,66294000,296500000,328927000,106726000,-5776000,,-104497000,-104497000,55148,EGHT
2017-03-31,28999000,,-4877000,,-4751000,140768000,163098000,-6669000,-6669000,,-1510000,,,,-126000,253388000,260057000,90290000,1792000,,-4751000,-4751000,55148,EGHT
2020-12-31,606194000,,-127020000,,-128323000,690110000,1243300000,-53004000,-53004000,,-635000,,,,1303000,1692658000,1745662000,449358000,-74016000,,-128323000,-128323000,55150,PINS
2019-12-31,1207059000,,-1360839000,,-1361371000,965665000,783858000,-1388866000,-1388866000,,-2137000,,,,532000,1142761000,2531627000,358903000,28027000,,-1361371000,-1361371000,55150,PINS
2018-12-31,251662000,,-62564000,,-62974000,337407000,514348000,-74721000,-74721000,,-995000,,,,410000,755932000,830653000,241584000,12157000,,-62974000,-62974000,55150,PINS
2017-12-31,207973000,,-129733000,,-130044000,224149000,294188000,-137934000,-137934000,,-112000,,,,311000,472852000,610786000,178664000,8201000,,-130044000,-130044000,55150,PINS
2020-12-31,,,40587000,,30242000,50613000,100615000,0,42948000,7054000,,,,,10345000,100615000,57667000,0,-2361000,,30242000,30242000,55151,BMRC
2019-12-31,,,45894000,,34241000,51048000,103302000,0,46580000,5674000,,,,,11653000,103302000,56722000,0,-686000,,34241000,34241000,55151,BMRC
2018-12-31,,,43417000,,32622000,51518000,101683000,0,45094000,5071000,,,,,10795000,101683000,56589000,0,-2498000,,32622000,32622000,55151,BMRC
2017-12-31,,,28838000,,15976000,45131000,82620000,0,31678000,5811000,,,,,12862000,82620000,50942000,0,-2840000,,15976000,15976000,55151,BMRC
2020-02-01,,,580525000,,465116000,2228178000,3048554000,618760000,618760000,-9104000,-50826000,,,,115409000,7277294000,6658534000,4228740000,-38235000,,465116000,465116000,55154,BURL
2019-02-02,,,507584000,,414745000,2018737000,2793868000,566839000,566839000,-9592000,-55990000,,,,92839000,6658887000,6092048000,3865019000,-59255000,,414745000,414745000,55154,BURL
2018-02-03,,,428980000,,384852000,1863501000,2541815000,486139000,486139000,-9070000,-58777000,,,,44128000,6100973000,5614834000,3559158000,-57159000,,384852000,384852000,55154,BURL
2017-01-28,,,333212000,,215873000,1723251000,2284444000,386139000,386139000,-9133000,-56161000,,,,117339000,5581817000,5195678000,3297373000,-52927000,,215873000,215873000,55154,BURL
2020-06-28,48698000,,77842000,,58998000,460321000,622196000,80664000,80664000,,-2438000,,,,18844000,1489637000,1408973000,867441000,-2822000,,58998000,58998000,55155,FLWS
2019-06-30,43758000,,42983000,,34766000,406590000,526121000,45808000,45808000,,-2769000,,,,8217000,1248623000,1202815000,722502000,-2825000,,34766000,34766000,55155,FLWS
2018-07-01,39258000,,38022000,,40791000,375450000,489025000,41848000,41848000,,-3631000,,,,-2769000,1151921000,1110073000,662896000,-3826000,,40791000,40791000,55155,FLWS
2017-07-02,38903000,,56009000,,44041000,400643000,520281000,47359000,47359000,,-5821000,,,,11968000,1193625000,1146266000,673344000,8650000,,44041000,44041000,55155,FLWS
2019-12-31,,,265500000,900000,189500000,981700000,1342200000,360500000,360500000,,-85700000,,,,74700000,3106000000,2745500000,1763800000,-95000000,-1400000,190800000,189500000,55158,TPX
2018-12-31,,,165000000,2900000,100500000,860500000,1132700000,272200000,272200000,,-92300000,,,,49600000,2702900000,2430700000,1570200000,-107200000,-17800000,115400000,100500000,55158,TPX
2017-12-31,,,215400000,2200000,151400000,847300000,1121000000,294500000,294500000,-20800000.0,-87300000,,,,43800000,2700600000,2406100000,1579600000,-79100000,-30900000,171600000,151400000,55158,TPX
2016-12-31,,,283600000,10600000,190600000,909000000,1289500000,400000000,400000000,-19500000.0,-82900000,,,,86300000,3079700000,2679700000,1790200000,-116400000,-12300000,197300000,190600000,55158,TPX
2020-10-31,,,-6509299,,-6509299,1744402,3760433,2035833,2035833,-19802,-831703,,,,0,3760433,1724600,0,-8545132,,-6509299,-6509299,55159,GLV
2019-10-31,,,9291392,,9291392,1647696,4408689,2703158,2703158,57835,-1569116,,,,0,4408689,1705531,0,6588234,,9291392,9291392,55159,GLV
2018-10-31,,,-6091818,,-6091818,1826395,4987314,3151542,3151542,9377,-1580388,,,,0,4987314,1835772,0,-9243360,,-6091818,-6091818,55159,GLV
2017-10-31,,,23505223,,23505223,2941065,5629305,2688240,2688240,9377,-1363538,,,,0,5629305,2941065,0,20816983,,23505223,23505223,55159,GLV
2020-12-31,,,9749000000,1985000000,7747000000,9731000000,19581000000,9798000000,9798000000,52000000,-1437000000,,,,1981000000,33014000000,23216000000,13433000000,-49000000,,7768000000,7747000000,55160,KO
2019-12-31,,,10786000000,2117000000,8920000000,12011000000,22647000000,10625000000,10625000000,11000000,-946000000,,,,1801000000,37266000000,26641000000,14619000000,161000000,,8985000000,8920000000,55160,KO
2018-12-31,,,8225000000,2077000000,6434000000,11013000000,21233000000,10203000000,10203000000,17000000,-950000000,,,,1749000000,34300000000,24097000000,13067000000,-1978000000,,6476000000,6434000000,55160,KO
2017-12-31,,,6890000000,1905000000,1248000000,12901000000,22491000000,9340000000,9340000000,250000000,-853000000,,,,5607000000,36212000000,26872000000,13721000000,-2450000000,,1283000000,1248000000,55160,KO
2020-12-31,,,148000000,140000000,110000000,2041000000,2571000000,530000000,530000000,,-325000000,,,,31000000,16252000000,15722000000,13681000000,-382000000,,117000000,79000000,55161,XPO
2019-12-31,,,569000000,153000000,419000000,1739000000,2669000000,930000000,930000000,,-292000000,,,,129000000,16648000000,15718000000,13979000000,-361000000,,440000000,379000000,55161,XPO
2018-12-31,,,566000000,395000000,422000000,1717000000,2542000000,825000000,825000000,,-217000000,,,,122000000,17279000000,16454000000,14737000000,-259000000,,444000000,390000000,55161,XPO
2017-12-31,,,261000000,406000000,340000000,1617000000,2243000000,626000000,626000000,,-284000000,,,,-99000000,15381000000,14755000000,13138000000,-365000000,,360000000,312000000,55161,XPO
2020-12-31,,,267342000,216775000,254962000,46858000,985213000,427513000,427513000,,-167562000,,,,3327000,1677984000,1250471000,692771000,-160171000,,264015000,251274000,55165,MAA
2019-12-31,,,370314000,220894000,353811000,46121000,973161000,430197000,430197000,,-179847000,,,,3696000,1641017000,1210820000,667856000,-59883000,,366618000,349604000,55165,MAA
2018-12-31,,,233633000,222349000,222899000,34786000,929125000,404580000,404580000,,-173594000,,,,2611000,1571346000,1166766000,642221000,-170947000,,231022000,218920000,55165,MAA
2017-12-31,,,343155000,233982000,328379000,40194000,908668000,374766000,374766000,,-154751000,,,,2619000,1528987000,1154221000,620319000,-31611000,,340536000,324156000,55165,MAA
2019-12-31,,,296598573,,296598573,11317568,63139398,51821830,51821830,,-10177865,,,,0,63139398,11317568,0,244776743,,296598573,296598573,55167,RNP
2018-12-31,,,-63605113,,-63605113,10630119,61226422,50596303,50596303,,-8884752,,,,0,61226422,10630119,0,-114201416,,-63605113,-63605113,55167,RNP
2017-12-31,,,120855636,,120855636,10779297,62815109,52035812,52035812,,-7093912,,,,0,62815109,10779297,0,68819824,,120855636,120855636,55167,RNP
2016-12-31,,,76129555,,76129555,10624539,66236839,55612300,55612300,,-6761821,,,,0,66236839,10624539,0,20517255,,76129555,76129555,55167,RNP
2020-09-30,55300000,,87300000,,67600000,573200000,886000000,257500000,257500000,,-61200000,,,,19700000,1949700000,1692200000,1063700000,-170200000,,67600000,67600000,55168,EPC
2019-09-30,53500000,,-390300000,,-372200000,605200000,967200000,308500000,308500000,,-62600000,,,,-18100000,2141000000,1832500000,1173800000,-698800000,,-372200000,-372200000,55168,EPC
2018-09-30,61100000,,163800000,,103300000,682100000,1034700000,291500000,291500000,,-68000000,,,,60500000,2234400000,1942900000,1199700000,-127700000,,103300000,103300000,55168,EPC
2017-09-30,67600000,,-52900000,,5700000,703600000,1126600000,355400000,355400000,,-69200000,,,,-58600000,2298400000,1943000000,1171800000,-408300000,,5700000,5700000,55168,EPC
2019-12-31,129700000,,14500000,,11600000,300600000,480300000,50000000,50000000,,-34600000,,,,2900000,738200000,688200000,257900000,-35500000,,11600000,11600000,55170,PODD
2018-12-31,90500000,,5200000,,3300000,239700000,370200000,40000000,40000000,,-28900000,,,,1900000,563800000,523800000,193600000,-34800000,,3300000,3300000,55170,PODD
2017-12-31,75700000,,-26600000,,-26800000,208900000,277200000,-7400000,-7400000,,-21200000,,,,200000,463800000,471200000,186600000,-19200000,,-26800000,-26800000,55170,PODD
2016-12-31,55710000,,-26818000,,-28879000,166080000,211086000,-10704000,-10704000,,-14388000,,,,392000,366989000,377693000,155903000,-16114000,-1669000.0,-27210000,-28879000,55170,PODD
2019-12-31,28368000,,46679000,,36195000,58827000,147667000,60907000,60907000,-435000,-11917000,,,,10484000,169022000,108115000,21355000,-14228000,,36195000,36195000,55171,PHAR
2018-12-31,28882000,,857000,,24993000,46760000,112950000,37992000,37992000,-684000,-14311000,,,,-24136000,135130000,97138000,22180000,-37135000,,24993000,24993000,55171,PHAR
2017-12-31,18657000,,-85689000,,-76247000,37396000,77175000,21912000,21912000,-790000,-18651000,,,,-9442000,89620000,67708000,12445000,-107601000,,-76247000,-76247000,55171,PHAR
2016-12-31,15388000,,-17536000,,-17536000,7677000,11190000,-11540000,-11540000,-335000,-3587000,,,,0,15873000,27413000,4683000,-5996000,,-17536000,-17536000,55171,PHAR
2019-12-31,,,-5722983,,-5722983,4268177,-1429971,-5698148,-5698148,,-24835,,,,0,1122740,6820888,2552711,-24835,,-5722983,-5722983,55173,IKT
2018-12-31,,,-2152453,,-2152453,2515968,393847,-2122121,-2122121,,-30332,,,,0,4040955,6163076,3647108,-30332,,-2152453,-2152453,55173,IKT
2017-12-31,,,-436075,,-436075,710375,305245,-405130,-405130,,-30945,,,,0,2060937,2466067,1755692,-30945,,-436075,-436075,55173,IKT
2016-12-31,,,-628737,,-628737,734288,121000,-613288,-613288,,-15449,,,,0,967386,1580674,846386,-15449,,-628737,-628737,55173,IKT
2019-12-31,,,-11102000,,-11102000,5785000,6155000,-10771000,-10771000,,-824000,,,,0,12972000,23743000,6817000,-331000,,-11102000,-11102000,55174,PED
2018-12-31,,,53607000,,53607000,4140000,1702000,-9004000,-9004000,,-7699000,,,,0,4523000,13527000,2821000,62611000,,53607000,53607000,55174,PED
2017-12-31,,,-36370000,,-36370000,2529000,1667000,-23568000,-23568000,,-12798000,,,,0,3015000,26583000,1348000,-12802000,,-36370000,-36370000,55174,PED
2016-12-31,,,-19619000,,-19619000,3912000,2281000,-6942000,-6942000,,-13959000,,,,0,3968000,10910000,1687000,-12677000,,-19619000,-19619000,55174,PED
2019-12-31,,,92788000,,31472000,1452691000,1838045000,385354000,385354000,,-16967000,,,,61316000,3947656000,3562302000,2109611000,-292566000,,31472000,31472000,55176,PRG
2018-12-31,,,252204000,,196210000,1424406000,1907020000,482614000,482614000,,-16440000,,,,55994000,3828923000,3346309000,1921903000,-230410000,,196210000,196210000,55176,PRG
2017-12-31,,,239577000,,292536000,1251725000,1676143000,425653000,425653000,-1235000.0,-20538000,,,,-52959000,3383708000,2958055000,1707565000,-186076000,,292536000,292536000,55176,PRG
2016-12-31,,,218422000,,139283000,1217681000,1608233000,390552000,390552000,-1235000.0,-23390000,,,,79139000,3207716000,2817164000,1599483000,-172130000,,139283000,139283000,55176,PRG
2020-11-30,,,40803434,,40803434,3043766,13713335,10669569,10669569,,-2083043,,,,0,13713335,3043766,0,30133865,,40803434,40803434,55177,WIA
2019-11-30,,,37371331,,37341331,2885846,16574476,13688630,13688630,,-4921612,,,,30000,16574476,2885846,0,23682701,,37341331,37341331,55177,WIA
2018-11-30,,,-9620126,,-9620126,3101767,15808241,12706474,12706474,,-2966157,,,,0,15808241,3101767,0,-22326600,,-9620126,-9620126,55177,WIA
2017-11-30,,,23838964,,23838964,3736258,17375483,13639225,13639225,,-1432675,,,,0,17375483,3736258,0,10199739,,23838964,23838964,55177,WIA
2020-09-30,,,848786,869981,823606,1972595,4964536,2101015,2101015,,-1365057,,,,35331,30167779,28066764,25203243,-1252229,,813455,823606,55178,FAMI
2019-09-30,,,-276440,839048,-307437,2386511,5422124,3035613,3035613,,-3310809,,,,34564,30841875,27806262,25419751,-3312053,,-311004,-307437,55178,FAMI
2018-09-30,,,3238329,875372,3222032,1989687,5067615,3077928,3077928,,-154400,,,,9063,29819088,26741160,24751473,160401,,3229266,3222032,55178,FAMI
2017-09-30,,,3276139,896576,3271310,1055493,4524722,3469229,3469229,,-209159,,,,5793,26665601,23196372,22140879,-193090,,3270346,3271310,55178,FAMI
2019-12-31,,,22211000,12581000,15798000,79156000,662320000,78725000,78725000,1561000,-55991000,,,,5797000,944330000,865605000,282010000,-56514000,,16414000,15798000,55179,CDEV
2018-12-31,,,272176000,143692000,199899000,63304000,693585000,298051000,298051000,-15336000,-26358000,,,,59440000,891045000,592994000,197460000,-25875000,,212736000,199899000,55179,CDEV
2017-12-31,,,113485000,169747000,75568000,49882000,331134000,110418000,110418000,-5138000,-5729000,,,,29930000,429902000,319484000,98768000,3067000,,83555000,75568000,55179,CDEV
2016-12-31,,,-228115000,197793000,-226805000,17852000,72154000,-36858000,-36858000,8386000,-6004000,,,,-406000,98833000,135691000,26679000,-191257000,,-227709000,-8035000,55179,CDEV
2020-12-31,,,530066000,,390606000,503236000,1162879000,0,587768000,71875000,,,,,139460000,1162879000,575111000,0,-57702000,,390606000,377918000,55180,VLYPP
2019-12-31,,,456795000,,309793000,454807000,1070886000,0,553016000,63063000,,,,,147002000,1070886000,517870000,0,-96221000,,309793000,297105000,55180,VLYPP
2018-12-31,,,329693000,,261428000,462483000,934554000,0,408314000,63757000,,,,,68265000,934554000,526240000,0,-78621000,,261428000,248740000,55180,VLYPP
2017-12-31,,,252738000,,161907000,391335000,720064000,0,282575000,46154000,,,,,90831000,720064000,437489000,0,-29837000,,161907000,152458000,55180,VLYPP
2019-12-31,,,177846030,,177846030,9353427,22359902,13006475,13006475,,-3751771,,,,0,22359902,9353427,0,164839555,,177846030,177846030,55184,BTO
2018-12-31,,,-115969453,,-115969453,10041389,20207569,10166180,10166180,,-2732732,,,,0,20207569,10041389,0,-126135633,,-115969453,-115969453,55184,BTO
2017-12-31,,,64087231,,64087231,9475566,18372830,8897264,8897264,,-1873669,,,,0,18372830,9475566,0,55189967,,64087231,64087231,55184,BTO
2016-12-31,,,191415290,,191415290,7778674,18288968,10510294,10510294,,-1362037,,,,0,18288968,7778674,0,180904996,,191415290,191415290,55184,BTO
2020-06-30,253252000,,3003000,69106000,83365000,757095000,1232487000,170354000,170354000,,-76158000,,,,-80992000,2481358000,2311004000,1248871000,-167351000,,83995000,83365000,55186,CMPR
2019-06-30,236797000,,126912000,63182000,95052000,875375000,1349732000,184304000,184304000,,-63892000,,,,33432000,2751076000,2566772000,1401344000,-57392000,,93480000,95052000,55186,CMPR
2018-06-30,245758000,,66366000,90802000,43733000,891612000,1312742000,125491000,125491000,,-52788000,,,,19578000,2592541000,2467050000,1279799000,-59125000,,46788000,43733000,55186,CMPR
2017-06-30,242552000,,-79317000,48081000,-71711000,776112000,1099549000,34740000,34740000,,-43704000,,,,-7118000,2135405000,2100665000,1035856000,-114057000,,-72199000,-71711000,55186,CMPR
2019-12-31,,,615730,,442826,410256,0,-410256,-410256,,,,,,172903,0,410256,0,1025986,,442826,442826,55187,CHPM
2019-11-30,,,-6215974,,-6215974,3129710,0,-6326048,-6326048,19863,,,,,0,0,6326048,0,110074,,-6215974,-6215974,55188,GLDG
2018-11-30,,,-6596404,,-6596404,3467966,0,-6838354,-6838354,14133,,,,,0,0,6838354,0,241950,,-6596404,-6596404,55188,GLDG
2017-11-30,,,-7727143,,-7727143,4269803,0,-7894196,-7894196,8941,,,,,0,0,7894196,0,167053,,-7727143,-7727143,55188,GLDG
2016-11-30,,,-7536983,,-7536983,4606596,-18844,-7549624,-7549624,7025,,,,,0,0,7549624,18844,12641,,-7536983,-7536983,55188,GLDG
2019-12-31,,,-10535000,,-10535000,30756000,116586000,37780000,37780000,-854000,-29089000,,,,0,220728000,182948000,104142000,-48315000,,-10535000,-16304000,55189,DSX
2018-12-31,,,16580000,,16580000,31912000,123274000,39698000,39698000,-542000,-30238000,,,,0,226189000,186491000,102915000,-23118000,,16580000,10811000,55189,DSX
2017-12-31,,,-511714000,,-511714000,28215000,62922000,-52592000,-52592000,296000,-26433000,,,,0,161897000,214489000,98975000,-459122000,,-511714000,-517483000,55189,DSX
2016-12-31,,,-164237000,,-164237000,26974000,14478000,-93821000,-93821000,-253000,-21026000,,,,0,114259000,208080000,99781000,-70416000,,-164237000,-170006000,55189,DSX
2020-12-26,89034000,,85175000,,78523000,115098000,287920000,83788000,83788000,,-864000,,,,6652000,693616000,609828000,405696000,1387000,,78523000,78523000,55190,FORM
2019-12-28,81499000,,51063000,,39346000,105835000,237961000,50627000,50627000,,-1915000,,,,11717000,589464000,538837000,351503000,436000,,39346000,39346000,55190,FORM
2018-12-29,74976000,,33927000,,104036000,99254000,210339000,36109000,36109000,,-3314000,,,,-70109000,529675000,493566000,319336000,-2182000,,104036000,104036000,55190,FORM
2017-12-30,73807000,,42206000,,40913000,95489000,216166000,46870000,46870000,,-4491000,,,,1293000,548441000,501571000,332275000,-4664000,,40913000,40913000,55190,FORM
2019-12-31,,,-1238584,,-1382735,105220816,114197341,-252922,-252922,,-990741,,,,144151,245862054,246114976,131664713,-985662,,-1382735,-1382735,55192,FRPT
2018-12-31,,,-5284108,,-5361204,86835254,89990239,-4537537,-4537537,,-296234,,,,77096,193237462,197774999,103247223,-746571,,-5361204,-5361204,55192,FRPT
2017-12-31,,,-4187146,,-4262341,68309159,72415918,-2543250,-2543250,,-910492,,,,75195,152359487,154902737,79943569,-1643896,,-4262341,-4262341,55192,FRPT
2016-12-31,,,-3094919,,-3160673,55614843,60370883,-923950,-923950,,-698119,,,,65754,129706613,130630563,69335730,-2170969,,-3160673,-3160673,55192,FRPT
2019-12-31,43791000,,-32361000,,-32365000,10266000,21410000,-32647000,-32647000,,-483000,,,,4000,21410000,54057000,0,286000,,-32365000,-32365000,55194,AFMD
2018-12-31,35148000,,-19476000,,-19477000,9638000,23755000,-21031000,-21031000,,-847000,,,,1000,23755000,44786000,0,1555000,,-19477000,-19477000,55194,AFMD
2017-12-31,21489000,,-30243000,,-30223000,7986000,2205000,-27270000,-27270000,,-690000,,,,-20000,2205000,29475000,0,-2973000,,-30223000,-30223000,55194,AFMD
2016-12-31,29883000,,-32274000,,-32216000,8620000,6485000,-32018000,-32018000,,-803000,,,,-58000,6485000,38503000,0,-256000,,-32216000,-32216000,55194,AFMD
2019-12-31,,,231832000,,178608000,208941000,439803000,230862000,230862000,,,,,,53224000,1838154000,1607292000,1398351000,970000,,178608000,178608000,55195,LGIH
2018-12-31,,,199098000,,155286000,179805000,381324000,201519000,201519000,,,,,,43812000,1504400000,1302881000,1123076000,-2421000,,155286000,155286000,55195,LGIH
2017-12-31,,,171402000,,113306000,150619000,320666000,170047000,170047000,,,,,,58096000,1257960000,1087913000,937294000,1355000,,113306000,113306000,55195,LGIH
2016-12-31,,,113672000,,75031000,110142000,222098000,111956000,111956000,,,,,,38641000,838320000,726364000,616222000,1716000,,75031000,75031000,55195,LGIH
2020-03-31,296398000,,458439000,,404459000,776659000,1546520000,425350000,425350000,,-2637000,,,,53980000,3088970000,2663620000,1542450000,33089000,,404459000,404459000,55196,TTWO
2019-03-31,230170000,,232785000,,333837000,672634000,1152176000,209140000,209140000,,-8032000,,,,-101052000,2668394000,2459254000,1516218000,23645000,,333837000,333837000,55196,TTWO
2018-03-31,196373000,,136625000,,173533000,503920000,895641000,151379000,151379000,,-22269000,,,,-36908000,1792892000,1641513000,897251000,-14754000,,173533000,173374000,55196,TTWO
2017-03-31,137915000,,76965000,,67303000,496862000,776955000,111471000,111471000,,-29569000,,,,9662000,1779748000,1668277000,1002793000,-34506000,,67303000,66028000,55196,TTWO
2019-12-31,94737000,,-117223000,,-117223000,24581000,0,-119318000,-119318000,,,,,,0,0,119318000,0,2095000,,-117223000,-117223000,55198,SLDB
2018-12-31,57965000,,-74798000,,-74798000,17722000,0,-75687000,-75687000,,,,,,0,0,75687000,0,889000,,-74798000,-74798000,55198,SLDB
2017-12-31,39905000,,-53178000,,-52118000,14952000,0,-54857000,-54857000,,,,,,0,0,54857000,0,1679000,,-53178000,-39317000,55198,SLDB
2016-12-31,20116000,,-23773000,46474000.0,-21539000,5460000,0,-25576000,-25576000,,,,,,0,0,25576000,0,1803000,,-23773000,-17230000,55198,SLDB
2019-12-31,,,165504813,,165504813,9652753,15996055,6343302,6343302,,,,,,0,15996055,9652753,0,159161511,,165504813,165504813,55202,TDF
2018-12-31,,,-116325149,,-116325149,10739106,21553256,10814150,10814150,,,,,,0,21553256,10739106,0,-127139299,,-116325149,-116325149,55202,TDF
2017-12-31,,,245646472,,245646472,10473121,16966554,6493433,6493433,,,,,,0,16966554,10473121,0,239153039,,245646472,245646472,55202,TDF
2016-12-31,,,6955623,,6955623,9181689,18430660,9248971,9248971,,,,,,0,18430660,9181689,0,-2293348,,6955623,6955623,55202,TDF
2020-06-30,,,-10610000,,-9250000,8035000,0,-11078000,-11078000,1799000,-2000,,,,-1360000,0,11078000,0,468000,,-9250000,-9250000,55206,RNLX
2019-06-30,,,-5652750,,-4933500,3996000,0,-5667000,-5667000,815250,-15000,,,,-719250,0,5667000,0,14250,,-4933500,-4933500,55206,RNLX
2018-06-30,,,-1254000,,-1254000,1254000,0,-1254000,-1254000,815250,-15000,,,,0,0,1254000,0,0,,-1254000,-1254000,55206,RNLX
2019-12-31,30214000,,-36980000,,-36980000,8954000,0,-39168000,-39168000,,,,,,0,0,39168000,0,2188000,,-36980000,-36980000,55208,CRTX
2018-12-31,10085000,,-12476000,,-12476000,2034000,0,-12119000,-12119000,,-957000.0,,,,0,0,12119000,0,-357000,,-12476000,-12476000,55208,CRTX
2017-12-31,9099000,,-12235000,,-12235000,1271000,0,-10370000,-10370000,,-1643000.0,,,,0,0,10370000,0,-1865000,,-12235000,-12235000,55208,CRTX
2019-12-31,,,-8691834,,-8691834,18634884,66439991,47704788,47704788,100319,-13458070,,,,0,66439991,18735203,0,-56396622,,-8691834,-8691834,55212,ECCB
2018-12-31,,,-54848492,,-54848492,20080125,69680994,49490819,49490819,110050,-14796919,,,,0,69680994,20190175,0,-104339311,,-54848492,-54848492,55212,ECCB
2017-12-31,,,31130956,,31130956,18435353,65291679,46096126,46096126,760200,-12929131,,,,0,65291679,19195553,0,-14965170,,31130956,31130956,55212,ECCB
2016-12-31,,,90580063,,90580063,15363476,55839799,39310929,39310929,1165394,-7936089,,,,0,55839799,16528870,0,51269134,,90580063,90580063,55212,ECCB
2019-12-31,14054305,,-21156758,,-21156758,7254239,0,-21308544,-21308544,,,,,,0,0,21308544,0,151786,,-21156758,-21156758,55216,EYEN
2018-12-31,11071826,,-17253108,,-17253108,6184617,0,-17256443,-17256443,,,,,,0,0,17256443,0,3335,,-17253108,-17253108,55216,EYEN
2017-12-31,3771054,,-5129987,,-5129987,1361313,0,-5132367,-5132367,,,,,,0,0,5132367,0,2380,,-5129987,-5129987,55216,EYEN
2016-12-31,2929575,,-3533443,,-3533443,605365,0,-3534940,-3534940,,,,,,0,0,3534940,0,1497,,-3533443,-3533443,55216,EYEN
2020-02-01,,,88417000,,73300000,478120000,655305000,102397000,102397000,,-8194000,,,,15117000,1870667000,1768270000,1215362000,-13980000,,73300000,73300000,55223,PLCE
2019-02-02,,,108524000,,100960000,498343000,683596000,117424000,117424000,-1055000.0,-3534000,,,,7564000,1938084000,1820660000,1254488000,-8900000,,100960000,100960000,55223,PLCE
2018-02-03,,,161203000,,84698000,476486000,711355000,166700000,166700000,10000.0,-2222000,,,,76505000,1870275000,1703575000,1158920000,-5497000,,84698000,84698000,55223,PLCE
2017-01-28,,,147013000,,102336000,454143000,671593000,151434000,151434000,282000.0,-1953000,,,,44677000,1785316000,1633882000,1113723000,-4421000,,102336000,102336000,55223,PLCE
2020-10-31,,,15622988,,15622988,3720678,4277569,589932,589932,-33041,-1446376,,,,0,4277569,3687637,0,15033056,,15622988,15622988,55227,GLQ
2019-10-31,,,12600579,,12600579,3297985,5267961,1809549,1809549,160427,-2538602,,,,0,5267961,3458412,0,10791030,,12600579,12600579,55227,GLQ
2018-10-31,,,5404753,,5404753,3584055,6213801,2606665,2606665,23081,-2443587,,,,0,6213801,3607136,0,2798088,,5404753,5404753,55227,GLQ
2017-10-31,,,53766422,,53766422,5287367,7152903,1865536,1865536,23081,-2139979,,,,0,7152903,5287367,0,51900886,,53766422,53766422,55227,GLQ
2019-12-31,25797000,,-32968000,,-32968000,7804000,0,-33601000,-33601000,,,,,,0,0,33601000,0,633000,,-32968000,-32968000,55228,BTAI
2018-12-31,14558000,,-19270000,,-19270000,5404000,0,-19962000,-19962000,,,,,,0,0,19962000,0,692000,,-19270000,-19270000,55228,BTAI
2017-12-31,2690000,,-4539000,,-4539000,1847000,0,-4537000,-4537000,,-2000.0,,,,0,0,4537000,0,-2000,,-4539000,-4539000,55228,BTAI
2016-12-31,1399000,,-2120000,,-2120000,721000,0,-2120000,-2120000,,-2000.0,,,,0,0,2120000,0,0,,-2120000,-2120000,55228,BTAI
2019-12-31,,,384535680,,384535680,9156717,21891612,12734895,12734895,,-2324015,,,,0,21891612,9156717,0,371800785,,384535680,384535680,55230,RVT
2018-12-31,,,-219298532,,-219298532,7878239,25749716,17871477,17871477,,-1678886,,,,0,25749716,7878239,0,-237170009,,-219298532,-219298532,55230,RVT
2017-12-31,,,239049665,,239049665,7381614,19922911,12541297,12541297,,-1571615,,,,0,19922911,7381614,0,226508368,,239049665,239049665,55230,RVT
2016-12-31,,,271902031,,271902031,7138652,18024681,10886029,10886029,,-1205769,,,,0,18024681,7138652,0,261016002,,271902031,271902031,55230,RVT
2019-12-31,,,4226759,,4226759,327399,0,-327399,-327399,,,,,,0,0,327399,0,4554158,,4226759,4226759,55231,RPLA
2018-12-31,,,-16164,,-16164,16164,0,-16164,-16164,,,,,,0,0,16164,0,0,,-16164,-16164,55231,RPLA
2020-12-31,,,-24439000,,-28280000,236357000,245252000,8895000,8895000,,-28406000,,,,3841000,850689000,841794000,605437000,-33334000,,-28280000,-28280000,55233,IVC
2019-12-31,,,-44025000,,-53327000,259983000,262067000,2084000,2084000,,-29076000,,,,9302000,927964000,925880000,665897000,-46109000,,-53327000,-53327000,55233,IVC
2018-12-31,,,-34102000,,-43922000,282056000,267676000,-14380000,-14380000,,-28336000,,,,9820000,972347000,986727000,704671000,-19722000,,-43922000,-43922000,55233,IVC
2017-12-31,,,-66250000,,-76541000,296738000,269251000,-27487000,-27487000,,-22907000,,,,10291000,966497000,993984000,697246000,-38763000,,-76541000,-76541000,55233,IVC
2020-09-27,,,2843000,1931000,-3106000,,350738000,55223000,55223000,259382000,-59709000,,,,4104000,618004000,562781000,267266000,-52380000,,-1261000,-3106000,55234,LEE
2019-09-29,,,23840000,1653000,14268000,,304748000,81707000,81707000,193709000,-54702000,,,,7931000,509854000,428147000,205106000,-57867000,,15909000,14268000,55234,LEE
2018-09-30,,,30820000,1094000,45766000,,319842000,88423000,88423000,199653000,-58153000,,,,-16228000,543955000,455532000,224113000,-57603000,,47048000,45766000,55234,LEE
2017-09-24,,,40216000,1022000,27481000,3866000.0,332347000,91311000,91311000,195888000,-62391000,,,,11611000,566943000,475632000,234596000,-51095000,,28605000,27481000,55234,LEE
2020-12-31,1870000000,,6706000000,64000000,5384000000,6788000000,15672000000,7014000000,7014000000,,-529000000,,,,1318000000,32184000000,25170000000,16512000000,-308000000,,5388000000,5384000000,55235,MMM
2019-12-31,1874000000,,5712000000,63000000,4570000000,6390000000,15400000000,7136000000,7136000000,,-448000000,,,,1130000000,32136000000,25000000000,16736000000,-1424000000,,4582000000,4570000000,55235,MMM
2018-12-31,1816000000,,7000000000,52000000,5349000000,6527000000,16110000000,7767000000,7767000000,,-350000000,,,,1637000000,32765000000,24998000000,16655000000,-767000000,,5363000000,5349000000,55235,MMM
2017-12-31,1862000000,,7548000000,59000000,4858000000,6493000000,15688000000,7333000000,7333000000,,-322000000,,,,2679000000,31657000000,24324000000,15969000000,215000000,,4869000000,4858000000,55235,MMM
2019-12-31,,,30580789,,30580789,53909027,195165915,141256888,141256888,,-45301290,,,,0,195165915,53909027,0,-110676099,,30580789,30580789,55236,TCPC
2018-12-31,,,45568582,,45475882,56553068,190499184,133946116,133946116,,-39470340,,,,92700,190499184,56553068,0,-88377534,,45475882,45475882,55236,TCPC
2017-12-31,,,90647717,,67931014,29440357,175969500,146529143,146529143,,-31516314,,,,36380,175969500,29440357,0,-55881426,,90611337,67931014,55236,TCPC
2016-12-31,,,95937335,,76317159,27164942,148180765,121015823,121015823,,-23903660,,,,569511,148180765,27164942,0,-25078488,,95367824,76317159,55236,TCPC
2019-12-31,,,-34769000,,-34769000,19401000,295695000,186985000,186985000,,-82797000,,,,0,379745000,192760000,84050000,-221754000,,-34769000,-67747000,55237,GLOP
2018-12-31,,,128046000,,128046000,19754000,305698000,198360000,198360000,,-70806000,,,,0,386901000,188541000,81203000,-70314000,,128046000,77481000,55237,GLOP
2018-01-01,,,148098000,,148098000,15719000,320501000,217734000,217734000,,-69659000,,,,0,401806000,184072000,81305000,-69636000,,148098000,83160000,55237,GLOP
2017-01-01,,,99709000,,99709000,13206000,250080000,166584000,166584000,,-59179000,,,,0,317489000,150905000,67409000,-66875000,,99709000,72480000,55237,GLOP
2019-12-31,,,-12526891,-10027860,-11262821,34694209,22544655,0,-12149554,,,,,,216857,35518790,47668344,12974135,-377337,,-12743748,-11262821,55240,JRJC
2018-12-31,,,-22417716,-9109839,-19950120,50244101,28634910,0,-21609191,,,,,,52779,45476825,67086016,16841915,-808525,,-22470495,-19950120,55240,JRJC
2017-12-31,,,-42064021,-8335071,-36736553,60925679,20685768,0,-40009737,-230174.0,,,,,324416,42619446,82629183,21933678,-2054284,,-42388437,-36736553,55240,JRJC
2016-12-31,,,-6805575,-4369874,-1678813,84405383,62675363,0,-20535245,-1194775.0,,,,,4160603,83055621,103590866,20380258,13729670,,-10966178,-1678813,55240,JRJC
2019-12-31,,,-77960000,,-77960000,21039000,-59113000,-80152000,-80152000,,-300000,,,,0,388000,80540000,59501000,2192000,,-77960000,-91661000,55241,CDAK
2018-12-31,,,-44542000,,-44542000,9898000,-28471000,-38369000,-38369000,,-300000,,,,0,0,38369000,28471000,-6173000,,-44542000,-58223000,55241,CDAK
2017-12-31,21320000.0,,-26951000,,-26951000,6178000,0,-27498000,-27498000,,-300000,,,,0,0,27498000,0,547000,,-26951000,-32737000,55241,CDAK
2019-12-31,47029264,,-57891911,,-57891911,14360038,0,-61389302,-61389302,,,,,,0,0,61389302,0,3497391,,-57891911,-57891911,55242,GLYC
2018-12-31,40091773,,-48273633,,-48273633,11413050,0,-51504823,-51504823,,,,,,0,0,51504823,0,3231190,,-48273633,-48273633,55242,GLYC
2017-12-31,24100092,,-33281068,,-33281068,9832188,0,-33932280,-33932280,,,,,,0,0,33932280,0,651212,,-33281068,-33281068,55242,GLYC
2016-12-31,23281820,,-31809838,,-31809838,8650165,18500,-31913485,-31913485,,,,,,0,18500,31931985,0,103647,,-31809838,-31809838,55242,GLYC
2019-12-31,,,-132000000,2981000000,-22000000,895000000,1193000000,129000000,129000000,,-22000000,,,,-16000000,1560000000,1431000000,367000000,-261000000,,-116000000,-22000000,55244,LTRPB
2018-12-31,,,48000000,3400000000,-64000000,966000000,1254000000,128000000,128000000,,-26000000,,,,57000000,1615000000,1487000000,361000000,-80000000,,-9000000,-64000000,55244,LTRPB
2017-12-31,,,-1810000000,3329000000,-397000000,1021000000,1240000000,6000000,6000000,,-25000000,,,,-229000000,1569000000,1563000000,329000000,-1816000000,,-1581000000,-397000000,55244,LTRPB
2016-12-31,,,46000000,4621000000,21000000,918000000,1163000000,23000000,23000000,,-25000000,,,,-1000000,1532000000,1509000000,369000000,23000000,,47000000,21000000,55244,LTRPB
2019-12-31,,,183060000,-782000,166603000,185926000,617164000,300413000,300413000,,-151024000,,,,16648000,2477922000,2177509000,1860758000,-117353000,,166412000,166603000,55245,GEO
2018-12-31,,,158944000,-599000,145089000,184515000,575614000,264665000,264665000,,-150103000,,,,14117000,2331386000,2066721000,1755772000,-105721000,,144827000,145089000,55245,GEO
2017-12-31,,,163982000,-322000,146241000,190343000,562925000,248285000,248285000,,-148024000,,,,17958000,2263420000,2015135000,1700495000,-84303000,,146024000,146241000,55245,GEO
2016-12-31,,,156402000,-99000,148715000,148709000,529209000,265584000,265584000,,-128718000,,,,7904000,2179490000,1913906000,1650281000,-109182000,,148498000,148715000,55245,GEO
2020-01-31,,,-47765000,1781000,-42689000,37225000,-10220000,-50945000,-50945000,,,,,,-7053000,238997000,289942000,249217000,3180000,,-40712000,-42689000,55247,AGX
2019-01-31,,,47218000,-196000,52036000,34010000,79338000,41728000,41728000,,-659000.0,,,,-4651000,482153000,440425000,402815000,5490000,,51869000,52036000,55247,AGX
2018-01-31,,,112625000,43000,72011000,36264000,146925000,107561000,107561000,,-659000.0,,,,40279000,892815000,785254000,745890000,5064000,,72346000,72011000,55247,AGX
2017-01-31,,,114532000,937000,70328000,26978000,144411000,114233000,114233000,,-659000.0,,,,37106000,675047000,560814000,530636000,299000,,77426000,70328000,55247,AGX
2020-12-31,,,972000000,,817000000,2507000000,3767000000,0,1045000000,215000000,,,,,155000000,3767000000,2722000000,0,-73000000,,817000000,717000000,55249,HBANN
2019-12-31,,,1659000000,,1411000000,2413000000,4390000000,0,1756000000,221000000,,,,,248000000,4390000000,2634000000,0,-97000000,,1411000000,1337000000,55249,HBANN
2018-12-31,,,1628000000,,1393000000,2286000000,4273000000,0,1766000000,221000000,,,,,235000000,4273000000,2507000000,0,-138000000,,1393000000,1323000000,55249,HBANN
2017-12-31,,,1394000000,,1186000000,2204000000,4108000000,0,1682000000,222000000,,,,,208000000,4108000000,2426000000,0,-288000000,,1186000000,1110000000,55249,HBANN
2019-12-31,,,95975000,,38690000,34730000,367379000,107616000,107616000,,-43268000,,,,57285000,570983000,463367000,203604000,-11641000,,38690000,38690000,55250,GTE
2018-12-31,,,151487000,,102616000,39483000,438729000,201379000,201379000,,-27364000,,,,48871000,613431000,412052000,174702000,-49892000,,102616000,102616000,55250,GTE
2017-12-31,,,37330000,,-31708000,39014000,286758000,115185000,115185000,1224000.0,-13882000,,,,69038000,421734000,306549000,134976000,-77855000,,-31708000,-31708000,55250,GTE
2016-12-31,,,-650234000,,-465565000,33218000,169904000,-5947000,-5947000,3098000.0,-14145000,,,,-184669000,289269000,295216000,119365000,-644287000,,-465565000,-465565000,55250,GTE
2020-10-31,1050519000,,1311617000,,1220761000,641027000,3690478000,1569477000,1569477000,,-193305000,,,,90856000,5603056000,4033579000,1912578000,-257860000,,1220761000,1220761000,55251,ADI
2019-11-02,1130348000,,1485728000,,1363011000,647897000,4013750000,1806464000,1806464000,,-229075000,,,,122717000,5991065000,4184601000,1977315000,-320736000,,1363011000,1359782000,55251,ADI
2018-11-03,1165047000,,1655314000,,1506980000,696597000,4250396000,1959850000,1959850000,,-253589000,,,,148334000,6224689000,4264839000,1974293000,-304536000,,1506980000,1501071000,55251,ADI
2017-10-28,968133000,,934747000,,805379000,644398000,3526959000,1617077000,1617077000,,-250840000,,,,129368000,5246354000,3629277000,1719395000,-682330000,,805379000,803136000,55251,ADI
2019-12-31,,,37506000,,36991000,16771000,76327000,0,37506000,22050000,,,,,515000,76327000,38821000,0,0,,36991000,36991000,55252,ACRE
2018-12-31,,,39042000,,38596000,16240000,55282000,0,39042000,22050000,,,,,446000,55282000,16240000,0,0,,38596000,38596000,55252,ACRE
2017-12-31,,,30610000,,30407000,14970000,46348000,0,31378000,22050000,,,,,178000,46348000,14970000,0,-768000,,30432000,30407000,55252,ACRE
2016-12-31,,,30681000,10644000.0,40336000,14426000,45107000,0,30681000,22050000,,,,,230000,45107000,14426000,0,0,14417000.0,30451000,40336000,55252,ACRE
2019-12-29,,,8485000,1558000,8817000,18750000,91026000,10227000,10227000,49316000,-580000,,,,-568000,247269000,237042000,156243000,-1742000,-236000,9053000,8817000,55253,JAX
2018-12-30,,,2862000,7844000,3999000,20485000,90152000,9339000,9339000,48043000,-724000,,,,-1596000,242264000,232925000,152112000,-6477000,-459000,4458000,3999000,55253,JAX
2017-12-31,,,6426000,5200000,7334000,18886000,87166000,10800000,10800000,46443000,-816000,,,,-1347000,233255000,222455000,146089000,-4374000,-439000,7773000,7334000,55253,JAX
2017-01-01,,,9539000,3740000,7043000,18852000,83160000,10409000,10409000,43622000,-662000,,,,2062000,219582000,209173000,136422000,-870000,-434000,7477000,7043000,55253,JAX
2020-12-31,,,67743000,,58869000,85899000,167806000,0,67743000,14164000,,,,,8874000,167806000,100063000,0,0,,58869000,58869000,55260,SYBT
2019-12-31,,,75660000,,66067000,86187000,171747000,0,76537000,8694000,,,,,9593000,171747000,95210000,0,-877000,,66067000,66067000,55260,SYBT
2018-12-31,,,67548000,,55517000,80023000,155319000,0,68008000,7040000,,,,,12031000,155319000,87311000,0,-460000,,55517000,55517000,55260,SYBT
2017-12-31,,,55182000,,38043000,74502000,138478000,0,56142000,7615000,,,,,17139000,138478000,82336000,0,-960000,,38043000,38043000,55260,SYBT
2020-12-31,93000000,,179000000,2000000,219000000,526000000,1067000000,448000000,448000000,,-210000000,,,,-40000000,4969000000,4521000000,3902000000,-269000000,,219000000,219000000,55261,CC
2019-12-31,80000000,,-124000000,6000000,-52000000,536000000,1063000000,447000000,447000000,,-208000000,,,,-72000000,5526000000,5079000000,4463000000,-571000000,,-52000000,-52000000,55261,CC
2018-12-31,82000000,,1155000000,6000000,995000000,630000000,1971000000,1259000000,1259000000,,-195000000,,,,159000000,6638000000,5379000000,4667000000,-104000000,,996000000,995000000,55261,CC
2017-12-31,81000000,,912000000,5000000,746000000,592000000,1745000000,1072000000,1072000000,,-214000000,,,,165000000,6183000000,5111000000,4438000000,-160000000,,747000000,746000000,55261,CC
2019-12-31,,,-41618000,,-41595000,10803000,-32016000,-42819000,-42819000,,-1434000,,,,-23000,6829000,49648000,38845000,1201000,,-41595000,-40027000,55262,XENE
2018-12-31,23634000.0,,-34521000,,-34497000,8406000,-23634000,-32040000,-32040000,,-1394000,,,,-24000,0,32040000,23634000,-2481000,,-34497000,-31616000,55262,XENE
2017-12-31,25453000.0,,-30704000,,-30704000,7313000,-25262000,-32575000,-32575000,,-1394000,,,,0,311000,32886000,25573000,1871000,,-30704000,-30704000,55262,XENE
2016-12-31,18714000.0,,-22997000,,-22997000,6792000,689000,-24817000,-24817000,,-1394000,,,,0,1803000,26620000,1114000,1820000,,-22997000,-22997000,55262,XENE
2019-12-31,,,-22442646,,-22442646,6623787,46738974,40115187,40115187,,-1015809,,,,0,46738974,6623787,0,-62557833,,-22442646,-22442646,55263,BHK
2019-08-31,,,133795468,,133795468,5928769,48647525,42718756,42718756,,-7255305,,,,0,48647525,5928769,0,91076712,,133795468,133795468,55263,BHK
2018-08-31,,,-5393748,,-5393748,6389830,51345647,44955817,44955817,,-6584321,,,,0,51345647,6389830,0,-50349565,,-5393748,-5393748,55263,BHK
2017-08-31,,,26368249,,26368249,6160732,49961888,43801156,43801156,,-1444374,,,,0,49961888,6160732,0,-17432907,,26368249,26368249,55263,BHK
2019-12-31,,,25252982,,23565399,39157519,65346424,24819616,24819616,740402,-108426,,,,1687583,242775489,217955873,177429065,433366,,23565399,23565399,55266,IGIC
2018-12-31,,,25603944,,25541703,35351679,65389285,28881951,28881951,683531,-108426,,,,62241,209457462,180575511,144068177,-3278007,,25541703,25541703,55266,IGIC
2017-12-31,,,7016918,,7031340,30902604,37109449,4382887,4382887,609502,-108426,,,,-14422,176981043,172598156,139871594,2634031,,7031340,7031340,55266,IGIC
2017-01-01,,,32015855,,32947984,31348578,62881465,30745280,30745280,-14292,-108426,,,,-932129,184677256,153931976,121795791,1270575,,32947984,32947984,55266,IGIC
2019-12-31,5700000,,9800000,,3100000,52300000,108000000,47500000,47500000,2500000,-4700000,,,,6700000,443500000,396000000,335500000,-37700000,,3100000,3100000,55267,LXFR
2018-12-31,6400000,,30500000,,25000000,56100000,122100000,59600000,59600000,2500000,-5000000,,,,5500000,487900000,428300000,365800000,-29100000,,25000000,25000000,55267,LXFR
2017-12-31,7800000,,19900000,,16600000,63900000,108600000,36900000,36900000,2500000,-6600000,,,,3300000,441300000,404400000,332700000,-17000000,,16600000,16600000,55267,LXFR
2016-12-31,7600000,,24600000,,17800000,59000000,94600000,28600000,28600000,-600000,-6300000,,,,6800000,414800000,386200000,320200000,-4000000,,17800000,17800000,55267,LXFR
2019-12-31,,,-5645000,,-5645000,5816000,217000,-5599000,-5599000,,-60000,,,,0,12969000,18568000,12752000,-46000,,-5645000,-5645000,55269,CHNR
2018-12-31,,,-6176000,,-6176000,6207000,0,-6207000,-6207000,,-60000,,,,0,0,6207000,0,31000,,-6176000,-6176000,55269,CHNR
2017-12-31,,,-6179000,,-29996000,6204000,0,-6204000,-6204000,,-60000,,,,0,0,6204000,0,25000,-23817000.0,-6179000,-29996000,55269,CHNR
2016-12-31,,,-4445000,,-23036000,4519000,0,-4519000,-4519000,,-60000,,,,0,0,4519000,0,74000,-18591000.0,-4445000,-23036000,55269,CHNR
2017-12-31,2618795,,-9519269,,-9519269,5415324,0,-8034119,-8034119,,-724684,,,,0,0,8034119,0,-1485150,,-9519269,-10398134,55270,PAVMW
2016-12-31,1719587,,-5650851,,-5650851,3931264,0,-5650851,-5650851,,-724684,,,,0,0,5650851,0,0,,-5650851,-5650851,55270,PAVMW
2015-12-31,489327,,-1776600,,-1776600,1287273,0,-1776600,-1776600,,-724684,,,,0,0,1776600,0,0,,-1776600,-1776600,55270,PAVMW
2014-12-31,22290,,-548768,,-548768,1287273,0,-422290,-422290,,-724684,,,,0,0,422290,0,-126478,,-548768,-548768,55270,PAVMW
2019-12-31,6451000,,-1156000,,-1187000,7377000,12550000,-1278000,-1278000,,,,,,31000,21568000,22846000,9018000,122000,,-1187000,-1187000,55271,DAIO
2018-12-31,7361000,,1897000,,1606000,8257000,17356000,1738000,1738000,,,,,,291000,29224000,27486000,11868000,159000,,1606000,1606000,55271,DAIO
2017-12-31,6896000,,5161000,,5449000,8116000,20059000,5047000,5047000,,,,,,-288000,34051000,29004000,13992000,114000,,5449000,5449000,55271,DAIO
2016-12-31,5065000,,1692000,,1656000,6376000,12868000,1427000,1427000,,,,,,36000,23413000,21986000,10545000,265000,,1656000,1656000,55271,DAIO
2019-12-31,,,2287000000,192000000,783000000,5019000000,7770000000,2548000000,2548000000,203000000,-516000000,,,,334000000,93736000000,91188000000,85966000000,-261000000,-1161000000,1953000000,783000000,55272,PUK
2018-12-31,,,3557000000,23000000,4019000000,3877000000,8165000000,3892000000,3892000000,396000000,-547000000,,,,676000000,35845000000,31953000000,27680000000,-335000000,1142000000,2881000000,4019000000,55272,PUK
2017-12-31,,,3970000000,7000000,2389000000,6208000000,11057000000,3865000000,3865000000,984000000,-425000000,,,,1580000000,86390000000,82525000000,75333000000,105000000,1142000000,2390000000,2389000000,55272,PUK
2016-12-31,,,3212000000,1000000,1921000000,5398000000,9588000000,3628000000,3628000000,562000000,-360000000,,,,1291000000,71718000000,68090000000,62130000000,-416000000,1142000000,1921000000,1921000000,55272,PUK
2019-12-31,,,55213000,,31011000,52699000,182981000,134684000,134684000,-4402000,-79158000,,,,4192000,416540000,281856000,233559000,-79471000,-20010000,51021000,22182000,55273,CAI
2018-12-31,,,83659000,,78596000,46240000,181463000,145109000,145109000,-9886000,-62573000,,,,4554000,396395000,251286000,214932000,-61450000,-509000,79105000,73472000,55273,CAI
2017-12-31,,,55871000,,72060000,39588000,132706000,98451000,98451000,-5333000,-41815000,,,,-6694000,315917000,217466000,183211000,-42580000,9495000,62565000,72060000,55273,CAI
2016-12-31,,,9878000,,5997000,36967000,103635000,53997000,53997000,12671000,-42754000,,,,3844000,294354000,240357000,190719000,-44119000,9495000,6034000,5997000,55273,CAI
2019-12-31,168982000,,-1034510000,,-1034510000,369550000,-516003000,-1053282000,-1053282000,-1253000,-20038000,,,,0,1422623000,2475905000,1938626000,18772000,,-1034510000,-1034510000,55276,CAN
2018-12-31,189680000,,200242000,,122432000,185415000,508119000,243255000,243255000,-110231000,-53069000,,,,77810000,2705291000,2462036000,2197172000,-43013000,,122432000,122432000,55276,CAN
2017-12-31,99769000,,400969000,,375816000,145987000,604384000,397439000,397439000,-38811000,-53069000,,,,25153000,1308083000,910644000,703699000,3530000,,375816000,375816000,55276,CAN
2019-12-31,,,-8557000,,-8569000,35828000,45505000,9677000,9677000,,-58000,,,,12000,229683000,220006000,184178000,-18234000,,-8569000,-8569000,55278,PGNY
2018-12-31,,,-6893000,,661000,22886000,19434000,-3452000,-3452000,,-409000,,,,-1777000,105400000,108852000,85966000,-3441000,5777000.0,-5116000,236000,55278,PGNY
2017-12-31,,,-12459000,,-12452000,18405000,7400000,-11005000,-11005000,,-740000,,,,-3000,48584000,59589000,41184000,-1454000,4000.0,-12456000,-13464000,55278,PGNY
2020-08-31,,,796000,,-9435000,130028000,145370000,4645000,4645000,,-2318000,,,,10231000,198456000,193811000,53086000,-3849000,,-9435000,-9435000,55280,FC
2019-08-31,,,592000,,-1023000,138696000,159314000,4489000,4489000,,-2358000,,,,1615000,225356000,220867000,66042000,-3897000,,-1023000,-1023000,55280,FC
2018-08-31,,,-5520000,,-5887000,137266000,148289000,-2352000,-2352000,,-2676000,,,,367000,209758000,212110000,61469000,-3168000,,-5887000,-5887000,55280,FC
2017-08-31,,,-10909000,,-7172000,122884000,124774000,-5527000,-5527000,,-2408000,,,,-3737000,185256000,190783000,60482000,-5382000,,-7172000,-7172000,55280,FC
2019-12-31,11242000,,-59853000,,-59854000,13890000,-8749000,-33881000,-33881000,,-10954000,,,,1000,8488000,42369000,17237000,-25972000,,-59854000,-59854000,55281,RMO
2018-12-31,18446000,,-59327000,,-59328000,19768000,-9731000,-47945000,-47945000,,-8802000,,,,1000,3064000,51009000,12795000,-11382000,,-59328000,-59328000,55281,RMO
2019-12-31,,,510939000,4471000,392334000,299500000,1112944000,577962000,577962000,,-77026000,,,,116843000,7183188000,6605226000,6070244000,-67023000,,394096000,392334000,55282,MTZ
2018-12-31,,,365303000,2126000,259659000,287278000,970109000,469901000,469901000,,-82571000,,,,106072000,6909417000,6439516000,5939308000,-104598000,,259231000,259659000,55282,MTZ
2017-12-31,,,371826000,2554000,347213000,274503000,861671000,399119000,399119000,,-61011000,,,,22942000,6606978000,6207859000,5745307000,-27293000,,348884000,347213000,55282,MTZ
2016-12-31,,,225819000,7103000,131263000,249133000,692578000,278530000,278530000,,-50734000,,,,91784000,5134703000,4856173000,4442125000,-52711000,,134035000,131263000,55282,MTZ
2019-12-31,,,1878804,,1878804,16886638,22561847,2140121,2140121,,-401497,,,,0,79733568,77593447,57171721,-261317,,1878804,1878804,55284,GRWG
2018-12-31,,,-5073755,,-5073755,8453917,6444558,-4255648,-4255648,,-1013166,,,,0,29000730,33256378,22556172,-818107,,-5073755,-5073755,55284,GRWG
2017-12-31,,,-2542582,,-2542582,4890575,3269555,-2850513,-2850513,,-15339,,,,0,14363886,17214399,11094331,307931,,-2542582,-2542582,55284,GRWG
2016-12-31,,,-431244,,-431244,2357975,2204277,-425993,-425993,,-5251,,,,0,7980471,8406464,5776194,-5251,,-431244,-431244,55284,GRWG
2019-12-31,,,-114000000,3000000,91000000,639000000,1116000000,488000000,488000000,-11000000,-436000000,,,,54000000,7115000000,6627000000,5999000000,-602000000,258000000,-168000000,91000000,55285,PTVE
2018-12-31,,,-47000000,9000000,279000000,565000000,1113000000,551000000,551000000,-3000000,-432000000,,,,-16000000,7395000000,6844000000,6282000000,-598000000,312000000,-31000000,279000000,55285,PTVE
2017-12-31,,,121000000,10000000,594000000,599000000,1353000000,758000000,758000000,-4000000,-442000000,,,,-218000000,7439000000,6681000000,6086000000,-637000000,257000000,339000000,594000000,55285,PTVE
2016-12-31,,,272000000,9000000,159000000,1170000000,2377000000,1216000000,1216000000,-9000000,-872000000,,,,105000000,10646000000,9430000000,8269000000,-944000000,-6000000,167000000,159000000,55285,PTVE
2020-12-31,,,22311000,,16885000,22882000,43825000,20943000,20943000,,,,,,5426000,71206000,50263000,27381000,1368000,,16885000,16885000,55286,NTP
2019-12-31,,,-15231000,,-13191000,17458000,1609000,-15849000,-15849000,,-67000.0,,,,-2040000,2965000,18814000,1356000,618000,,-13191000,-13191000,55286,NTP
2018-12-31,,,-13254000,,-13254000,20920000,420000,-20500000,-20500000,,-67000.0,,,,0,493000,20993000,73000,7246000,,-13254000,-13254000,55286,NTP
2017-12-31,,,3944000,,3944000,9280000,1851000,-7429000,-7429000,,-67000.0,,,,0,1851000,9280000,0,11373000,,3944000,3944000,55286,NTP
2020-04-30,,,-9000544,,-9000544,1921763,12317956,10396193,10396193,,-2388088,,,,0,12317956,1921763,0,-19396737,,-9000544,-9000544,55287,BTA
2019-04-30,,,11166075,,11166075,1848852,12740739,10891887,10891887,,-2524785,,,,0,12740739,1848852,0,274188,,11166075,11166075,55287,BTA
2018-04-30,,,8830524,,8830524,1903517,12644451,10740934,10740934,,-2000271,,,,0,12644451,1903517,0,-1910410,,8830524,8830524,55287,BTA
2017-04-30,,,520688,,520688,1916621,12422311,10505690,10505690,,-1481316,,,,0,12422311,1916621,0,-9985002,,520688,520688,55287,BTA
2019-12-31,10575000,,9981000,,18972000,58105000,80291000,11611000,11611000,,-1358000,,,,-8991000,229437000,217826000,149146000,-1630000,,18972000,18972000,55288,CLAR
2018-12-31,9471000,,6473000,,7301000,55680000,75011000,9860000,9860000,,-1339000,,,,-828000,212141000,202281000,137130000,-3387000,,7301000,7301000,55288,CLAR
2017-12-31,7984000,,-5760000,,-673000,48311000,55908000,-387000,-387000,,-1288000,,,,-5087000,170687000,171074000,114779000,-5373000,,-673000,-673000,55288,CLAR
2016-12-31,6598000,,-8313000,,-8978000,43338000,43684000,-6252000,-6252000,,-2876000,,,,665000,148189000,154441000,104505000,-2061000,,-8978000,-8978000,55288,CLAR
2020-12-31,,,18305000,,16978000,61045000,84808000,0,20670000,3093000,,,,,1327000,84808000,64138000,0,-2365000,,16978000,16978000,55289,FBIZ
2019-12-31,,,24499000,,23324000,57444000,87100000,0,25784000,3872000,,,,,1175000,87100000,61316000,0,-1285000,,23324000,22822000,55289,FBIZ
2018-12-31,,,17654000,,16303000,52446000,77934000,0,19499000,5989000,,,,,1351000,77934000,58435000,0,-1845000,,16303000,16063000,55289,FBIZ
2017-12-31,,,14231000,,11905000,46558000,68318000,0,15476000,6284000,,,,,2326000,68318000,52842000,0,-4029000,,11905000,11743000,55289,FBIZ
2020-09-30,,,-4674000,92000,-4756000,5820000,5984000,-1983000,-1983000,,-3000,,,,3000,18347000,20330000,12363000,-2691000,,-4677000,-4756000,55292,BRN
2019-09-30,,,-12648000,100000,-12414000,5524000,1889000,-6657000,-6657000,,-5000,,,,-231000,12075000,18732000,10186000,-5991000,,-12417000,-12414000,55292,BRN
2018-09-30,,,-2019000,213000,-1770000,6262000,3085000,-4288000,-4288000,,-7000,,,,-601000,9368000,13656000,6283000,2269000,,-1418000,-1770000,55292,BRN
2017-09-30,,,1234000,931000,1171000,6976000,6771000,-1408000,-1408000,,-6000,,,,-1080000,13030000,14438000,6259000,2642000,,2314000,1171000,55292,BRN
2019-12-31,,,1175000000,-81000000,1175000000,113000000,2687000000,2047000000,2047000000,,-885000000,,,,0,6838000000,4791000000,4151000000,-872000000,,1175000000,1089000000,55293,CQP
2018-12-31,,,1274000000,-16000000,1274000000,84000000,2495000000,1987000000,1987000000,,-719000000,,,,0,6426000000,4439000000,3931000000,-713000000,,1274000000,1214000000,55293,CQP
2017-12-31,,,490000000,12000000,490000000,92000000,1589000000,1158000000,1158000000,,-610000000,,,,0,4304000000,3146000000,2715000000,-668000000,,490000000,479000000,55293,CQP
2016-12-31,,,-171000000,11000000,-171000000,103000000,509000000,250000000,250000000,,-351000000,,,,0,1100000000,850000000,591000000,-421000000,,-171000000,-168000000,55293,CQP
2020-12-31,,,-196320000,,-198983000,102716000,821919000,434102000,434102000,,-229054000,,,,2663000,1481564000,1047462000,659645000,-630422000,,-198983000,-198983000,55294,NS
2019-12-31,,,211588000,,-105693000,103459000,771695000,395312000,395312000,,-183070000,,,,4754000,1498021000,1102709000,726326000,-183724000,-312527000.0,206834000,-248130000,55294,NS
2018-12-31,,,156532000,,203328000,97089000,691687000,338706000,338706000,,-184398000,,,,10157000,1520262000,1181556000,828575000,-182174000,59419000.0,146375000,-276531000,55294,NS
2017-12-31,,,118668000,37826000.0,101058000,104553000,626258000,293513000,293513000,,-171774000,,,,7773000,1444772000,1151259000,818514000,-174845000,37069000.0,110895000,57645000,55294,NS
2020-08-31,,,437574,,437574,909680,5089634,4179954,4179954,,-850635,,,,0,5089634,909680,0,-3742380,,437574,437574,55296,BFY
2019-08-31,,,7675297,,7675297,921344,5178924,4257580,4257580,,-1225717,,,,0,5178924,921344,0,3417717,,7675297,7675297,55296,BFY
2018-08-31,,,-410910,,-410910,866433,5160671,4294238,4294238,,-1091255,,,,0,5160671,866433,0,-4705148,,-410910,-410910,55296,BFY
2017-08-31,,,-503802,,-503802,873935,5290131,4416196,4416196,,-843159,,,,0,5290131,873935,0,-4919998,,-503802,-503802,55296,BFY
2020-06-30,,,-10349017,,-10351415,4049714,0,-4049714,-4049714,,-3152335,,,,2398,0,4049714,0,-6299303,,-10351415,-10351415,55297,GMBL
2019-06-30,,,-6371650,,-6381365,3014473,0,-3014473,-3014473,,-5877337,,,,9715,0,3014473,0,-3357177,,-6381365,-6381365,55297,GMBL
2018-06-30,,,-2028662,,-2028662,2005715,0,-2005715,-2005715,,-121,,,,0,0,2005715,0,-22947,,-2028662,-2028662,55297,GMBL
2017-06-30,,,-837932,,-837932,754149,0,-754149,-754149,,-57696,,,,0,0,754149,0,-83783,,-837932,-837932,55297,GMBL
2020-03-31,,,122512000000,1875000000,97218000000,72730000000,174147000000,101417000000,101417000000,,-5136000000,,,,24799000000,610232000000,508815000000,436085000000,21095000000,,97713000000,97218000000,55298,WIT
2019-03-31,,,115415000000,2637000000,90031000000,74482000000,174292000000,99810000000,99810000000,,-5616000000,,,,25242000000,585845000000,486035000000,411553000000,15605000000,,90173000000,90031000000,55298,WIT
2018-03-31,,,102474000000,2410000000,80081000000,75847000000,159296000000,83449000000,83449000000,,-3451000000,,,,22390000000,544871000000,461422000000,385575000000,19025000000,,80084000000,80081000000,55298,WIT
2017-03-31,,,110356000000,2391000000,84895000000,69782000000,158858000000,89076000000,89076000000,,-2675000000,,,,25213000000,550402000000,461326000000,391544000000,21280000000,,85143000000,84895000000,55298,WIT
2020-12-31,,,81042000,,63309000,175537000,329920000,0,132373000,22010000,,,,,17733000,329920000,197547000,0,-51331000,,63309000,61212000,55302,OCFCP
2019-12-31,,,107358000,,88574000,142411000,296500000,0,133165000,20924000,,,,,18784000,296500000,163335000,0,-25807000,,88574000,88574000,55302,OCFCP
2018-12-31,,,85502000,,71932000,131033000,271839000,0,123088000,17718000,,,,,13570000,271839000,148751000,0,-37586000,,71932000,71932000,55302,OCFCP
2017-12-31,,,65325000,,42470000,93048000,191845000,0,84426000,14371000,,,,,22855000,191845000,107419000,0,-19101000,,42470000,42470000,55302,OCFCP
2019-12-31,,,4695592000,,3367517000,1918043000,7846017000,5707922000,5707922000,91953000,-658881000,,,,1328075000,17983654000,12275732000,10137637000,-1012330000,,3367517000,3367517000,55303,SBS
2018-12-31,,,3932098000,,2835068000,1631607000,6998638000,5170145000,5170145000,30159000,-503835000,,,,1097030000,16085094000,10914949000,9086456000,-1238047000,,2835068000,2835068000,55303,SBS
2017-12-31,,,3521515000,,2519310000,1692561000,5829270000,3955908000,3955908000,98120000,-459118000,,,,1002205000,14608233000,10652325000,8778963000,-434393000,,2519310000,2519310000,55303,SBS
2016-12-31,,,4147877000,,2947098000,1397361000,5085088000,3425798000,3425798000,84437000,-564135000,,,,1200779000,14098208000,10672410000,9013120000,722079000,,2947098000,2947098000,55303,SBS
2019-12-31,6079000,,-38403000,,-38403000,87235000,60511000,-32803000,-32803000,,-4949000,,,,0,67301000,100104000,6790000,-5600000,,-38403000,-38403000,55304,SIBN
2018-12-31,4176000,,-17453000,,-17453000,58336000,50547000,-11965000,-11965000,,-5108000,,,,0,55380000,67345000,4833000,-5488000,,-17453000,-17453000,55304,SIBN
2017-12-31,4513000,,-23039000,,-23039000,55708000,42871000,-17350000,-17350000,,-6204000,,,,0,47983000,65333000,5112000,-5689000,,-23039000,-23039000,55304,SIBN
2016-12-31,5380000,,-20589000,,-20589000,49121000,36936000,-17565000,-17565000,,-3308000,,,,0,42101000,59666000,5165000,-3024000,,-20589000,-20589000,55304,SIBN
2019-12-31,47826000,,-63140000,,-63140000,19653000,0,-67479000,-67479000,,-580000,,,,0,0,67479000,0,4339000,,-63140000,-63140000,55305,KURA
2018-12-31,46787000,,-60447000,,-60447000,16096000,0,-62883000,-62883000,,-970000,,,,0,0,62883000,0,2436000,,-60447000,-60447000,55305,KURA
2017-12-31,26426000,,-35434000,,-35434000,9651000,0,-36077000,-36077000,,-888000,,,,0,0,36077000,0,643000,,-35434000,-35434000,55305,KURA
2016-12-31,20404000,,-27560000,,-27560000,7963000,0,-28367000,-28367000,,-577000,,,,0,0,28367000,0,807000,,-27560000,-27560000,55305,KURA
2019-12-31,18192000,,-28618000,,-28618000,10636000,0,-28828000,-28828000,,,,,,0,0,28828000,0,210000,,-28618000,-31092000,55306,TNXP
2018-12-31,17558000,,-26089000,,-26089000,8764000,0,-26322000,-26322000,,,,,,0,0,26322000,0,233000,,-26089000,-29355000,55306,TNXP
2017-12-31,13342000,,-21123000,,-21123000,7949000,0,-21291000,-21291000,,,,,,0,0,21291000,0,368000,,-21123000,-21123000,55306,TNXP
2016-12-31,28533000,,-38842000,,-38842000,10436000,0,-38969000,-38969000,,,,,,0,0,38969000,0,127000,,-38842000,-38842000,55306,TNXP
2019-12-31,,,64504000,19372000,72968000,75880000,154042000,0,41586000,36576000,,,,,-10552000,223778000,182192000,69736000,22918000,,75056000,72315000,55308,RC
2018-12-31,,,62843000,19244000,59258000,79553000,174504000,0,63291000,31660000,,,,,1386000,212277000,148986000,37773000,-448000,,61457000,59041000,55308,RC
2017-12-31,,,47653000,19394000,43290000,77491000,155461000,0,47653000,30317000,,,,,1839000,207521000,159868000,52060000,23481000,,45814000,43228000,55308,RC
2016-12-31,,,65215000,39005000,49169000,50796000,122998000,0,49997000,22205000,,,,,9651000,128206000,78209000,5208000,39457000,-2158000.0,55564000,49169000,55308,RC
2020-12-31,356863000,,441371000,97552000,363228000,811956000,2087062000,725636000,725636000,,-131802000,,,,73999000,5084239000,4358603000,2997177000,-284265000,,367372000,363228000,55309,IFF
2019-12-31,346128000,,557452000,111287000,455873000,791175000,2120242000,789842000,789842000,,-138221000,,,,97184000,5140084000,4350242000,3019842000,-232390000,,460268000,452776000,55309,IFF
2018-12-31,311583000,,447757000,92229000,337302000,607518000,1700884000,705904000,705904000,,-132910000,,,,107976000,3977539000,3271635000,2276655000,-258147000,,339781000,333454000,55309,IFF
2017-12-31,295469000,,537045000,5092000,295665000,533702000,1501165000,637301000,637301000,,-65363000,,,,241380000,3398719000,2761418000,1897554000,-100256000,,295665000,294665000,55309,IFF
2019-12-31,,,-245006000,421636000,-216245000,2102968000,2285187000,182219000,182219000,,-339957000,,,,10172000,12926464000,12744245000,10641277000,-427225000,,-255178000,-216245000,55310,ARKO
2018-12-31,,,52175000,514888000,38772000,2102288000,2197597000,95309000,95309000,,-110464000,,,,-30382000,12983170000,12887861000,10785573000,-43134000,,82557000,38772000,55310,ARKO
2017-12-31,,,-5416000,465177000,-5595000,1659188000,1758142000,98954000,98954000,,-71300000,,,,-31295000,9613833000,9514879000,7855691000,-104370000,-40000.0,25879000,-5595000,55310,ARKO
2016-12-31,,,19708000,409401000,-20979000,1413484000,1511575000,98091000,98091000,,-51520000,,,,9667000,7466786000,7368695000,5955211000,-78383000,-59000.0,10041000,-20979000,55310,ARKO
2020-12-31,4087000000,,834000000,79000000,-2431000000,2898000000,8214000000,918000000,918000000,311000000,,,,,3255000000,21867000000,20949000000,13653000000,-84000000,-3000000,-2421000000,-2431000000,55313,NOK
2019-12-31,4411000000,,156000000,76000000,7000000,3042000000,8449000000,1057000000,1057000000,-61000000,-299000000.0,,,,138000000,23315000000,22258000000,14866000000,-901000000,-7000000,18000000,7000000,55313,NOK
2018-12-31,4592000000,,-360000000,82000000,-340000000,3239000000,8994000000,1224000000,1224000000,-61000000,-267000000.0,,,,189000000,22563000000,21339000000,13569000000,-1584000000,214000000,-549000000,-340000000,55313,NOK
2017-12-31,4859000000,,-510000000,80000000,-1494000000,3652000000,9592000000,1101000000,1101000000,-20000000,-252000000.0,,,,927000000,23147000000,22046000000,13555000000,-1611000000,-21000000,-1437000000,-1494000000,55313,NOK
2020-12-31,132963000,,51307000,,46314000,364041000,715972000,115966000,115966000,,-52446000,,,,4993000,1158484000,1042518000,442512000,-64659000,,46314000,46314000,55319,RP
2019-12-31,112222000,,60558000,,58208000,311864000,604024000,99174000,99174000,,-37129000,,,,2350000,988136000,888962000,384112000,-38616000,,58208000,58208000,55319,RP
2018-12-31,118525000,,34300000,,34725000,279678000,541098000,71187000,71187000,,-32402000,,,,-425000,869480000,798293000,328382000,-36887000,,34725000,34725000,55319,RP
2017-12-31,89452000,,15241000,,377000,247891000,412828000,35567000,35567000,,-15072000,,,,14864000,670963000,635396000,258135000,-20326000,,377000,377000,55319,RP
2020-12-31,,,-1838000000,29115000000,-1098000000,816000000,3280000000,2145000000,2145000000,,-2592000000,,,,220000000,5844000000,3699000000,2564000000,-3983000000,,-2058000000,-1098000000,55320,BPYPN
2019-12-31,,,3353000000,31241000000,884000000,953000000,7057000000,5763000000,5763000000,,-2924000000,,,,196000000,10172000000,4409000000,3115000000,-2410000000,,3157000000,949000000,55320,BPYPN
2018-12-31,,,3735000000,34387000000,764000000,746000000,5174000000,4120000000,4120000000,,-2464000000,,,,81000000,8186000000,4066000000,3012000000,-385000000,,3654000000,862000000,55320,BPYPN
2017-12-31,,,2660000000,27729000000,136000000,669000000,4455000000,3511000000,3511000000,,-1967000000,,,,192000000,7096000000,3585000000,2641000000,-851000000,,2468000000,158000000,55320,BPYPN
2019-12-31,23179000,,147335000,,75359000,1760718000,1927658000,143761000,143761000,,,,,,71976000,3031167000,2887406000,1103509000,3574000,,75359000,-45080000,55321,YSG
2018-12-31,2641000,,-36114000,,-40124000,433916000,403243000,-33314000,-33314000,,-214000.0,,,,4010000,635316000,668630000,232073000,-2800000,,-40124000,-47110000,55321,YSG
2019-12-31,38394000,,-53710000,,-53710000,10648000,121000,-48921000,-48921000,,-2157000,,,,0,121000,49042000,0,-4789000,,-53710000,-53710000,55322,SCYX
2018-12-31,21560000,,-19204000,,-12468000,8680000,257000,-29983000,-29983000,,-2054000,,,,-6736000,257000,30240000,0,10779000,,-12468000,-12468000,55322,SCYX
2017-12-31,18326000,,-25060000,,-25060000,8251000,257000,-26320000,-26320000,,-1855000,,,,0,257000,26577000,0,1260000,,-25060000,-25060000,55322,SCYX
2016-12-31,20076000,,-29989000,,-29989000,7798000,257000,-27617000,-27617000,,-451000,,,,0,257000,27874000,0,-2372000,,-29989000,-29989000,55322,SCYX
2020-03-31,,,-7234000,,-7234000,11753000,61924000,39911000,39911000,10260000,-13809000,,,,0,61924000,22013000,0,-47145000,,-7234000,-7234000,55328,GAINL
2019-03-31,,,81590000,,81590000,35618000,59663000,10545000,10545000,13500000,-18191000,,,,0,59663000,49118000,0,71045000,,81590000,81590000,55328,GAINL
2018-03-31,,,60687000,,60687000,21888000,58355000,36467000,36467000,13500000,-14507000,,,,0,58355000,21888000,0,24220000,,60687000,60687000,55328,GAINL
2017-03-31,,,44763000,,44763000,15355000,51875000,36520000,36520000,13500000,-14098000,,,,0,51875000,15355000,0,8243000,,44763000,44763000,55328,GAINL
2019-12-31,204942000,,339020000,5652000,292170000,602273000,1082404000,311069000,311069000,-35880000,,,,,45190000,4647513000,4336444000,3565109000,27951000,,293830000,292170000,55329,VIOT
2018-12-31,124230000,,89411000,2992000,65358000,424918000,717797000,170478000,170478000,-1829000,,,,,24061000,2561229000,2390751000,1843432000,-81067000,,65350000,50544000,55329,VIOT
2017-12-31,60749000,,107958000,2992000,93240000,111114000,275183000,105556000,105556000,-2236000,,,,,14718000,873219000,767663000,598036000,2402000,,93240000,8033000,55329,VIOT
2016-12-31,29926000,,14012000,2992000,16259000,35315000,80030000,14308000,14308000,481000,-296000.0,,,,-2247000,312574000,298266000,232544000,-296000,,16259000,-3453000,55329,VIOT
2020-09-30,,,-706318000,,-680808000,217326000,301050000,0,52092000,31632000,,,,,-25510000,301050000,248958000,0,-758410000,,-680808000,-680808000,55330,GWB
2019-09-30,,,215595000,,167365000,200238000,440493000,0,219962000,20293000,,,,,48230000,440493000,220531000,0,-4367000,,167365000,167365000,55330,GWB
2018-09-30,,,232035000,,157916000,207885000,463460000,0,236404000,19171000,,,,,74119000,463460000,227056000,0,-4369000,,157916000,157916000,55330,GWB
2017-09-30,,,214227000,,144786000,195261000,430870000,0,216686000,18923000,,,,,69441000,430870000,214184000,0,-2459000,,144786000,144786000,55330,GWB
2019-12-31,,,1898900000,40500000,1558900000,3873700000,6221400000,2347700000,2347700000,,-215100000,,,,322700000,14906300000,12558600000,8684900000,-448800000,,1576200000,1558900000,55331,ECL
2018-12-31,,,1804600000,50400000,1429100000,3890100000,6051600000,2161500000,2161500000,,-236900000,,,,364300000,14668200000,12506700000,8616600000,-356900000,,1440300000,1429100000,55331,ECL
2017-12-31,,,1762400000,70200000,1504600000,3758000000,5815700000,2057700000,2057700000,,-252700000,,,,243800000,13835900000,11778200000,8020200000,-295300000,,1518600000,1504600000,55331,ECL
2016-12-31,,,1649400000,69800000,1229000000,3664400000,5683900000,2019500000,2019500000,,-285400000,,,,402900000,13151800000,11132300000,7467900000,-370100000,,1246500000,1229000000,55331,ECL
2020-12-31,,,-92579000,,-80696000,86604000,19367000,-63907000,-63907000,-3330000,-10986000,,,,-11883000,492625000,556532000,473258000,-28672000,,-80696000,-80696000,55332,NR
2019-12-31,,,-3158000,,-12946000,113394000,142181000,28617000,28617000,170000,-14369000,,,,9788000,820119000,791502000,677938000,-31775000,,-12946000,-12946000,55332,NR
2018-12-31,,,47278000,,32281000,113327000,179573000,66158000,66158000,88000,-14864000,,,,14997000,946548000,880390000,766975000,-18880000,,32281000,32281000,55332,NR
2017-12-31,,,16112000,,-6148000,108838000,139864000,31436000,31436000,-410000,-13273000,,,,4893000,747763000,716327000,607899000,-15324000,-17367000.0,11219000,-6148000,55332,NR
2019-12-31,,,101600000,131500000,49600000,23800000,157800000,107100000,107100000,,-5900000,,,,0,522800000,415700000,365000000,-5500000,,101600000,49600000,55333,CINR
2018-12-31,,,103000000,110100000,49900000,24400000,131700000,78900000,78900000,,-5100000,,,,0,486700000,407800000,355000000,24100000,,103000000,49900000,55333,CINR
2017-12-31,,,86400000,103600000,41600000,22400000,140600000,91100000,91100000,,-4600000,,,,0,497300000,406200000,356700000,-4700000,,86400000,41600000,55333,CINR
2016-12-31,,,86300000,109800000,41400000,22800000,139600000,90700000,90700000,,-3600000,,,,0,475200000,384500000,335600000,-4400000,,86300000,41400000,55333,CINR
2020-06-30,,,-796746,,-796746,309004,0,-309004,-309004,,,,,,0,0,309004,0,-487742,,-796746,-796746,55334,ZGYH
2019-06-30,,,-10162,,-10162,10162,0,-10162,-10162,,,,,,0,0,10162,0,0,,-10162,-10162,55334,ZGYH
2019-05-24,,,-12000,,-12000,10162,0,0,-10162,,,,,,0,0,0,0,-12000,,-12000,-12000,55334,ZGYH
2020-12-31,,,167000000,,114300000,432400000,625400000,193000000,193000000,,-13300000,,,,52700000,1508600000,1315600000,883200000,-26000000,,114300000,114300000,55338,WTS
2019-12-31,39600000.0,,183900000,,131500000,435600000,677500000,202300000,202300000,,-14100000,,,,52400000,1600500000,1398200000,923000000,-18400000,,131500000,131500000,55338,WTS
2018-12-31,34500000.0,,174600000,,128000000,430200000,656500000,191800000,191800000,,-16300000,,,,46600000,1564900000,1373100000,908400000,-17200000,,128000000,128000000,55338,WTS
2017-12-31,29000000.0,,143100000,,73100000,403300000,602400000,170100000,170100000,,-19100000,,,,70000000,1456700000,1286600000,854300000,-27000000,,73100000,73100000,55338,WTS
2019-12-31,,,-108897000,,-108897000,37121000,-62334000,-99455000,-99455000,,-11892000,,,,0,48835000,148290000,111169000,-9442000,,-108897000,-108897000,55339,BCRX
2018-12-31,,,-101252000,,-101252000,29514000,-64706000,-94220000,-94220000,,-9176000,,,,0,20653000,114873000,85359000,-7032000,,-101252000,-101252000,55339,BCRX
2017-12-31,,,-65782000,,-65782000,13933000,-43478000,-57411000,-57411000,,-8565000,,,,0,25186000,82597000,68664000,-8372000,,-65782000,-65782000,55339,BCRX
2016-12-31,,,-55144000,,-55144000,11253000,-37354000,-48607000,-48607000,,-6487000,,,,0,26353000,74960000,63707000,-6537000,,-55144000,-55144000,55339,BCRX
2019-12-31,97900000,,414400000,2900000,325100000,410900000,910100000,401300000,401300000,,,,,,89900000,2846400000,2445100000,1936300000,13100000,1700000,324500000,325100000,55340,ITT
2018-12-31,98400000,,391000000,2500000,333700000,430700000,887200000,358100000,358100000,,-400000.0,,,,57700000,2745100000,2387000000,1857900000,32900000,1300000,333300000,333700000,55340,ITT
2017-12-31,93500000,,309400000,1700000,113500000,420300000,819900000,306100000,306100000,,-700000.0,,,,194600000,2585300000,2279200000,1765400000,3300000,-1500000,114800000,113500000,55340,ITT
2016-12-31,80500000,,258400000,2000000,186100000,404400000,760900000,276000000,276000000,,-500000.0,,,,76000000,2405400000,2129400000,1644500000,-17600000,4200000,182400000,186100000,55340,ITT
2020-10-31,,,-71469871,,-71469871,2672460,9828061,7155601,7155601,,-1982439,,,,0,9828061,2672460,0,-78625472,,-71469871,-71469871,55342,NRO
2019-10-31,,,61412985,,61412985,3499122,17641098,14141976,14141976,,-3571176,,,,0,17641098,3499122,0,47271009,,61412985,61412985,55342,NRO
2018-10-31,,,-9217825,,-9217825,3511732,14579106,11067374,11067374,,-3806838,,,,0,14579106,3511732,0,-20285199,,-9217825,-9217825,55342,NRO
2017-10-31,,,15574025,,15574025,4072523,21979758,17907235,17907235,,-4184715,,,,0,21979758,4072523,0,-2333210,,15574025,15574025,55342,NRO
2019-12-31,,,187067000,138128000,167884000,17092000,106891000,86447000,86447000,722000,-15127000,,,,0,128468000,42021000,21577000,100620000,,187067000,165378000,55343,BPMP
2018-12-31,,,165676000,140974000,133057000,18877000,97376000,75358000,75358000,483000,-4043000,,,,0,116439000,41081000,19063000,90318000,,165676000,133057000,55343,BPMP
2017-12-31,,,55192000,342330000,21775000,7730000,87251000,76455000,76455000,393000,-107000,,,,25318000,108151000,31696000,20900000,-21263000,,29874000,21775000,55343,BPMP
2016-12-31,,,75335000,342330000,45870000,8266000,86051000,74815000,74815000,366000,-107000,,,,29465000,103003000,28188000,16952000,520000,,45870000,45870000,55343,BPMP
2020-12-31,,,49527000,,41203000,49658000,113108000,0,52086000,11364000,,,,,8324000,113108000,61022000,0,-2559000,,41203000,41203000,55345,FLIC
2019-12-31,,,49783000,,41555000,47319000,110747000,0,52383000,11045000,,,,,8228000,110747000,58364000,0,-2600000,,41555000,41555000,55345,FLIC
2018-12-31,,,46635000,,41573000,49565000,105976000,0,46070000,10341000,,,,,5062000,105976000,59906000,0,565000,,41573000,41458000,55345,FLIC
2017-12-31,,,45011000,,35122000,44328000,99863000,0,45011000,10524000,,,,,9889000,99863000,54852000,0,0,,35122000,34994000,55345,FLIC
2019-12-31,,,-14773000,,-14773000,4173000,32970000,16246000,16246000,159000,-18497000,,,,0,66088000,49842000,33118000,-31019000,,-14773000,-30989000,55346,TOPS
2018-12-31,,,-11129000,,-11134000,16419000,19035000,-3889000,-3889000,115000,-8996000,,,,0,41048000,44937000,22013000,-7240000,,-11129000,-11134000,55346,TOPS
2017-12-31,,,-13372000,1185000.0,-13404000,12192000,18730000,1616000,1616000,-822000,-14556000,,,,0,39363000,37747000,20633000,-14988000,,-13372000,-13404000,55346,TOPS
2016-12-31,,,-351000,1185000.0,-351000,6307000,11528000,4848000,4848000,-3094000,-2888000,,,,0,28433000,23585000,16905000,-5199000,,-351000,-351000,55346,TOPS
2019-12-31,23559000,,-25779000,,-25779000,9128000,0,-32687000,-32687000,,-146000,,,,0,0,32687000,0,6908000,,-25779000,-25779000,55347,VKTX
2018-12-31,19040000,,-22063000,,-22063000,7121000,0,-26161000,-26161000,,-562000,,,,0,0,26161000,0,4098000,,-22063000,-22063000,55347,VKTX
2017-12-31,13741000,,-20578000,,-20578000,5329000,0,-19070000,-19070000,,-1951000,,,,0,0,19070000,0,-1508000,,-20578000,-20578000,55347,VKTX
2016-12-31,9000499,,-14731822,,-14731822,4846776,0,-13847275,-13847275,,-2032340,,,,0,0,13847275,0,-884547,,-14731822,-14731822,55347,VKTX
2020-03-31,,,-162583,,-162583,745023,3983395,3238372,3238372,,-772655,,,,0,3983395,745023,0,-3400955,,-162583,-162583,55348,VFL
2019-03-31,,,3192352,,3192352,672901,4173281,3500380,3500380,,-812588,,,,0,4173281,672901,0,-308028,,3192352,3192352,55348,VFL
2018-03-31,,,2848257,,2848257,650704,4179263,3528559,3528559,,-651448,,,,0,4179263,650704,0,-680302,,2848257,2848257,55348,VFL
2017-03-31,,,-136200,,-136200,634473,4160231,3525758,3525758,,-529895,,,,0,4160231,634473,0,-3661958,,-136200,-136200,55348,VFL
2020-12-31,,,-12628000,862557000,-24704000,64917000,428657000,128540000,128540000,,-144208000,,,,1493000,696244000,567704000,267587000,-141168000,-5075000,-14121000,-24770000,55349,PGRE
2019-12-31,,,4520000,845232000,-36899000,68556000,474885000,166225000,166225000,,-148464000,,,,312000,739587000,573362000,264702000,-161705000,-33811000,4208000,-36970000,55349,PGRE
2018-12-31,,,16554000,890864000,9147000,57563000,456733000,158302000,158302000,,-147653000,,,,3139000,711430000,553128000,254697000,-141748000,5578000,13415000,9068000,55349,PGRE
2017-12-31,,,112353000,845343000,86381000,61577000,467662000,140048000,140048000,,-141960000,,,,5177000,733798000,593750000,266136000,-27695000,5578000,107176000,86283000,55349,PGRE
2020-12-31,,,10378000,,8163000,32802000,52325000,0,15036000,4487000,,,,,2215000,52325000,37289000,0,-4658000,,8163000,8163000,55350,SLCT
2019-12-31,,,16731000,,13035000,29351000,51871000,0,18286000,4234000,,,,,3696000,51871000,33585000,0,-1555000,,13035000,13035000,55350,SLCT
2018-12-31,,,17692000,,13782000,26736000,52242000,0,21277000,4229000,,,,,3910000,52242000,30965000,0,-3585000,,13782000,13782000,55350,SLCT
2017-12-31,,,8897000,,3185000,20182000,36216000,0,12391000,3643000,,,,,5712000,36216000,23825000,0,-3494000,,3185000,3185000,55350,SLCT
2019-12-31,,,-92000000,,-77000000,104000000,476000000,-39000000,-39000000,340000000,-27000000,,,,-15000000,476000000,515000000,0,-53000000,,-77000000,-77000000,55351,BATRK
2018-12-31,,,-4000000,-8000000.0,5000000,100000000,442000000,1000000,1000000,265000000,-26000000,,,,-15000000,442000000,441000000,0,-5000000,,11000000,5000000,55351,BATRK
2017-12-31,,,-62000000,14000000.0,-25000000,136000000,386000000,-113000000,-113000000,296000000,-15000000,,,,-36000000,386000000,499000000,0,51000000,,-26000000,-25000000,55351,BATRK
2016-12-31,,,-79000000,15000000.0,-62000000,67000000,262000000,-61000000,-61000000,224000000,-1000000,,,,-17000000,262000000,323000000,0,-18000000,,-62000000,-62000000,55351,BATRK
2020-09-30,,,-14769753,,-15969753,25942712,100224807,74282095,74282095,,-32167755,,,,1200000,100224807,25942712,0,-89051848,,-15969753,-15969753,55352,PNNT
2019-09-30,,,17124806,,15924806,30286166,112106654,81820488,81820488,,-28943312,,,,1200000,112106654,30286166,0,-64695682,,15924806,15924806,55352,PNNT
2018-09-30,,,47713462,,47713462,32125404,108278048,76152644,76152644,,-22818492,,,,0,108278048,32125404,0,-28439182,,47713462,47713462,55352,PNNT
2017-09-30,,,63411501,,61711501,35887267,124534324,88647057,88647057,,-26642113,,,,1700000,124534324,35887267,0,-25235556,,61711501,61711501,55352,PNNT
2019-12-31,,,11784000,16757000,16177000,,9657000,3802000,3802000,,-1054000,,,,2962000,21802000,18000000,12145000,7982000,6856000,8822000,16177000,55353,FRPH
2018-12-31,,,1483000,18648000,124472000,,9307000,1874000,1874000,-465000.0,-3103000,,,,524000,21934000,20060000,12627000,-391000,122129000,959000,124472000,55353,FRPH
2017-12-31,,,56898000,21052000,41750000,,5568000,-366000,-366000,-465000.0,-2741000,,,,7350000,14004000,14370000,8436000,57264000,11003000,49548000,41750000,55353,FRPH
2016-12-31,,,10102000,21052000,6233000,,21994000,11744000,11744000,2000000.0,-1386000,,,,3869000,36103000,24359000,14109000,-1642000,11003000,6233000,6233000,55353,FRPH
2020-12-31,,,533566000,,423475000,446921000,976002000,529081000,529081000,,-2177000,,,,110091000,4501217000,3972136000,3525215000,4485000,,423475000,423475000,55355,MTH
2019-12-31,,,302945000,,249663000,392821000,707494000,314673000,314673000,,-8370000,,,,53282000,3666944000,3352271000,2959450000,-11728000,,249663000,249663000,55355,MTH
2018-12-31,,,283254000,,227332000,380375000,659897000,279522000,279522000,,-785000,,,,55922000,3528581000,3249059000,2868684000,3732000,,227332000,227332000,55355,MTH
2017-12-31,,,247519000,,143255000,345688000,595254000,249566000,249566000,,-3853000,,,,104264000,3240975000,2991409000,2645721000,-2047000,,143255000,143255000,55355,MTH
2020-09-30,1641000,,337000,,326000,5069000,6400000,-1278000,-1278000,,-7000,,,,11000,10907000,12185000,4507000,1615000,,326000,-2094000,55357,BLIN
2019-09-30,2185000,,-9470000,,-9474000,8070000,4592000,-6283000,-6283000,,-534000,,,,4000,9952000,16235000,5360000,-3187000,,-9474000,-9789000,55357,BLIN
2018-09-30,1604000,,-7222000,,-7219000,6803000,6820000,-1943000,-1943000,,-373000,,,,-3000,13568000,15511000,6748000,-5279000,,-7219000,-7529000,55357,BLIN
2017-09-30,1587000,,-1586000,,-1602000,8063000,9133000,-1099000,-1099000,,-128000,,,,16000,16293000,17392000,7160000,-487000,,-1602000,-1883000,55357,BLIN
2019-12-31,327260,,-9295621,4346216,-6356967,4975328,5977500,674912,674912,,-443262,,,,363662,49230570,48555658,43253070,-9970533,-299412,-9659283,-6356967,55359,TANH
2018-12-31,386628,,2027789,7918096,1976767,5292283,8029080,2350169,2350169,,-626343,,,,1031158,29561399,27211230,21532319,-322380,83367,996631,1976767,55359,TANH
2017-12-31,627577,,4475584,8799460,3767215,5356397,10555859,4571885,4571885,,-551044,,,,1528003,42297612,37725727,31741753,-96301,65550,2947581,3767215,55359,TANH
2016-12-31,136626,,8332830,8799460,4299251,4235107,13023026,8651293,8651293,,-470656,,,,1367270,39902342,31251049,26879316,-318463,-2357867,6965560,4299251,55359,TANH
2020-03-28,29997000,,87152000,,76526000,283997000,487822000,173828000,173828000,,-13500000,,,,10626000,988479000,814651000,500657000,-86676000,,76526000,76526000,55362,HAE
2019-03-30,34973000,,73633000,,55019000,286700000,440011000,118338000,118338000,,-12600000,,,,18614000,967579000,849241000,527568000,-44705000,,55019000,55019000,55362,HAE
2018-03-31,34553000,,59632000,,45572000,277790000,412625000,100282000,100282000,,-7700000,,,,14060000,903923000,803641000,491298000,-40650000,,45572000,45572000,55362,HAE
2017-04-01,37556000,,-27476000,,-26268000,301726000,378494000,39212000,39212000,,-7900000,,,,-1208000,886116000,846904000,507622000,-66688000,,-26268000,-26268000,55362,HAE
2019-12-31,,,68752181,,68752181,3558546,12635777,9077231,9077231,,-5640072,,,,0,12635777,3558546,0,59674950,,68752181,68752181,55363,JTD
2018-12-31,,,-31022655,,-31022655,3761818,13100227,9338409,9338409,,-2475173,,,,0,13100227,3761818,0,-40361064,,-31022655,-31022655,55363,JTD
2017-12-31,,,55186853,,55186853,3625267,12750157,9124890,9124890,,-1204109,,,,0,12750157,3625267,0,46061963,,55186853,55186853,55363,JTD
2016-12-31,,,15552941,,15552941,3452419,12524704,9072285,9072285,,-1406052,,,,0,12524704,3452419,0,6480656,,15552941,15552941,55363,JTD
2019-12-31,,,-56793000,,-56793000,47711000,2310000,-47861000,-47861000,,-6176000,,,,0,20365000,68226000,18055000,-8932000,,-56793000,-56793000,55364,EYPT
2018-12-31,,,-86126000,,-86126000,25088000,-13931000,-39019000,-39019000,,-2362000,,,,0,4571000,43590000,18502000,-47107000,,-86126000,-86126000,55364,EYPT
2018-06-30,,,-53171000,,-53171000,13057000,-13217000,-26274000,-26274000,,-720000,,,,0,2961000,29235000,16178000,-26897000,,-53171000,-53171000,55364,EYPT
2017-06-30,,,-18485000,,-18485000,11235000,-7341000,-18576000,-18576000,,-720000,,,,0,7539000,26115000,14880000,91000,,-18485000,-18485000,55364,EYPT
2020-04-30,,,-23713000,,-23713000,3562943,27755506,24192563,24192563,,-1040362,,,,0,27755506,3562943,0,-47905563,,-23713000,-23713000,55365,MUA
2019-04-30,,,28539524,,28539524,3506876,29090397,25583521,25583521,,-1580939,,,,0,29090397,3506876,0,2956003,,28539524,28539524,55365,MUA
2018-04-30,,,22330501,,22330501,3539699,29309381,25769682,25769682,,-1184596,,,,0,29309381,3539699,0,-3439181,,22330501,22330501,55365,MUA
2017-04-30,,,11362405,,11362405,3542402,29751988,26209586,26209586,,-911519,,,,0,29751988,3542402,0,-14847181,,11362405,11362405,55365,MUA
2020-06-30,,,-31612000,,-24047000,41538000,76750000,31264000,31264000,,-5045000,,,,-7565000,363073000,331809000,286323000,-62876000,,-24047000,-24047000,55367,MCFT
2019-06-30,,,26746000,,21354000,45376000,113509000,64641000,64641000,,-6513000,,,,5392000,466381000,401740000,352872000,-37895000,,21354000,21354000,55367,MCFT
2018-06-30,,,52509000,,39653000,32784000,90865000,56484000,56484000,,-3474000,,,,12856000,332725000,276241000,241860000,-3975000,,39653000,39653000,55367,MCFT
2017-06-30,,,31293000,,19570000,29854000,63476000,33515000,33515000,,-2222000,,,,11723000,228634000,195119000,165158000,-2222000,,19570000,19570000,55367,MCFT
2019-12-31,,,70921000,,49339000,59110000,153757000,94647000,94647000,,-29424000,,,,15253000,711518000,616871000,557761000,-23726000,-6329000,55668000,49339000,55369,GLDD
2018-12-31,,,16453000,,-6293000,54923000,120511000,65588000,65588000,,-33578000,,,,5437000,620795000,555207000,500284000,-49135000,-17309000,11016000,-6293000,55369,GLDD
2017-12-31,,,-49129000,,-31260000,56046000,65691000,9645000,9645000,,-28362000,,,,-33761000,592159000,582514000,526468000,-58774000,-15892000,-15368000,-31260000,55369,GLDD
2016-12-31,,,365000,,-8177000,55271000,85338000,30067000,30067000,,-23471000,,,,-177000,637468000,607401000,552130000,-29702000,-8719000,542000,-8177000,55369,GLDD
2020-12-31,40473000,,1603000,,9517000,367843000,474786000,66470000,66470000,,-44052000,,,,-7914000,862459000,795989000,387673000,-64867000,,9517000,9517000,55370,CNMD
2019-12-31,45460000,,31225000,,28620000,388361000,528908000,95087000,95087000,,-42701000,,,,2605000,955097000,860010000,426189000,-63862000,,28620000,28620000,55370,CNMD
2018-12-31,37976000,,50653000,,40854000,353245000,469110000,77889000,77889000,,-20652000,,,,9799000,859634000,781745000,390524000,-27236000,,40854000,40854000,55370,CNMD
2017-12-31,32307000,,28732000,,55487000,330636000,433944000,71001000,71001000,,-18203000,,,,-26755000,796392000,725391000,362448000,-42269000,,55487000,55487000,55370,CNMD
2020-06-30,,,-16224000,,-16224000,209468000,623530000,414062000,414062000,,-136123000,,,,0,623530000,209468000,0,-430286000,,-16224000,-16224000,55373,PSEC
2019-06-30,,,144487000,,144487000,233677000,703767000,470090000,470090000,,-147304000,,,,0,703767000,233677000,0,-325603000,,144487000,144487000,55373,PSEC
2018-06-30,,,299863000,,299863000,217386000,657845000,440459000,440459000,,-155039000,,,,0,657845000,217386000,0,-140596000,,299863000,299863000,55373,PSEC
2017-06-30,,,251806000,,252906000,231216000,701046000,469830000,469830000,,-156101000,,,,-1100000,701046000,231216000,0,-218024000,,252906000,252906000,55373,PSEC
2019-12-31,57848000,,183735000,6773000,136440000,318105000,636612000,260659000,260659000,,-13589000,,,,46086000,1401981000,1141322000,765369000,-76924000,,137649000,136215000,55377,MSA
2018-12-31,52696000,,162335000,5637000,124150000,319722000,611863000,239445000,239445000,,-18881000,,,,37220000,1358104000,1118659000,746241000,-77110000,,125115000,123991000,55377,MSA
2017-12-31,50061000,,29775000,4977000,26027000,292069000,538891000,196761000,196761000,,-15360000,,,,2819000,1196809000,1000048000,657918000,-166986000,,26956000,25923000,55377,MSA
2016-12-31,46847000,,151911000,3047000,91936000,302217000,522247000,173183000,173183000,,-16411000,,,,57804000,1149530000,976347000,627283000,-21272000,-245000.0,94107000,91751000,55377,MSA
2019-12-31,,,18475000,-632023000,18075000,17919000,54124000,36205000,36205000,,-15975000,,,,63000,371070000,334865000,316946000,-17462000,,18412000,-7040000,55378,BKEP
2018-12-31,,,-41849000,-631791000,-41535000,15995000,41700000,25705000,25705000,,-16860000,,,,198000,384835000,359130000,343135000,-67554000,,-42047000,-66650000,55378,BKEP
2017-12-31,,,20211000,-703597000,19101000,17112000,49327000,32215000,32215000,,-14027000,,,,166000,181939000,149724000,132612000,-12004000,,20045000,-5885000,55378,BKEP
2016-12-31,,,-4580000,-699527000,-5273000,18229000,52173000,33944000,33944000,,-12554000,,,,260000,177394000,143450000,125221000,-38524000,,-4840000,-30398000,55378,BKEP
2019-12-31,,,172477000,-704000,173736000,36366000,211992000,0,175626000,,,,,,-419000,225461000,49835000,13469000,-3149000,,172896000,144835000,55379,NYMTM
2018-12-31,,,103738000,904000,102886000,28234000,132408000,0,104174000,44050000.0,,,,,-1057000,145644000,41470000,13236000,-436000,,104795000,79186000,55379,NYMTM
2017-12-31,,,91922000,4136000,91980000,22874000,114796000,0,91922000,44050000.0,,,,,3355000,132999000,41077000,18203000,0,,88567000,76320000,55379,NYMTM
2016-12-31,,,70655000,3087000,67551000,24507000,95097000,0,70590000,44050000.0,,,,,3095000,105811000,35221000,10714000,65000,,67560000,54651000,55379,NYMTM
2019-12-28,,,2617000,1888000,-758000,104784000,116151000,396000,396000,,-35583000,,,,3221000,1190022000,1189626000,1073871000,2221000,,-604000,-8780000,55380,STKL
2018-12-29,,,-114521000,1504000,-109205000,107235000,130684000,12411000,12411000,,-34691000,,,,-5378000,1260852000,1248441000,1130168000,-126932000,,-109143000,-117114000,55380,STKL
2017-12-30,,,-170397000,1575000,-135320000,104613000,145676000,29868000,29868000,,-32596000,,,,-35829000,1279593000,1249725000,1133917000,-200265000,,-134568000,-143129000,55380,STKL
2016-12-31,,,-74361000,2731000,-51188000,92740000,139195000,35173000,35173000,,-32991000,,,,-23797000,1346731000,1311558000,1207536000,-109534000,-570000.0,-50564000,-53000000,55380,STKL
2020-04-24,847000000,,944000000,,819000000,1845000000,3623000000,931000000,931000000,,-55000000,,,,125000000,5412000000,4481000000,1789000000,13000000,,819000000,819000000,55388,NTAP
2019-04-26,827000000,,1268000000,,1169000000,1935000000,3945000000,1183000000,1183000000,,-58000000,,,,99000000,6146000000,4963000000,2201000000,85000000,,1169000000,1169000000,55388,NTAP
2018-04-27,783000000,,1199000000,,116000000,1986000000,3709000000,940000000,940000000,,-62000000,,,,1083000000,5919000000,4979000000,2210000000,259000000,,116000000,116000000,55388,NTAP
2017-04-28,779000000,,621000000,,481000000,1922000000,3364000000,663000000,663000000,,-52000000,,,,140000000,5491000000,4828000000,2127000000,-42000000,,481000000,481000000,55388,NTAP
2020-07-31,40662000,,140690000,,112369000,336059000,528565000,151844000,151844000,,-2166000,,,,28321000,1081299000,929455000,552734000,-11154000,,112369000,111531000,55389,BRC
2019-07-31,45168000,,164644000,,131258000,371082000,578678000,162428000,162428000,,-2830000,,,,33386000,1160645000,998217000,581967000,2216000,,131258000,130430000,55389,BRC
2018-07-31,45253000,,152015000,,91060000,390342000,588291000,152696000,152696000,,-3168000,,,,60955000,1173851000,1021155000,585560000,-681000,,91060000,90247000,55389,BRC
2017-07-31,39624000,,126632000,,95645000,387653000,558292000,131015000,131015000,,-5504000,,,,30987000,1113316000,982301000,555024000,-4383000,,95645000,94843000,55389,BRC
2020-02-01,,,407704000,,297462000,2120177000,2567658000,442213000,442213000,,-17012000,,,,110242000,8750743000,8308530000,6183085000,-34509000,,297462000,297462000,55393,DKS
2019-02-02,,,431920000,,319864000,1986576000,2437782000,444733000,444733000,,-10248000,,,,112056000,8436570000,7991837000,5998788000,-12813000,,319864000,319864000,55393,DKS
2018-02-03,,,501337000,,323445000,1968663000,2489060000,491274000,491274000,,-8047000,,,,177892000,8590472000,8099198000,6101412000,10063000,,323445000,323445000,55393,DKS
2017-01-28,,,458422000,,287396000,1826543000,2412183000,545354000,545354000,,-5856000,,,,171026000,7921981000,7376627000,5509798000,-86932000,,287396000,287396000,55393,DKS
2019-12-31,,,989253972,,938272885,94607497,1061771201,0,967163704,2116000,,,,,158349518,1176468056,209304352,114696855,22090268,,830904454,938272885,55394,HKIB
2018-12-31,,,608965226,542600297.0,468061079,77489607,671062058,0,593572451,2116000,,,,,83839597,714179071,120606620,43117013,15392775,,525125629,468061079,55394,HKIB
2017-12-31,,,808585471,485535747.0,568266428,120566239,911237544,0,790671305,2116000,,,,,135213625,1004438995,213767690,93201451,17914166,,673371846,568266428,55394,HKIB
2020-12-31,13609000,,18565000,,17140000,14657000,47552000,19237000,19237000,49000,-266000,,,,1425000,133246000,114009000,85694000,-672000,,17140000,17140000,55395,KMDA
2019-12-31,10913000,,22981000,,22251000,15710000,49737000,22784000,22784000,330000,-293000,,,,730000,127187000,104403000,77450000,197000,,22251000,22251000,55395,KMDA
2018-12-31,7757000,,20341000,,22296000,14145000,41472000,19259000,19259000,311000,-293000,,,,-1955000,114469000,95210000,72997000,1082000,,22296000,22296000,55395,KMDA
2017-12-31,9648000,,7170000,,6901000,14996000,32088000,7444000,7444000,311000,-293000,,,,269000,102825000,95381000,70737000,-274000,,6901000,6901000,55395,KMDA
2020-12-31,,,12423000,,8335000,30086000,49269000,0,13377000,5806000,,,,,4088000,49269000,35892000,0,-954000,,8335000,8335000,55397,PMBC
2019-12-31,,,7815000,,5680000,35062000,45994000,0,8311000,2621000,,,,,2135000,45994000,37683000,0,-496000,,5680000,5514000,55397,PMBC
2018-12-31,,,16587000,,27339000,33282000,53557000,0,17637000,2638000,,,,,-10752000,53557000,35920000,0,-1050000,,27339000,26691000,55397,PMBC
2017-12-31,,,10358000,,10449000,33913000,48116000,0,11431000,2772000,,,,,-91000,48116000,36685000,0,-1073000,,10449000,10400000,55397,PMBC
2020-12-31,4400000,,-6100000,,-12500000,150200000,165800000,11200000,11200000,,-60800000,,,,8200000,566300000,555100000,400500000,-17300000,1800000,-14300000,-12500000,55398,BW
2019-12-31,2861000,,-124447000,1417000.0,-121974000,156212000,160258000,1185000,1185000,,-94901000,,,,5286000,859111000,857926000,698853000,-125632000,694000,-129733000,-121974000,55398,BW
2018-12-31,3780000,,-555801000,8829000.0,-725292000,265454000,-129644000,-398878000,-398878000,,-49613000,,,,102224000,1062388000,1461266000,1192032000,-156923000,-66832000,-658025000,-725292000,55398,BW
2017-12-31,7614000,,-317550000,8600000.0,-379824000,188157000,24218000,-171553000,-171553000,,-25933000,,,,63709000,1341429000,1512982000,1317211000,-145997000,2244000,-381259000,-379824000,55398,BW
2020-12-31,,,24276000,,13817000,8335000,73446000,23110000,23110000,,-2107000,,,,10459000,93025000,69915000,19579000,1166000,,13817000,13817000,55400,SAND
2019-12-31,,,23008000,,16397000,8274000,65238000,16459000,16459000,,-3503000,,,,6611000,89434000,72975000,24196000,6549000,,16397000,16397000,55400,SAND
2018-12-31,,,8704000,,5872000,6897000,52791000,12391000,12391000,,-1661000,,,,2832000,73150000,60759000,20359000,-3687000,,5872000,5872000,55400,SAND
2017-12-31,,,14614000,,10537000,6850000,48504000,2970000,2970000,,-2187000,,,,4077000,68275000,65305000,19771000,11644000,,10537000,10537000,55400,SAND
2019-12-31,,,-9126000,,-7830000,5024000,-4658000,-9682000,-9682000,,,,,,-1296000,0,9682000,4658000,556000,,-7830000,-8031000,55402,CYCC
2018-12-31,,,-8625000,,-7288000,5371000,-4177000,-9548000,-9548000,,,,,,-1337000,150000,9698000,4327000,923000,,-7288000,-7489000,55402,CYCC
2017-12-31,,,-8463000,,-7470000,5254000,-4237000,-9491000,-9491000,,,,,,-993000,0,9491000,4237000,1028000,,-7470000,-14846000,55402,CYCC
2016-12-31,,,-13774000,,-11791000,5516000,-8634000,-14150000,-14150000,,,,,,-1983000,843000,14993000,9477000,376000,,-11791000,-11991000,55402,CYCC
2020-12-31,,,1212000000,3000000,933000000,1356000000,2903000000,1345000000,1345000000,,-101000000,,,,279000000,5627000000,4282000000,2724000000,-133000000,,933000000,933000000,55404,NDAQ
2019-12-31,,,1019000000,3000000,774000000,1208000000,2535000000,1137000000,1137000000,,-124000000,,,,245000000,4262000000,3125000000,1727000000,-118000000,,774000000,774000000,55404,NDAQ
2018-12-31,,,1064000000,3000000,458000000,1235000000,2526000000,1081000000,1081000000,,-150000000,,,,606000000,4277000000,3196000000,1751000000,-17000000,,458000000,458000000,55404,NDAQ
2017-12-31,,,872000000,3000000,729000000,1155000000,2411000000,1068000000,1068000000,,-143000000,,,,143000000,3948000000,2880000000,1537000000,-196000000,,729000000,729000000,55404,NDAQ
2019-12-31,,,3181201,,2512971,,0,-564339,-564339,564339,,,,,668230,0,564339,0,3745540,,2512971,-217549,55405,GXGX
2018-12-31,,,-3294,,-3294,,0,-3294,-3294,3294,,,,,0,0,3294,0,0,,-3294,-3294,55405,GXGX
2019-12-31,740475,,696418,,564349,9771744,14853810,4001362,4001362,,,,,,132069,23162621,19161259,8308811,-3304944,,564349,564349,55408,KRMD
2018-12-31,241124,,1176950,,910570,8196562,10810488,2063539,2063539,,,,,,266380,17353737,15290198,6543249,-886589,,910570,910570,55408,KRMD
2017-12-31,60704,,1569024,,1085948,7913484,9766738,1483841,1483841,,,,,,483076,15976673,14492832,6209935,85183,,1085948,1085948,55408,KRMD
2017-02-28,237486,,-776699,,-534999,7767712,7569558,-736251,-736251,,-1886.0,,,,-241700,12293655,13029906,4724097,-40448,,-534999,-534999,55408,KRMD
2020-07-31,,,22773119,,22773119,5535919,28289758,22753839,22753839,,-4012359,,,,0,28289758,5535919,0,19280,,22773119,22773119,55411,MIY
2019-07-31,,,37787099,,37787099,4873803,29280621,24406818,24406818,,-6076291,,,,0,29280621,4873803,0,13380281,,37787099,37787099,55411,MIY
2018-07-31,,,8086821,,8086821,4039050,30025954,25986904,25986904,,-5725433,,,,0,30025954,4039050,0,-17900083,,8086821,8086821,55411,MIY
2017-07-31,,,-3324075,,-3324075,4066869,30650976,26584107,26584107,,-4537774,,,,0,30650976,4066869,0,-29908182,,-3324075,-3324075,55411,MIY
2019-12-31,2023000,,-7761000,,-7761000,6845000,5400000,-4789000,-4789000,,-187000,,,,0,12827000,17616000,7427000,-2972000,,-7761000,-7788000,55413,OBLG
2018-12-31,7754891,,-17843658,,-17853707,21073911,12749640,-17409172,-17409172,,-129165,,,,10049,17249458,34658630,4499818,-434486,,-17853707,-17853707,55413,OBLG
2017-12-31,8334074,,-20584545,,-20686259,24985331,14978625,-19951265,-19951265,,-207041,,,,101714,22283271,42234536,7304646,-633280,,-20686259,-20686259,55413,OBLG
2016-12-31,8248064,,-14949501,,-14949501,21097446,16606234,-13964222,-13964222,,-382001,,,,0,25082930,39047152,8476696,-985279,,-14949501,-14949501,55413,OBLG
2019-12-31,,,94457000,94432000,63115000,139917000,301397000,133931000,133931000,4172000,-39370000,,,,16892000,907675000,773744000,606278000,-39474000,,77565000,63115000,55414,TWNK
2018-12-31,,,94380000,350454000,62895000,117900000,277414000,132826000,132826000,2631000,-39404000,,,,12954000,850389000,717563000,572975000,-38446000,,81426000,62895000,55414,TWNK
2017-12-31,,,190904000,342240000,223897000,118033000,326898000,183770000,183770000,1240000,-39174000,,,,-67204000,776188000,592418000,449290000,7134000,,258108000,223897000,55414,TWNK
2016-12-31,,,44617000,334192000,52807000,109147000,314157000,183958000,183958000,15945000,-67033000,,,,-7323000,727586000,543628000,413429000,-139341000,,51940000,-4404000,55414,TWNK
2020-12-31,,,231000,,-7812000,77566000,129887000,17195000,17195000,,-5588000,,,,8043000,432079000,414884000,302192000,-16964000,,-7812000,-7812000,55415,AMK
2019-12-31,,,14905000,,-420000,72112000,138181000,35713000,35713000,,-12269000,,,,15325000,417936000,382223000,279755000,-20808000,,-420000,-420000,55415,AMK
2018-12-31,,,54563000,,37426000,55522000,139158000,57532000,57532000,,-1920000,,,,17137000,363634000,306102000,224476000,-2969000,,37426000,37426000,55415,AMK
2017-12-31,,,19343000,,98978000,48403000,95411000,24027000,24027000,,-1920000,,,,-79635000,295517000,271490000,200106000,-4684000,,98978000,98978000,55415,AMK
2019-12-31,,,-207184000,1850000,-119842000,597832000,788316000,78602000,78602000,,-63660000,,,,-85994000,1867909000,1789307000,1079593000,-285786000,,-121190000,-119842000,55417,GCI
2018-12-30,,,20019000,1547000,18196000,501196000,660790000,74803000,74803000,,-36072000,,,,1912000,1526024000,1451221000,865234000,-54784000,,18107000,18196000,55417,GCI
2017-12-31,,,-434000,1547000,-915000,446354000,599182000,78434000,78434000,,-30476000,,,,481000,1342004000,1263570000,742822000,-78868000,,-915000,-915000,55417,GCI
2016-12-25,,,29322000,1547000,31641000,415067000,556044000,73203000,73203000,,-29635000,,,,-2319000,1255356000,1182153000,699312000,-43881000,,31641000,31641000,55417,GCI
2019-12-31,,,-103916000,,-103916000,22211000,-87732000,-109943000,-109943000,,,,,,0,1666000,111609000,89398000,6027000,,-103916000,-103916000,55420,FIXX
2018-12-31,,,-55577000,,-55577000,17300000,-42626000,-59926000,-59926000,,,,,,0,5322000,65248000,47948000,4349000,,-55577000,-55577000,55420,FIXX
2017-12-31,21378154.0,,-29991000,,-29991000,8279000,-21378000,-29657000,-29657000,,,,,,0,0,29657000,21378000,-334000,,-29991000,-29991000,55420,FIXX
2016-12-31,5694997.0,,-8046817,,-8046817,4305021,0,-10000018,-10000018,,,,,,0,0,10000018,0,1953201,,-8046817,-8046817,55420,FIXX
2020-12-31,,,106700000,,407300000,433300000,760800000,327500000,327500000,,-32800000,,,,-300600000,1045900000,718400000,285100000,-220800000,,407300000,407300000,55421,NBIX
2019-12-31,,,46500000,,37000000,354100000,580700000,226600000,226600000,,-32000000,,,,9500000,788100000,561500000,207400000,-180100000,,37000000,37000000,55421,NBIX
2018-12-31,99924000.0,,21800000,,21100000,248900000,290500000,41600000,41600000,,-30500000,,,,700000,451200000,409600000,160700000,-19800000,,21100000,21100000,55421,NBIX
2017-12-31,93627000.0,,-142542000,,-142542000,169906000,68545000,-101361000,-101361000,,-19523000,,,,0,161626000,262987000,93081000,-41181000,,-142542000,-142542000,55421,NBIX
2017-12-31,,,-3235000,,-3235000,6097000,19417000,2802000,2802000,,-17338000,,,,0,74834000,72032000,55417000,-6037000,,-3235000,-3235000,55424,SHIPW
2016-12-31,,,-24589000,,-24623000,5029000,-1153000,-14713000,-14713000,,-9824000,,,,34000,34662000,49375000,35815000,-9876000,,-24623000,-24623000,55424,SHIPW
2015-12-31,,,-8956000,,-8956000,3210000,-1950000,-7055000,-7055000,,-2024000,,,,0,11223000,18278000,13173000,-1901000,,-8956000,-8956000,55424,SHIPW
2014-12-31,,,80348000,,80348000,3418000,-294000,-3753000,-3753000,,-1453000,,,,0,2010000,5763000,2304000,84101000,,80348000,80348000,55424,SHIPW
2019-12-31,,,105146000,140994000,60249000,288209000,392936000,104727000,104727000,,-2146000,,,,29076000,713514000,608787000,320578000,419000,,76070000,60249000,55426,IPAR
2018-12-31,,,95859000,138139000,53793000,283931000,378662000,94731000,94731000,,-2578000,,,,26144000,675574000,580843000,296912000,1128000,,69715000,53793000,55426,IPAR
2017-12-31,,,78065000,137339000,41594000,255940000,336686000,80746000,80746000,,-1992000,,,,22812000,591251000,510505000,254565000,-2681000,,55253000,41594000,55426,IPAR
2016-12-31,,,67074000,113267000,33331000,220987000,288671000,67684000,67684000,,-2340000,,,,23826000,521072000,453388000,232401000,-610000,,43248000,33331000,55426,IPAR
2019-12-31,,,982100000,371400000,624100000,1120500000,2409000000,1288500000,1288500000,,-351700000,,,,275000000,13234100000,11945600000,10825100000,-306400000,-3800000,707100000,624100000,55428,WPP
2018-12-31,,,1463300000,424400000,1062900000,1515900000,2938900000,1423000000,1423000000,,-280900000,,,,323900000,15602400000,14179400000,12663500000,40300000,126400000,1139400000,1062900000,55428,WPP
2017-12-31,,,2109300000,468800000,1816600000,1277200000,3175200000,1898000000,1898000000,,-259600000,,,,197000000,15804200000,13906200000,12629000000,211300000,237100000,1912300000,1816600000,55428,WPP
2016-12-31,,,1890500000,443100000,1400100000,987100000,3040800000,2053700000,2053700000,,-245100000,,,,388900000,14887300000,12833600000,11846500000,-163200000,237100000,1501600000,1400100000,55428,WPP
2020-12-31,,,93489000,,82153000,104906000,216796000,0,98230000,13660000,,,,,11336000,216796000,118566000,0,-4741000,,82153000,82153000,55429,SBSI
2019-12-31,,,87775000,,74554000,101018000,207072000,0,93052000,13002000,,,,,13221000,207072000,114020000,0,-5277000,,74554000,74554000,55429,SBSI
2018-12-31,,,84301000,,74138000,97229000,204400000,0,93798000,13373000,,,,,10163000,204400000,110602000,0,-9497000,,74138000,74138000,55429,SBSI
2017-12-31,,,70433000,,54312000,83842000,176768000,0,78509000,14417000,,,,,16121000,176768000,98259000,0,-8076000,,54312000,54312000,55429,SBSI
2019-12-31,,,98085000,,98085000,46748000,197945000,151197000,151197000,,-66330000,,,,0,197945000,46748000,0,-53112000,,98085000,98085000,55430,BCSF
2018-12-31,,,26645000,,26645000,19353000,99294000,79941000,79941000,,-24011000,,,,309,99294000,19353000,0,-53296000,,26645000,26645000,55430,BCSF
2017-12-31,,,19305000,,19300000,6451000,24605000,18154000,18154000,,-3945000,,,,5000,24605000,6451000,0,1151000,,19300000,19300000,55430,BCSF
2016-12-31,,,608975,,608975,1831917,868550,-963367,-963367,,-118167,,,,0,868550,1831917,0,1572342,,608975,608975,55430,BCSF
2019-12-31,,,-76318000,,-76318000,21102000,424569000,61631000,61631000,135235000,-80676000,,,,0,543468000,481837000,118899000,-137949000,,-76318000,-77347000,55432,NOG
2018-12-31,,,143634000,,143689000,14568000,381970000,442028000,442028000,-185006000,-86889000,,,,-55000,448616000,6588000,66646000,-298394000,,143689000,143689000,55432,NOG
2017-12-31,,,-10764000,,-9194000,15399000,153650000,82784000,82784000,14667000,-70381000,,,,-1570000,203383000,120599000,49733000,-93548000,,-9194000,-9194000,55432,NOG
2016-12-31,,,-294895887,,-293493708,14757641,98528512,28107979,28107979,14818734,-65575130,,,,-1402179,144208622,116100643,45680110,-323003866,,-293493708,-293493708,55432,NOG
2019-12-31,,,48559209,,48559209,2578596,5468944,2890348,2890348,,,,,,0,5468944,2578596,0,45668861,,48559209,48559209,55433,SPXX
2018-12-31,,,-15746500,,-15746500,2407506,5288747,2881241,2881241,,,,,,0,5288747,2407506,0,-18627741,,-15746500,-15746500,55433,SPXX
2017-12-31,,,39972966,,39972966,2355708,5367561,3011853,3011853,,,,,,0,5367561,2355708,0,36961113,,39972966,39972966,55433,SPXX
2016-12-31,,,20022844,,20022844,2190195,5467666,3277471,3277471,,,,,,0,5467666,2190195,0,16745373,,20022844,20022844,55433,SPXX
2019-12-31,121878000,,80646000,,95894000,332787000,547343000,92678000,92678000,,-24320000,,,,-15248000,818379000,725701000,271036000,-12032000,,95894000,95894000,55438,ETSY
2018-12-31,88859000,,55078000,,77491000,241016000,412912000,83037000,83037000,,-22178000,,,,-22413000,603693000,520656000,190781000,-27959000,,77491000,77454000,55438,ETSY
2017-12-31,71384000,,32265000,,81800000,190644000,290983000,28955000,28955000,,-11130000,,,,-49535000,441231000,412276000,150248000,3310000,,81800000,81720000,55438,ETSY
2016-12-31,55083000,,-2876000,,-29901000,167858000,241639000,18698000,18698000,,-7204000,,,,27025000,364967000,346269000,123328000,-21574000,,-29901000,-29901000,55438,ETSY
2019-12-31,65003000,,-77878000,,-77187000,15749000,231000,-80521000,-80521000,,-169000,,,,-691000,231000,80752000,0,2643000,,-77187000,-77187000,55439,PTGX
2018-12-31,59497000,,-39723000,,-38924000,13697000,30925000,-42269000,-42269000,,-169000,,,,-799000,30925000,73194000,0,2546000,,-38924000,-38924000,55439,PTGX
2017-12-31,46181000,,-36957000,,-36957000,11779000,20063000,-37897000,-37897000,,-169000,,,,0,20063000,57960000,0,940000,,-36957000,-36957000,55439,PTGX
2016-12-31,25705000,,-37177000,,-37177000,6961000,0,-32666000,-32666000,,-169000,,,,0,0,32666000,0,-4511000,,-37177000,-37735000,55439,PTGX
2019-12-31,,,-3132000,13080000,-5886000,36261000,47855000,4345000,4345000,4701000,-8991000,,,,-363000,68250000,63905000,20395000,-7477000,-1544000,-2769000,-6905000,55442,KFS
2018-12-31,,,-21949000,11796000,-30101000,29232000,28867000,-10111000,-10111000,7370000,-7407000,,,,315000,46136000,56247000,17269000,-11838000,-6072000,-22264000,-30721000,55442,KFS
2017-12-31,,,-13008000,9361000,-15694000,27111000,32463000,-2268000,-2268000,6535000,-6348000,,,,-16688000,47544000,49812000,15081000,-10740000,-15289000,3680000,-16942000,55442,KFS
2016-12-31,,,-6213000,829000,803000,20739000,22895000,-3279000,-3279000,4193000,-4496000,,,,-9720000,32497000,35776000,9602000,-2934000,-2985000,3507000,238000,55442,KFS
2020-12-31,,,151084000,556227000,413563000,99237000,841132000,187946000,187946000,,-218336000,,,,-9423000,1644875000,1456929000,803743000,-36862000,267450000,160507000,411147000,55443,PEAK
2019-12-31,,,169990000,582416000,45530000,91966000,833132000,305975000,305975000,,-217612000,,,,-5479000,1240339000,934364000,407207000,-135985000,-115381000,175469000,43987000,55443,PEAK
2018-12-31,,,832822000,568152000,1061093000,94702000,811526000,312143000,312143000,,-261280000,,,,-4396000,1191320000,879177000,379794000,520679000,236169000,837218000,1058424000,55443,PEAK
2017-12-31,,,421301000,293933000,414169000,87772000,1030164000,407666000,407666000,,-307716000,,,,-1333000,1848378000,1440712000,818214000,13635000,236169000,422634000,413013000,55443,PEAK
2020-06-30,,,15521000,809000,10541000,115369000,151694000,19754000,19754000,,-2285000,,,,3157000,855197000,835443000,703503000,-4233000,,12364000,10541000,55444,RLGT
2019-06-30,,,22180000,246000,16346000,131016000,169726000,23501000,23501000,,-3023000,,,,4800000,890517000,867016000,720791000,-1321000,,17380000,13731000,55444,RLGT
2018-06-30,,,10506000,142000,10188000,115009000,141579000,12181000,12181000,,-3109000,,,,73000,842417000,830236000,700838000,-1675000,,10433000,8142000,55444,RLGT
2017-06-30,,,8592000,53000,4862000,166108000,194636000,16179000,16179000,,-2522000,,,,3673000,777613000,761434000,582977000,-7587000,,4919000,2816000,55444,RLGT
2019-12-31,,,20243000,,17529000,154644000,175946000,21302000,21302000,,-398000,,,,2714000,281052000,259750000,105106000,-1059000,,17529000,-7914000,55446,RMNI
2018-12-31,,,-61959000,,-63951000,126697000,157479000,30782000,30782000,,-91565000,,,,1992000,253460000,222678000,95981000,-92741000,,-63951000,-74592000,55446,RMNI
2017-12-31,,,-48705000,,-50024000,101828000,131962000,30134000,30134000,,-61718000,,,,1319000,214860000,184726000,82898000,-78839000,,-50024000,-50024000,55446,RMNI
2016-12-31,,,-11405000,,-12937000,109148000,93130000,-16018000,-16018000,,-19728000,,,,1532000,160175000,176193000,67045000,4613000,,-12937000,-22937000,55446,RMNI
2019-12-31,50408000,,-95354000,,-95178000,45908000,443000,-95873000,-95873000,,-921000,,,,-176000,443000,96316000,0,519000,,-95178000,-95178000,55447,VYNE
2018-12-31,64474000,,-73951000,,-74163000,14013000,3595000,-74892000,-74892000,,-921000,,,,212000,3595000,78487000,0,941000,,-74163000,-74163000,55447,VYNE
2017-12-31,57779000,,-64551000,,-65715000,11491000,3656000,-65614000,-65614000,,-921000,,,,1164000,3669000,69283000,13000,1063000,,-65715000,-65715000,55447,VYNE
2016-12-31,25897000,,-28949000,,-29336000,9221000,5468000,-29650000,-29650000,,-243000,,,,387000,5527000,35177000,59000,701000,,-29336000,-29336000,55447,VYNE
2019-12-31,,,142642000,46233000,135733000,214954000,524788000,162086000,162086000,,-54223000,,,,-151000,1115167000,953081000,590379000,-19444000,,142793000,122002000,55449,SHO
2018-12-31,,,260826000,47685000,250445000,219189000,542122000,176484000,176484000,,-47690000,,,,1767000,1153253000,976769000,611131000,84342000,,259059000,236801000,55449,SHO
2017-12-31,,,138229000,48440000,145376000,225185000,565606000,181787000,181787000,,-51766000,,,,-7775000,1193638000,1011851000,628032000,-43558000,7000000.0,146004000,131686000,55449,SHO
2016-12-31,,,140061000,49062000,134197000,228819000,562350000,170815000,170815000,,-50283000,,,,-616000,1189440000,1018625000,627090000,-30754000,7000000.0,140677000,117479000,55449,SHO
2019-12-31,,,232000000,10000000,264000000,1690000000,2011000000,375000000,375000000,-54000000,-67000000,,,,-34000000,3869000000,3494000000,1858000000,-143000000,,266000000,264000000,55450,PSO
2018-12-31,,,498000000,9000000,588000000,1875000000,2186000000,380000000,380000000,-69000000,-42000000,,,,-92000000,4129000000,3749000000,1943000000,118000000,,590000000,588000000,55450,PSO
2017-12-31,,,421000000,8000000,406000000,2184000000,2447000000,327000000,327000000,-64000000,-99000000,,,,13000000,4513000000,4186000000,2066000000,94000000,,408000000,406000000,55450,PSO
2016-12-31,,,-2557000000,4000000,-2337000000,2225000000,2459000000,319000000,319000000,-85000000,-74000000,,,,-222000000,4552000000,4233000000,2093000000,-2876000000,,-2335000000,-2337000000,55450,PSO
2019-12-31,4636000,,-4777000,,-7358000,45131000,26390000,-23377000,-23377000,,-2711000,,,,2581000,31265000,54642000,4875000,18600000,,-7358000,-7358000,55452,BFRA
2018-12-31,4427000,,-19269000,,-8878000,30707000,16656000,-18478000,-18478000,,-1784000,,,,-10391000,21107000,39585000,4451000,-791000,,-8878000,-8878000,55452,BFRA
2017-12-31,4225000,,-16102000,,-16102000,20019000,10310000,-13934000,-13934000,,-1133000,,,,0,12025000,25959000,1715000,-2168000,,-16102000,-16102000,55452,BFRA
2016-12-31,4640000,,-10579000,,-10579000,11617000,4478000,-11779000,-11779000,,-1207000,,,,0,6130000,17909000,1652000,1200000,,-10579000,-10579000,55452,BFRA
2019-12-31,121393000,,390949000,,314963000,591545000,1110480000,363547000,363547000,,-2615000,,,,75986000,1399719000,1036172000,289239000,27402000,,314963000,314963000,55454,CSGP
2018-12-31,97602000,,284015000,,238334000,519852000,926399000,278064000,278064000,,-2830000,,,,45681000,1191832000,913768000,265433000,5951000,,238334000,238334000,55454,CSGP
2017-12-31,86129000,,165058000,,122695000,467211000,744827000,173816000,173816000,,-9014000,,,,42363000,965230000,791414000,220403000,-8758000,,122695000,122695000,55454,CSGP
2016-12-31,76400000,,136662000,,85071000,419780000,663816000,144905000,144905000,,-10016000,,,,51591000,837630000,692725000,173814000,-8243000,,85071000,85071000,55454,CSGP
2020-03-31,,,65615000,,52335000,76971000,141888000,64870000,64870000,47000,-11859000,,,,14427000,1335769000,1270899000,1193881000,745000,1147000,51188000,52078000,55455,SENEB
2019-03-31,,,-49259000,,5747000,72549000,39496000,-33022000,-33022000,-31000,-15165000,,,,-12776000,1199581000,1232603000,1160085000,-16237000,42230000,-36483000,5678000,55455,SENEB
2018-03-31,,,8734000,,-8480000,70185000,81503000,11348000,11348000,-30000,-12827000,,,,-1315000,1162894000,1151546000,1081391000,-2614000,-18529000,10049000,-8486000,55455,SENEB
2017-03-31,,,25648000,,15895000,72996000,112004000,39000000,39000000,8000,-9690000,,,,9753000,1262198000,1223198000,1150194000,-13352000,-18529000,15895000,15726000,55455,SENEB
2020-07-31,,,33228519,,33228519,4976234,25851572,20875338,20875338,,-4693773,,,,0,25851572,4976234,0,12353181,,33228519,33228519,55456,BFZ
2019-07-31,,,36782808,,36782808,4972983,29537494,24564511,24564511,,-7919163,,,,0,29537494,4972983,0,12218297,,36782808,36782808,55456,BFZ
2018-07-31,,,4454239,,4454239,5061121,32384209,27323088,27323088,,-6533002,,,,0,32384209,5061121,0,-22868849,,4454239,4454239,55456,BFZ
2017-07-31,,,-7678778,,-7678778,5251576,33782993,28531417,28531417,,-5284709,,,,0,33782993,5251576,0,-36210195,,-7678778,-7678778,55456,BFZ
2019-12-31,,,-25991000,,-25991000,15062000,-12851000,-27913000,-27913000,,-854000,,,,0,20789000,48702000,33640000,1922000,,-25991000,-25991000,55457,ARCT
2018-12-31,,,-21785000,,-21785000,13282000,-1229000,-14511000,-14511000,,-186000,,,,0,15753000,30264000,16982000,-7274000,,-21785000,-21785000,55457,ARCT
2017-12-31,,,-10901000,,-10902000,7572000,-2920000,-10492000,-10492000,,-150000,,,,1000,12998000,23490000,15918000,-757000,,-10902000,-10902000,55457,ARCT
2016-12-31,,,-1536000,,-1571000,3448000,2448000,-1000000,-1000000,,-295000,,,,35000,20382000,21382000,17934000,-536000,,-1571000,-1571000,55457,ARCT
2021-01-03,681000000,,856000000,,656000000,797000000,2235000000,729000000,729000000,,,,,,200000000,3239000000,2510000000,1004000000,127000000,,656000000,656000000,55458,ILMN
2019-12-29,575000000,,1118000000,,1002000000,864000000,2501000000,1028000000,1028000000,,-52000000.0,,,,128000000,3543000000,2515000000,1042000000,90000000,,990000000,1002000000,55458,ILMN
2018-12-30,568000000,,894000000,148000000.0,826000000,849000000,2335000000,883000000,883000000,,-57000000.0,,,,112000000,3333000000,2450000000,998000000,11000000,,782000000,826000000,55458,ILMN
2017-12-31,500000000,,1043000000,220000000.0,726000000,720000000,1883000000,624000000,624000000,,-37000000.0,,,,365000000,2752000000,2128000000,869000000,419000000,,678000000,725000000,55458,ILMN
2020-12-31,,,40090000,,32743000,61056000,147416000,0,55352000,31008000,,,,,7347000,147416000,92064000,0,-15262000,,32743000,31596000,55461,CCNEP
2019-12-31,,,48641000,,40081000,68599000,136149000,0,50630000,16920000,,,,,8560000,136149000,85519000,0,-1989000,,40081000,39934000,55461,CCNEP
2018-12-31,,,40229000,,33719000,61804000,119571000,0,42523000,15244000,,,,,6510000,119571000,77048000,0,-2294000,,33719000,33569000,55461,CCNEP
2017-12-31,,,36252000,,23860000,54641000,105753000,0,38127000,12985000,,,,,12392000,105753000,67626000,0,-1875000,,23860000,23725000,55461,CCNEP
2019-12-31,,,1355578,,1070906,550339,0,-550339,-550339,,,,,,284671,0,550339,0,1905917,,1070906,-60889,55463,THCA
2019-12-31,29109000,,17929000,,15770000,78461000,150222000,14783000,14783000,,-102000,,,,3733000,254112000,239329000,103890000,3146000,1574000,14196000,15770000,55466,HSTM
2018-12-31,25735000,,16575000,,32217000,69820000,135602000,15816000,15816000,,-130000,,,,3324000,231616000,215800000,96014000,759000,18966000,13251000,32217000,55466,HSTM
2017-12-31,24148000,,10140000,,10004000,70089000,127691000,9407000,9407000,,-132000,,,,1302000,214899000,205492000,87208000,733000,1166000,8838000,10004000,55466,HSTM
2016-12-31,24234000,,7752000,,3755000,65387000,117158000,7171000,7171000,,-102000,,,,2961000,192124000,184953000,74966000,581000,-1036000,4791000,3755000,55466,HSTM
2020-03-31,1011000,,-7315000,,-7315000,5968000,115000,-6864000,-6864000,,,,,,0,4072000,10936000,3957000,-451000,,-7315000,-7315000,55468,IGC
2019-03-31,1256000,,-4095000,,-4097000,3519000,132000,-4643000,-4643000,,,,,,2000,5116000,9759000,4984000,548000,,-4097000,-4097000,55468,IGC
2018-03-31,137000,,-1786000,,-1786000,1734000,82000,-1789000,-1789000,,-31000.0,,,,464,2193000,3982000,2111000,3000,,-1786000,-1786000,55468,IGC
2017-03-31,137000,,-1838430,-8836.0,-1867260,2271690,218237,-2053453,-2053453,,-223464.0,,,,14431,580372,2633825,362135,215023,,-1852861,-1867260,55468,IGC
2019-12-31,,,3437731000,1467863000,3147937000,169920000,1080971000,491944000,491944000,,-264083000,,,,103439000,2003565000,1511621000,922594000,2945787000,-30000,3334292000,3097497000,55470,VNO
2018-12-31,,,459598000,1426214000,449954000,141871000,1190071000,601630000,601630000,,-347949000,,,,37633000,2172869000,1571239000,982798000,-142032000,638000,421965000,384788000,55470,VNO
2017-12-31,,,319731000,1654986000,227416000,150782000,1207632000,627461000,627461000,,-345654000,,,,42375000,2096004000,1468543000,888372000,-307730000,-13228000,277356000,161971000,55470,VNO
2016-12-31,,,584933000,1998423000,906917000,143643000,1323865000,767969000,767969000,-8770000.0,-330240000,,,,7923000,2177882000,1409913000,854017000,-183036000,404912000,577010000,823510000,55470,VNO
2019-12-31,,,-76282000,,-76282000,20705000,-48566000,-77090000,-77090000,,-400000,,,,0,0,77090000,48566000,808000,,-76282000,-76282000,55471,ABEO
2018-12-31,,,-56671000,,-56671000,20106000,-35700000,-58166000,-58166000,,-11000,,,,0,2998000,61164000,38698000,1495000,,-56671000,-56671000,55471,ABEO
2017-12-31,16989000.0,,-27319000,,-27319000,10943000,-16152000,-27836000,-27836000,,-8000,,,,0,837000,28673000,16989000,964000,,-27319000,-27319000,55471,ABEO
2016-12-31,10655000.0,,-21873000,,-21873000,13290000,-9766000,-23881000,-23881000,,-6000,,,,0,889000,24770000,10655000,3899000,,-21873000,-21873000,55471,ABEO
2019-12-31,,,196400000,2700000,137500000,122000000,343000000,221000000,221000000,,-70900000,,,,56800000,1329700000,1108700000,986700000,-24600000,-2400000,139600000,137500000,55473,CHDN
2018-12-31,,,233900000,2700000,352800000,90600000,289700000,199100000,199100000,,-40100000,,,,51300000,1009000000,809900000,719300000,34800000,170200000,182600000,352800000,55473,CHDN
2017-12-31,,,102500000,2700000,140500000,83500000,253200000,169700000,169700000,,-49300000,,,,-19900000,882600000,712900000,629400000,-67200000,18100000,122400000,140400000,55473,CHDN
2016-12-31,,,147400000,2700000,108100000,79400000,244900000,165500000,165500000,,-43700000,,,,50700000,822400000,656900000,577500000,-18100000,11400000,96700000,107100000,55473,CHDN
2019-12-31,,,-2328242000,47045000,-2159576000,3499175000,3287512000,-2360301000,-2360301000,,,,,,-174597000,4424963000,6785264000,1137451000,32059000,,-2153645000,-2170287000,55474,JFU
2018-12-31,,,2377586000,10450000,1981804000,2906121000,5111652000,2208168000,2208168000,,,,,,402403000,5556482000,3348314000,444830000,169418000,,1975183000,1719990000,55474,JFU
2017-12-31,,,1076185000,16196000,597704000,5317298000,6239730000,920551000,920551000,,,,,,352432000,6741780000,5821229000,502050000,155634000,,723753000,401308000,55474,JFU
2016-12-31,,,432758000,11976000,156038000,1696058000,2092628000,396570000,396570000,,,,,,271132000,2260652000,1864082000,168024000,36188000,,161626000,142312000,55474,JFU
2019-12-31,42000000,,-60000000,,116000000,105000000,182000000,40000000,40000000,-5000000,-16000000,,,,31000000,1242000000,1202000000,1060000000,-100000000,207000000,-91000000,96000000,55477,KODK
2018-12-31,48000000,,3000000,,-16000000,93000000,180000000,46000000,46000000,-7000000,-9000000,,,,12000000,1320000000,1274000000,1140000000,-43000000,-7000000,-9000000,-36000000,55477,KODK
2017-12-31,64000000,,-27000000,,94000000,87000000,218000000,67000000,67000000,-7000000,-8000000,,,,-120000000,1386000000,1319000000,1168000000,-94000000,1000000,93000000,75000000,55477,KODK
2016-12-31,60000000,,51000000,,15000000,198000000,404000000,145000000,145000000,1000000,-60000000,,,,33000000,1643000000,1498000000,1239000000,-94000000,-2000000,18000000,12000000,55477,KODK
2020-12-31,54500000,,401300000,,320100000,632000000,1195300000,517400000,517400000,-8600000,-76600000,,,,77100000,4245200000,3727800000,3049900000,-116100000,-4100000,324200000,319000000,55479,CSL
2019-12-31,60800000,,595300000,,472800000,661500000,1378800000,661000000,661000000,-4500000,-66100000,,,,121600000,4811600000,4150600000,3432800000,-65700000,-900000,473700000,471500000,55479,CSL
2018-12-31,55000000,,445900000,,611100000,623500000,1190200000,526900000,526900000,-15200000,-64700000,,,,87300000,4479500000,3952600000,3289300000,-81000000,252500000,358600000,609200000,55479,CSL
2017-12-31,51200000,,429000000,,365500000,517100000,1059200000,490800000,490800000,100000,-34000000,,,,88400000,3750800000,3260000000,2691600000,-61800000,24900000,340600000,362400000,55479,CSL
2020-12-31,,,11000000,,-10600000,470900000,539300000,68400000,68400000,,-65900000,,,,2000000,3076400000,3008000000,2537100000,-57400000,-19600000,9000000,-10600000,55483,TEX
2019-12-31,72400000.0,,247500000,,54400000,480300000,887800000,335100000,335100000,,-87900000,,,,37800000,4353100000,4018000000,3465300000,-87600000,-155300000,209700000,54400000,55483,TEX
2018-12-31,63200000.0,,287100000,500000.0,113700000,535800000,961900000,362900000,362900000,,-72800000,,,,45400000,4517200000,4154300000,3555300000,-75800000,-128000000,241700000,113700000,55483,TEX
2017-12-31,55600000.0,,163400000,500000.0,128700000,478800000,767300000,232900000,232900000,,-67200000,,,,52400000,3793700000,3560800000,3026400000,-69500000,17700000,111000000,128700000,55483,TEX
2020-03-31,,,2247000,,3466000,33745000,36679000,0,2542000,,,,,,-1219000,36679000,34137000,0,-295000,,3466000,3434000,55484,NICK
2019-03-31,,,-4588000,,-3648000,33168000,35360000,0,1812000,,,,,,-940000,35360000,33548000,0,-6400000,,-3648000,-3648000,55484,NICK
2018-03-31,,,3163000,,-1098000,32681000,36313000,0,3163000,,,,,,4261000,36313000,33150000,0,0,,-1098000,-1098000,55484,NICK
2017-03-31,,,8740000,,5409000,34707000,44289000,0,9090000,,,,,,3331000,44289000,35199000,0,-350000,,5409000,5339000,55484,NICK
2020-12-31,,,357914000,134545000,347402000,32531000,509080000,234964000,234964000,,-80962000,,,,0,740905000,505941000,231825000,122950000,,357914000,344914000,55485,HIW
2019-12-31,,,141683000,155226000,136918000,44067000,490744000,203773000,203773000,,-81648000,,,,0,739255000,535482000,248511000,-62090000,,141683000,134430000,55485,HIW
2018-12-31,,,177630000,123536000,171835000,40006000,479858000,209897000,209897000,,-71422000,,,,0,722273000,512376000,242415000,-32267000,,177630000,169343000,55485,HIW
2017-12-31,,,191663000,161425000,185365000,39648000,473253000,205773000,205773000,,-69105000,,,,0,710141000,504368000,236888000,-14110000,,191663000,182873000,55485,HIW
2019-12-31,3251000,,-124605000,-12370000,-123749000,66749000,-49362000,-119362000,-119362000,,-6954000,,,,928000,101229000,220591000,150591000,-5243000,,-125533000,-123749000,55487,ATNX
2018-12-31,2621000,,-128611000,-10586000,-117440000,49008000,-74891000,-126520000,-126520000,,-3581000,,,,100000,89100000,215620000,163991000,-2091000,,-128711000,-117440000,55487,ATNX
2017-12-31,2030000,,-131311000,685000,-131170000,46112000,-61766000,-109908000,-109908000,,-6279000,,,,85000,38043000,147951000,99809000,-21403000,,-131396000,-131170000,55487,ATNX
2016-12-31,2030000,,-88171000,862000,-87715000,25956000,-59791000,-85747000,-85747000,,-1891000,,,,-265000,20551000,106298000,80342000,-2871000,,-87906000,-87715000,55487,ATNX
2020-12-31,,,228452000,,172640000,1013765000,1299942000,286177000,286177000,,-41913000,,,,55812000,8340579000,8054402000,7040637000,-57725000,,172640000,172640000,55488,NSIT
2019-12-31,,,211716000,,159407000,834528000,1138098000,257361000,257361000,,-28478000,,,,52309000,7731190000,7473829000,6593092000,-45645000,,159407000,159407000,55488,NSIT
2018-12-31,,,211902000,,163677000,719071000,993718000,237189000,237189000,,-21737000,,,,48225000,7080136000,6842947000,6086418000,-25287000,,163677000,163677000,55488,NSIT
2017-12-31,,,159098000,,90683000,723328000,918570000,195242000,195242000,,-17965000,,,,68415000,6703623000,6508381000,5785053000,-36144000,,90683000,90683000,55488,NSIT
2019-12-31,,,305927000,,243020000,394925000,1526721000,366818000,366818000,650080000,-45814000,,,,62808000,3066262000,2699444000,1539541000,-60891000,,243119000,243020000,55491,PRAH
2018-12-31,,,221690000,6390000.0,153905000,371795000,1371696000,316476000,316476000,570405000,-50922000,,,,67232000,2871922000,2555446000,1500226000,-94786000,,154458000,153905000,55491,PRAH
2017-12-31,,,74670000,5710000.0,86927000,320087000,975521000,260898000,260898000,311015000,-39874000,,,,-12623000,2259389000,1998491000,1283868000,-186228000,,87293000,86927000,55491,PRAH
2016-12-31,,,96669000,5710000.0,68175000,269893000,779023000,165770000,165770000,231688000,-48992000,,,,28494000,1811711000,1645941000,1032688000,-69101000,,68175000,68175000,55491,PRAH
2020-12-26,719000000,,9069000000,98000000,7120000000,27173000000,38637000000,10751000000,10751000000,-6000000,-1128000000,,,,1894000000,70372000000,59621000000,31735000000,-1682000000,,7175000000,7120000000,55492,PEP
2019-12-28,711000000,,9312000000,82000000,7314000000,25795000000,37178000000,10671000000,10671000000,1000000,-935000000,,,,1959000000,67161000000,56490000000,29983000000,-1359000000,,7353000000,7314000000,55492,PEP
2018-12-29,680000000,,9189000000,84000000,12515000000,24327000000,35280000000,10276000000,10276000000,-3000000,-1219000000,,,,-3370000000,64661000000,54385000000,29381000000,-1087000000,,12559000000,12513000000,55492,PEP
2017-12-30,737000000,,9602000000,92000000,4857000000,23366000000,34729000000,10627000000,10627000000,-1000000,-1151000000,,,,4694000000,63525000000,52898000000,28796000000,-1025000000,,4908000000,4853000000,55492,PEP
2019-12-31,,,302432000,,238167000,291058000,763544000,0,353262000,119224000,,,,,64265000,763544000,410282000,0,-50830000,,238167000,237828000,55493,SFNC
2018-12-31,,,266071000,,215713000,271086000,658300000,0,285390000,101824000,,,,,50358000,658300000,372910000,0,-19319000,,215713000,215713000,55493,SFNC
2017-12-31,,,154923000,,92940000,205980000,467302000,0,184018000,77304000,,,,,61983000,467302000,283284000,0,-29095000,,92940000,92940000,55493,SFNC
2016-12-31,,,143438000,,96814000,182679000,398523000,0,159803000,56041000,,,,,46624000,398523000,238720000,0,-16365000,,96814000,96790000,55493,SFNC
2019-12-31,,,-49490000,,-49394000,15628000,-16599000,-32677000,-32677000,450000,,,,,-96000,303308000,335985000,319907000,-16813000,,-49394000,-49394000,55494,GIFI
2018-12-31,,,-19807000,,-20378000,19015000,-11596000,-30647000,-30647000,36000,-142000.0,,,,571000,221247000,251894000,232843000,10840000,,-20378000,-20378000,55494,GIFI
2017-12-31,,,-68959000,,-44766000,17800000,-49625000,-67414000,-67414000,-11000,-349000.0,,,,-24193000,171022000,238436000,220647000,-1545000,,-44766000,-44769000,55494,GIFI
2016-12-31,,,5556000,,3515000,19670000,24853000,5107000,5107000,76000,-308000.0,,,,2041000,286326000,281219000,261473000,449000,,3515000,3485000,55494,GIFI
2019-12-31,,,-124201000,,-124201000,33544000,-87456000,-121140000,-121140000,140000,-3810000,,,,0,7281000,128421000,94737000,-3061000,,-124201000,-124201000,55497,QURE
2018-12-31,,,-83073000,,-83304000,25305000,-61730000,-86437000,-86437000,-598000,-2160000,,,,231000,11284000,97721000,73014000,3364000,,-83304000,-83304000,55497,QURE
2017-12-31,,,-79459000,,-79260000,24635000,-54302000,-77280000,-77280000,-1657000,-2232000,,,,-199000,13107000,90387000,67409000,-2179000,,-79260000,-79260000,55497,QURE
2016-12-31,,,-72229000,,-73374000,24899000,-47592000,-71026000,-71026000,-1465000,-2172000,,,,1145000,25098000,96124000,72690000,-1203000,,-73374000,-73374000,55497,QURE
2019-12-31,,,-5013859,,-5115747,8989686,5949210,-5062996,-5062996,,,,,,101888,28200535,33263531,22251325,49137,,-5115747,-5115747,55498,USIO
2018-12-31,,,-3698035,,-3775815,7468384,5569513,-3774509,-3774509,,,,,,77780,25024124,28798633,19454611,76474,,-3775815,-3775815,55498,USIO
2017-12-31,,,-2734469,,-3008785,5347110,3768226,-2837016,-2837016,,,,,,274316,14571158,17408174,10802932,102547,,-3008785,-3008785,55498,USIO
2016-12-31,,,-1163974,,-1196642,4241977,3783004,-1360573,-1360573,,,,,,32668,12076358,13436931,8293354,196599,,-1196642,-1196642,55498,USIO
2019-12-31,33476000,,-39206000,,-31941000,7607000,0,-41083000,-41083000,,-50000,,,,-7265000,0,41083000,0,1877000,,-31941000,-31941000,55794,VRNA
2018-12-31,19294000,,-24133000,,-19901000,6297000,0,-25591000,-25591000,,-50000,,,,-4232000,0,25591000,0,1458000,,-19901000,-19901000,55794,VRNA
2017-12-31,23717000,,-25203000,,-20497000,6039000,0,-29756000,-29756000,,-50000,,,,-4706000,0,29756000,0,4553000,,-20497000,-20497000,55794,VRNA
2016-12-31,4522000,,-5973000,,-5019000,2498000,0,-7020000,-7020000,,-50000,,,,-954000,0,7020000,0,1047000,,-5019000,-5019000,55794,VRNA
2019-12-31,,,31763000,48479000,26443000,62617000,-14317000,0,20796000,-98867000,,,,,5553000,35142000,14346000,49459000,10967000,,26210000,25290000,55798,ATLC
2018-12-31,,,3482000,-338000,7856000,35554000,18782000,0,-32742000,14983000,,,,,-4130000,55927000,88669000,37145000,36224000,,7612000,7856000,55798,ATLC
2017-12-31,,,-47250000,-94000,-40781000,35821000,6622000,0,-47304000,17084000,,,,,-6378000,38156000,85460000,31534000,54000,,-40872000,-40781000,55798,ATLC
2016-12-31,,,-12356000,-10000,-6335000,28930000,29681000,0,-13197000,6471000,,,,,-6015000,60343000,73540000,30662000,841000,,-6341000,-6335000,55798,ATLC
2019-12-31,,,9411000,12406000,2419000,36869000,49250000,10191000,10191000,,-1046000,,,,3578000,252876000,242685000,203626000,-780000,,5833000,2419000,55799,SGRP
2018-12-31,,,3040000,8476000,-1551000,38449000,44287000,3729000,3729000,,-1095000,,,,1402000,229191000,225462000,184904000,-689000,,1638000,-1551000,55799,SGRP
2017-12-31,,,4154000,5905000,-923000,30564000,36780000,4090000,4090000,,-337000,,,,2977000,181381000,177291000,144601000,64000,,1177000,-923000,55799,SGRP
2016-12-31,,,2197000,5405000,173000,25241000,29543000,2202000,2202000,,-133000,,,,441000,134324000,132122000,104781000,-5000,,1756000,173000,55799,SGRP
2020-09-30,3321763,,-13028904,-8725,-13027219,10138103,1210597,-12534999,-12534999,,-115830,,,,0,1931497,14466496,720900,-493905,,-13028904,-13030061,55800,APDN
2019-09-30,2967278,,-8617446,-7040,-8623123,10278045,4511476,-9124271,-9124271,,-162432,,,,15000,5389089,14513360,877613,506825,,-8632446,-8932730,55800,APDN
2018-09-30,2751578,,-11692928,-7040,-11692928,11043463,2696529,-11646308,-11646308,,-9615,,,,0,3903343,15549651,1206814,-46620,,-11692928,-11692928,55800,APDN
2017-09-30,2282362,,-12855767,-7040,-12855767,13876743,4226268,-12566165,-12566165,,-9615,,,,0,4751260,17317425,524992,-289602,,-12855767,-12855767,55800,APDN
2019-12-31,,,-97488000,,-94733000,51815000,-97193000,-148998000,-148998000,-10000,,,,,-2755000,35233000,184231000,132426000,51510000,,-94733000,-94733000,55801,RGNX
2018-12-31,83873000.0,,104116000,,99937000,36850000,124992000,88100000,88100000,42000,,,,,4179000,218505000,130405000,93513000,16016000,,99937000,99937000,55801,RGNX
2017-12-31,83873000.0,,-73169000,,-73169000,27229000,-48540000,-75885000,-75885000,116000,,,,,0,10393000,86278000,58933000,2716000,,-73169000,-73169000,55801,RGNX
2016-12-31,83873000.0,,-63402000,,-62967000,23590000,-41852000,-65340000,-65340000,-102000,,,,,-435000,4589000,69929000,46441000,1938000,,-62967000,-62967000,55801,RGNX
2020-12-31,,,12808000,,11246000,47192000,70811000,0,20389000,3230000,,,,,1562000,70811000,50422000,0,-7581000,,11246000,11246000,55802,EVBN
2019-12-31,,,22242000,,17014000,41756000,69947000,0,23321000,4670000,,,,,5228000,69947000,46626000,0,-1079000,,17014000,17014000,55802,EVBN
2018-12-31,,,18639000,,16356000,37477000,59950000,0,19943000,2330000,,,,,2283000,59950000,40007000,0,-1304000,,16356000,16356000,55802,EVBN
2017-12-31,,,15688000,,10479000,33560000,51439000,0,16541000,1238000,,,,,5209000,51439000,34898000,0,-853000,,10479000,10479000,55802,EVBN
2019-12-31,,,4164000,,2337600,3723600,11608800,6589200,6589200,,-985200,,,,1826400,48960000,42370800,37351200,-2425200,,2337600,2205600,55804,MDIA
2019-02-28,,,7887000,,5369000,3723600,9261000,7943000,7943000,,-985200,,,,2518000,43091000,35148000,33830000,-56000,,5369000,5369000,55804,MDIA
2019-12-31,,,-11076000,,-11076000,24152000,18029000,-9012000,-9012000,,,,,,0,30286000,39298000,12257000,-2064000,,-11076000,-11076000,55805,RDVT
2018-12-31,,,-6868000,,-6868000,13159000,7664000,-7491000,-7491000,,,,,,0,16302000,23793000,8638000,623000,,-6868000,-6868000,55805,RDVT
2017-12-31,,,-21500000,,-21500000,12683000,1512000,-12309000,-12309000,,,,,,0,8578000,20887000,7066000,-9191000,,-21500000,-21500000,55805,RDVT
2016-12-31,,,-16901000,,-16863000,10036000,279000,-10364000,-10364000,,,,,,-38000,4585000,14949000,4306000,-6537000,,-16863000,-16863000,55805,RDVT
2020-02-29,,,64140863,,64140863,5355315,36292594,30937279,30937279,,-8302368,,,,0,36292594,5355315,0,33203584,,64140863,64140863,55806,VKI
2019-02-28,,,15522831,,15449651,5141100,37714085,32572985,32572985,,-8072880,,,,73180,37714085,5141100,0,-17050154,,15449651,15449651,55806,VKI
2018-02-28,,,19501591,,19391751,5557733,41393979,35836246,35836246,,-6435163,,,,109840,41393979,5557733,0,-16334655,,19391751,19391751,55806,VKI
2017-02-28,,,2146010,,2054634,5546293,42508201,36961908,36961908,,-5788772,,,,91376,42508201,5546293,0,-34815898,,2054634,2054634,55806,VKI
2020-02-01,,,1561000,,261000,151947000,153623000,1676000,1676000,,-15000,,,,1300000,338543000,336867000,184920000,-115000,,261000,261000,55808,BBW
2019-02-02,,,-18507000,,-17933000,155500000,143949000,-11551000,-11551000,,-85000,,,,-574000,336585000,348136000,192636000,-6956000,,-17933000,-17933000,55808,BBW
2018-02-03,,,-12336000,,-10140000,183840000,166824000,-17016000,-17016000,,-120000,,,,-2196000,362676000,379692000,195852000,4680000,,-10140000,-10140000,55808,BBW
2017-12-30,,,13813000,,7916000,156666000,168994000,12328000,12328000,,-11000,,,,5897000,357866000,345538000,188872000,1485000,,7916000,7820000,55808,BBW
2019-12-31,222877,,-3650758,-141056,-3137203,11270859,9197982,-2889608,-2889608,593854,-761150,,,,-122500,12468578,15358186,3270596,-761150,,-3528258,-3137203,55811,CVLB
2018-12-31,120541,,-2410528,-77962,-1240828,7823560,6327907,-2056140,-2056140,439946,-354388,,,,-124700,8324129,10380269,1996222,-354388,925738.0,-2285828,-1240828,55811,CVLB
2017-12-31,120541,,-1379270,-259084,-1205961,3892306,2663951,-1228355,-1228355,439946,-100523,,,,0,3681827,4910182,1017876,-150915,160821.0,-1379270,-1205961,55811,CVLB
2016-12-31,120541,,-1223293,-6555,-1107544,4467231,3292549,-1174682,-1174682,439946,-48611,,,,0,5238604,6413286,1946055,-48611,160821.0,-1223293,-1107544,55811,CVLB
2020-12-31,904000000,,623000000,191000000,512000000,1624000000,3997000000,1348000000,1348000000,,-276000000,,,,111000000,11303000000,9955000000,7306000000,-725000000,,512000000,414000000,55812,GLW
2019-12-31,1031000000,,1216000000,90000000,960000000,1585000000,4035000000,1306000000,1306000000,,-221000000,,,,256000000,11503000000,10197000000,7468000000,-90000000,,960000000,862000000,55812,GLW
2018-12-31,993000000,,1503000000,94000000,1066000000,1649000000,4461000000,1725000000,1725000000,,-191000000,,,,437000000,11290000000,9565000000,6829000000,-222000000,,1066000000,968000000,55812,GLW
2017-12-31,864000000,,1657000000,72000000,-497000000,1473000000,4020000000,1608000000,1608000000,,-155000000,,,,2154000000,10116000000,8508000000,6096000000,49000000,,-497000000,-595000000,55812,GLW
2020-10-31,,,-2474783,,-2474783,1553406,10314441,8761035,8761035,,-16287,,,,0,10314441,1553406,0,-11235818,,-2474783,-2474783,55813,AGD
2019-10-31,,,13982597,,13982597,1564643,11157939,9593296,9593296,,-69948,,,,0,11157939,1564643,0,4389301,,13982597,13982597,55813,AGD
2018-10-31,,,1939585,,1939585,1697866,9340800,7642934,7642934,,-45523,,,,0,9340800,1697866,0,-5703349,,1939585,1939585,55813,AGD
2017-10-31,,,28223626,,28223626,1596245,10934453,9338208,9338208,,-56078,,,,0,10934453,1596245,0,18885418,,28223626,28223626,55813,AGD
2020-06-30,2025376,,14149511,55253,8240205,26717345,42393637,13650916,13650916,,-74321,,,,2444778,85690462,72039546,43296825,498595,,11704733,7864150,55815,FONR
2019-06-30,1812347,,22519194,2155725,15317131,19261755,43208294,22134192,22134192,,-98636,,,,2005520,87192887,65058695,43984593,385002,,20513674,14608829,55815,FONR
2018-06-30,1755747,,19782435,3559182,21230802,18125266,57461752,19684211,19684211,,-160074,,,,-5669750,99412522,79728311,41950770,98224,,25452185,20238797,55815,FONR
2017-06-30,1480670,,19316364,5472799,19620621,19407411,56155595,19096080,19096080,,-160074,,,,-4362434,94208020,75111940,38052425,220284,,23678798,18703852,55815,FONR
2019-12-31,20200000,,-64000000,,-45900000,401500000,402200000,-40600000,-40600000,21100000,-15000000,,,,-18100000,697600000,738200000,295400000,-23400000,,-45900000,-45900000,55820,AVNS
2018-12-31,41800000,,-18100000,,57500000,334000000,390900000,6900000,6900000,8200000,-26400000,,,,-9600000,652300000,645400000,261400000,-25000000,66000000.0,-8500000,57500000,55820,AVNS
2017-12-31,38200000,,-72200000,,79300000,321700000,336900000,-43100000,-43100000,20100000,-31600000,,,,-40100000,611600000,654700000,274700000,-29100000,111400000.0,-32100000,79300000,55820,AVNS
2016-12-31,38400000,,-139200000,,39800000,346200000,297200000,-107100000,-107100000,19700000,-32700000,,,,-55900000,566200000,673300000,269000000,-32100000,123100000.0,-83300000,39800000,55820,AVNS
2019-12-31,,,326000,,355000,12449000,14330000,0,376000,1505000,,,,,-29000,14330000,13954000,0,-50000,,355000,355000,55821,AFBI
2018-12-31,,,1759000,,1558000,10921000,14234000,0,1902000,1411000,,,,,201000,14234000,12332000,0,-143000,,1558000,1558000,55821,AFBI
2018-09-30,,,1654000,,449000,10889000,14144000,0,1799000,1456000,,,,,1205000,14144000,12345000,0,-145000,,449000,449000,55821,AFBI
2017-09-30,,,2071000,,1365000,8804000,12596000,0,2207000,1585000,,,,,706000,12596000,10389000,0,-136000,,1365000,583000,55821,AFBI
2019-12-31,,,590619,,590619,2251232,5090964,1400824,1400824,,-1075576,,,,0,8668322,7267498,3577358,-810205,,590619,590619,55822,SELF
2018-12-31,,,619448,,619448,2024446,4848376,1425572,1425572,,-897937,,,,0,8110979,6685407,3262603,-806124,,619448,619448,55822,SELF
2017-12-31,,,-146290,,-146290,1941880,4318906,677471,677471,,-880834,,,,0,7472793,6795322,3153887,-823761,,-146290,-146290,55822,SELF
2016-12-31,,,310908,,310908,1460518,2879553,466528,466528,,-456719,,,,0,4981529,4515001,2101976,-155620,,310908,384135,55822,SELF
2020-12-31,,,1088000000,1957000000,-733000000,,4301000000,1341000000,1341000000,,-421000000,,,,1666000000,53270000000,51929000000,48969000000,-253000000,,-578000000,-733000000,55823,MT
2019-12-31,301000000.0,,-1932000000,1962000000,-2454000000,2459000000.0,3655000000,895000000,895000000,,-695000000,,,,459000000,70615000000,69720000000,66960000000,-2827000000,,-2391000000,-2454000000,55823,MT
2018-12-31,290000000.0,,4981000000,2022000000,5149000000,2528000000.0,9793000000,6975000000,6975000000,,-687000000,,,,-349000000,76033000000,69058000000,66240000000,-1994000000,,5330000000,5149000000,55823,MT
2017-12-31,278000000.0,,5007000000,2066000000,4568000000,2444000000.0,8009000000,5287000000,5287000000,,-879000000,,,,432000000,68679000000,63392000000,60670000000,-280000000,,4575000000,4568000000,55823,MT
2020-08-31,,,72505208,,72505208,2998848,3486531,418067,418067,69616,,,,,0,3486531,3068464,0,72087141,,72505208,72505208,55825,TWN
2019-08-31,,,-6109657,,-6109657,2618340,4353456,1660736,1660736,74380,,,,,0,4353456,2692720,0,-7770393,,-6109657,-6109657,55825,TWN
2018-08-31,,,-3459205,,-3459205,3221677,5144431,1818323,1818323,104431,,,,,0,5144431,3326108,0,-5277528,,-3459205,-3459205,55825,TWN
2017-08-31,,,35260703,,35260703,2952734,4686955,1670412,1670412,63809,,,,,0,4686955,3016543,0,33590291,,35260703,35260703,55825,TWN
2020-11-30,,,497221,,497221,1632307,8897280,7264973,7264973,,-1365367,,,,0,8897280,1632307,0,-6767752,,497221,497221,55826,CMU
2019-11-30,,,13256852,,13256852,1672256,10291685,8619429,8619429,,-2062211,,,,0,10291685,1672256,0,4637423,,13256852,13256852,55826,CMU
2018-11-30,,,3420838,,3420838,1687214,10950735,9263521,9263521,,-1954691,,,,0,10950735,1687214,0,-5842683,,3420838,3420838,55826,CMU
2017-11-30,,,11091693,,11091693,1711557,10987142,9275585,9275585,,-1508025,,,,0,10987142,1711557,0,1816108,,11091693,11091693,55826,CMU
2019-12-31,20790000,,-23132000,,-23132000,2424000,0,-23214000,-23214000,,,,,,0,0,23214000,0,82000,,-23132000,-23132000,55827,LRMR
2018-12-31,9609000,,-11192000,,-11192000,1583000,0,-11192000,-11192000,,,,,,0,0,11192000,0,0,,-11192000,-11192000,55827,LRMR
2019-12-31,6523000,,-23676000,,-23676000,15992000,384000,-22131000,-22131000,,-385000,,,,0,3281000,25412000,2897000,-1545000,,-23676000,-23676000,55831,OBLN
2018-12-31,10697000,,-37380000,,-37380000,29946000,3678000,-36965000,-36965000,,-226000,,,,0,9101000,46066000,5423000,-415000,,-37380000,-37380000,55831,OBLN
2017-12-31,10647000,,-34765000,,-34765000,26929000,5085000,-32491000,-32491000,,-135000,,,,0,9914000,42405000,4829000,-2274000,,-34765000,-34765000,55831,OBLN
2016-12-31,9872000,,-20467000,,-20467000,10217000,584000,-19505000,-19505000,,-477000,,,,0,3393000,22898000,2809000,-962000,,-20467000,-20467000,55831,OBLN
2019-12-31,,,101709000,,131258000,446281000,1029910000,341164000,341164000,,-129820000,,,,-29549000,4675815000,4334651000,3645905000,-239455000,,131258000,131258000,55835,SYNH
2018-12-31,,,57258000,,24284000,406305000,955806000,275816000,275816000,,-130701000,,,,32974000,4390116000,4114300000,3434310000,-218558000,,24284000,24284000,55835,SYNH
2017-12-31,,,-111877000,,-138469000,282620000,620820000,126937000,126937000,,-63725000,,,,26592000,1852843000,1725906000,1232023000,-238814000,,-138469000,-138469000,55835,SYNH
2016-12-31,,,134118000,,112630000,172386000,403704000,172114000,172114000,,-12016000,,,,21488000,1030337000,858223000,626633000,-37996000,,112630000,112630000,55835,SYNH
2020-06-30,49784000,,5690000,,3827000,87398000,149721000,12539000,12539000,,-18080000,,,,1863000,382928000,370389000,233207000,-6849000,,3827000,3827000,55836,ARAY
2019-06-30,56493000,,-14344000,,-16430000,105575000,162651000,583000,583000,,-15084000,,,,2086000,418785000,418202000,256134000,-14927000,,-16430000,-16430000,55836,ARAY
2018-06-30,57251000,,-23021000,,-23899000,108241000,161695000,-3797000,-3797000,,-14959000,,,,878000,404897000,408694000,243202000,-19224000,,-23899000,-23899000,55836,ARAY
2017-06-30,49921000,,-28541000,,-29579000,101243000,141341000,-9823000,-9823000,,-17302000,,,,1038000,383414000,393237000,242073000,-18718000,,-29579000,-29579000,55836,ARAY
2020-04-30,4398814,,-1096565,,-1096565,6377131,9976378,-799567,-799567,,-335351,,,,0,12101326,12900893,2124948,-296998,,-1096565,-1096565,55840,CPAH
2019-04-30,5547587,,-5013439,,-5013439,7839094,8540920,-4845761,-4845761,,-107323,,,,0,10764904,15610665,2223984,-167678,,-5013439,-5013439,55840,CPAH
2018-04-30,5506887,,-3220670,,-3220670,8038810,10751927,-2793770,-2793770,,-364,,,,0,12381741,15175511,1629814,-426900,,-3220670,-3220670,55840,CPAH
2017-04-30,4843813,,-2458515,,-2458515,7065464,8955660,-2953617,-2953617,,-3056,,,,0,10685590,13639207,1729930,495102,,-2458515,-2458515,55840,CPAH
2020-03-31,137500000,,392700000,88600000,311400000,443100000,1083600000,498600000,498600000,4400000,-124800000,,,,73800000,3623200000,3124600000,2539600000,-105900000,,318900000,311400000,55841,CAE
2019-03-31,101400000,,399700000,78700000,330000000,420900000,941500000,423500000,423500000,-4300000,-65700000,,,,59600000,3304100000,2880600000,2362600000,-23800000,,340100000,330000000,55841,CAE
2018-03-31,114900000,,385600000,68400000,346000000,385700000,877900000,376000000,376000000,1300000,-60300000,,,,30900000,2823500000,2447500000,1945600000,9600000,,354700000,346000000,55841,CAE
2017-03-31,111000000,,292300000,60200000,251500000,369600000,811200000,336600000,336600000,-6000000,-62500000,,,,35200000,2704500000,2367900000,1893300000,-44300000,-500000.0,257100000,251500000,55841,CAE
2019-12-31,13747000,,-29044000,,-29044000,60450000,47267000,-26930000,-26930000,,-3685000,,,,0,62656000,89586000,15389000,-2114000,,-29044000,-29044000,55844,STIM
2018-12-31,8232000,,-24097000,,-24097000,51931000,40329000,-19834000,-19834000,,-3688000,,,,0,52776000,72610000,12447000,-4263000,,-24097000,-24097000,55844,STIM
2017-12-31,7937000,,-16059000,,-16059000,36472000,30801000,-13608000,-13608000,,-2808000,,,,0,40433000,54041000,9632000,-2451000,,-16059000,-16059000,55844,STIM
2016-12-31,8223000,,-11234000,,-11234000,28720000,27606000,-9337000,-9337000,,-1835000,,,,0,34228000,43565000,6622000,-1897000,,-11234000,-11234000,55844,STIM
2019-12-31,6630330,,-17268131,-814279,-16457241,7664965,0,-14295295,-14295295,,-32667,,,,0,0,14295295,0,-2972836,,-17268131,-16727136,55846,PAVM
2018-12-31,4252999,,-18172822,-161512,-17968750,6310206,0,-10563205,-10563205,,-2392447,,,,0,0,10563205,0,-7609617,,-18172822,-18750798,55846,PAVM
2017-12-31,2621526,,-9519269,-161512,-9519269,5412593,0,-8034119,-8034119,,-724684,,,,0,0,8034119,0,-1485150,,-9519269,-10398134,55846,PAVM
2016-12-31,1719587,,-5650851,-161512,-5650851,3931264,0,-5650851,-5650851,,-724684,,,,0,0,5650851,0,0,,-5650851,-5650851,55846,PAVM
2020-11-01,4968000000,,2443000000,,2960000000,1932000000,17370000000,4250000000,4250000000,,-1777000000,,,,-518000000,23888000000,19638000000,6518000000,-1807000000,-1000000,2961000000,2663000000,55847,AVGO
2019-11-03,4696000000,,2226000000,,2724000000,1635000000,15874000000,4331000000,4331000000,,-1444000000,,,,-510000000,22597000000,18266000000,6723000000,-2105000000,-12000000,2736000000,2695000000,55847,AVGO
2018-11-04,3768000000,,4545000000,,12259000000,1027000000,13827000000,5487000000,5487000000,,-628000000,,,,-8084000000,20848000000,15361000000,7021000000,-942000000,-19000000,12629000000,12259000000,55847,AVGO
2017-10-29,3302000000,,1825000000,2901000000.0,1692000000,777000000,11043000000,2689000000,2689000000,,-454000000,,,,35000000,17636000000,14947000000,6593000000,-864000000,-6000000,1790000000,1692000000,55847,AVGO
2020-12-31,,,28749000,,22438000,34726000,72654000,0,30754000,7174000,,,,,6311000,72654000,41900000,0,-2005000,,22438000,22438000,55848,PFBI
2019-12-31,,,31221000,,24196000,35307000,74985000,0,33879000,5799000,,,,,7025000,74985000,41106000,0,-2658000,,24196000,24196000,55848,PFBI
2018-12-31,,,26066000,,20168000,32802000,66537000,0,27652000,6083000,,,,,5898000,66537000,38885000,0,-1586000,,20168000,20168000,55848,PFBI
2017-12-31,,,23426000,,14819000,31502000,63644000,0,26676000,5466000,,,,,8607000,63644000,36968000,0,-3250000,,14819000,14819000,55848,PFBI
2019-12-31,,,-2057000,,-1775000,63168000,71877000,8067000,8067000,,-6285000,,,,-282000,553334000,545267000,481457000,-10124000,,-1775000,-1775000,55851,LMB
2018-12-31,,,-2480000,,-1845000,57089000,59431000,1070000,1070000,,-3305000,,,,-635000,546526000,545456000,487095000,-3550000,,-1845000,-3951000,55851,LMB
2017-12-31,,,3863000,,712000,56023000,65623000,6018000,6018000,,-2034000,,,,3151000,485739000,479721000,420116000,-2155000,,712000,-944000,55851,LMB
2016-12-31,,,-2001000,,1870000,46240000,55657000,6314000,6314000,,-3694000,,,,-3871000,446995000,440681000,391338000,-8315000,,1870000,-1121000,55851,LMB
2019-12-31,2372502,,-6168960,,-6168960,1820477,0,-4192979,-4192979,,-1409096,,,,0,0,4192979,0,-1975981,,-6168960,-6168960,55853,OCUP
2018-12-31,555951,,-1626871,,-1626871,743279,0,-1299230,-1299230,,-196506,,,,0,0,1299230,0,-327641,,-1626871,-1626871,55853,OCUP
2020-06-30,2376000,,383687000,,130364000,440540000,866801000,392939000,392939000,-24584000,,,,,92561000,1299592000,906653000,432791000,-9252000,556000,291126000,598675000,55854,PINC
2019-06-30,1224000,,368139000,,109120000,425831000,862008000,381668000,381668000,-24584000,,,,,33462000,1217638000,835970000,355630000,-13529000,-24650000,334677000,-8944000,55854,PINC
2018-06-30,1423000,,517533000,,33301000,416916000,842660000,548694000,548694000,-177174000,,,,,259526000,1184657000,635963000,341997000,-31161000,-158000,258007000,190882000,55854,PINC
2017-06-30,3107000,,531528000,,113425000,379996000,757525000,333747000,333747000,-5447000,,,,,81924000,1066238000,732491000,308713000,197781000,-51000,449604000,76249000,55854,PINC
2020-06-30,10098439,,-13456800,,-13456800,3446139,-352922,-13929701,-13929701,44217,,,,,0,0,13929701,352922,472901,,-13456800,-13456800,55855,ATHE
2019-06-30,12983185,,-12337830,,-12337830,4308352,4629070,-12795432,-12795432,132965,,,,,0,4951167,17746599,322097,457602,,-12337830,-12337830,55855,ATHE
2018-06-30,6698016,,-8265737,,-8265737,4341058,2901195,-8196051,-8196051,58172,,,,,0,3125775,11321826,224580,-69686,,-8265737,-8265737,55855,ATHE
2017-06-30,5700339,,-7542076,,-7542076,3968630,2913177,-6881863,-6881863,126071,,,,,0,3155069,10036932,241892,-660213,,-7542076,-7542076,55855,ATHE
2019-12-31,,,41135000,,41135000,43698000,59295000,15096000,15096000,,-20422000,,,,0,59295000,44199000,0,26039000,,41135000,41135000,55856,NEWT
2018-12-31,,,35678000,,35678000,39445000,49515000,9586000,9586000,,-16066000,,,,0,49515000,39929000,0,26092000,,35678000,35678000,55856,NEWT
2017-12-31,,,38976000,,38976000,35451000,38914000,3061000,3061000,,-11397000,,,,0,38914000,35853000,0,35915000,,38976000,38976000,55856,NEWT
2016-12-31,,,27305000,,27305000,31489000,30965000,-820000,-820000,,-8440000,,,,0,30965000,31785000,0,28125000,,27305000,27305000,55856,NEWT
2019-12-31,,,37197000,606000,24535000,75706000,135809000,58815000,58815000,1288000,-22806000,,,,12928000,430912000,372097000,295103000,-21618000,,24269000,24535000,55857,TGLS
2018-12-31,,,14462000,872000,9031000,72177000,120217000,47195000,47195000,845000,-21187000,,,,5976000,370984000,323789000,250767000,-32733000,,8486000,9031000,55857,TGLS
2017-12-31,,,11518000,1417000,5449000,63923000,99182000,34364000,34364000,895000,-19872000,,,,5793000,314456000,280092000,215274000,-22846000,,5725000,5449000,55857,TGLS
2016-12-31,,,39252000,1417000,23180000,63497000,112647000,47848000,47848000,1302000,-16814000,,,,16072000,305016000,257168000,192369000,-8596000,,23180000,23180000,55857,TGLS
2020-09-30,,,8980000,,9191000,14392000,17662000,1773000,1773000,,-886000,,,,-211000,113573000,111800000,95911000,7207000,,9191000,9191000,55860,SIF
2019-09-30,,,-8207000,,-7506000,15431000,7006000,-10073000,-10073000,,-1053000,,,,-701000,112454000,122527000,105448000,1866000,,-7506000,-7506000,55860,SIF
2018-09-30,,,-7531000,,-7170000,14812000,10102000,-6415000,-6415000,,-2139000,,,,-361000,111212000,117627000,101110000,-1116000,,-7170000,-7170000,55860,SIF
2017-09-30,,,-13140000,,-14209000,15573000,13364000,-4377000,-4377000,,-2208000,,,,1069000,121458000,125835000,108094000,-8763000,,-14209000,-14209000,55860,SIF
2020-03-29,,,7768000,,6561000,13004000,21590000,7737000,7737000,,-2000,,,,1207000,73396000,65659000,51806000,31000,,6561000,6561000,55862,CRWS
2019-03-31,,,6791000,,5019000,14360000,22307000,7113000,7113000,,-325000,,,,1772000,76381000,69268000,54074000,-322000,,5019000,5019000,55862,CRWS
2018-04-01,,,5421000,,3021000,11180000,19779000,7770000,7770000,,-162000,,,,2400000,70270000,62500000,50491000,-2349000,,3021000,3021000,55862,CRWS
2017-04-02,,,8796000,,5572000,9569000,19411000,9095000,9095000,,-68000,,,,3224000,65978000,56883000,46567000,-299000,,5572000,5572000,55862,CRWS
2019-12-31,12466149,,-19998376,,-20192250,10467714,3165766,-19768097,-19768097,,-1373378,,,,193874,5527571,25295668,2361805,-230279,,-20192250,-20192250,55865,PROF
2018-12-31,10265388,,-20532205,,-20762989,10748070,823777,-20189681,-20189681,,-1092165,,,,230784,2602278,22791959,1778501,-342524,,-20762989,-20762989,55865,PROF
2017-12-31,9638190,,-18748219,,-18822342,9144252,1872342,-16910100,-16910100,,-1384263,,,,74123,4904550,21814650,3032208,-1838119,,-18822342,-18822342,55865,PROF
2016-12-31,9654290,,-16312715,,-16326769,5986124,0,-15640414,-15640414,,-1077202,,,,14054,0,15640414,0,-672301,,-16326769,-16326769,55865,PROF
2020-12-31,,,56603000,,45353000,113288000,196000000,0,56603000,26109000,,,,,11250000,196000000,139397000,0,0,,45353000,45353000,55871,SPFI
2019-12-31,,,36701000,,29220000,102145000,158409000,0,36701000,19563000,,,,,7481000,158409000,121708000,0,0,,29220000,29220000,55871,SPFI
2018-12-31,,,25389000,,29290000,97366000,140832000,0,25389000,18077000,,,,,-3901000,140832000,115443000,0,0,,29290000,29290000,55871,SPFI
2017-12-31,,,23742000,,23635000,89768000,131395000,0,23742000,17885000,,,,,107000,131395000,107653000,0,0,,23635000,23635000,55871,SPFI
2020-01-31,,,286000000,10000000,226000000,288000000,706000000,418000000,418000000,,-90000000,,,,57000000,6379000000,5961000000,5673000000,-132000000,,229000000,226000000,55874,SAIC
2019-02-01,,,170000000,14000000,137000000,158000000,464000000,306000000,306000000,,-53000000,,,,33000000,4659000000,4353000000,4195000000,-136000000,,137000000,137000000,55874,SAIC
2018-02-02,,,214000000,14000000,179000000,155000000,411000000,256000000,256000000,,-44000000,,,,35000000,4454000000,4198000000,4043000000,-42000000,,179000000,179000000,55874,SAIC
2017-02-03,,,212000000,14000000,143000000,166000000,439000000,273000000,273000000,,-52000000,,,,69000000,4442000000,4169000000,4003000000,-61000000,,143000000,143000000,55874,SAIC
2019-12-31,3740642,,-18269904,,-18331479,31019659,17351656,-17408645,-17408645,,-1366924,,,,61575,33941900,51350545,16590244,-861259,,-18331479,-18331479,55875,CYRX
2018-12-31,1840443,,-9535647,,-9555601,17044437,10240265,-8644615,-8644615,,-69253,,,,19954,19626453,28271068,9386188,-891032,,-9555601,-9555601,55875,CYRX
2017-12-31,1205692,,-7893858,,-7899001,12653243,5966433,-7892502,-7892502,,-15693,,,,5143,11954267,19846769,5987834,-1356,,-7899001,-7899001,55875,CYRX
2016-12-31,598106,,-13107547,,-13113220,11269426,3101423,-8766109,-8766109,,-139416,,,,5673,7678816,16444925,4577393,-4341438,,-13113220,-13188680,55875,CYRX
2019-12-31,,,109539000,,83814000,194938000,354380000,0,121258000,38184000,,,,,25725000,354380000,233122000,0,-11719000,,83814000,83367000,55877,FBK
2018-12-31,,,105854000,,80236000,180761000,329312000,0,110882000,37669000,,,,,25618000,329312000,218430000,0,-5028000,,80236000,79808000,55877,FBK
2017-12-31,,,73485000,,52398000,168197000,295802000,0,94514000,33091000,,,,,21087000,295802000,201288000,0,-21029000,,52398000,52398000,55877,FBK
2016-12-31,,,62324000,,40591000,144061000,252667000,0,82675000,25931000,,,,,21733000,252667000,169992000,0,-20351000,,40591000,40591000,55877,FBK
2020-12-31,17119000,,7064000,,6127000,17742000,40384000,5523000,5523000,,,,,,937000,78335000,72812000,37951000,1541000,,6127000,6127000,55878,OIIM
2019-12-31,19065000,,-3868000,,-5039000,19286000,31968000,-6383000,-6383000,,,,,,1171000,60928000,67311000,28960000,2515000,,-5039000,-5039000,55878,OIIM
2018-12-31,19766000,,3229000,,2088000,20332000,31973000,-8125000,-8125000,,,,,,1141000,62714000,70839000,30741000,11354000,,2088000,2088000,55878,OIIM
2017-12-31,17989000,,-5135000,,-6145000,19047000,30779000,-6257000,-6257000,,,,,,1010000,60205000,66462000,29426000,1122000,,-6145000,-6145000,55878,OIIM
2019-12-31,,,9048000,,6787000,21401000,29967000,8566000,8566000,,-58000,,,,2261000,208759000,200193000,178792000,482000,,6787000,6657000,55879,WSTG
2018-12-31,,,5117000,,3538000,20319000,26920000,6601000,6601000,,-37000,,,,1579000,181444000,174843000,154524000,-1484000,,3538000,3420000,55879,WSTG
2017-12-31,,,8553000,,5062000,19263000,27076000,7813000,7813000,,-100000,,,,3491000,160567000,152754000,133491000,740000,,5062000,4840000,55879,WSTG
2016-12-31,,,8933000,,5901000,18715000,27331000,8616000,8616000,,-100000,,,,3032000,164609000,155993000,137278000,317000,,5901000,5650000,55879,WSTG
2020-06-30,14206000,,18686000,,18102000,32064000,52475000,6205000,6205000,,-696000,,,,584000,490339000,484134000,437864000,12481000,,18102000,18102000,55881,QNST
2019-06-30,12329000,,10719000,,62480000,29889000,61645000,19427000,19427000,,-367000,,,,-51761000,455154000,435727000,393509000,-8708000,,62480000,62480000,55881,QNST
2018-06-30,13805000,,16504000,,15930000,28970000,58411000,15636000,15636000,,-367000,,,,574000,404358000,388722000,345947000,868000,,15930000,15930000,55881,QNST
2017-06-30,13476000,,-13288000,,-12208000,25123000,30376000,-8223000,-8223000,,-346000,,,,-1080000,299785000,308008000,269409000,-5065000,,-12208000,-12208000,55881,QNST
2019-12-31,,,24358283,,24358283,1610993,3347468,1736475,1736475,,,,,,0,3347468,1610993,0,22621808,,24358283,24358283,55882,MCN
2018-12-31,,,-15947604,,-15947604,1896878,3116689,1219811,1219811,,,,,,0,3116689,1896878,0,-17167415,,-15947604,-15947604,55882,MCN
2017-12-31,,,11163155,,11163155,1814869,3631352,1816483,1816483,,,,,,0,3631352,1814869,0,9346672,,11163155,11163155,55882,MCN
2016-12-31,,,12594223,,12594223,1726416,2348918,622502,622502,,,,,,0,2348918,1726416,0,11971721,,12594223,12594223,55882,MCN
2019-12-31,7818000,,-3377000,,-4396000,69321000,86424000,5409000,5409000,,-131000,,,,1019000,247735000,242326000,161311000,-8786000,,-4396000,-4396000,55883,DRTT
2018-12-31,4176000,,8830000,,5550000,77418000,107009000,21754000,21754000,,-503000,,,,3280000,274681000,252927000,167672000,-12924000,,5550000,5550000,55883,DRTT
2017-12-31,6335000,,-7267000,,-7725000,81774000,85489000,-5358000,-5358000,,-500000,,,,458000,226539000,231897000,141050000,-1909000,,-7725000,-7725000,55883,DRTT
2016-12-31,6335000,,12136000,,7284000,91295000,116272000,12670000,12670000,,-339000,,,,4852000,267030000,254360000,150758000,-534000,,7284000,7284000,55883,DRTT
2020-01-31,2700000,,-104900000,,-96400000,82700000,81200000,-4200000,-4200000,,-30400000,,,,-8500000,544000000,548200000,462800000,-100700000,,-96400000,-96400000,55884,KLXE
2019-01-31,2400000,,15000000,,14400000,70200000,125300000,52700000,52700000,,-7700000,,,,600000,495300000,442600000,370000000,-37700000,,14400000,14400000,55884,KLXE
2018-01-31,2000000,,-24000000,,-24100000,70100000,51700000,-20400000,-20400000,,-7700000,,,,100000,320500000,340900000,268800000,-3600000,,-24100000,-24100000,55884,KLXE
2017-01-31,300000,,-89500000,,-89600000,60100000,-29100000,-89500000,-89500000,,-7700000,,,,100000,152200000,241700000,181300000,0,,-89600000,-89600000,55884,KLXE
2020-06-30,,,37878000,3890000,30509000,36756000,66973000,30217000,30217000,,-18859000,,,,6387000,5461094000,5430877000,5394121000,7661000,,31491000,30509000,55886,AMRK
2019-06-30,,,3277000,2908000,2225000,32502000,31958000,-544000,-544000,,-17146000,,,,1015000,4783157000,4783701000,4751199000,3821000,,2262000,2225000,55886,AMRK
2018-06-30,,,-3411000,3410000,-3397000,33398000,29443000,-3955000,-3955000,,-13891000,,,,8000,7606248000,7610203000,7576805000,544000,,-3419000,-3397000,55886,AMRK
2017-06-30,,,10785000,3432000,7086000,23243000,31334000,8091000,8091000,,-10117000,,,,3721000,6989624000,6981533000,6958290000,2694000,,7064000,7086000,55886,AMRK
2020-01-31,130188000,,-139782000,500000,-141779000,355663000,339786000,-146065000,-146065000,,-442000,,,,1997000,481413000,627478000,141627000,6283000,,-141779000,-141779000,55887,CRWD
2019-01-31,84551000,,-138710000,500000,-140077000,214899000,162586000,-136864000,-136864000,,-428000,,,,1367000,249824000,386688000,87238000,-1846000,,-140077000,-140077000,55887,CRWD
2018-01-31,58887000,,-134561000,500000,-135490000,136819000,64266000,-131440000,-131440000,,-1648000,,,,929000,118752000,250192000,54486000,-3121000,,-135490000,-141343000,55887,CRWD
2017-01-31,39145000,,-91253000,500000,-91340000,70150000,18739000,-90556000,-90556000,,-615000,,,,87000,52745000,143301000,34006000,-697000,,-91340000,-108352000,55887,CRWD
2019-12-31,749249,,-257636,,39616,6775915,7162314,-362850,-362850,,-203603,,,,-297252,32637484,33000334,25475170,105214,,39616,39616,55888,LIQT
2018-12-31,661014,,-4179958,,-3814528,4890638,1066144,-4485508,-4485508,,-71781,,,,-365430,12232088,16717596,11165944,305550,,-3814528,-3814528,55888,LIQT
2017-12-31,536848,,-4778163,,-4460353,4277158,206751,-4607255,-4607255,,-45888,,,,-317810,11343177,15950432,11136426,-170908,,-4460353,-4460353,55888,LIQT
2016-12-31,626147,,-13198957,,-16418634,6162084,1432429,-5791596,-5791596,,-38945,,,,3219677,13906394,19697990,12473965,-7407361,,-16418634,-16418634,55888,LIQT
2020-03-31,,,3084380,,3084380,1714104,10232874,8518770,8518770,,,,,,0,10232874,1714104,0,-5434390,,3084380,3084380,55889,INSI
2019-03-31,,,8825087,,8782314,1605860,10749886,9144026,9144026,,,,,,42773,10749886,1605860,0,-318939,,8782314,8782314,55889,INSI
2018-03-31,,,9034505,,9034505,1672713,11010442,9337729,9337729,,,,,,0,11010442,1672713,0,-303224,,9034505,9034505,55889,INSI
2017-03-31,,,15561728,,15561728,1667354,11045707,9378353,9378353,,,,,,0,11045707,1667354,0,6183375,,15561728,15561728,55889,INSI
2019-12-31,299726000,,450213000,,523367000,736942000,2033831000,697249000,697249000,,-72261000,,,,-73154000,2161761000,1464512000,127930000,-247036000,,523367000,523367000,55890,JAZZ
2018-12-31,226616000,,527260000,,447098000,625330000,1769378000,715934000,715934000,,-77075000,,,,80162000,1890922000,1174988000,121544000,-188674000,,447098000,447098000,55890,JAZZ
2017-12-31,198442000,,440108000,,487848000,544156000,1508505000,613842000,613842000,,-77756000,,,,-47740000,1618693000,1004851000,110188000,-173734000,,487848000,487848000,55890,JAZZ
2016-12-31,160397000,,532067000,,396831000,480092000,1382587000,640104000,640104000,,-61942000,,,,135236000,1487973000,847869000,105386000,-108037000,,396831000,396831000,55890,JAZZ
2019-12-31,58994000,,-40002000,,-40002000,66578000,84234000,-41338000,-41338000,,,,,,0,143308000,184646000,59074000,1336000,,-40002000,-40002000,55894,CSLT
2018-12-31,60455000,,-39706000,,-39706000,74754000,96215000,-38994000,-38994000,,,,,,0,156404000,195398000,60189000,-712000,,-39706000,-39706000,55894,CSLT
2017-12-31,54502000,,-57108000,,-51902000,86163000,85368000,-55297000,-55297000,,,,,,-5206000,132020000,187317000,46652000,-1811000,,-51902000,-51902000,55894,CSLT
2016-12-31,40460000,,-58686000,,-58686000,82600000,66842000,-56218000,-56218000,,,,,,0,98708000,154926000,31866000,-2468000,,-58686000,-58686000,55894,CSLT
2020-06-30,,,1635188,,1593269,10723752,13040630,1478012,1478012,,-67732,,,,41919,20038054,18560042,6997424,157176,,1593269,1006825,55895,PCYG
2019-06-30,,,4045116,,3902406,10748802,15339524,3989289,3989289,,-42684,,,,142710,21169608,17180319,5830084,55827,,3902406,3315963,55895,PCYG
2018-06-30,,,3514178,,3408783,11298089,15448792,3516849,3516849,,-166888,,,,105395,22036278,18519429,6587486,-2671,,3408783,2835435,55895,PCYG
2017-06-30,,,3885101,,3777532,9234068,13621221,3901129,3901129,,-26408,,,,107569,18939263,15038134,5318042,-16028,,3777532,2986721,55895,PCYG
2020-12-31,,,10969000000,1936000000,8056000000,7332000000,19125000000,11720000000,11720000000,,-728000000,,,,2377000000,28694000000,16974000000,9569000000,-751000000,,8592000000,8036000000,55896,PM
2019-12-31,,,10021000000,1978000000,7185000000,8168000000,19292000000,11058000000,11058000000,,-796000000,,,,2293000000,29805000000,18747000000,10513000000,-1037000000,,7728000000,7168000000,55896,PM
2018-12-31,,,10731000000,1720000000,7911000000,7449000000,18867000000,11336000000,11336000000,,-855000000,,,,2445000000,29625000000,18289000000,10758000000,-605000000,,8286000000,7895000000,55896,PM
2017-12-31,,,10648000000,1856000000,6035000000,6725000000,18316000000,11503000000,11503000000,,-1096000000,,,,4307000000,28748000000,17245000000,10432000000,-855000000,,6341000000,6021000000,55896,PM
2020-09-30,,,2983000000,281500000,2373700000,1683100000,4622000000,2938900000,2938900000,,,,,,602500000,20311100000,17372200000,15689100000,44100000,,2380500000,2373700000,55897,DHI
2019-09-30,,,2125300000,274200000,1618500000,1539500000,3650600000,2111100000,2111100000,,,,,,506700000,17592900000,15481800000,13942300000,14200000,,1618600000,1618500000,55897,DHI
2018-09-30,,,2060000000,174500000,1460300000,1404200000,3462800000,2058600000,2058600000,,,,,,597700000,16068000000,14009400000,12605200000,1400000,,1462300000,1460300000,55897,DHI
2017-09-30,,,1602100000,500000,1038400000,1232300000,2834800000,1602500000,1602500000,,,,,,563700000,14091000000,12488500000,11256200000,-400000,,1038400000,1038400000,55897,DHI
2020-10-31,,,11533095,,11533095,25365597,160368981,135003384,135003384,,-21424891,,,,0,160368981,25365597,0,-123470289,,11533095,11533095,55901,NZF
2019-10-31,,,334904972,,334904972,25750350,166159469,140409119,140409119,,-33617306,,,,0,166159469,25750350,0,194495853,,334904972,334904972,55901,NZF
2018-10-31,,,-18732903,,-18732903,25325435,168495371,143169936,143169936,,-28690022,,,,0,168495371,25325435,0,-161902839,,-18732903,-18732903,55901,NZF
2017-10-31,,,84179706,,84179706,30307523,170941416,140633893,140633893,,-16515175,,,,0,170941416,30307523,0,-56454187,,84179706,84179706,55901,NZF
2020-01-31,,,5623000000,,4281000000,15282000000,23100000000,6579000000,6579000000,,-718000000,,,,1342000000,72148000000,65569000000,49048000000,-956000000,,4281000000,4268000000,55903,LOW
2019-02-01,,,3394000000,,2314000000,16431000000,22908000000,5153000000,5153000000,,-652000000,,,,1080000000,71309000000,66156000000,48401000000,-1759000000,,2314000000,2307000000,55903,LOW
2018-02-02,,,5489000000,,3447000000,14444000000,22434000000,6586000000,6586000000,,-652000000,,,,2042000000,68619000000,62033000000,46185000000,-1097000000,,3447000000,3436000000,55903,LOW
2017-02-03,,,5201000000,,3093000000,14328000000,21674000000,5893000000,5893000000,,-657000000,,,,2108000000,65017000000,59124000000,43343000000,-692000000,,3093000000,3062000000,55903,LOW
2019-12-31,,,-9186000,,-9186000,14205000,6663000,-8329000,-8329000,,-863000,,,,0,59830000,68159000,53167000,-857000,,-9186000,-9186000,55904,SUNW
2018-12-31,,,-5740000,,-5740000,13825000,12264000,-3258000,-3258000,,-544000,,,,0,70965000,74223000,58701000,-2482000,,-5740000,-5740000,55904,SUNW
2017-12-31,,,-7222000,,-7222000,18408000,13663000,-6314000,-6314000,,-924000,,,,0,77448000,83762000,63785000,-908000,,-7222000,-7222000,55904,SUNW
2016-12-31,,,-9380000,,-9380000,23764000,22110000,-8018000,-8018000,,-1033000,,,,0,86421000,94439000,64311000,-1362000,,-9380000,-9380000,55904,SUNW
2020-12-31,,,67393000000,,46853000000,212136000000,546460000000,165355000000,165355000000,4725000000,-33600000000,,,,16366000000,1016887000000,851532000000,470427000000,-97962000000,,51027000000,46853000000,55906,AMX
2019-12-31,,,121346988000,48996906000.0,67730891000,227370919000,535611712000,143582753000,143582753000,5742830000,-36194503000,,,,51033533000,1007347869000,863765116000,471736157000,-22235765000,,70313455000,67730891000,55906,AMX
2018-12-31,,,100993902000,49876777000.0,52566197000,237161004000,529385251000,130253422000,130253422000,6258245000,-30307066000,,,,46477079000,1038207681000,907954259000,508822430000,-29259520000,,54516823000,52566197000,55906,AMX
2017-12-31,,,57096844000,66469205000.0,29325921000,249357042000,525297789000,91565917000,91565917000,24199888000,-28929728000,,,,24941511000,1021633535000,930067618000,496335746000,-34469073000,,32155333000,29325921000,55906,AMX
2020-12-31,,,14393000,,11940000,25905000,42830000,0,14902000,2023000,,,,,2453000,42830000,27928000,0,-509000,,11940000,11775000,55907,SAL
2019-12-31,,,13495000,,11136000,25481000,42407000,0,14988000,1938000,,,,,2359000,42407000,27419000,0,-1493000,,11136000,10976000,55907,SAL
2018-12-31,,,10533000,,8824000,25722000,40027000,0,12344000,1961000,,,,,1709000,40027000,27683000,0,-1811000,,8824000,8713000,55907,SAL
2017-12-31,,,9170000,,6256000,24082000,38476000,0,12356000,2038000,,,,,2914000,38476000,26120000,0,-3186000,,6256000,6201000,55907,SAL
2020-12-31,,,-1006000000,26000000,-770000000,2154000000,3083000000,929000000,929000000,,-274000000,,,,-236000000,9385000000,8456000000,6302000000,-1935000000,,-770000000,-770000000,55908,NWL
2019-12-31,149000000.0,,-851600000,32700000,106600000,2263800000,3235300000,822500000,822500000,,-303300000,,,,-1037700000,9714900000,8892400000,6479600000,-1674100000,-79500000.0,186100000,106600000,55908,NWL
2018-12-31,151000000.0,,-7991700000,34800000,-6942500000,2485700000,3517700000,881000000,881000000,,-449300000,,,,-1358900000,10154000000,9273000000,6636300000,-8872700000,-309700000.0,-6632800000,-6942500000,55908,NWL
2017-12-31,175000000.0,,919300000,36600000,2748800000,2749100000,3810500000,886400000,886400000,,-475800000,,,,-1515000000,11170400000,10284000000,7359900000,32900000,314500000.0,2434300000,2748800000,55908,NWL
2019-12-31,,,-32057000,,-32057000,8309000,12078000,85000,85000,,-570000,,,,0,26846000,26761000,14768000,-32142000,,-32057000,-32057000,55910,PSHG
2018-12-31,,,-52895000,,-52895000,8030000,8846000,-4129000,-4129000,,-11467000,,,,0,25566000,29695000,16720000,-48766000,,-52895000,-52895000,55910,PSHG
2017-12-31,,,3819000,,3819000,8366000,-628000,-17141000,-17141000,,-13761000,,,,0,23806000,40947000,24434000,20960000,,3819000,3819000,55910,PSHG
2016-12-31,,,-149014000,,-149014000,7241000,-188000,-20169000,-20169000,,-7021000,,,,0,33194000,53363000,33382000,-128845000,,-149014000,-149014000,55910,PSHG
2019-12-31,,,296000000,,313000000,197000000,1224000000,540000000,540000000,304000000,-175000000,,,,-17000000,16596000000,16056000000,15372000000,-244000000,,313000000,235000000,55912,SUN
2018-12-31,,,92000000,,-207000000,141000000,1050000000,364000000,364000000,363000000,-147000000,,,,34000000,16994000000,16630000000,15944000000,-272000000,-265000000.0,58000000,-285000000,55912,SUN
2017-12-31,,,20000000,,149000000,140000000,1027000000,343000000,343000000,375000000,-210000000,,,,-306000000,11723000000,11380000000,10696000000,-323000000,-177000000.0,326000000,35000000,55912,SUN
2016-12-31,,,-16000000,,-406000000,236000000,1156000000,370000000,370000000,374000000,-164000000,,,,-72000000,9986000000,9616000000,8830000000,-386000000,-462000000.0,56000000,-492000000,55912,SUN
2020-12-31,,,515300000,3400000,441800000,6782000000,7539600000,757600000,757600000,,-104500000,,,,72600000,10088900000,9331300000,2549300000,-242300000,,442700000,423100000,55913,AIZP
2019-12-31,,,554500000,29300000,382600000,6782000000,934300000,740300000,740300000,194000000.0,-110600000,,,,167700000,9923800000,9183500000,8989500000,-185800000,,386800000,363900000,55913,AIZP
2018-12-31,,,333500000,21900000,251000000,6782000000,785600000,515000000,515000000,270600000.0,-100300000,,,,80900000,8057600000,7542600000,7272000000,-181500000,,252600000,236800000,55913,AIZP
2017-12-31,,,444500000,10900000,519600000,6782000000,707500000,494000000,494000000,213500000.0,-49500000,,,,-75100000,6415000000,5921000000,5707500000,-49500000,,519600000,519600000,55913,AIZP
2019-12-31,,,1244000000,10000000,881000000,452000000,2512000000,1565000000,1565000000,149000000,-414000000,,,,358000000,3766000000,2201000000,1254000000,-321000000,,886000000,881000000,55916,HLT
2018-12-31,,,1078000000,7000000,764000000,454000000,2336000000,1421000000,1421000000,136000000,-371000000,,,,309000000,3668000000,2247000000,1332000000,-343000000,,769000000,764000000,55916,HLT
2017-12-31,,,753000000,3000000,1084000000,449000000,2135000000,1122000000,1122000000,228000000,-351000000,,,,-336000000,3404000000,2282000000,1269000000,-369000000,,1089000000,1084000000,55916,HLT
2016-12-31,,,540000000,-50000000,338000000,401000000,1691000000,859000000,859000000,78000000,-330000000,,,,557000000,2970000000,2111000000,1279000000,-319000000,371000000.0,-17000000,338000000,55916,HLT
2020-12-31,,,2530000000,,2013000000,,4632000000,3478000000,3478000000,,-625000000,,,,517000000,9789000000,6311000000,5157000000,-948000000,,2013000000,2010000000,55919,NSC
2019-12-31,,,3491000000,,2722000000,,5159000000,4052000000,4052000000,-31000000.0,-604000000,,,,769000000,11296000000,7244000000,6137000000,-561000000,,2722000000,2717000000,55919,NSC
2018-12-31,,,3469000000,,2666000000,,5122000000,4020000000,4020000000,-31000000.0,-557000000,,,,803000000,11458000000,7438000000,6336000000,-551000000,,2666000000,2660000000,55919,NSC
2017-12-31,,,3128000000,,5404000000,,4641000000,3586000000,3586000000,-31000000.0,-550000000,,,,-2276000000,10551000000,6965000000,5910000000,-458000000,,5404000000,5400000000,55919,NSC
2019-12-31,6079042,,-12928998,,-12941658,7952035,0,-14031077,-14031077,,,,,,12660,0,14031077,0,1102079,,-12941658,-12941658,55920,MNOV
2018-12-31,5625814,,-14669811,,-14675087,9961012,0,-15586826,-15586826,,,,,,5276,0,15586826,0,917015,,-14675087,-14675087,55920,MNOV
2017-12-31,4166746,,-12907186,,-11163136,8860347,0,-13027093,-13027093,,,,,,-1744050,0,13027093,0,119907,,-11163136,-11163136,55920,MNOV
2016-12-31,3462172,,-10862225,,-10865979,7419662,0,-10881834,-10881834,,,,,,3754,0,10881834,0,19609,,-10865979,-10865979,55920,MNOV
2019-12-31,18400000,,34400000,2400000,46300000,273000000,383100000,91700000,91700000,,-20000000,,,,-6600000,1013500000,921800000,630400000,-57300000,5700000,41000000,46300000,55922,GCP
2018-12-31,20200000,,10500000,2000000,15200000,289100000,410100000,100800000,100800000,,-29100000,,,,26300000,1125400000,1024600000,715300000,-90300000,31300000,-15800000,15200000,55922,GCP
2017-12-31,20000000,,-28300000,1800000,553400000,290400000,420000000,109600000,109600000,,-61100000,,,,82100000,1084400000,974800000,664400000,-137900000,664300000,-110400000,553400000,55922,GCP
2016-12-31,18400000,,35300000,3700000,72800000,266300000,418900000,134200000,134200000,,-64600000,,,,6700000,1046500000,912300000,627600000,-98900000,45200000,28600000,72800000,55922,GCP
2019-12-31,,,35014000,,26991000,79770000,122215000,0,36677000,5768000,,,,,8450000,122215000,85538000,0,-1663000,427000,26564000,26512000,55923,MVBF
2018-12-31,,,15376000,,12003000,65708000,88254000,0,17222000,5324000,,,,,3373000,88254000,71032000,0,-1846000,427000,12003000,11514000,55923,MVBF
2017-12-31,,,12330000,,7575000,63844000,82486000,0,13783000,4859000,,,,,4755000,82486000,68703000,0,-1453000,427000,7575000,7077000,55923,MVBF
2016-12-31,,,13355000,,12912000,62792000,82564000,0,14883000,4889000,,,,,4378000,82564000,67681000,0,-1528000,3935000,8977000,11784000,55923,MVBF
2019-12-31,,,-4123000,84549000,-1665000,8201000,62312000,34462000,34462000,,-35187000,,,,0,116165000,81703000,53853000,-38585000,,-4123000,-1984000,55925,CLPR
2018-12-31,,,-9001000,96303000,-3633000,9873000,60336000,32458000,32458000,,-32781000,,,,0,109997000,77539000,49661000,-41459000,,-9001000,-3902000,55925,CLPR
2017-12-31,,,-6001000,110679000,-2357000,9944000,56169000,29504000,29504000,,-35505000,,,,0,103952000,74448000,47783000,-35505000,,-6001000,-2594000,55925,CLPR
2016-12-31,,,-12339000,88015000,-3735000,8405000,49497000,25797000,25797000,,-38136000,,,,0,93005000,67208000,43508000,-38136000,,-12339000,-3874000,55925,CLPR
2020-09-30,,,10020000,,7114000,24195000,45589000,14391000,14391000,,-3562000,,,,2906000,209185000,194794000,163596000,-4371000,,7114000,7114000,55926,DLHC
2019-09-30,,,7495000,,5324000,20525000,35840000,11359000,11359000,,-2494000,,,,2171000,160391000,149032000,124551000,-3864000,,5324000,5324000,55926,DLHC
2018-09-30,,,7666000,,1836000,16838000,27862000,8782000,8782000,,-1075000,,,,5830000,133236000,124454000,105374000,-1116000,,1836000,1836000,55926,DLHC
2017-09-30,,,5402000,,3288000,17466000,25850000,6630000,6630000,,-1151000,,,,2114000,115662000,109032000,89812000,-1228000,,3288000,3288000,55926,DLHC
2020-02-29,,,7751900,,5645100,69105900,76148600,7042700,7042700,,-888100,,,,2106800,113011900,105969200,36863300,709200,,5645100,5645100,55927,EDUC
2019-02-28,,,9180800,,6678400,71195300,79747700,8552400,8552400,,-931300,,,,2502400,118811300,110258900,39063600,628400,,6678400,6678400,55927,EDUC
2018-02-28,,,7832700,,5214700,68790000,76160300,7370300,7370300,,-1119500,,,,2618000,111984600,104614300,35824300,462400,,5214700,5214700,55927,EDUC
2017-02-28,,,4612100,,2860900,72986100,78014600,5028500,5028500,,-1028800,,,,1751200,106628100,101599600,28613500,-416400,,2860900,2860900,55927,EDUC
2019-12-31,,,5466000,,5820000,13632000,47042000,13650000,13650000,,-5576000,,,,-354000,107383000,93733000,60341000,-8184000,,5820000,5820000,55931,MNTK
2018-12-31,,,36563000,,28767000,11953000,65001000,36853000,36853000,,-3083000,,,,7796000,116433000,79580000,51432000,-290000,,28767000,28767000,55931,MNTK
2020-12-31,,,56897000,,46916000,126053000,211895000,0,60927000,24915000,,,,,9981000,211895000,150968000,0,-4030000,,46916000,46916000,55933,UVSP
2019-12-31,,,80053000,,65719000,121287000,226136000,0,81702000,23147000,,,,,14334000,226136000,144434000,0,-1649000,,65719000,65719000,55933,UVSP
2018-12-31,,,60686000,,50543000,111941000,197479000,0,62647000,22891000,,,,,10143000,197479000,134832000,0,-1961000,,50543000,50543000,55933,UVSP
2017-12-31,,,61811000,,44094000,106471000,191635000,0,62558000,22606000,,,,,17717000,191635000,129077000,0,-747000,,44094000,44094000,55933,UVSP
2019-12-31,40581000,,-61317000,,-61317000,21721000,0,-62302000,-62302000,,,,,,0,0,62302000,0,985000,,-61317000,-61317000,55934,GBIO
2018-12-31,25317000,,-35803000,,-35803000,12013000,36000,-37294000,-37294000,,,,,,0,36000,37330000,0,1491000,,-35803000,-35803000,55934,GBIO
2020-08-31,,,-14397,,-14397,545596,1867878,1322282,1322282,,-253166,,,,0,1867878,545596,0,-1336679,,-14397,-14397,55935,BZM
2019-08-31,,,2764967,,2764967,582033,1925809,1343776,1343776,,-351189,,,,0,1925809,582033,0,1421191,,2764967,2764967,55935,BZM
2018-08-31,,,381912,,381912,559874,1976405,1416531,1416531,,-277904,,,,0,1976405,559874,0,-1034619,,381912,381912,55935,BZM
2017-08-31,,,-155020,,-155020,549315,1938507,1389192,1389192,,-168465,,,,0,1938507,549315,0,-1544212,,-155020,-155020,55935,BZM
2020-04-03,328000000,,819000000,,3887000000,1069000000,2097000000,620000000,620000000,,-196000000,,,,241000000,2490000000,1870000000,393000000,199000000,3309000000,578000000,3887000000,55938,NLOK
2019-03-29,420000000,,-107000000,,31000000,1122000000,2001000000,379000000,379000000,,-208000000,,,,3000000,2456000000,2077000000,455000000,-486000000,141000000,-110000000,31000000,55938,NLOK
2018-03-30,455000000,,244000000,,1138000000,1328000000,2096000000,226000000,226000000,,-256000000,,,,-720000000,2559000000,2333000000,463000000,18000000,174000000,964000000,1138000000,55938,NLOK
2017-03-31,823000000,,-262000000,,-106000000,2023000000,3166000000,173000000,173000000,,-208000000,,,,-26000000,4019000000,3846000000,853000000,-435000000,130000000,-236000000,-106000000,55938,NLOK
2019-12-31,,,-10615000,,-15390000,627861000,1104668000,299230000,299230000,,-229262000,,,,4775000,4889747000,4590517000,3785079000,-309845000,,-15390000,-15390000,55939,CNR
2018-12-31,,,-581142000,,-457140000,574698000,504540000,-190950000,-190950000,,-171336000,,,,-124002000,3359220000,3550170000,2854680000,-390192000,,-457140000,-457140000,55939,CNR
2018-10-28,,,83095000,,63106000,307106000,462682000,145928000,145928000,,-21808000,,,,19989000,2000577000,1854649000,1537895000,-62833000,,63106000,62694000,55939,CNR
2017-10-29,,,83138000,,54724000,293145000,416064000,113299000,113299000,,-28899000,,,,28414000,1770278000,1656979000,1354214000,-30161000,,54724000,54399000,55939,CNR
2020-12-31,,,61943000,133000,46188000,121824000,195829000,0,63313000,10692000,,,,,15755000,195829000,132516000,0,-1370000,,46188000,46188000,55940,AMAL
2019-12-31,,,64174000,134000,47202000,117259000,192001000,0,65548000,9194000,,,,,16972000,192001000,126453000,0,-1374000,,47202000,47180000,55940,AMAL
2018-12-31,,,50320000,134000,44654000,115109000,178323000,0,52389000,10825000,,,,,5666000,178323000,125934000,0,-2069000,,44654000,44632000,55940,AMAL
2017-12-31,,,19721000,134000,6108000,112509000,141995000,0,19992000,9494000,,,,,13613000,141995000,122003000,0,-271000,,6108000,5952000,55940,AMAL
2020-12-31,,,176145000,,132217000,121541000,320307000,0,184086000,14680000,,,,,43928000,320307000,136221000,0,-7941000,,132217000,132217000,55942,EGBN
2019-12-31,,,196791000,,142943000,112462000,336653000,0,208197000,15994000,,,,,53848000,336653000,128456000,0,-11406000,,142943000,142943000,55942,EGBN
2018-12-31,,,204208000,,152276000,107416000,330919000,0,207720000,15783000,,,,,51932000,330919000,123199000,0,-3512000,,152276000,152276000,55942,EGBN
2017-12-31,,,185736000,,100232000,100129000,304288000,0,188290000,15869000,,,,,85504000,304288000,115998000,0,-2554000,,100232000,100232000,55942,EGBN
2020-12-31,,,30367000,,29809000,7195000,95843000,47243000,47243000,,-16741000,,,,0,140865000,93622000,45022000,-16876000,,30367000,29809000,55943,CPLP
2019-12-31,,,24421000,8572000.0,-122691000,5502000,74895000,40132000,40132000,,-15836000,,,,0,108374000,68242000,33479000,-15711000,-146876000.0,24421000,-134592000,55943,CPLP
2018-12-31,,,-7611000,15436000.0,248000,5713000,77834000,39308000,39308000,,-17422000,,,,0,117595000,78287000,39761000,-46919000,7507000.0,-7611000,-10750000,55943,CPLP
2017-12-31,,,15795000,16427000.0,38397000,6236000,80141000,37926000,37926000,,-18441000,,,,0,116672000,78746000,36531000,-22131000,22688000.0,15795000,27283000,55943,CPLP
2020-06-30,9700000,,33047000,,24506000,278176000,337233000,33457000,33457000,,,,,,8541000,1040765000,1007308000,703532000,-410000,,24506000,24506000,55946,LRN
2019-06-30,9500000,,47729000,,37209000,268029000,338615000,45486000,45486000,,,,,,10520000,1015752000,970266000,677137000,2243000,,37209000,37209000,55946,LRN
2018-06-30,9200000,,26510000,,27620000,261194000,313139000,25545000,25545000,,,,,,-910000,917734000,892189000,604595000,965000,,27420000,27620000,55946,LRN
2017-06-30,12457000,,4937000,700000.0,451000,300717000,331903000,18729000,18729000,,,,,,5396000,888519000,869790000,556616000,-13792000,,-459000,451000,55946,LRN
2020-06-30,,,-3772000000,3000000,-3696000000,4572000000,6868000000,1779000000,1779000000,,-238000000,,,,-79000000,152922000000,151143000000,146054000000,-5551000000,,-3693000000,-3696000000,55948,CAH
2019-06-30,,,1751000000,2000000,1363000000,4480000000,6834000000,1808000000,1808000000,,-294000000,,,,386000000,145534000000,143726000000,138700000000,-57000000,,1365000000,1363000000,55948,CAH
2018-06-30,,,-228000000,12000000,256000000,4596000000,7181000000,1985000000,1985000000,,-329000000,,,,-487000000,136809000000,134824000000,129628000000,-2213000000,,259000000,256000000,55948,CAH
2017-06-30,,,1924000000,138000000,1288000000,3775000000,6544000000,2291000000,2291000000,,-201000000,,,,630000000,129976000000,127685000000,123432000000,-367000000,,1294000000,1288000000,55948,CAH
2018-12-31,58000000,,28700000,,-23700000,295600000,708600000,183400000,183400000,,-134700000,,,,52400000,1212800000,1029400000,504200000,-154700000,,-23700000,-23700000,55949,ATC
2017-12-31,68900000,,-50900000,,-73600000,270500000,630500000,146000000,146000000,,-94200000,,,,22700000,1184900000,1038900000,554400000,-196900000,,-73600000,-73600000,55949,ATC
2016-12-31,79100000,,237300000,,173000000,266400000,653800000,256400000,256400000,,-4500000,,,,64300000,1124200000,867800000,470400000,-19100000,,173000000,173000000,55949,ATC
2020-12-31,,,423000000,,499000000,,775000000,775000000,775000000,,-284000000,,,,-76000000,17439000000,16664000000,16664000000,-352000000,,499000000,499000000,55950,LNC
2019-12-31,,,919000000,,886000000,2691000000.0,4589000000,1441000000,1441000000,431000000.0,-326000000,,,,33000000,17258000000,15817000000,12669000000,-522000000,,886000000,886000000,55950,LNC
2018-12-31,,,1885000000,,1641000000,2418000000.0,5167000000,2343000000,2343000000,397000000.0,-297000000,,,,244000000,16424000000,14081000000,11257000000,-458000000,,1641000000,1641000000,55950,LNC
2017-12-31,,,1130000000,,2079000000,2204000000.0,4871000000,2331000000,2331000000,332000000.0,-253000000,,,,-949000000,14257000000,11926000000,9386000000,-1201000000,,2079000000,2079000000,55950,LNC
2019-12-31,,,-123362000,200943000,-128243000,123506000,1106875000,77816000,77816000,106314000,-176223000,,,,-32715000,1959152000,1881336000,852277000,-201178000,,-90647000,-128243000,55952,OAS
2018-12-31,,,-25343000,184304000,-35296000,121346000,1259727000,118882000,118882000,-28457000,-159085000,,,,-5843000,2188251000,2069369000,928524000,-144225000,,-19500000,-35296000,55952,OAS
2017-12-31,,,-75858000,137888000,123796000,91797000,783280000,70537000,70537000,71657000,-146837000,,,,-203304000,1205586000,1135049000,422306000,-146395000,,127446000,123796000,55952,OAS
2016-12-31,,,-371554000,137888000,-243016000,89342000,442612000,-234847000,-234847000,105317000,-140305000,,,,-128538000,648100000,882947000,205488000,-136707000,,-243016000,-243016000,55952,OAS
2019-12-31,,,4163000,18899000,4147000,21475000,216377000,58572000,58572000,,-77994000,,,,0,299744000,241172000,83367000,-54409000,,4163000,-3101000,55953,AFINO
2018-12-31,,,-37471000,8335000,-37409000,23233000,208339000,40433000,40433000,,-66789000,,,,0,291207000,250774000,82868000,-77904000,,-37471000,-37409000,55953,AFINO
2017-12-31,,,-46577000,4546000,-46494000,19791000,197257000,23411000,23411000,,-60305000,,,,0,270910000,247499000,73653000,-69988000,,-46577000,-46494000,55953,AFINO
2016-12-31,,,-54255000,4546000,-54255000,11168000,138991000,26680000,26680000,,-54253000,,,,0,177668000,150988000,38677000,-80935000,,-54255000,-54255000,55953,AFINO
2019-12-31,45038000,,-193083000,,-193548000,213329000,100773000,-192212000,-192212000,,-4367000,,,,465000,13207315000,13399527000,13106542000,-871000,,-193548000,-193548000,55955,MKD
2018-12-31,36889000,,-254639000,,-254639000,277165000,80169000,-235792000,-235792000,,-19049000,,,,0,9053266000,9289058000,8973097000,-18847000,,-254639000,-254639000,55955,MKD
2017-12-31,18608000,,-107807000,,-107807000,106680000,50234000,-89731000,-89731000,,-16828000,,,,0,4201907000,4291638000,4151673000,-18076000,,-107807000,-107807000,55955,MKD
2016-12-31,20067000,,-113936000,,-113936000,100961000,26118000,-105773000,-105773000,,-8436000,,,,0,3206079000,3311852000,3179961000,-8163000,,-113936000,-113936000,55955,MKD
2020-10-31,,,6206161,,6206161,4416554,11809530,7392976,7392976,,-1767953,,,,0,11809530,4416554,0,-1186815,,6206161,6206161,55956,ETO
2019-10-31,,,57795939,,57795939,4341241,14588966,10247725,10247725,,-3601033,,,,0,14588966,4341241,0,47548214,,57795939,57795939,55956,ETO
2018-10-31,,,-4906098,,-4906098,4547833,14058459,9510626,9510626,,-2948109,,,,0,14058459,4547833,0,-14416724,,-4906098,-4906098,55956,ETO
2017-10-31,,,72200034,,72200034,4412851,13588416,9175565,9175565,,-2060802,,,,0,13588416,4412851,0,63024469,,72200034,72200034,55956,ETO
2020-12-31,,,-45086000,,-45858000,77349000,112502000,0,21511000,13642000,,,,,772000,112502000,90991000,0,-66597000,,-45858000,-45858000,55959,CARE
2019-12-31,,,27784000,,26575000,73456000,123360000,0,34260000,15644000,,,,,1209000,123360000,89100000,0,-6476000,,26575000,26575000,55959,CARE
2018-12-31,,,14308000,,11905000,69529000,109775000,0,27633000,12613000,,,,,2403000,109775000,82142000,0,-15178000,,11905000,11905000,55959,CARE
2017-12-31,,,-18212000,,-681000,66677000,72394000,0,-3622000,9339000,,,,,-17531000,72394000,76016000,0,-14590000,,-681000,-681000,55959,CARE
2019-12-31,72380000,,80517000,,65234000,611181000,855713000,121055000,121055000,,-38525000,,,,15283000,1168070000,1047015000,312357000,-40538000,,65234000,65234000,55962,NUVA
2018-12-31,61695000,,8723000,,12479000,575836000,790555000,102354000,102354000,,-37857000,,,,-3756000,1101714000,999360000,311159000,-93631000,,12479000,12479000,55962,NUVA
2017-12-31,50425000,,72363000,3845000.0,81598000,539507000,758244000,120273000,120273000,,-38021000,,,,-7492000,1026685000,906412000,268441000,-47910000,,79855000,81598000,55962,NUVA
2016-12-31,47999000,,64780000,5588000.0,37192000,533600000,722027000,98427000,98427000,,-40520000,,,,29309000,962132000,863705000,240105000,-33647000,,35471000,37192000,55962,NUVA
2019-12-31,2400000,,-11909000,,-11939000,25777000,19768000,-8409000,-8409000,,-5381000,,,,30000,42901000,51310000,23133000,-3500000,,-11939000,-11939000,55963,AZYO
2018-12-31,2481000,,-11540000,,-11566000,21685000,15945000,-8221000,-8221000,,-5519000,,,,26000,39038000,47259000,23093000,-3319000,,-11566000,-11566000,55963,AZYO
2020-12-31,,,14723000,21394000,30640000,24141000,129288000,25695000,25695000,,-55994000,,,,0,231098000,205403000,101810000,-10972000,,14723000,-44674000,55964,BRG
2019-12-31,,,29119000,48170000,36743000,22553000,139864000,46859000,46859000,,-59554000,,,,0,219768000,172909000,79904000,-17740000,,29119000,-20704000,55964,BRG
2018-12-31,,,-15275000,56597000,-1152000,19553000,122524000,40288000,40288000,,-52998000,,,,0,195028000,154740000,72504000,-55563000,,-15275000,-43433000,55964,BRG
2017-12-31,,,-7028000,63346000,-15645000,51095000,66422000,-33297000,-33297000,,-31520000,,,,0,133912000,167209000,67490000,26269000,,-7028000,-45679000,55964,BRG
2020-10-03,,,24170000,,19009000,31348000,55787000,24439000,24439000,,-106000,,,,5161000,472618000,448179000,416831000,-269000,,19009000,19009000,55965,IIIN
2019-09-28,,,7455000,,5598000,24552000,29416000,4864000,4864000,,-168000,,,,1857000,455713000,450849000,426297000,2591000,,5598000,5598000,55965,IIIN
2018-09-29,,,42630000,,36266000,28330000,70368000,42038000,42038000,,-114000,,,,6364000,453217000,411179000,382849000,592000,,36266000,36266000,55965,IIIN
2017-09-30,,,34168000,,22548000,25508000,59781000,34273000,34273000,,-136000,,,,11620000,388871000,354598000,329090000,-105000,,22548000,22548000,55965,IIIN
2020-12-31,,,1959000000,132000000,1431000000,1509000000,3717000000,2108000000,2108000000,-3000000,-163000000,,,,460000000,9437000000,7329000000,5720000000,-149000000,,1499000000,1425000000,55967,DGX
2019-12-31,,,1133000000,122000000,858000000,1409000000,2724000000,1219000000,1219000000,-3000000,-180000000,,,,247000000,7726000000,6507000000,5002000000,-86000000,20000000.0,886000000,855000000,55967,DGX
2018-12-31,,,970000000,128000000,736000000,1359000000,2661000000,1214000000,1214000000,-2000000,-169000000,,,,182000000,7531000000,6317000000,4870000000,-244000000,20000000.0,788000000,733000000,55967,DGX
2017-12-31,,,1065000000,114000000,772000000,1421000000,2694000000,1198000000,1198000000,1000000,-153000000,,,,241000000,7402000000,6204000000,4708000000,-133000000,20000000.0,824000000,769000000,55967,DGX
2019-12-31,,,-35582000,,-36030000,94905000,144415000,-17189000,-17189000,,-54645000,,,,448000,443335000,460524000,298920000,-18393000,,-36030000,-36030000,55969,CSU
2018-12-31,,,-55367000,,-53596000,86812000,160567000,2503000,2503000,,-63166000,,,,-1771000,457028000,454525000,296461000,-57870000,,-53596000,-53596000,55969,CSU
2017-12-31,,,-41672000,,-44168000,82806000,177487000,20800000,20800000,,-49471000,,,,2496000,465249000,444449000,287762000,-62472000,,-44168000,-44168000,55969,CSU
2016-12-31,,,-27582000,,-28017000,85389000,171822000,14390000,14390000,,-42207000,,,,435000,445721000,431331000,273899000,-41972000,,-28017000,-28017000,55969,CSU
2019-12-31,8239000,,32472000,38774000,20266000,60238000,102129000,33652000,33652000,,-11000,,,,6874000,325630000,291978000,223501000,-1180000,,25598000,12795000,55972,MGIC
2018-12-31,5696000,,31847000,31648000,19883000,51424000,88818000,31698000,31698000,,-4000,,,,7071000,284375000,252677000,195557000,149000,,24776000,18157000,55972,MGIC
2017-12-31,6942000,,24245000,29121000,15442000,50081000,82979000,25956000,25956000,,-62000,,,,6331000,258140000,232184000,175161000,-1711000,,17914000,15442000,55972,MGIC
2016-12-31,5839000,,20657000,26421000,14169000,41338000,68264000,21087000,21087000,,-257000,,,,3949000,201646000,180559000,133382000,-430000,,16708000,11907000,55972,MGIC
2019-12-31,4371179000,,-11414354000,1477874000,-11413101000,5509188000,-1198822000,-11079189000,-11079189000,,-370536000,,,,7888000,7824904000,18904093000,9023726000,-335165000,,-11422242000,-11413101000,55973,NIO
2018-12-31,3964837000,,-23347523000,1313301000,-23327862000,5374895000,-255876000,-9595608000,-9595608000,,-123643000,,,,22044000,4951171000,14546779000,5207047000,-13751915000,,-23369567000,-23327862000,55973,NIO
2017-12-31,2590522000,,-7590203000,11309000,-7561669000,2363074000,0,-4953596000,-4953596000,,-18084000,,,,7906000,0,4953596000,0,-2636607000,,-7598109000,-7561669000,55973,NIO
2016-12-31,1454868000,,-3550173000,-11583000,-3517549000,1147672000,0,-2602540000,-2602540000,,-55000,,,,4314000,0,2602540000,0,-947633000,,-3554487000,-3517549000,55973,NIO
2020-05-31,15400000,,478200000,,365900000,311800000,942200000,615000000,615000000,,-108000000,,,,112300000,3792400000,3177400000,2850200000,-136800000,,365900000,365900000,55974,LW
2019-05-26,15400000,,620800000,,478600000,316400000,1003500000,671700000,671700000,,-107100000,,,,133600000,3756500000,3084800000,2753000000,-50900000,,487200000,467800000,55974,LW
2018-05-27,13500000,,554900000,55600000.0,416800000,281900000,879500000,584100000,584100000,,-108800000,,,,121200000,3423700000,2839600000,2544200000,-29200000,,433700000,414100000,55974,LW
2017-05-28,10600000,,510400000,50700000.0,326900000,220700000,778800000,547500000,547500000,,-61200000,,,,170200000,3168000000,2620500000,2389200000,-37100000,,340200000,324800000,55974,LW
2020-03-31,1559000000,,1508000000,,3039000000,1137000000,4168000000,1450000000,1450000000,,-44000000,,,,-1531000000,5537000000,4087000000,1369000000,58000000,,3039000000,3039000000,55975,EA
2019-03-31,1433000000,,1079000000,,1019000000,1162000000,3628000000,1010000000,1010000000,,-45000000,,,,60000000,4950000000,3940000000,1322000000,69000000,,1019000000,1019000000,55975,EA
2018-03-31,1320000000,,1449000000,,1043000000,1110000000,3873000000,1434000000,1434000000,,-44000000,,,,406000000,5150000000,3716000000,1277000000,15000000,,1043000000,1043000000,55975,EA
2017-03-31,1205000000,,1210000000,,967000000,1112000000,3562000000,1239000000,1239000000,,-47000000,,,,243000000,4845000000,3606000000,1283000000,-29000000,,967000000,967000000,55975,EA
2019-12-31,,,11941000,-89000,9492000,25713000,36779000,11066000,11066000,,-5000,,,,2449000,45472000,34406000,8693000,875000,,9492000,9492000,55978,ZYXI
2018-12-31,,,10216000,-89000,9552000,15651000,26021000,10370000,10370000,,-154000,,,,664000,31917000,21547000,5896000,-154000,,9552000,9552000,55978,ZYXI
2017-12-31,100000.0,,7494000,-89000,7365000,9569000,18613000,8944000,8944000,,-1450000,,,,129000,23432000,14488000,4819000,-1450000,,7365000,7365000,55978,ZYXI
2016-12-31,100000.0,,84000,-89000,69000,9156000,9796000,640000,640000,,-352000,,,,15000,13313000,12673000,3517000,-556000,,69000,69000,55978,ZYXI
2020-12-31,74671000,,750244000,,814888000,186003000,1084875000,824201000,824201000,,-90144000,,,,-64644000,1265052000,440851000,180177000,-73957000,,814888000,814888000,55979,VRSN
2019-12-31,60805000,,758776000,,612299000,184262000,1051194000,806127000,806127000,,-90611000,,,,146477000,1231661000,425534000,180467000,-47351000,,612299000,612299000,55979,VRSN
2018-12-31,57884000,,729516000,,582489000,197559000,1022835000,767392000,767392000,,-114845000,,,,147027000,1214969000,447577000,192134000,-37876000,,582489000,582489000,55979,VRSN
2017-12-31,52342000,,599012000,,457248000,211705000,971769000,707722000,707722000,,-136336000,,,,141764000,1165095000,457373000,193326000,-108710000,,457248000,457248000,55979,VRSN
2020-12-31,,,-4334000,,-1722000,158463000,174475000,0,8285000,7727000,,,,,-2612000,174475000,166190000,0,-12619000,,-1722000,-1722000,55980,AMTB
2019-12-31,,,64031000,,51334000,188383000,274234000,0,74306000,11545000,,,,,12697000,274234000,199928000,0,-10275000,,51334000,51334000,55980,AMTB
2018-12-31,,,57566000,,45833000,186261000,271657000,0,75975000,9421000,,,,,11733000,271657000,195682000,0,-18409000,,45833000,45833000,55980,AMTB
2017-12-31,,,77049000,,43057000,180045000,284685000,0,89918000,14722000,,,,,33992000,284685000,194767000,0,-12869000,,43057000,43057000,55980,AMTB
2019-12-31,,,117359000,57625000,86158000,681094000,993056000,247687000,247687000,46811000,-138528000,,,,19680000,1017081000,769394000,24025000,-130328000,,97679000,86158000,55981,PRAA
2018-12-31,,,89497000,35182000,65563000,622805000,874831000,185260000,185260000,47444000,-126740000,,,,13763000,908256000,722996000,33425000,-95763000,,75734000,65563000,55981,PRAA
2017-12-31,,,160273000,59696000,164315000,538708000,816308000,213734000,213734000,44103000,-105678000,,,,-10852000,828206000,614472000,11898000,-53461000,,171125000,164315000,55981,PRAA
2016-12-31,,,135627000,61310000,86255000,548549000,832124000,219750000,219750000,39466000,-85911000,,,,43577000,930603000,710853000,98479000,-84123000,,92050000,86255000,55981,PRAA
2019-12-31,,,-4096000,15437000,-2054000,45307000,42031000,0,-3594000,,,,,,-523000,42031000,45625000,0,-502000,,-3573000,-2054000,55982,COHN
2018-12-31,,,-4828000,6664000,-2463000,45466000,40812000,0,-4915000,,,,,,-841000,40812000,45727000,0,87000,,-3987000,-2463000,55982,COHN
2017-12-31,,,1224000,8284000,2064000,39891000,41507000,0,1367000,,,,,,-1211000,41507000,40140000,0,-143000,,2435000,2064000,55982,COHN
2016-12-31,,,3851000,7980000,2267000,46471000,50575000,0,3813000,,,,,,422000,50575000,46762000,0,38000,,3429000,2267000,55982,COHN
2019-12-31,3959450,,-8351651,,-8351651,4585638,15394,-8529694,-8529694,,-8920,,,,0,15394,8545088,0,178043,,-8351651,-8351651,55984,SNCA
2018-12-31,3960191,,-4924617,,-4924617,4559265,260000,-8259456,-8259456,,-7698,,,,0,260000,8519456,0,3334839,,-4924617,-4924617,55984,SNCA
2017-12-31,8096095,,-15665983,,-15665983,5471010,260000,-13307105,-13307105,,-159066,,,,0,260000,13567105,0,-2358878,,-15665983,-15665983,55984,SNCA
2016-12-31,13155887,,-21074611,,-21074611,7497202,16246,-20636843,-20636843,,-1141297,,,,0,16246,20653089,0,-437768,,-21074611,-21074611,55984,SNCA
2020-12-31,155949000,,-217998000,,-216484000,563700000,540714000,-178935000,-178935000,,-27317000,,,,-1514000,774533000,953468000,233819000,-39063000,,-216484000,-216484000,55986,TWOU
2019-12-31,115473000,,-255082000,,-235222000,454548000,412511000,-157510000,-157510000,,-13419000,,,,-19860000,574671000,732181000,162160000,-97572000,,-235222000,-235222000,55986,TWOU
2018-12-31,63812000,,-43197000,,-38330000,304004000,321276000,-46540000,-46540000,,-108000,,,,-4867000,411769000,458309000,90493000,3343000,,-38330000,-38330000,55986,TWOU
2017-12-31,45926000,,-30720000,,-29423000,213588000,229376000,-30138000,-30138000,,-87000,,,,-1297000,286752000,316890000,57376000,-582000,,-29423000,-29423000,55986,TWOU
2020-12-31,,,1797000000,,1427000000,3536000000,6515000000,0,1797000000,1182000000,,,,,370000000,6515000000,4718000000,0,0,,1427000000,1317000000,55989,FITB
2019-12-31,,,3202000000,,2512000000,3412000000,7893000000,0,3457000000,1024000000,,,,,690000000,7893000000,4436000000,0,-255000000,,2512000000,2398000000,55989,FITB
2018-12-31,,,2765000000,,2193000000,3031000000,6772000000,0,2841000000,900000000,,,,,572000000,6772000000,3931000000,0,-76000000,,2193000000,2095000000,55989,FITB
2017-12-31,,,2979000000,20000000.0,2180000000,2847000000,6820000000,0,3052000000,921000000,,,,,799000000,6820000000,3768000000,0,-73000000,,2180000000,2082000000,55989,FITB
2020-12-31,,,23819000,,18328000,39135000,77600000,0,26459000,12006000,,,,,5491000,77600000,51141000,0,-2640000,,18328000,18328000,55990,SFST
2019-12-31,,,35479000,,27858000,41379000,81448000,0,37788000,2281000,,,,,7621000,81448000,43660000,0,-2309000,,27858000,27858000,55990,SFST
2018-12-31,,,28690000,,22289000,36342000,68453000,0,29974000,2137000,,,,,6401000,68453000,38479000,0,-1284000,,22289000,22289000,55990,SFST
2017-12-31,,,23661000,,13045000,31169000,58213000,0,24807000,2237000,,,,,10616000,58213000,33406000,0,-1146000,,13045000,13045000,55990,SFST
2019-12-31,2497000,,-19689000,,-19689000,15168000,60000,-17605000,-17605000,,-2657000,,,,0,3364000,20969000,3304000,-2084000,,-19689000,-19689000,55991,DMTK
2018-12-31,2054000,,-10004000,,-10004000,6321000,-185000,-8560000,-8560000,,-1093000,,,,0,2442000,11002000,2627000,-1444000,,-10004000,-10004000,55991,DMTK
2017-12-31,1997203,,-8369049,,-8369049,5501644,-852575,-8351422,-8351422,,-17627,,,,0,1718612,10070034,2571187,-17627,,-8369049,-8369049,55991,DMTK
2013-12-31,1957641,,-5178379,,-5178379,1304433,0,-3262074,-3262074,,-1916305,,,,0,0,3262074,0,-1916305,,-5178379,-5178379,55991,DMTK
2020-12-31,,,370300000,,286500000,1164500000,1768900000,528600000,528600000,,-102100000,,,,83800000,10851800000,10323200000,9082900000,-158300000,,286500000,286500000,55994,GPI
2019-12-31,,,227300000,,174000000,1340600000,1816100000,403900000,403900000,,-136500000,,,,53300000,12043800000,11639900000,10227700000,-176600000,,174000000,167600000,55994,GPI
2018-12-31,,,205400000,,157800000,1270400000,1725200000,387700000,387700000,,-135700000,,,,47600000,11601400000,11213700000,9876200000,-182300000,,157800000,152400000,55994,GPI
2017-12-31,,,219000000,,213400000,1212000000,1645600000,375700000,375700000,,-122900000,,,,5600000,11123700000,10748000000,9478100000,-156700000,,213400000,205900000,55994,GPI
2019-12-31,7876000,,-9906000,,-10328000,18572000,19163000,-7285000,-7285000,,-1367000,,,,422000,23101000,30386000,3938000,-2621000,,-10328000,-10328000,55995,BWAY
2018-12-31,6156000,,-6270000,,-6479000,11766000,13148000,-4774000,-4774000,,-873000,,,,209000,16397000,21171000,3249000,-1496000,,-6479000,-6479000,55995,BWAY
2017-12-31,5343000,,-6885000,,-7054000,9818000,8775000,-6386000,-6386000,,-360000,,,,169000,11145000,17531000,2370000,-499000,,-7054000,-7054000,55995,BWAY
2016-12-31,3792000,,-2397000,,-2397000,7374000,9097000,-2069000,-2069000,,-404000,,,,0,11524000,13593000,2427000,-328000,,-2397000,-2397000,55995,BWAY
2019-12-31,,,-8129000,2080000,-8039000,6658000,44035000,16058000,16058000,,-18985000,,,,15000,63162000,47104000,19127000,-24187000,,-8144000,-22668000,55997,WHLR
2018-12-31,,,-17769000,2194000,-16500000,8303000,46802000,12535000,12535000,250000.0,-20228000,,,,40000,65275000,52740000,18473000,-30304000,903000.0,-17809000,-29327000,55997,WHLR
2017-12-31,,,-14159000,7088000,-12094000,6251000,40325000,9583000,9583000,250000.0,-17165000,,,,137000,58535000,48952000,18210000,-23742000,1518000.0,-14296000,-22063000,55997,WHLR
2016-12-31,,,-12955000,10359000,-11203000,11491000,31837000,-291000,-291000,250000.0,-13356000,,,,107000,44160000,44451000,12323000,-12664000,824000.0,-13062000,-15916000,55997,WHLR
2019-12-31,,,-111560000,-5981000,-107657000,46041000,-18291000,-64332000,-64332000,,-41451000,,,,0,150048000,214380000,168339000,-47228000,,-111560000,-107865000,55999,AGEN
2018-12-31,,,-162044000,-2078000,-159692000,37340000,-87816000,-125156000,-125156000,,-25273000,,,,0,36784000,161940000,124600000,-36888000,,-162044000,-159899000,55999,AGEN
2017-12-31,,,-120692000,-2078000,-120692000,33741000,-73248000,-106989000,-106989000,,-18868000,,,,0,42877000,149866000,116125000,-13703000,,-120692000,-120898000,55999,AGEN
2016-12-31,,,-126995175,-2078000,-126995175,33125690,-72398076,-105523766,-105523766,,-17316073,,,,0,22573303,128097069,94971379,-21471409,,-126995175,-127199421,55999,AGEN
2020-09-30,133134000,,281881000,,240395000,197196000,640243000,309913000,309913000,,2320000,,,,41486000,2495665000,2185752000,1855422000,-28032000,,240395000,240395000,56001,WWD
2019-09-30,159107000,,320612000,,259602000,207684000,707543000,340752000,340752000,,-34557000,,,,61010000,2900197000,2559445000,2192654000,-20140000,,259602000,259602000,56001,WWD
2018-09-30,148279000,,219578000,,180378000,189630000,619395000,281486000,281486000,,-31770000,,,,39200000,2325873000,2044387000,1706478000,-61908000,,180378000,180378000,56001,WWD
2017-09-30,126519000,,252747000,,200507000,175191000,571117000,269407000,269407000,,-27430000,,,,52240000,2098685000,1829278000,1527568000,-16660000,,200507000,200507000,56001,WWD
2020-09-30,59063000,,74972000,,64853000,240637000,380325000,80625000,80625000,,-2944000,,,,9937000,897273000,816648000,516948000,-5653000,-182000,65035000,64853000,56003,BRKS
2019-09-30,56368000,,9443000,,437416000,205260000,316729000,55101000,55101000,,-22250000,,,,-111000,780848000,725747000,464119000,-45658000,427862000,9554000,437416000,56003,BRKS
2018-09-30,46936000,,20466000,,116575000,163222000,246081000,35923000,35923000,,-9520000,,,,-47251000,631560000,595637000,385479000,-15457000,48747000,67717000,116575000,56003,BRKS
2017-09-30,39875000,,14067000,,62612000,140849000,199410000,18686000,18686000,,-408000,,,,3380000,527499000,508813000,328089000,-4619000,51925000,10687000,62612000,56003,BRKS
2020-12-31,,,475100000,,390200000,,1047300000,544900000,544900000,217300000,-96500000,,,,84600000,5532700000,4987800000,4485400000,-69800000,-300000,390500000,390200000,56005,MDU
2019-12-31,,,398445000,,335453000,1962000.0,933380000,479258000,479258000,196143000,-98587000,,,,63279000,5336776000,4857518000,4403396000,-80813000,287000,335166000,335453000,56005,MDU
2018-12-31,,,316871000,,272318000,2894000.0,790566000,398829000,398829000,168638000,-84614000,,,,47485000,4531552000,4132723000,3740986000,-81958000,2932000,269386000,272318000,56005,MDU
2017-12-31,,,350027000,,281203000,2894000.0,798207000,424048000,424048000,166673000,-82788000,,,,65041000,4443351000,4019303000,3645144000,-74021000,-3783000,284986000,280432000,56005,MDU
2019-12-31,,,336644774,,336644774,19683006,34684099,15001093,15001093,,-16,,,,0,34684099,19683006,0,321643681,,336644774,316134261,56008,GAB
2018-12-31,,,-127874378,,-127874378,20234047,37297400,17063353,17063353,,-78,,,,0,37297400,20234047,0,-144937731,,-127874378,-147640474,56008,GAB
2017-12-31,,,323252947,,323252947,19673142,28497885,8824743,8824743,,-1252,,,,0,28497885,19673142,0,314428204,,323252947,304962881,56008,GAB
2016-12-31,,,181478539,,181478539,18133459,33559802,15426343,15426343,,-2630,,,,0,33559802,18133459,0,166052196,,181478539,165267659,56008,GAB
2020-06-30,,,55512000,,33552000,189622000,257162000,67540000,67540000,,-14613000,,,,21960000,800354000,732814000,543192000,-12028000,,33552000,33552000,56009,PAHC
2019-06-30,,,71505000,,54713000,176410000,264624000,88214000,88214000,,-13677000,,,,16792000,827995000,739781000,563371000,-16709000,,54713000,54713000,56009,PAHC
2018-06-30,,,88070000,,64883000,166869000,268550000,101681000,101681000,,-13603000,,,,23187000,819982000,718301000,551432000,-13611000,,64883000,64883000,56009,PAHC
2017-06-30,,,80543000,,64615000,152543000,248243000,95700000,95700000,,-16872000,,,,15928000,764281000,668581000,516038000,-15157000,,64615000,64615000,56009,PAHC
2019-09-30,,,-498274000,9677000,-498242000,318838000,-71222000,-402094000,-402094000,-2427000,-94378000,,,,63000,1233770000,1635864000,1304992000,-96180000,,-498337000,-805631000,56011,QK
2018-09-30,,,-497529000,17772000,-499859000,345326000,-8022000,-375821000,-375821000,-4034000,-79759000,,,,2393000,889937000,1265758000,897959000,-121708000,,-499922000,-635404000,56011,QK
2017-09-30,,,-244844000,17835000,-245475000,120521000,-24881000,-166796000,-166796000,1460000,-50352000,,,,596000,522737000,689533000,547618000,-78048000,,-245440000,-304238000,56011,QK
2019-12-31,,,-57903000,,-57903000,6515000,0,-55877000,-55877000,2072000,-160000,,,,0,0,55877000,0,-2026000,,-57903000,-57903000,56013,PLM
2018-12-31,,,-15043000,,-15043000,5569000,0,-7495000,-7495000,1796000,-160000,,,,0,0,7495000,0,-7548000,,-15043000,-15043000,56013,PLM
2017-12-31,,,-11015999,,-11015999,5397818,0,-7339636,-7339636,1937454,-160000,,,,0,0,7339636,0,-3676364,,-11015999,-11015999,56013,PLM
2017-01-31,,,-9229000,,-9229000,5195000,0,-6678000,-6678000,1465000,-160000,,,,0,0,6678000,0,-2551000,,-9229000,-9229000,56013,PLM
2020-12-31,,,330266000,,246177000,468819000,1037678000,0,330266000,69582000,,,,,84313000,1037678000,707412000,0,0,,245953000,246177000,56014,WD
2019-12-31,,,230351000,6596000.0,173373000,355304000,795587000,0,230351000,57460000,,,,,57121000,795587000,565236000,0,0,,173230000,167724000,56014,WD
2018-12-31,,,212850000,5068000.0,161439000,305410000,714308000,0,214954000,51810000,,,,,51908000,714308000,499354000,0,-2104000,,160942000,155649000,56014,WD
2017-12-31,,,233661000,5565000.0,211127000,296334000,702355000,0,233661000,41114000,,,,,21827000,702355000,468694000,0,0,,211834000,202684000,56014,WD
2020-12-31,,,68548000,,40504000,944941000,1098472000,0,79303000,29500000,,,,,19192000,1238213000,1158910000,139741000,-10755000,,49356000,40504000,56015,PIPR
2019-12-31,,,118979000,75245000.0,111711000,581665000,731613000,0,133300000,12350000,,,,,24577000,834566000,701266000,102953000,-14321000,23772000.0,94402000,107200000,56015,PIPR
2018-12-31,,,72489000,52972000.0,57036000,549617000,642635000,0,75987000,12173000,,,,,18046000,740953000,664966000,98318000,-3498000,1387000.0,54443000,49993000,56015,PIPR
2017-12-31,,,79316000,47903000.0,-61939000,650253000,755044000,0,83243000,11370000,,,,,53808000,823621000,740378000,68577000,-118290000,-85060000.0,25508000,-64875000,56015,PIPR
2019-12-31,5348000,,-15544000,,-15551000,11426000,2726000,-14048000,-14048000,,-1499000,,,,7000,4873000,18921000,2147000,-1496000,,-15551000,-15551000,56018,RWLK
2018-12-31,7349000,,-21680000,,-21675000,14690000,2825000,-19214000,-19214000,,-2398000,,,,-5000,6545000,25759000,3720000,-2466000,,-21675000,-21675000,56018,RWLK
2017-12-31,6042000,,-24598000,,-24717000,19051000,3101000,-21992000,-21992000,,-2451000,,,,119000,7753000,29745000,4652000,-2606000,,-24717000,-24717000,56018,RWLK
2016-12-31,7928000,,-32500000,,-32503000,22149000,736000,-29341000,-29341000,,-1976000,,,,3000,5869000,35210000,5133000,-3159000,,-32503000,-32503000,56018,RWLK
2020-02-29,,,35261558,,35261558,1541921,11149627,9607706,9607706,,,,,,0,11149627,1541921,0,25653852,,35261558,35261558,56019,NCA
2019-02-28,,,8111054,,8111054,1776602,11399064,9622462,9622462,,,,,,0,11399064,1776602,0,-1511408,,8111054,8111054,56019,NCA
2018-02-28,,,9624703,,9624703,1610333,12258780,10648447,10648447,,,,,,0,12258780,1610333,0,-1023744,,9624703,9624703,56019,NCA
2017-02-28,,,2766169,,2766169,1670482,13335322,11664840,11664840,,-26071.0,,,,0,13335322,1670482,0,-8898671,,2766169,2766169,56019,NCA
2019-12-31,,,-2943000,-149931000,-2943000,36389000,138988000,52078000,52078000,,-39344000,,,,0,684393000,632315000,545405000,-55021000,,-2943000,-17261000,56024,EVA
2018-12-31,,,6952000,-133687000,6952000,22311000,94305000,31815000,31815000,,-36471000,,,,0,573741000,541926000,479436000,-24863000,,6952000,1085000,56024,EVA
2017-12-31,,,14373000,-128569000,20562000,26509000,120905000,54492000,54492000,,-31744000,,,,0,540521000,486029000,419616000,-40119000,,14373000,17164000,56024,EVA
2016-12-31,,,13463000,-2704000,24608000,32271000,106858000,46887000,46887000,,-16221000,,,,0,464276000,417389000,357418000,-33424000,,13463000,23531000,56024,EVA
2020-12-31,113000000,,1379000000,133000000,1420000000,1140000000,3394000000,2141000000,2141000000,,-521000000,,,,-43000000,27753000000,25612000000,24359000000,-762000000,-2000000,1422000000,1420000000,56025,LYB
2019-12-31,111000000,,4045000000,135000000,3390000000,1106000000,5449000000,4232000000,4232000000,,-354000000,,,,648000000,34727000000,30495000000,29278000000,-187000000,-7000000,3397000000,3384000000,56025,LYB
2018-12-31,115000000,,5309000000,139000000,4688000000,1037000000,6475000000,5323000000,5323000000,,-362000000,,,,613000000,39004000000,33681000000,32529000000,-14000000,-8000000,4696000000,4682000000,56025,LYB
2017-12-31,106000000,,5493000000,1000000,4879000000,843000000,6425000000,5476000000,5476000000,,-491000000,,,,598000000,34484000000,29008000000,28059000000,17000000,-18000000,4895000000,4874000000,56025,LYB
2019-12-31,,,12921000,10564000,925000,193147000,308125000,97993000,97993000,,-81400000,,,,10864000,436929000,338936000,128804000,-85072000,,2057000,925000,56031,UONE
2018-12-31,,,3406000,10232000,137442000,183250000,313734000,97295000,97295000,,-76667000,,,,-135199000,439098000,341803000,125364000,-93889000,,138605000,137442000,56031,UONE
2017-12-31,,,-10701000,10780000,111887000,193967000,309624000,81641000,81641000,,-79420000,,,,-123163000,440041000,358400000,130417000,-92342000,,112462000,111887000,56031,UONE
2016-12-31,,,10296000,12410000,-423000,198541000,322219000,89431000,89431000,,-81636000,,,,9580000,456219000,366788000,134000000,-79135000,,716000,-423000,56031,UONE
2019-12-31,,,-120830000,-3740000,80750000,145680000,96230000,-57250000,-57250000,,-58270000,,,,-10820000,690450000,747700000,594220000,-63580000,189520000,-110010000,80750000,56032,HZN
2018-12-31,,,-230880000,-2500000,-203960000,132420000,115880000,-23950000,-23950000,,-27450000,,,,-11520000,714010000,737960000,598130000,-206930000,14460000,-219360000,-203960000,56032,HZN
2017-12-31,,,4980000,-1490000,-3550000,160320000,207600000,36380000,36380000,,-22410000,,,,9750000,892980000,856600000,685380000,-31400000,14460000,-4770000,-3550000,56032,HZN
2016-12-31,,,-16390000,-300000,-12360000,135900000,160350000,15200000,15200000,,-20080000,,,,-3730000,649200000,634000000,488850000,-31590000,14460000,-12660000,-12360000,56032,HZN
2019-12-31,430822000,,651258000,-3162000,575196000,430437000,1467743000,606484000,606484000,,,,,,77887000,5812255000,5205771000,4344512000,44774000,,573371000,572746000,56033,HMI
2018-12-31,263220000,,388356000,-1337000,340046000,310511000,939450000,365719000,365719000,,,,,,52036000,3645335000,3279616000,2705885000,22637000,,336320000,113490000,56033,HMI
2017-12-31,153827000,,194706000,2389000,167682000,158906000,494702000,181969000,181969000,,,,,,27611000,2048896000,1866927000,1554194000,12737000,,167095000,46120000,56033,HMI
2016-12-31,132304000,,27034000,2389000,23946000,130465000,276152000,13383000,13383000,,,,,,3088000,1556476000,1543093000,1280324000,13651000,,23946000,-12122000,56033,HMI
2019-12-31,,,206844000,,158350000,304406000,546964000,242558000,242558000,,-20629000,,,,48494000,1491118000,1248560000,944154000,-35714000,,158350000,158350000,56034,B
2018-12-31,,,207495000,,166186000,296791000,532365000,235574000,235574000,,-16841000,,,,41309000,1495889000,1260315000,963524000,-28079000,,166186000,166186000,56034,B
2017-12-31,,,195699000,,59415000,289679000,500180000,210501000,210501000,,-14571000,,,,136284000,1436499000,1225998000,936319000,-14802000,,59415000,59415000,56034,B
2016-12-31,,,182621000,,135601000,247659000,442027000,194368000,194368000,,-11883000,,,,47020000,1230754000,1036386000,788727000,-11747000,,135601000,135601000,56034,B
2020-12-31,84276000,,113776000,,87240000,109202000,316485000,114061000,114061000,,,,,,26536000,586372000,472311000,269887000,-285000,,87240000,87240000,56035,MANH
2019-12-31,87608000,,116077000,,85762000,121463000,332982000,115924000,115924000,,,,,,30315000,617949000,502025000,284967000,153000,,85762000,85762000,56035,MANH
2018-12-31,71896000,,136231000,,104690000,103880000,318276000,133887000,133887000,,,,,,31541000,559157000,425270000,240881000,2344000,,104690000,104690000,56035,MANH
2017-12-31,57704000,,184833000,,116481000,93536000,348866000,188566000,188566000,,,,,,68352000,594599000,406033000,245733000,-3733000,,116481000,116481000,56035,MANH
2018-12-31,,,135200000,72800000,136400000,124000000,298000000,160900000,160900000,-8000000,-24900000,,,,5000000,920200000,759300000,622200000,-25700000,100000,130200000,136000000,56036,BSA
2017-12-31,,,142000000,95900000,4200000,111400000,282100000,152400000,152400000,-8000000,-24500000,,,,132800000,887400000,735000000,605300000,-10400000,-100000,9200000,4000000,56036,BSA
2016-12-31,,,160800000,6500000,126400000,92200000,292400000,188200000,188200000,-8000000,-11300000,,,,40800000,663500000,475300000,371100000,-27400000,6200000,120000000,125500000,56036,BSA
2015-12-31,,,201300000,6500000,155500000,88200000,287100000,191800000,191800000,-8000000,-3100000,,,,46600000,699300000,507500000,412200000,9500000,800000,154700000,154900000,56036,BSA
2019-12-31,30321000,,-47683000,,-49451000,45810000,17890000,-63263000,-63263000,,,,,,1768000,21712000,84975000,3822000,15580000,,-49451000,-49451000,56037,SBBP
2018-12-31,25441000,,32387000,,31851000,63336000,14041000,-81923000,-81923000,,-12515000.0,,,,536000,18027000,99950000,3986000,114310000,,31851000,31851000,56037,SBBP
2017-12-31,17268000,,-111712000,,-113483000,36292000,5563000,-53019000,-53019000,,-4313000.0,,,,1771000,7046000,60065000,1483000,-58693000,,-113483000,-113483000,56037,SBBP
2016-12-31,20023000,,-51357000,,-48597000,14875000,0,-34898000,-34898000,,-20000.0,,,,-2638000,0,34898000,0,-16459000,,-48719000,-48597000,56037,SBBP
2020-12-31,1113000000,,841000000,314000000,5146000000,4689000000,8011000000,2564000000,2564000000,-355000000,-446000000,,,,496000000,26134000000,23570000000,18123000000,-1723000000,4860000000,345000000,5146000000,56040,ABB
2019-12-31,1197000000,,1862000000,454000000,1439000000,5135000000,8960000000,2628000000,2628000000,-355000000,-93000000,,,,772000000,27978000000,25350000000,19018000000,-766000000,438000000,1090000000,1439000000,56040,ABB
2018-12-31,1142000000,,2119000000,582000000,2173000000,5137000000,8603000000,2324000000,2324000000,-355000000,-305000000,,,,544000000,27662000000,25338000000,19059000000,-205000000,723000000,1575000000,2173000000,56040,ABB
2017-12-31,1018000000,,2102000000,530000000,2213000000,4757000000,7918000000,2143000000,2143000000,-355000000,-254000000,,,,583000000,25196000000,23053000000,17278000000,-41000000,846000000,1519000000,2213000000,56040,ABB
2020-12-31,,,-124745000,,-45174000,535860000,664047000,0,-95274000,223461000,,,,,-79571000,664047000,759321000,0,-29471000,,-45174000,-46930000,56041,HWC
2019-12-31,,,392739000,,327380000,632729000,1158473000,0,466302000,59442000,,,,,65359000,1158473000,692171000,0,-73563000,,327380000,321834000,56041,HWC
2018-12-31,,,382116000,,323770000,596899000,1092696000,0,439406000,56391000,,,,,58346000,1092696000,653290000,0,-57290000,,323770000,317840000,56041,HWC
2017-12-31,,,308434000,,215632000,576274000,996275000,0,364412000,55589000,,,,,92802000,996275000,631863000,0,-55978000,,215632000,210962000,56041,HWC
2020-06-30,3800000,,-19997000,,-21839000,72390000,62210000,-13980000,-13980000,,-975000,,,,1842000,201451000,215431000,139241000,-6017000,,-21839000,-21839000,56042,SCX
2019-06-30,3700000,,9610000,,6079000,60950000,74941000,10291000,10291000,,-976000,,,,3531000,228022000,217731000,153081000,-681000,,6079000,6079000,56042,SCX
2018-06-30,3600000,,4865000,,-3633000,61233000,69557000,4724000,4724000,,-845000,,,,8498000,216328000,211604000,146771000,141000,,-3633000,-3633000,56042,SCX
2017-06-30,3500000,,1538000,,991000,59155000,62599000,-56000,-56000,,-674000,,,,547000,207023000,207079000,144424000,1594000,,991000,991000,56042,SCX
2020-10-31,,,-1587335,,-1587335,3022764,17610989,14588225,14588225,,-2183536,,,,0,17610989,3022764,0,-16175560,,-1587335,-1587335,56047,MFM
2019-10-31,,,29378160,,29378160,3153092,20615719,17462627,17462627,,-3277961,,,,0,20615719,3153092,0,11915533,,29378160,29378160,56047,MFM
2018-10-31,,,3234090,,3234090,3180075,21565735,18385660,18385660,,-3047920,,,,0,21565735,3180075,0,-15151570,,3234090,3234090,56047,MFM
2017-10-31,,,8773590,,8773590,3295815,21788111,18492296,18492296,,-2316317,,,,0,21788111,3295815,0,-9718706,,8773590,8773590,56047,MFM
2019-12-31,143403000,,-180307000,,-180307000,39136000,0,-182539000,-182539000,,,,,,0,0,182539000,0,2232000,,-180307000,-180307000,56049,GOSS
2018-12-31,55283000,,-146969000,,-146969000,44051000,0,-99334000,-99334000,,,,,,0,0,99334000,0,-47635000,,-146969000,-146969000,56049,GOSS
2017-12-31,891000,,-6771000,,-6771000,262000,0,-1153000,-1153000,,,,,,0,0,1153000,0,-5618000,,-6771000,-6771000,56049,GOSS
2016-12-31,891000,,-83000,,-83000,83000,0,-83000,-83000,,,,,,0,0,83000,0,0,,-83000,-83000,56049,GOSS
2020-05-31,,,2691300000,835600000,2181200000,3038800000,6157200000,3118400000,3118400000,,-472500000,,,,480500000,17626600000,14508200000,11469400000,-427100000,,2210800000,2181200000,56050,GIS
2019-05-26,,,2154000000,864900000,1752700000,2822300000,5821000000,2998700000,2998700000,,-527400000,,,,367800000,16865200000,13866500000,11044200000,-844700000,,1786200000,1752700000,56050,GIS
2018-05-27,,,2220300000,1127500000,2131000000,2760700000,5460900000,2700200000,2700200000,,-385400000,,,,57300000,15740400000,13040200000,10279500000,-479900000,,2163000000,2131000000,56050,GIS
2017-05-28,,,2356300000,1268500000,1657500000,2814500000,5653200000,2838700000,2838700000,,-302100000,,,,655200000,15619800000,12781100000,9966600000,-482400000,,1701100000,1657500000,56050,GIS
2019-12-31,,,2337000,71320000,-1762000,49543000,105799000,33237000,33237000,21573000,-35045000,,,,341000,153185000,119948000,47386000,-30900000,,1996000,-1762000,56051,MFIN
2018-12-31,,,-22366000,27596000,-25046000,44906000,60697000,-2065000,-2065000,16773000,-28367000,,,,373000,119705000,121770000,59008000,-20301000,,-22739000,-25046000,56051,MFIN
2017-12-31,,,-450000,27596000,278000,12262000,19731000,5921000,5921000,1548000,-13770000,,,,-728000,19731000,13810000,0,-6371000,,278000,278000,56051,MFIN
2016-12-31,,,13468000,27596000,23515000,17359000,25496000,7809000,7809000,328000,-12638000,,,,-10047000,25496000,17687000,0,5659000,,23515000,23515000,56051,MFIN
2019-12-31,,,285682000,,284975000,52318000,648448000,380628000,380628000,-6473000,-157646000,,,,707000,659241000,278613000,10793000,-94946000,,284975000,284572000,56053,STOR
2018-12-31,,,217612000,,216970000,45725000,533898000,306347000,306347000,-6473000,-129875000,,,,642000,540756000,234409000,6858000,-88735000,,216970000,216572000,56053,STOR
2017-12-31,,,162496000,,162038000,40990000,446574000,255305000,255305000,-6473000,-120478000,,,,458000,452847000,197542000,6273000,-92809000,,162038000,161593000,56053,STOR
2016-12-31,,,123759000,,123325000,33972000,372276000,218686000,218686000,-6473000,-105180000,,,,434000,376343000,157657000,4067000,-94927000,,123325000,122812000,56053,STOR
2020-02-01,,,90993000,,66881000,256595000,366563000,86007000,86007000,,,,,,24112000,1034129000,948122000,667566000,4986000,,66881000,66881000,56054,ZUMZ
2019-02-02,,,62330000,,45205000,248214000,335936000,62778000,62778000,,,,,,17125000,978617000,915839000,642681000,-448000,,45205000,45205000,56054,ZUMZ
2018-02-03,,,48403000,,26802000,234168000,309874000,50360000,50360000,,,,,,21601000,927401000,877041000,617527000,-1957000,,26802000,26802000,56054,ZUMZ
2017-01-28,,,40224000,,25904000,207416000,275002000,41643000,41643000,,,,,,14320000,836268000,794625000,561266000,-1419000,,25904000,25904000,56054,ZUMZ
2020-06-30,,,3756076,,5937072,5259659,16093794,3689433,3689433,1383204,-110775,,,,-2180996,29599296,25909863,13505502,66643,,5937072,5937072,56055,EPM
2019-06-30,,,18859427,,15377066,5072931,28962837,17636823,17636823,1383204,-116546,,,,3482361,43229621,25592798,14266784,1222604,,15377066,15377066,56055,EPM
2018-06-30,,,16186515,,19618484,6773781,29087710,16211641,16211641,1383204,-110780,,,,-3431969,40773527,24561886,11685817,-25126,,19618484,19618484,56055,EPM
2017-06-30,,,12884977,,8044313,4985408,23649087,12914368,12914368,29906,-81758,,,,4840664,34484896,21570528,10835809,-29391,,8044313,6790883,56055,EPM
2019-12-31,,,257835000,5925000,232854000,10976000,506300000,287350000,287350000,38764000,-97178000,,,,24507000,1346383000,1059033000,840083000,-29515000,,233328000,232854000,56056,IDA
2018-12-31,,,244909000,5451000,226801000,15781000,501475000,281141000,281141000,39363000,-96099000,,,,17386000,1370752000,1089611000,869277000,-36232000,,227523000,226801000,56056,IDA
2017-12-31,,,261848000,4729000,212419000,11194000,516747000,304351000,304351000,39111000,-92440000,,,,48660000,1349486000,1045135000,832739000,-42503000,,213188000,212419000,56056,IDA
2016-12-31,,,234517000,3960000,198288000,11806000,459051000,271776000,271776000,31808000,-92229000,,,,36429000,1262020000,990244000,802969000,-37259000,,198088000,198288000,56056,IDA
2019-12-31,492696,,3182589,-9807,2739990,3552083,8221020,1932005,1932005,164399,-158119,,,,442599,21103114,19171109,12882094,1250584,,2739990,2739990,56058,NISN
2018-12-31,358411,,-5795767,-9807,-5144715,4635509,7831808,-5329410,-5329410,253856,-208306,,,,-651052,25290060,30619470,17458252,-466357,,-5144715,-5144715,56058,NISN
2017-12-31,508282,,4197538,-9807,7136387,5870847,11119668,3877317,3877317,675507,-56953,,,,-2938849,29200445,25323128,18080777,320221,,7136387,7136387,56058,NISN
2016-12-31,33847,,7937352,-9807,5934885,2675058,10905026,7980546,7980546,443448,-49625,,,,2002467,27097836,19117290,16192810,-43194,,5934885,5934885,56058,NISN
2020-03-31,,,-14556680,,-14556680,8752840,-3675539,-14027870,-14027870,,-719187,,,,0,14136630,28164500,17812169,-528810,,-14556680,-14556680,56059,POWW
2019-03-31,,,-11709412,,-11709412,8654662,-229694,-8980658,-8980658,,-610600,,,,0,4159397,13140055,4389091,-2728754,,-11709412,-11709412,56059,POWW
2018-03-31,,,-5065321,,-5065321,5186531,105455,-5093835,-5093835,,-111572,,,,0,2339522,7433357,2234067,28514,,-5065321,-5065321,56059,POWW
2017-12-31,,,-5788901,,-5788901,3960218,-8725,-3976228,-3976228,,-532752,,,,0,1162567,5138795,1171292,-1812673,,-5788901,-5788901,56059,POWW
2019-12-28,,,240674000,14018000,179650000,439047000,685518000,246471000,246471000,,-8700000,,,,58270000,4416009000,4169538000,3730491000,-5797000,,182404000,175154000,56060,UFPI
2018-12-29,,,197853000,15281000,148598000,392235000,592894000,200659000,200659000,,-8893000,,,,45441000,4489180000,4288521000,3896286000,-2806000,,152412000,145202000,56060,UFPI
2017-12-30,,,176007000,14547000,119512000,362220000,542826000,180606000,180606000,,-6218000,,,,51967000,3941182000,3760576000,3398356000,-4574000,,124040000,117287000,56060,UFPI
2016-12-31,,,160671000,11286000,101179000,310152000,474590000,164438000,164438000,,-4575000,,,,55174000,3240493000,3076055000,2765903000,-3500000,,105497000,99584000,56060,UFPI
2018-12-31,3478805,,-4245585,,-4245585,766780,0,-4245585,-4245585,,,,,,0,0,4245585,0,0,,-4245585,-4245585,56061,TARA
2017-12-31,1105768,,-1211757,,-1211757,105989,0,-1211757,-1211757,,,,,,0,0,1211757,0,0,,-1211757,-1211757,56061,TARA
2019-12-31,46588000,,14887000,308000,14098000,62277000,122966000,14101000,14101000,,,,,,778000,262977000,248876000,140011000,786000,,14109000,14098000,56064,VICR
2018-12-31,44286000,,32933000,434000,31725000,62224000,138971000,32461000,32461000,,,,,,1087000,291220000,258759000,152249000,472000,,31846000,31725000,56064,VICR
2017-12-31,44924000,,-98000,305000,167000,58092000,101656000,-1360000,-1360000,,,,,,-356000,227830000,229190000,126174000,1262000,,258000,167000,56064,VICR
2016-12-31,41848000,,-6030000,208000,-6247000,55675000,91209000,-6314000,-6314000,,,,,,231000,200280000,206594000,109071000,284000,,-6261000,-6247000,56064,VICR
2020-06-30,,,1046000000,27000000,684000000,8651000000,10752000000,2101000000,2101000000,,-161000000,,,,350000000,14294000000,12193000000,3542000000,-1055000000,,696000000,684000000,56065,EL
2019-06-30,,,2307000000,25000000,1785000000,8896000000,11498000000,2602000000,2602000000,,-133000000,,,,513000000,14863000000,12261000000,3365000000,-295000000,,1794000000,1785000000,56065,EL
2018-06-30,,,1980000000,22000000,1108000000,8599000000,10857000000,2258000000,2258000000,,-128000000,,,,863000000,13683000000,11425000000,2826000000,-278000000,,1117000000,1108000000,56065,EL
2017-06-30,,,1617000000,18000000,1249000000,7529000000,9405000000,1876000000,1876000000,,-103000000,,,,361000000,11824000000,9948000000,2419000000,-259000000,,1256000000,1249000000,56065,EL
2019-12-31,,,-35400000,,-35400000,137600000,152100000,11700000,11700000,,-20500000,,,,0,557400000,545700000,405300000,-47100000,,-35400000,-35400000,56066,ALTG
2018-12-31,,,1500000,,1500000,92000000,110100000,15800000,15800000,,-15100000,,,,0,413000000,397200000,302900000,-14300000,,1500000,1500000,56066,ALTG
2017-12-31,,,5908000,,5908000,74906000,88040000,11604000,11604000,,-6210000,,,,0,345468000,333864000,257428000,-5696000,,5908000,5908000,56066,ALTG
2020-08-31,,,7849000,,723000,181613000,217993000,28057000,28057000,,-18918000,,,,2292000,493292000,465235000,275299000,-20208000,-4834000,5557000,723000,56067,EPAC
2019-08-31,,,18724000,,-249145000,210631000,292652000,73099000,73099000,,-27463000,,,,10657000,654758000,581659000,362106000,-54375000,-257212000,8067000,-249145000,56067,EPAC
2018-08-31,,,19196000,,-21648000,210656000,283284000,63348000,63348000,,-30572000,,,,14450000,641303000,577955000,358019000,-44152000,-26394000,4746000,-21648000,56067,EPAC
2017-08-31,,,-117889000,,-66213000,209728000,260370000,41545000,41545000,,-28821000,,,,-22614000,616591000,575046000,356221000,-159434000,29062000,-95275000,-66213000,56067,EPAC
2020-12-31,2476000000,,-14476000000,241000000,-11873000000,4493000000,-1690000000,-8659000000,-8659000000,,-2156000000,,,,-2535000000,58158000000,66817000000,59848000000,-5817000000,,-11941000000,-11873000000,56068,BA
2019-12-31,3219000000,,-2259000000,317000000,-636000000,3642000000,4759000000,-2102000000,-2102000000,,-722000000,,,,-1623000000,76559000000,78661000000,71800000000,-157000000,,-636000000,-636000000,56068,BA
2018-12-31,3269000000,,11604000000,71000000,10460000000,4525000000,19637000000,11843000000,11843000000,,-475000000,,,,1144000000,101127000000,89284000000,81490000000,-239000000,,10460000000,10460000000,56068,BA
2017-12-31,3179000000,,10107000000,57000000,8458000000,4101000000,17393000000,10113000000,10113000000,,-360000000,,,,1649000000,94005000000,83892000000,76612000000,-6000000,,8458000000,8458000000,56068,BA
2020-12-31,,,599332000,215021000,568870000,65388000,1086823000,495938000,495938000,,-220633000,,,,0,1559787000,1063849000,472964000,103394000,,599332000,568870000,56069,ESS
2019-12-31,,,464448000,220487000,439286000,54262000,1148613000,610601000,610601000,,-217339000,,,,0,1579375000,968774000,430762000,-146153000,,464448000,439286000,56069,ESS
2018-12-31,,,413599000,162246000,390153000,53451000,1068933000,535598000,535598000,,-220492000,,,,0,1485523000,949925000,416590000,-121999000,,413599000,390153000,56069,ESS
2017-12-31,,,458043000,158625000,433059000,41385000,1043233000,532967000,532967000,,-222894000,,,,0,1450344000,917377000,407111000,-74924000,,458043000,433059000,56069,ESS
2020-12-31,33960000,,-43714000,,-43714000,14388000,1359000,-46989000,-46989000,,,,,,0,1359000,48348000,0,3275000,,-43714000,-43714000,56071,GNCA
2019-12-31,26952000,,-38950000,,-38950000,12037000,0,-38989000,-38989000,,-1600000.0,,,,0,0,38989000,0,39000,,-38950000,-38950000,56071,GNCA
2018-12-31,25209000,,-27811000,,-27811000,14309000,0,-39518000,-39518000,,-1700000.0,,,,0,0,39518000,0,11707000,,-27811000,-27811000,56071,GNCA
2017-12-31,39204000,,-56710000,,-56710000,13433000,0,-52637000,-52637000,,-1700000.0,,,,0,0,52637000,0,-4073000,,-56710000,-56710000,56071,GNCA
2020-02-29,,,111434598,,111434598,8731056,61595146,52864090,52864090,,-14563950,,,,0,61595146,8731056,0,58570508,,111434598,111434598,56073,VMO
2019-02-28,,,25583640,,25583640,8801851,64386613,55394866,55394866,189896.0,-14233522,,,,0,64386613,8991747,0,-29811226,,25583640,25583640,56073,VMO
2018-02-28,,,32097274,,32097274,9142121,69192401,59883433,59883433,166847.0,-10794202,,,,0,69192401,9308968,0,-27786159,,32097274,32097274,56073,VMO
2017-02-28,,,5030534,,5030534,9029069,70554333,61400238,61400238,125026.0,-8991170,,,,0,70554333,9154095,0,-56369704,,5030534,5030534,56073,VMO
2019-12-31,,,-305000,,-305000,1067000,917000,-150000,-150000,,,,,,0,981000,1131000,64000,-155000,,-305000,-305000,56074,OXBR
2018-12-31,,,-5749000,,-5749000,1282000,-6467000,-7749000,-7749000,,,,,,0,3802000,11551000,10269000,2000000,,-5749000,-5749000,56074,OXBR
2017-12-31,,,-20592000,,-20592000,1325000,-19267000,-20592000,-20592000,,,,,,0,23841000,44433000,43108000,0,,-20592000,-20592000,56074,OXBR
2016-12-31,,,2581000,,2581000,1420000,4001000,2581000,2581000,,,,,,0,19062000,16481000,15061000,0,,2581000,2581000,56074,OXBR
2019-12-31,,,5187000000,1634000000,4140000000,117000000,9094000000,5786000000,5786000000,727000000,-2333000000,,,,754000000,13255000000,7469000000,4161000000,-599000000,,4433000000,3976000000,56075,TRP
2018-12-31,,,3949000000,1655000000,3702000000,84000000,8705000000,5702000000,5702000000,569000000,-2265000000,,,,432000000,13679000000,7977000000,4974000000,-1753000000,,3517000000,3539000000,56075,TRP
2017-12-31,,,3306000000,1852000000,3157000000,93000000,7254000000,4537000000,4537000000,569000000,-2069000000,,,,-89000000,13449000000,8912000000,6195000000,-1231000000,,3395000000,2997000000,56075,TRP
2016-12-31,,,837000000,1726000000,233000000,93000000,6550000000,4056000000,4056000000,555000000,-1998000000,,,,352000000,12547000000,8491000000,5997000000,-3219000000,,485000000,124000000,56075,TRP
2020-10-31,,,-117626598,,-117626598,18969139,71556109,52586970,52586970,,-6871388,,,,0,71556109,18969139,0,-170213568,,-117626598,-117626598,56076,EVT
2019-10-31,,,251478896,,251478896,19188858,74927611,55738753,55738753,,-13633160,,,,0,74927611,19188858,0,195740143,,251478896,251478896,56076,EVT
2018-08-31,,,275186918,,275186918,19393237,70792842,51399605,51399605,,-10445077,,,,0,70792842,19393237,0,223787313,,275186918,275186918,56076,EVT
2017-08-31,,,170642692,,170642692,18625290,85954917,67329627,67329627,,-7294872,,,,0,85954917,18625290,0,103313065,,170642692,170642692,56076,EVT
2019-12-31,,,104700000,340100000,49200000,310700000,436800000,135300000,135300000,-9200000,-40800000,,,,26500000,1897500000,1762200000,1460700000,-30600000,,78200000,49200000,56078,VHI
2018-12-31,,,236200000,353600000,262200000,324500000,611500000,291300000,291300000,-4300000,-55700000,,,,-30700000,1820100000,1528800000,1208600000,-55100000,34100000.0,266900000,262200000,56078,VHI
2017-12-31,,,291800000,342300000,207500000,280300000,615100000,335800000,335800000,-1000000,-58900000,,,,-120000000,1879400000,1543600000,1264300000,-44000000,-109200000.0,411800000,207500000,56078,VHI
2016-12-31,,,39600000,243500000,-15900000,244100000,307900000,64400000,64400000,-600000,-58100000,,,,18600000,1519400000,1455000000,1211500000,-24800000,-24000000.0,21000000,-15900000,56078,VHI
2020-12-31,100146000,,21614000,,7717000,344614000,486061000,38386000,38386000,,-17287000,,,,13897000,913219000,874833000,427158000,-16772000,,7717000,7717000,56079,BLKB
2019-12-31,106164000,,10585000,,11908000,333966000,483199000,37753000,37753000,,-20618000,,,,-1323000,900423000,862670000,417224000,-27168000,,11908000,11908000,56079,BLKB
2018-12-31,98811000,,44622000,,44841000,292702000,467764000,71407000,71407000,,-15898000,,,,-219000,848606000,777199000,380842000,-26785000,,44841000,44841000,56079,BLKB
2017-12-31,89911000,,58341000,,73633000,264429000,426583000,68972000,68972000,,-12097000,,,,-15292000,788487000,719515000,361904000,-10631000,,73633000,73633000,56079,BLKB
2019-12-31,88053000,,-108723000,,-108790000,19058000,16000,-107095000,-107095000,,-1186000,,,,67000,16000,107111000,0,-1628000,,-108790000,-108790000,56080,OBSV
2018-12-31,62872000,,-76761000,,-76716000,14297000,15000,-77154000,-77154000,,-1186000,,,,-45000,15000,77169000,0,393000,,-76716000,-76716000,56080,OBSV
2017-12-31,54912000,,-66875000,,-66926000,12568000,16000,-67464000,-67464000,,-1000,,,,51000,16000,67480000,0,1178000,,-66926000,-66926000,56080,OBSV
2016-12-31,23711000,,-30202000,,-30202000,6452000,22000,-30141000,-30141000,,-97000,,,,0,22000,30163000,0,-122000,,-30202000,-30202000,56080,OBSV
2020-06-30,122378000,,-112222000,,-112598000,146274000,160862000,-107790000,-107790000,,,,,,376000,509528000,617318000,348666000,-4432000,,-112598000,-125803000,56081,AFRM
2019-06-30,76071000,,-120419000,,-120455000,105765000,54395000,-127441000,-127441000,,,,,,36000,264367000,391808000,209972000,7022000,,-120455000,-134568000,56081,AFRM
2019-12-31,4869160,,-7532533,,-7532533,3439357,769638,-7544560,-7544560,,,,,,0,1007198,8551758,237560,12027,,-7532533,-7532533,56082,CYTH
2018-12-31,2711275,,-4255033,,-4255033,2435887,890480,-4266806,-4266806,,,,,,0,1011477,5278283,120997,11773,,-4255033,-4255033,56082,CYTH
2017-12-31,2292892,,-3833060,,-3833060,2632813,1088838,-3846138,-3846138,,,,,,0,1237756,5083894,148918,13078,,-3833060,-3833060,56082,CYTH
2016-12-31,1864726,,-4223841,,-4223841,2651019,1275622,-3347219,-3347219,,-28603.0,,,,0,1502908,4850127,227286,-876622,,-4223841,-4223841,56082,CYTH
2019-12-31,12457000,,-28433000,,-28478000,49340000,36737000,-25060000,-25060000,,-2942000,,,,45000,77429000,102489000,40692000,-3373000,,-28478000,-28478000,56084,CFMS
2018-12-31,16869000,,-43304000,,-43365000,61144000,48485000,-29528000,-29528000,,-3356000,,,,61000,89789000,119317000,41304000,-13776000,,-43365000,-43365000,56084,CFMS
2017-12-31,17136000,,-53418000,,-53580000,66412000,28814000,-54734000,-54734000,,-2119000,,,,162000,78115000,132849000,49301000,1316000,,-53580000,-53580000,56084,CFMS
2016-12-31,16608000,,-57525000,,-57588000,66120000,26707000,-56021000,-56021000,,-138000,,,,63000,79899000,135920000,53192000,-1504000,,-57588000,-57588000,56084,CFMS
2020-07-31,,,29562986,,29562986,6206863,32133185,25926322,25926322,,-4070190,,,,0,32133185,6206863,0,3636664,,29562986,29562986,56085,MCA
2019-07-31,,,40347219,,40347219,5058778,34323492,29264714,29264714,,-8590043,,,,0,34323492,5058778,0,11082505,,40347219,40347219,56085,MCA
2018-07-31,,,7710814,,7710814,4936664,34953507,30016843,30016843,,-6924263,,,,0,34953507,4936664,0,-22306029,,7710814,7710814,56085,MCA
2017-07-31,,,-7116610,,-7116610,4998859,35570620,30571761,30571761,,-5369145,,,,0,35570620,4998859,0,-37688371,,-7116610,-7116610,56085,MCA
2020-12-31,,,3532000,,2707000,27814000,37831000,0,3532000,6485000,,,,,825000,37831000,34299000,0,0,,2707000,2707000,56086,FUSB
2019-12-31,,,5812000,,4566000,27479000,39186000,0,5812000,5895000,,,,,1246000,39186000,33374000,0,0,,4566000,4566000,56086,FUSB
2018-12-31,,,3391000,-11000.0,2490000,24967000,35385000,0,5032000,5386000,,,,,901000,35385000,30353000,0,-1641000,,2490000,2490000,56086,FUSB
2017-12-31,,,2624000,-11000.0,-411000,22998000,31073000,0,2624000,5451000,,,,,3035000,31073000,28449000,0,-538000,,-411000,-411000,56086,FUSB
2020-02-29,,,94679765,,94679765,6463841,40703196,34239355,34239355,,-8093422,,,,0,40703196,6463841,0,60440410,,94679765,94679765,56087,NXJ
2019-02-28,,,33678572,,33678572,6411666,41355291,34943625,34943625,,-7538063,,,,0,41355291,6411666,0,-1265053,,33678572,33678572,56087,NXJ
2018-02-28,,,36479847,,36479847,6563070,42187872,35624802,35624802,,-5669179,,,,0,42187872,6563070,0,855045,,36479847,36479847,56087,NXJ
2017-02-28,,,-17476781,,-17476781,8994655,42706285,33711630,33711630,,-290803,,,,0,42706285,8994655,0,-51188411,,-17476781,-17476781,56087,NXJ
2020-03-31,32800000,,288000000,,241500000,415800000,936500000,487900000,487900000,,-57500000,,,,46500000,2606800000,2118900000,1670300000,-199900000,,241500000,241500000,56090,JHX
2019-03-31,37900000,,300600000,,228800000,403600000,838700000,397200000,397200000,,-54200000,,,,71800000,2506600000,2109400000,1667900000,-96600000,,228800000,228800000,56090,JHX
2018-03-31,33300000,,174300000,,146100000,311300000,730900000,386300000,386300000,,-32900000,,,,28200000,2054500000,1668200000,1323600000,-212000000,,146100000,146100000,56090,JHX
2017-03-31,30300000,,367000000,,276500000,291600000,675200000,353300000,353300000,,-27200000,,,,90500000,1921600000,1568300000,1246400000,13700000,,276500000,276500000,56090,JHX
2019-12-31,2490259,,-12616073,281658,-11759184,17449197,10021711,-10953284,-10953284,1035539,-1645953,,,,741564,137231335,148184619,127209624,-1662789,,-13357637,-11759184,56091,VIAO
2018-12-31,1336840,,3756420,1794790,3959134,17561866,21805520,1946692,1946692,960122,-1140047,,,,378110,171678894,169732202,149873374,1809728,,3378310,3959134,56091,VIAO
2017-12-31,797999,,4615075,1794790,3353540,11723420,17799899,5160927,5160927,117553,-698220,,,,1261535,131031411,125870484,113231512,-545852,,3353540,3353540,56091,VIAO
2019-12-31,,,20936000,,15998000,21297000,38963000,17666000,17666000,,,,,,4938000,124243000,106577000,85280000,3270000,,15998000,15998000,56092,CIX
2018-12-31,,,20475000,,15325000,20460000,38271000,17811000,17811000,,,,,,5150000,118217000,100406000,79946000,2664000,,15325000,15325000,56092,CIX
2017-12-31,,,17164000,,13203000,19590000,34825000,15235000,15235000,,,,,,3961000,112035000,96800000,77210000,1929000,,13203000,13203000,56092,CIX
2016-12-31,,,15964000,,10457000,19593000,35167000,15574000,15574000,,,,,,5507000,108920000,93346000,73753000,390000,,10457000,10457000,56092,CIX
2020-03-31,,,-82600000000,171120000000,-66640000000,27350000000,421850000000,124710000000,124710000000,178830000000,-45990000000,,,,-35160000000,839540000000,714830000000,417690000000,-207310000000,,-47440000000,-66640000000,56095,VEDL
2019-03-31,,,135600000000,152270000000,70650000000,31460000000,445410000000,158570000000,158570000000,172960000000,-52110000000,,,,38620000000,913590000000,755020000000,468180000000,-22970000000,,96980000000,70650000000,56095,VEDL
2018-03-31,,,195690000000,159610000000,103420000000,26050000000,429480000000,189410000000,189410000000,151190000000,-48350000000,,,,58770000000,913720000000,724310000000,484240000000,6280000000,,136920000000,103420000000,56095,VEDL
2017-03-31,,,136490000000,139280000000,69580000000,24310000000,380210000000,152020000000,152020000000,140550000000,-49780000000,,,,23330000000,722250000000,570230000000,342040000000,-15530000000,,113160000000,69580000000,56095,VEDL
2019-12-31,332000,,-3106000,,-3146000,5522000,2615000,-3239000,-3239000,,,,,,0,9876000,13115000,7261000,133000,-40000,-3106000,-3146000,56097,PRPH
2018-12-31,398000,,-1467000,,-1740000,6017000,4781000,-1634000,-1634000,,-61000.0,,,,103000,13126000,14760000,8345000,167000,-170000,-1570000,-1740000,56097,PRPH
2017-12-31,431000,,-3663000,,40589000,5507000,1948000,-3990000,-3990000,,-54000.0,,,,-1421000,9867000,13857000,7919000,327000,42831000,-2242000,40589000,56097,PRPH
2016-12-31,358000,,-4006000,,-2868000,4433000,997000,-3794000,-3794000,,-213000.0,,,,0,4206000,8000000,3209000,-212000,1138000,-4006000,-2868000,56097,PRPH
2019-12-31,,,-242138000,609000,-242767000,133586000,11912000,-121674000,-121674000,,-58665000,,,,629000,152557000,274231000,140645000,-120464000,,-242767000,-270351000,56099,AMRS
2018-12-31,,,-230235000,937000,-230235000,90902000,-41816000,-132718000,-132718000,,-42703000,,,,0,63604000,196322000,105420000,-97517000,,-230235000,-223096000,56099,AMRS
2017-12-31,,,-149105000,937000,-155982000,63853000,7802000,-56051000,-56051000,,-37081000,,,,6877000,127671000,183722000,119869000,-93054000,,-155982000,-201857000,56099,AMRS
2016-12-31,,,-96781000,937000,-97334000,47721000,-40898000,-88619000,-88619000,,-37629000,,,,553000,67192000,155811000,108090000,-8162000,,-97334000,-97334000,56099,AMRS
2019-12-31,,,105558000,206380000,62135000,32246000,1046084000,441307000,441307000,261776000,-348672000,,,,30950000,1046084000,604777000,0,-335749000,,74608000,62135000,56100,AY
2018-12-31,,,97928000,138728000,41596000,15130000,1078003000,432255000,432255000,310642000,-356793000,,,,42659000,1078003000,645748000,0,-334327000,,55269000,41596000,56100,AY
2017-12-31,,,14950000,136595000,-111804000,18854000,1029518000,398260000,398260000,301444000,-391222000,,,,119837000,1029518000,631258000,0,-383310000,,-104887000,-111804000,56100,AY
2016-12-31,,,3333000,126395000,-4855000,14736000,951331000,363652000,363652000,260318000,-333914000,,,,1666000,978250000,614598000,26919000,-360319000,,1667000,-4855000,56100,AY
2020-01-31,,,5035000,,3576000,23106000,29046000,5940000,5940000,,-1106000,,,,1459000,127663000,121723000,98617000,-905000,,3576000,3576000,56101,PPIH
2019-01-31,,,1600000,,-550000,20596000,23318000,2722000,2722000,,-1286000,,,,2150000,128965000,126243000,105647000,-1522000,,-550000,-550000,56101,PPIH
2018-01-31,,,-10209000,,-9976000,20054000,11742000,-8312000,-8312000,,-808000,,,,-233000,105248000,113560000,93506000,-1897000,,-9976000,-9976000,56101,PPIH
2017-01-31,,,-13773000,,-12474000,21600000,11716000,-9884000,-9884000,,-746000,,,,-611000,98845000,108729000,87129000,-3889000,688000.0,-13162000,-12474000,56101,PPIH
2019-12-31,5324000,,-21312000,,-21312000,2701000,0,-8025000,-8025000,,-22000,,,,0,0,8025000,0,-13287000,,-21312000,-21312000,56102,NRBO
2018-12-31,5066000,,-15529000,,-15529000,1605000,0,-6671000,-6671000,,-40000,,,,0,0,6671000,0,-8858000,,-15529000,-15529000,56102,NRBO
2017-12-31,5066000,,-60000,,-60000,60000,0,-60000,-60000,,-40000,,,,0,0,60000,0,0,,-60000,-60000,56102,NRBO
2019-12-31,,,1940300000,727100000,1339100000,405900000,2712500000,2075100000,2075100000,,-197100000,,,,504400000,14953700000,12878600000,12241200000,-134800000,,1435900000,1339100000,56104,OMC
2018-12-31,,,1933200000,804100000,1326400000,453200000,2764400000,2047200000,2047200000,,-209100000,,,,492700000,15290200000,13243000000,12525800000,-114000000,,1440500000,1326300000,56104,OMC
2017-12-31,,,1888400000,719500000,1088400000,439700000,2756600000,2034800000,2034800000,,-199600000,,,,696200000,15273600000,13238800000,12517000000,-146400000,,1192200000,1086800000,56104,OMC
2016-12-31,,,1847200000,699200000,1148600000,443900000,2745700000,2008900000,2008900000,,-209700000,,,,600500000,15416900000,13408000000,12671200000,-161700000,,1246700000,1142100000,56104,OMC
2019-12-31,74860000,,25942000,24724000,20928000,51289000,163984000,37835000,37835000,,-40955000,,,,10991000,318924000,281089000,154940000,-11893000,,14951000,20928000,56106,IDCC
2018-12-31,69698000,,32058000,1284000,65031000,51030000,183323000,62595000,62595000,,-35956000,,,,-27417000,307404000,244809000,124081000,-30537000,,59475000,65031000,56106,IDCC
2017-12-31,75724000,,292390000,17881000,176220000,53068000,430287000,301495000,301495000,,-17845000,,,,121676000,532938000,231443000,102651000,-9105000,,170714000,176220000,56106,IDCC
2016-12-31,73118000,,422271000,14659000,309001000,52067000,562491000,437306000,437306000,,-21126000,,,,116791000,665854000,228548000,103363000,-15035000,,305480000,309001000,56106,IDCC
2019-12-31,,,23646000,,19750000,29251000,53959000,24708000,24708000,,-1062000,,,,3896000,198381000,173673000,144422000,-1450000,,19750000,19750000,56107,UFPT
2018-12-31,,,18403000,,14311000,27654000,48308000,20654000,20654000,,-1256000,,,,4092000,190455000,169801000,142147000,-2187000,,14311000,14311000,56107,UFPT
2017-12-31,,,11859000,,9210000,23724000,35487000,11763000,11763000,,-50000,,,,2649000,147843000,136080000,112356000,96000,,9210000,9210000,56107,UFPT
2016-12-31,,,12317000,,7970000,24105000,34650000,10545000,10545000,,-69000,,,,4347000,146132000,135587000,111482000,1772000,,7970000,7970000,56107,UFPT
2019-12-31,,,-285484,,-16826343,1170617,562235,-289403,-289403,,-23251,,,,128799,19584477,19873880,19022242,3919,-16412060,-414283,-16826343,56108,CCNC
2018-12-31,,,-400796,,1449992,747823,333905,-413918,-413918,,-16992,,,,4328,1453076,1866994,1119171,13122,1855116,-405124,1449992,56108,CCNC
2017-12-31,,,6167419,,4213477,1804895,19517745,11284589,11284589,,-173268,,,,1953942,38751765,27467176,19234020,-5117170,1855116,4213477,4213477,56108,CCNC
2016-12-31,,,11139276,,9289341,867872,12156887,11289015,11289015,,-143632,,,,1849935,26305723,15016708,14148836,-149739,1855116,9289341,9289341,56108,CCNC
2019-12-31,8538416,,-14175421,,-13675129,16138424,3531299,-12607125,-12607125,,-846831,,,,-500292,34464032,47071157,30932733,-1568296,,-13675129,-13675129,56109,CEMI
2018-12-31,8526256,,-7933170,,-7865649,11100775,3455752,-7645023,-7645023,,-846831,,,,-67521,34581440,42226463,31125688,-288147,,-7865649,-7865649,56109,CEMI
2017-12-31,8526256,,-6460065,,-6371760,9111363,2538889,-6572474,-6572474,,-846831,,,,-88305,24015427,30587901,21476538,112409,,-6371760,-6371760,56109,CEMI
2016-12-31,8526256,,-7546229,,-13347047,7595559,23782,-7571777,-7571777,,-846831,,,,5800818,17868841,25440618,17845059,25548,,-13347047,-13347047,56109,CEMI
2019-12-31,,,-31221151,36737663,-31671869,27778422,14940356,-26131345,-26131345,,-811017,,,,585000,55363906,81495251,40423550,-5089806,,-31806151,-34976816,56114,CSSEP
2018-12-31,,,29028,36737663,-844972,13412142,14513929,774799,774799,,-388036,,,,874000,26859519,26084720,12345590,-745771,,-844972,-1957882,56114,CSSEP
2017-12-31,,,20356283,36737663,21081283,7003274,6419980,-593113,-593113,,-1190111,,,,-725000,10657151,11250264,4237171,20949396,,21081283,21081283,56114,CSSEP
2016-12-31,,,1220133,36737663,781133,3182775,4962964,1780189,1780189,,-560069,,,,439000,8118632,6338443,3155668,-560056,,781133,781133,56114,CSSEP
2019-12-31,,,-152600000,,-152600000,72367000,-37284000,-118868000,-118868000,,-16977000,,,,0,35219000,154087000,72503000,-33732000,,-152600000,-155867000,56115,DVAX
2018-12-31,,,-158899000,,-158899000,64770000,-77687000,-153319000,-153319000,,-9338000,,,,0,8198000,161517000,85885000,-5580000,,-158899000,-158899000,56115,DVAX
2017-12-31,,,-95154000,,-95154000,27367000,-64661000,-93222000,-93222000,,-9338000,,,,0,327000,93549000,64988000,-1932000,,-95154000,-95154000,56115,DVAX
2016-12-31,,,-112444000,,-112444000,37257000,-73450000,-110707000,-110707000,,-9338000,,,,0,11043000,121750000,84493000,-1737000,,-112444000,-112444000,56115,DVAX
2020-10-31,1989000,,-448000,,-81000,10837000,11566000,-1260000,-1260000,,,,,,-367000,43044000,44304000,31478000,812000,,-81000,-81000,56116,RFIL
2019-10-31,1468000,,4557000,,3521000,9502000,15637000,4667000,4667000,,,,,,1036000,55325000,50658000,39688000,-110000,,3521000,3521000,56116,RFIL
2018-10-31,1480000,,7494000,,5846000,8173000,17100000,7447000,7447000,,,,,,1468000,50196000,42749000,33096000,73000,-180000.0,6026000,5846000,56116,RFIL
2017-10-31,824000,,232000,,382000,5981000,6987000,182000,182000,,,,,,62000,22983000,22801000,15996000,50000,212000.0,170000,382000,56116,RFIL
2019-12-31,42329000,,-7321000,,-17601000,64256000,131440000,18997000,18997000,,-8076000,,,,10280000,267028000,248031000,135588000,-26318000,,-17601000,-17601000,56119,CMBM
2018-12-31,38917000,,-2312000,,-1513000,61462000,115495000,6351000,6351000,,-8113000,,,,-799000,241762000,235411000,126267000,-8963000,,-1513000,-1513000,56119,CMBM
2017-12-31,32227000,,9381000,,9128000,53787000,110711000,15873000,15873000,,-5018000,,,,-418000,216671000,200798000,105960000,-6492000,,9799000,9128000,56119,CMBM
2016-12-31,26267000,,4460000,8617000.0,2275000,42839000,89729000,12190000,12190000,,-7565000,,,,1547000,181444000,169254000,91715000,-7730000,,2913000,2275000,56119,CMBM
2019-12-31,,,-1739,,-1739,,0,0,,,,,,,0,0,0,0,-1739,,-1739,-1739,56120,ROCH
2020-12-31,,,326971000,,306771000,629108000,1120712000,0,444914000,46690000,,,,,20200000,1120712000,675798000,0,-117943000,,306771000,286425000,56122,ASB
2019-12-31,,,406510000,,326790000,704942000,1200563000,0,448952000,46669000,,,,,79720000,1200563000,751611000,0,-42442000,,326790000,309515000,56122,ASB
2018-12-31,,,413348000,,333562000,691698000,1234600000,0,487374000,55528000,,,,,79786000,1234600000,747226000,0,-74026000,,333562000,321181000,56122,ASB
2017-12-31,,,338767000,,229264000,618478000,1047900000,0,379319000,50103000,,,,,109503000,1047900000,668581000,0,-40552000,,229264000,218560000,56122,ASB
2019-12-31,,,-22674000,,-22674000,7766000,-14530000,-22296000,-22296000,,-386000,,,,0,0,22296000,14530000,-378000,,-22674000,-22674000,56124,TCON
2018-12-31,6569000.0,,-34959000,,-34959000,7280000,-27460000,-34740000,-34740000,,-231000,,,,0,3000000,37740000,30460000,-219000,,-34959000,-34959000,56124,TCON
2017-12-31,6719000.0,,-19103000,,-19103000,7610000,-10600000,-18210000,-18210000,,-886000,,,,0,8755000,26965000,19355000,-893000,,-19103000,-19103000,56124,TCON
2016-12-31,6322000.0,,-27008000,,-27008000,7859000,-11795000,-25976000,-25976000,,-1119000,,,,0,3449000,29425000,15244000,-1032000,,-27008000,-27008000,56124,TCON
2019-12-31,204207000,,241916000,,171597000,417137000,935403000,314059000,314059000,,-27711000,,,,70319000,1887026000,1572967000,951623000,-72143000,,171597000,171597000,56125,FLIR
2018-12-31,176281000,,307103000,,282425000,386869000,903667000,340517000,340517000,,-16147000,,,,24678000,1775686000,1435169000,872019000,-33414000,,282425000,282425000,56125,FLIR
2017-12-31,170735000,,279065000,,107223000,373867000,858776000,314174000,314174000,,-16804000,,,,171842000,1800434000,1486260000,941658000,-35109000,,107223000,107223000,56125,FLIR
2016-12-31,147537000,,275957000,,166626000,322435000,767121000,297149000,297149000,,-18071000,,,,109331000,1662167000,1365018000,895046000,-21192000,,166626000,166626000,56125,FLIR
2019-12-31,,,-94433000,,-94433000,19409000,-78531000,-97940000,-97940000,,,,,,0,4365000,102305000,82896000,3507000,,-94433000,-94433000,56126,GRTS
2018-12-31,54965000.0,,-64775000,,-64775000,11806000,-53778000,-65584000,-65584000,,,,,,0,1187000,66771000,54965000,809000,,-64775000,-64775000,56126,GRTS
2017-12-31,54965000.0,,-41377000,,-41377000,6072000,-35691000,-41763000,-41763000,,,,,,0,0,41763000,35691000,386000,,-41377000,-41377000,56126,GRTS
2016-12-31,54965000.0,,-18750000,,-18750000,5064000,-13916000,-18980000,-18980000,,,,,,0,0,18980000,13916000,230000,,-18750000,-18750000,56126,GRTS
2019-12-31,,,27488000,,27488000,2479000,13103000,10624000,10624000,,,,,,0,13103000,2479000,0,16864000,,27488000,27488000,56128,MSD
2018-12-31,,,-15933000,,-15933000,2484000,12812000,10328000,10328000,,,,,,0,12812000,2484000,0,-26261000,,-15933000,-15933000,56128,MSD
2017-12-31,,,21415000,,21415000,2658000,14822000,12164000,12164000,,,,,,0,14822000,2658000,0,9251000,,21415000,21415000,56128,MSD
2016-12-31,,,22468000,,22468000,2555000,15713000,13158000,13158000,,,,,,0,15713000,2555000,0,9310000,,22468000,22468000,56128,MSD
2020-12-31,263000000,,430000000,,131000000,1468000000,4099000000,1862000000,1862000000,,-394000000,,,,299000000,8040000000,6178000000,3941000000,-1432000000,,131000000,131000000,56129,SIRI
2019-12-31,280000000,,1197000000,,914000000,1436000000,3940000000,1756000000,1756000000,,-390000000,,,,283000000,7794000000,6038000000,3854000000,-559000000,,914000000,914000000,56129,SIRI
2018-12-31,123000000,,1421000000,,1176000000,838000000,3061000000,1799000000,1799000000,,-350000000,,,,245000000,5771000000,3972000000,2710000000,-378000000,,1176000000,1176000000,56129,SIRI
2017-12-31,112000000,,1264000000,,648000000,773000000,2870000000,1686000000,1686000000,,-346000000,,,,616000000,5425000000,3739000000,2555000000,-422000000,,648000000,648000000,56129,SIRI
2019-12-31,,,84763000,,65091000,149567000,249547000,99980000,99980000,,-2205000,,,,19672000,1047439000,947459000,797892000,-15217000,,65091000,65091000,56130,ROCK
2018-12-31,,,79945000,,63809000,143839000,244266000,100427000,100427000,,-12064000,,,,16136000,1002372000,901945000,758106000,-20482000,,63809000,63809000,56130,ROCK
2017-12-31,,,77908000,,62560000,139177000,237455000,98278000,98278000,,-14032000,,,,14943000,986918000,888640000,749463000,-20370000,-405000.0,62965000,62560000,56130,ROCK
2016-12-31,,,49983000,,33675000,157496000,254765000,97269000,97269000,,-14577000,,,,16264000,1007981000,910712000,753216000,-47286000,-44000.0,33719000,33675000,56130,ROCK
2020-12-31,1142000000,,675000000,239000000,681000000,2675000000,5710000000,1211000000,1211000000,,-45000000,,,,-81000000,14217000000,13006000000,8507000000,-536000000,-55000000,756000000,681000000,56134,CTVA
2019-12-31,1147000000,,-316000000,246000000,-959000000,2874000000,5543000000,1047000000,1047000000,,-136000000,,,,-46000000,13846000000,12799000000,8303000000,-1363000000,-671000000,-270000000,-959000000,56134,CTVA
2018-12-31,1355000000,,-6806000000,493000000,-5065000000,2766000000,5893000000,1381000000,1381000000,,-337000000,,,,-31000000,14287000000,12906000000,8394000000,-8187000000,1748000000,-6775000000,-5065000000,56134,CTVA
2017-12-31,1075000000,,-498000000,493000000,2916000000,3082000000,4785000000,336000000,336000000,195000000.0,-369000000,,,,-2616000000,10684000000,10348000000,5899000000,-834000000,835000000,2118000000,2916000000,56134,CTVA
2019-12-31,,,172477000,-704000,173736000,36366000,211992000,0,175626000,,,,,,-419000,225461000,49835000,13469000,-3149000,,172896000,144835000,56135,NYMTN
2018-12-31,,,103738000,904000,102886000,28234000,132408000,0,104174000,44050000.0,,,,,-1057000,145644000,41470000,13236000,-436000,,104795000,79186000,56135,NYMTN
2017-12-31,,,91922000,4136000,91980000,22874000,114796000,0,91922000,44050000.0,,,,,3355000,132999000,41077000,18203000,0,,88567000,76320000,56135,NYMTN
2016-12-31,,,70655000,3087000,67551000,24507000,95097000,0,70590000,44050000.0,,,,,3095000,105811000,35221000,10714000,65000,,67560000,54651000,56135,NYMTN
2019-12-31,,,-282400000,,-282400000,228900000,-31200000,-260100000,-260100000,,-22300000,,,,0,290200000,550300000,321400000,-22300000,,-282400000,-282400000,56140,ROOT
2018-12-31,,,-69100000,,-69100000,68000000,-200000,-68200000,-68200000,,-900000,,,,0,43300000,111500000,43500000,-900000,,-69100000,-69100000,56140,ROOT
2019-12-31,,,103229000,,67928000,48274000,537094000,184912000,184912000,63185000,-2907000,,,,35301000,628921000,444009000,91827000,-81683000,,67928000,55627000,56141,CPE
2018-12-31,,,308470000,,300360000,35293000,482689000,308074000,308074000,-43461000,-2500000,,,,8110000,551869000,243795000,69180000,-4687000,,300360000,293065000,56141,CPE
2017-12-31,,,121697000,,120424000,27067000,294171000,122545000,122545000,21817000,-2159000,,,,1273000,344078000,221533000,49907000,-4289000,,120424000,113129000,56141,CPE
2016-12-31,,,-91827000,,-91813000,26093000,150628000,31975000,31975000,21191000,-11871000,,,,-14000,200851000,168876000,50223000,-123802000,,-91813000,-99108000,56141,CPE
2020-10-03,,,135397000,,117479000,153331000,312706000,159375000,159375000,,-16162000,,,,17918000,3390394000,3231019000,3077688000,-23978000,,117479000,117479000,56142,PLXS
2019-09-28,,,125955000,,108616000,148105000,291838000,143733000,143733000,,-12853000,,,,17339000,3164434000,3020701000,2872596000,-17778000,,108616000,108616000,56142,PLXS
2018-09-29,,,107610000,,13040000,139317000,257600000,118283000,118283000,,-12226000,,,,94570000,2873508000,2755225000,2615908000,-10673000,,13040000,13040000,56142,PLXS
2017-09-30,,,121823000,,112062000,125947000,255855000,129908000,129908000,,-13578000,,,,9761000,2528052000,2398144000,2272197000,-8085000,,112062000,112062000,56142,PLXS
2019-12-31,,,-37818000,,-37818000,4845000,-2318000,-10781000,-10781000,,-2988000,,,,0,0,10781000,2318000,-27037000,,-37818000,-37818000,56143,GATO
2018-12-31,,,-11667000,,-11664000,4396000,-2527000,-10939000,-10939000,,-283000,,,,-3000,0,10939000,2527000,-728000,,-11664000,-11664000,56143,GATO
2017-12-31,,,-12811000,,-12811000,6494000,-2408000,-12564000,-12564000,,-283000,,,,0,0,12564000,2408000,-247000,,-12811000,-12811000,56143,GATO
2012-12-31,,,-59596000,,-59582000,14516000,-24230000,-59826000,-59826000,,-283000,,,,-14000,0,59826000,24230000,230000,,-59582000,-59582000,56143,GATO
2019-12-31,,,-76929000,,-70513000,126098000,153408000,5810000,5810000,,-14262000,,,,-6416000,837398000,831588000,683990000,-82739000,,-70513000,-70513000,56146,LDL
2018-12-31,,,43397000,,34944000,90403000,156514000,56811000,56811000,,-6212000,,,,8453000,785897000,729086000,629383000,-13414000,,34944000,34944000,56146,LDL
2017-12-31,,,61291000,,49317000,93433000,163359000,65426000,65426000,,-2720000,,,,11974000,698437000,633011000,535078000,-4135000,,49317000,49317000,56146,LDL
2016-12-31,,,55008000,,37187000,80512000,140758000,60246000,60246000,,-1068000,,,,17821000,566852000,506606000,426094000,-5238000,,37187000,37187000,56146,LDL
2020-12-31,,,4190000000,2996000000,3363000000,6602000000,18418000000,8104000000,8104000000,,-2790000000,,,,774000000,39087000000,30983000000,20669000000,-3914000000,,3416000000,2983000000,56147,ENB
2019-12-31,,,7535000000,3364000000,5705000000,6890000000,19065000000,8784000000,8784000000,,-2663000000,,,,1708000000,50069000000,41285000000,31004000000,-1249000000,,5827000000,5322000000,56147,ENB
2018-12-31,,,3570000000,3965000000,2882000000,6662000000,16977000000,7069000000,7069000000,,-2703000000,,,,237000000,46378000000,39309000000,29401000000,-3499000000,,3333000000,2515000000,56147,ENB
2017-12-31,,,569000000,11664000000,2859000000,6194000000,15741000000,6384000000,6384000000,,-2556000000,,,,-2697000000,44378000000,37994000000,28637000000,-5815000000,,3266000000,2529000000,56147,ENB
2019-12-31,13291000,,-24871000,,-24871000,13136000,31000,-26396000,-26396000,,-931000,,,,0,31000,26427000,0,1525000,,-24871000,-24871000,56148,TRVN
2018-12-31,15824000,,-30039000,,-30784000,20372000,5732000,-30464000,-30464000,,-2231000,,,,745000,5732000,36196000,0,425000,,-30784000,-30784000,56148,TRVN
2017-12-31,48974000,,-71865000,,-71865000,20994000,-48974000,-69968000,-69968000,,-2780000,,,,0,0,69968000,48974000,-1897000,,-71865000,-71865000,56148,TRVN
2016-12-31,89956000,,-102994000,,-102994000,16077000,3750000,-102283000,-102283000,,-1738000,,,,0,3750000,106033000,89956000,-711000,,-102994000,-102994000,56148,TRVN
2019-12-31,,,-52013186,,-52013186,13886584,-3331945,-36426528,-36426528,,-206454,,,,0,257099,36683627,3589044,-15586658,,-52013186,-52013186,56153,HUGE
2018-12-31,,,-22710624,,-22710624,17379883,-1360477,-25363960,-25363960,,-206454,,,,0,0,25363960,1360477,2653336,,-22710624,-22710624,56153,HUGE
2017-12-31,,,-3524515,,-3524515,559858,25943,-3524515,-3524515,,-206454,,,,0,25943,3550458,0,0,,-3524515,-3524515,56153,HUGE
2016-12-31,,,-176916,,-176916,176916,0,-176916,-176916,,-206454,,,,0,0,176916,0,0,,-176916,-176916,56153,HUGE
2019-12-31,,,8673000,,7347000,,5420000,8673000,8673000,-3253000,,,,,1326000,495597000,486924000,490177000,0,,7347000,7347000,56155,PTVCB
2018-12-31,,,-43872000,,-34075000,,-31438000,-40720000,-40720000,9282000,,,,,-9797000,439169000,479889000,470607000,-3152000,,-34075000,-34075000,56155,PTVCB
2017-12-31,,,10122000,,18323000,,15912000,10122000,10122000,5790000,,,,,-8201000,371234000,361112000,355322000,0,,18323000,18323000,56155,PTVCB
2016-12-31,,,43054000,,28945000,,39227000,43054000,43054000,-3827000,,,,,14109000,318997000,275943000,279770000,0,,28945000,28945000,56155,PTVCB
2019-12-31,,,-18953000,1833000,-17115000,16376000,-3848000,-23418000,-23418000,,,,,,-1824000,11246000,34664000,15094000,4465000,,-17129000,-17422000,56156,ACTG
2018-12-31,,,-103669000,1847000,-105029000,18728000,49369000,11828000,11828000,2602000.0,,,,,1179000,131506000,119678000,82137000,-115497000,,-104848000,-105029000,56156,ACTG
2017-12-31,,,24639000,1358000,22180000,27219000,24349000,-25024000,-25024000,2602000.0,,,,,2955000,65402000,90426000,41053000,49663000,,21684000,22147000,56156,ACTG
2016-12-31,,,-36611000,1854000,-54067000,35998000,75637000,5431000,5431000,2602000.0,,,,,18188000,152699000,147268000,77062000,-42042000,,-54799000,-54067000,56156,ACTG
2019-12-31,54974000,,-72965000,,-72965000,20835000,0,-75809000,-75809000,,,,,,0,0,75809000,0,2844000,,-72965000,-72965000,56157,AVRO
2018-12-31,35095000,,-46361000,,-46361000,11148000,0,-46243000,-46243000,,,,,,0,0,46243000,0,-118000,,-46361000,-48604000,56157,AVRO
2017-12-31,15191000,,-18648000,,-18648000,3195000,0,-18386000,-18386000,,,,,,0,0,18386000,0,-262000,,-18648000,-18733000,56157,AVRO
2016-12-31,2663000,,-4664000,,-4664000,1962000,0,-4625000,-4625000,,,,,,0,0,4625000,0,-39000,,-4664000,-4969000,56157,AVRO
2020-12-31,,,108284000,,80084000,125618000,273131000,0,118092000,29421000,,,,,27688000,273131000,155039000,0,-9808000,-512000,80596000,80084000,56158,TBBK
2019-12-31,,,72494000,,51559000,137939000,241015000,0,90858000,12218000,,,,,21226000,241015000,150157000,0,-18364000,291000,51268000,51559000,56158,TBBK
2018-12-31,,,119781000,,88677000,127144000,271059000,0,130236000,13679000,,,,,32241000,271059000,140823000,0,-10455000,1137000,87540000,88677000,56158,TBBK
2017-12-31,,,40394000,,21673000,126616000,196207000,0,56344000,13247000,,,,,23056000,196207000,139863000,0,-15950000,4335000,17338000,21673000,56158,TBBK
2020-12-31,,,92496000,,71100000,56026000,197727000,94880000,94880000,-57219000,-11697000,,,,21396000,2940163000,2845283000,2742436000,-2384000,,71100000,71100000,56159,ARCB
2019-12-31,,,51471000,,39985000,46255000,204157000,76794000,76794000,-20034000,-11467000,,,,11486000,2988310000,2911516000,2784153000,-25323000,,39985000,39963000,56159,ARCB
2018-12-31,,,84386000,,67262000,36697000,289302000,125724000,125724000,27180000,-9468000,,,,17124000,3093788000,2968064000,2804486000,-41338000,,67262000,67112000,56159,ARCB
2017-12-31,,,51576000,,59726000,33727000,237976000,53882000,53882000,54770000,-6342000,,,,-8150000,2826457000,2772575000,2588481000,-2306000,,59726000,59488000,56159,ARCB
2019-12-31,,,2908267,,2801406,1916386,3319990,1403604,1403604,,-15736,,,,106861,9329720,7926116,6009730,1504663,,2801406,2801406,56160,AUVI
2018-12-31,,,720243,,720243,1913101,2666432,753331,753331,,-35640,,,,0,7556444,6803113,4890012,-33088,,720243,720243,56160,AUVI
2019-12-31,,,641113042,,641113042,30191524,104149878,73958354,73958354,,-24717670,,,,0,104149878,30191524,0,567154688,,641113042,641113042,56161,UTF
2018-12-31,,,-123551778,,-123551778,28405535,94691347,66285812,66285812,,-21577255,,,,0,94691347,28405535,0,-189837590,,-123551778,-123551778,56161,UTF
2017-12-31,,,452194823,,452194823,28438125,103135556,74697431,74697431,,-17228071,,,,0,103135556,28438125,0,377497392,,452194823,452194823,56161,UTF
2016-12-31,,,154751163,,154751163,26966793,102168011,75201218,75201218,,-16421565,,,,0,102168011,26966793,0,79549945,,154751163,154751163,56161,UTF
2019-12-31,,,1006000000,5628000000,494000000,1495000000,3940000000,1628000000,1628000000,231000000,-435000000,,,,271000000,7794000000,6166000000,3854000000,-622000000,,735000000,494000000,56164,LSXMK
2018-12-31,,,1245000000,5108000000,676000000,878000000,2993000000,1623000000,1623000000,106000000,-388000000,,,,241000000,5771000000,4148000000,2778000000,-378000000,,1004000000,676000000,56164,LSXMK
2017-12-31,,,1193000000,5615000000,1124000000,812000000,2824000000,1547000000,1547000000,97000000,-356000000,,,,-466000000,5425000000,3878000000,2601000000,-354000000,,1659000000,1124000000,56164,LSXMK
2016-12-31,,,998000000,5945000000,413000000,761000000,2507000000,1352000000,1352000000,69000000,-342000000,,,,341000000,5014000000,3662000000,2507000000,-354000000,,657000000,413000000,56164,LSXMK
2020-12-31,,,515300000,3400000,441800000,6782000000,7539600000,757600000,757600000,,-104500000,,,,72600000,10088900000,9331300000,2549300000,-242300000,,442700000,423100000,56165,AIZ
2019-12-31,,,554500000,29300000,382600000,6782000000,934300000,740300000,740300000,194000000.0,-110600000,,,,167700000,9923800000,9183500000,8989500000,-185800000,,386800000,363900000,56165,AIZ
2018-12-31,,,333500000,21900000,251000000,6782000000,785600000,515000000,515000000,270600000.0,-100300000,,,,80900000,8057600000,7542600000,7272000000,-181500000,,252600000,236800000,56165,AIZ
2017-12-31,,,444500000,10900000,519600000,6782000000,707500000,494000000,494000000,213500000.0,-49500000,,,,-75100000,6415000000,5921000000,5707500000,-49500000,,519600000,519600000,56165,AIZ
2019-12-31,,,-231044000,,-187001000,134989000,1111634000,-54822000,-54822000,122327000,-159102000,,,,-44043000,1524243000,1579065000,412609000,-176222000,,-187001000,-187001000,56168,SM
2018-12-31,,,651777000,,508407000,118609000,1173688000,407315000,407315000,-122604000,-160906000,,,,143370000,1573255000,1165940000,399567000,244462000,,508407000,508407000,56168,SM
2017-12-31,,,-343813000,,-160843000,122051000,767498000,-37461000,-37461000,55081000,-179257000,,,,-182970000,1208004000,1245465000,440506000,-306352000,,-160843000,-160843000,56168,SM
2016-12-31,,,-1201916000,,-757744000,127099000,594211000,-1087689000,-1087689000,264105000,-158685000,,,,-444172000,1128476000,2216165000,534265000,-114227000,,-757744000,-757744000,56168,SM
2019-12-31,5708325,,37886481,516467,29524392,32456520,80103568,47485210,47485210,-5546487,-10396961,,,,9623447,349990753,302505543,269887185,-9598729,1260790,28263034,29524392,56169,DQ
2018-12-31,2736520,,73514263,516467,38124705,27076669,98113706,81204907,81204907,-12904390,-10762677,,,,11716545,301599897,220394990,203486191,-7690644,-23032181,61797718,38124705,56169,DQ
2017-12-31,676323,,115008885,2792480,92841128,15842494,144047764,131012428,131012428,-3483481,-16262205,,,,17332226,323199694,192187266,179151930,-16003543,-3821259,97676659,92841128,56169,DQ
2016-12-31,3878414,,48571495,1629161,43493756,12481878,77810799,63735838,63735838,-2285331,-12720155,,,,7358089,196219101,132483263,118408302,-15164343,2710591,41213406,43493756,56169,DQ
2019-12-31,1861103,,-33054121,8242,-32913412,21302804,2059348,-21099044,-21099044,-5515,-7262646,,,,-108293,26511640,47610684,24452292,-11955077,,-32945828,-32929350,56170,DPW
2018-12-31,1430538,,-33058800,40658,-32233881,22853168,5379561,-18905456,-18905456,1311,-16190276,,,,-76599,27154219,46059675,21774658,-14153344,,-32982201,-32341930,56170,DPW
2017-12-31,1119745,,-10973442,780737,-10616231,8712773,3849473,-5983045,-5983045,1311,-4990397,,,,-78393,10174500,16157545,6325027,-4990397,,-10895049,-11254472,56170,DPW
2016-12-31,709000,,-1142000,780737,-1122000,3216000,2706000,-1219000,-1219000,1311,-34000,,,,-20000,7596000,8815000,4890000,77000,,-1122000,-1122000,56170,DPW
2019-12-31,13126000,,-105965000,,-97370000,39241000,22901000,-42307000,-42307000,,-170000,,,,-8595000,36443000,78750000,13542000,-63658000,,-97370000,-95840000,56173,GTYH
2018-12-31,9957000,,-15743000,,-16520000,22493000,19415000,-13430000,-13430000,,-506000,,,,777000,29810000,43240000,10395000,-2313000,,-16520000,-16520000,56173,GTYH
2017-12-31,9957000,,3860175,,3860175,694226,0,-694226,-694226,,-506000,,,,0,0,694226,0,4554401,,3860175,3860175,56173,GTYH
2016-12-31,9957000,,153463,,153463,479602,0,-479602,-479602,,-506000,,,,0,0,479602,0,633065,,153463,153463,56173,GTYH
2019-12-31,8128000,,-16011000,,-16011000,6056000,0,-14184000,-14184000,,,,,,0,0,14184000,0,-1827000,,-16011000,-16011000,56174,ELDN
2018-12-31,6817000,,-14065000,,-14065000,7243000,0,-14060000,-14060000,,,,,,0,0,14060000,0,-5000,,-14065000,-14065000,56174,ELDN
2017-12-31,2022000,,-13116000,,-13116000,11099000,0,-13121000,-13121000,,,,,,0,0,13121000,0,5000,,-13116000,-10778000,56174,ELDN
2016-12-31,3191000,,-5655000,,-5655000,1937000,0,-5128000,-5128000,,,,,,0,0,5128000,0,-527000,,-5655000,-941000,56174,ELDN
2019-12-31,16384000,,-46519000,,-46519000,3582000,0,-19966000,-19966000,,-33000,,,,0,0,19966000,0,-26553000,,-46519000,-46519000,56177,KDNY
2018-12-31,3204000,,-4128000,,-4128000,804000,0,-4008000,-4008000,,-18000,,,,0,0,4008000,0,-120000,,-4128000,-4128000,56177,KDNY
2019-12-31,,,1702955,,1345334,,0,-459782,-459782,459782,,,,,357621,0,459782,0,2162736,,1345334,-174531,56182,EXPC
2020-09-30,,,-8079000,,-5938000,18322000,18808000,0,-2368000,,,,,,-1865000,229785000,232153000,210977000,-5711000,,-6214000,-5938000,56184,NHLD
2019-09-30,,,2160000,1761000.0,-819000,17880000,27552000,0,7840000,,,,,,319000,212909000,205069000,185357000,-5680000,,1841000,-819000,56184,NHLD
2018-09-30,,,-8322000,1761000.0,-11510000,13539000,21126000,0,6036000,,,,,,3188000,211018000,204982000,189892000,-14358000,,-11510000,-11510000,56184,NHLD
2017-09-30,,,16579000,15000.0,12528000,13746000,28526000,0,13551000,,,,,,4051000,189856000,176305000,161330000,3028000,,12528000,12528000,56184,NHLD
2017-12-31,,,-8352,,-8352,,0,0,,,,,,,0,0,0,0,-8352,,-8352,-8352,56186,MUDSU
2020-03-31,43080000000,,160912000000,115147000000,149433000000,78870000000,229998000000,94660000000,94660000000,,-5180000000,,,,20562000000,509711000000,415051000000,279713000000,66252000000,,140350000000,149263000000,56189,BABA
2019-03-31,37435000000,,96787000000,116326000000,87886000000,62990000000,172758000000,61606000000,61606000000,,-5190000000,,,,16553000000,376844000000,315238000000,204086000000,35181000000,,80234000000,87600000000,56189,BABA
2018-03-31,22754000000,,79611000000,70616000000,64093000000,43540000000,144023000000,70609000000,70609000000,,-3566000000,,,,18199000000,250266000000,179657000000,106243000000,9002000000,,61412000000,63985000000,56189,BABA
2017-03-31,17060000000,,55002000000,42330000000,43675000000,28553000000,99647000000,48912000000,48912000000,,-2671000000,,,,13776000000,158273000000,109361000000,58626000000,6090000000,,41226000000,43675000000,56189,BABA
2020-09-30,,,13597000,48969000,10430000,95326000,107960000,18789000,18789000,-6155000,-1021000,,,,5460000,209558000,190769000,101598000,-5192000,,8137000,10352000,56192,DL
2019-09-30,,,24315000,50915000,21254000,86379000,107081000,23670000,23670000,-2968000,-2819000,,,,8121000,211822000,188152000,104741000,645000,,16194000,21117000,56192,DL
2018-09-30,,,14610000,65491000,11626000,65970000,78785000,15866000,15866000,-3051000,-3331000,,,,2307000,166668000,150802000,87883000,-1256000,,12303000,11583000,56192,DL
2017-09-30,,,20888000,24029000,14935000,54378000,73576000,21110000,21110000,-1912000,-1049000,,,,4620000,130988000,109878000,57412000,-222000,,16268000,14891000,56192,DL
2019-12-31,30411000,,-50912000,,-50915000,18909000,2541000,-46779000,-46779000,,-4793000,,,,3000,2541000,49320000,0,-4133000,,-50915000,-50915000,56194,NBTX
2018-12-31,20893000,,-30345000,,-30345000,12653000,3479000,-30067000,-30067000,,-847000,,,,0,3479000,33546000,0,-278000,,-30345000,-30345000,56194,NBTX
2017-12-31,17733000,,-26143000,,-26143000,11255000,3722000,-25266000,-25266000,,-108000,,,,0,3722000,28988000,0,-877000,,-26143000,-26143000,56194,NBTX
2016-12-31,16915243,,-21790086,,-21880511,8370208,5421613,-21854693,-21854693,,-102203,,,,90425,5421613,27276306,0,64607,,-21880511,-21880511,56194,NBTX
2020-09-30,,,13870194,,10564534,-100195,22603696,12618377,12618377,2194789,-4099158,,,,3305660,63075391,50457014,40471695,1251817,,10564534,10564534,56198,RGCO
2019-09-30,,,11349143,,8698412,1421,21116532,11594043,11594043,2066794,-3618551,,,,2650731,68026525,56432482,46909993,-244900,,8698412,8698412,56198,RGCO
2018-09-30,,,10192341,,7297205,-122539,20304861,11593046,11593046,1878010,-2461565,,,,2895136,65534736,53941690,45229875,-1400705,,7297205,7297205,56198,RGCO
2017-09-30,,,10038255,,6232865,526433,20235549,11666309,11666309,1786070,-1917254,,,,3805390,62296870,50630561,42061321,-1628054,,6232865,6232865,56198,RGCO
2019-12-31,,,-327116000,6689000,-301971000,239646000,197550000,-103009000,-103009000,,-14534000,,,,-21536000,846383000,949392000,648833000,-224107000,,-305580000,-301971000,56199,EVH
2018-12-31,,,-54151000,45532000,-52658000,231018000,228349000,-47184000,-47184000,,-5484000,,,,40000,627063000,674247000,398714000,-6967000,,-54191000,-52658000,56199,EVH
2017-12-31,,,-76404000,35427000,-60665000,195170000,165598000,-61940000,-61940000,,-3636000,,,,-6637000,434950000,496890000,269352000,-14464000,,-69767000,-60665000,56199,EVH
2016-12-31,,,-237533000,209588000,-159742000,147736000,101811000,-63149000,-63149000,,-247000,,,,-10755000,254188000,317337000,152377000,-174384000,,-226778000,-159742000,56199,EVH
2019-12-31,44616000,,-18276000,,-18276000,9899000,43798000,-10717000,-10717000,,-7335000,,,,0,54693000,65410000,10895000,-7559000,,-18276000,-18276000,56203,PLX
2018-12-31,33330000,,-26457000,,-26457000,10916000,24938000,-19308000,-19308000,,-7334000,,,,0,34240000,53548000,9302000,-7149000,,-26457000,-26457000,56203,PLX
2017-12-31,28834000,,-83440000,,-83440000,11530000,5847000,-34517000,-34517000,,-11288000,,,,0,21078000,55595000,15231000,-48923000,,-83440000,-83440000,56203,PLX
2016-12-31,23608000,,-29176000,,-29365000,10356000,801000,-33163000,-33163000,,-3824000,,,,0,9199000,42362000,8398000,3987000,-189000.0,-29176000,-29365000,56203,PLX
2019-12-31,670606000,,378213000,,375446000,1061082000,1896635000,26557000,26557000,126959000,-44247000,,,,2767000,4713500000,4686943000,2816865000,351656000,,375446000,375446000,56205,SQ
2018-12-31,497479000,,-36127000,,-38453000,750396000,1310790000,-36614000,-36614000,88077000,-36878000,,,,2326000,3298177000,3334791000,1987387000,487000,,-38453000,-38453000,56205,SQ
2017-12-31,321888000,,-62664000,,-62813000,503723000,845850000,-54206000,-54206000,67018000,-15574000,,,,149000,2214253000,2268459000,1368403000,-8458000,,-62813000,-62813000,56205,SQ
2016-12-31,268537000,,-169673000,,-171590000,377869000,584066000,-122453000,-122453000,51235000,-15574000,,,,1917000,1708721000,1831174000,1124655000,-47220000,,-171590000,-171590000,56205,SQ
2019-12-31,,,84822000,60849000,79206000,14450000,101254000,12533000,12533000,,-30537000,,,,0,185755000,173222000,84501000,72289000,,84822000,71848000,56208,CSR
2018-12-31,,,-8835000,80631000,-6597000,14718000,100747500,10345500,10345500,,-32038500,,,,0,182806500,172461000,82059000,-19180500,855000.0,-8835000,-13417500,56208,CSR
2018-04-30,,,-37194000,88544000,116788000,14203000,91134000,24161000,24161000,,-34178000,,,,0,169745000,145584000,78611000,-61355000,164823000.0,-37194000,104562000,56208,CSR
2017-04-30,,,-46228000,89554000,43347000,15871000,87456000,27332000,27332000,,-34314000,,,,0,160104000,132772000,72648000,-73560000,76753000.0,-46228000,31366000,56208,CSR
2019-12-31,210500000,,436300000,,288900000,556300000,1321300000,554500000,554500000,,-61600000,,,,147400000,1887600000,1333100000,566300000,-118200000,,288900000,288900000,56210,PLTK
2018-12-31,148300000,,430700000,,338000000,444000000,1053700000,461400000,461400000,,-500000,,,,92700000,1490700000,1029300000,437000000,-30700000,,338000000,338000000,56210,PLTK
2017-12-31,107700000,,337800000,,257400000,347900000,802600000,347000000,347000000,,-500000,,,,80400000,1150800000,803800000,348200000,-9200000,,257400000,257400000,56210,PLTK
2020-12-31,75000000,,353000000,,249000000,403000000,972000000,426000000,426000000,68000000,-221000000,,,,89000000,6091000000,5665000000,5119000000,-73000000,,264000000,249000000,56211,OI
2019-12-31,68000000,,-261000000,97000000.0,-400000000,437000000,1209000000,623000000,623000000,81000000,-246000000,,,,118000000,6691000000,6068000000,5482000000,-884000000,-3000000.0,-379000000,-400000000,56211,OI
2018-12-31,70000000,,277000000,114000000.0,257000000,483000000,1288000000,662000000,662000000,73000000,-250000000,,,,108000000,6877000000,6215000000,5589000000,-385000000,113000000.0,169000000,257000000,56211,OI
2017-12-31,60000000,,275000000,119000000.0,180000000,484000000,1333000000,548000000,548000000,241000000,-250000000,,,,70000000,6869000000,6321000000,5536000000,-273000000,-3000000.0,205000000,180000000,56211,OI
2019-12-31,,,384318011,,384318011,15501945,51074171,35572226,35572226,,,,,,0,51074171,15501945,0,348745785,,384318011,384318011,56213,BDJ
2018-12-31,,,-125121833,,-125121833,15528225,49275881,33747656,33747656,,,,,,0,49275881,15528225,0,-158869489,,-125121833,-125121833,56213,BDJ
2017-12-31,,,244440761,,244440761,15444541,46386747,30942206,30942206,,,,,,0,46386747,15444541,0,213498555,,244440761,244440761,56213,BDJ
2016-12-31,,,204044200,,204044200,13957929,45285903,31327974,31327974,,,,,,0,45285903,13957929,0,172716226,,204044200,204044200,56213,BDJ
2020-12-31,,,982000000,,797000000,467000000,2085000000,1484000000,1484000000,134000000,-443000000,,,,185000000,7532000000,6048000000,5447000000,-502000000,,797000000,797000000,56214,WY
2019-12-31,,,-213000000,,-76000000,493000000,1142000000,615000000,615000000,34000000,-378000000,,,,-137000000,6554000000,5939000000,5412000000,-828000000,,-76000000,-76000000,56214,WY
2018-12-31,,,807000000,,748000000,478000000,1884000000,1374000000,1374000000,32000000,-375000000,,,,59000000,7476000000,6102000000,5592000000,-567000000,,748000000,748000000,56214,WY
2017-12-31,,,716000000,,582000000,459000000,1898000000,1415000000,1415000000,24000000,-393000000,,,,134000000,7196000000,5781000000,5298000000,-699000000,,582000000,582000000,56214,WY
2020-12-31,,,-111427000,,-111144000,38703000,-74031000,-112734000,-112734000,,,,,,-283000,853000,113587000,74884000,1307000,,-111144000,-111144000,56216,PRTA
2019-12-31,,,-77298000,,-77677000,35736000,-50022000,-85758000,-85758000,,,,,,379000,814000,86572000,50836000,8460000,,-77677000,-77677000,56216,PRTA
2018-12-31,,,-156115000,,-155645000,42482000,-100228000,-142710000,-142710000,,-3697000.0,,,,-470000,955000,143665000,101183000,-13405000,,-155645000,-155645000,56216,PRTA
2017-12-31,,,-157603000,,-153237000,48226000,-107028000,-155254000,-155254000,,-3688000.0,,,,-4366000,27519000,182773000,134547000,-2349000,,-153237000,-153237000,56216,PRTA
2019-12-31,,,118953000,428000,79896000,212515000,363073000,162584000,162584000,-12026000,-52079000,,,,38837000,2959077000,2796493000,2596004000,-43631000,,80116000,79896000,56217,ARCO
2018-12-31,,,85169000,376000,36847000,229324000,352920000,134391000,134391000,-10795000,-52868000,,,,48136000,3081571000,2947180000,2728651000,-49222000,,37033000,36847000,56217,ARCO
2017-12-31,,,182813000,492000,129166000,244664000,444943000,182832000,182832000,17447000,-68357000,,,,53314000,3319525000,3136693000,2874582000,-19000,,129499000,129166000,56217,ARCO
2016-12-31,,,138629000,585000,78810000,221075000,358269000,119610000,119610000,17584000,-66880000,,,,59641000,2928630000,2809020000,2570361000,19019000,,78988000,78810000,56217,ARCO
2019-12-31,,,929000000,,791000000,159000000,3321000000,1397000000,1397000000,478000000,-567000000,,,,138000000,12301000000,10904000000,8980000000,-468000000,,791000000,674000000,56218,CNP
2018-12-31,,,514000000,,368000000,27000000,2480000000,804000000,804000000,406000000,-420000000,,,,146000000,10589000000,9785000000,8109000000,-290000000,,368000000,333000000,56218,CNP
2017-12-31,,,1063000000,,1792000000,65000000,2563000000,1071000000,1071000000,391000000,-390000000,,,,-729000000,9614000000,8543000000,7051000000,-8000000,,1792000000,1792000000,56218,CNP
2016-12-31,,,686000000,,432000000,72000000,2533000000,951000000,951000000,384000000,-429000000,,,,254000000,7528000000,6577000000,4995000000,-265000000,,432000000,432000000,56218,CNP
2019-12-31,,,3546000,,3428000,30641000,39496000,0,3546000,5309000,,,,,118000,39496000,35950000,0,0,,3428000,3428000,56220,RNDB
2018-12-31,,,-2055000,,-2086000,25635000,29527000,0,-1177000,5069000,,,,,31000,29527000,30704000,0,-1093000,,-2086000,-2086000,56220,RNDB
2017-12-31,,,-2569000,,-2126000,24477000,27253000,0,-1299000,4075000,,,,,-443000,27253000,28552000,0,-1270000,,-2126000,-2126000,56220,RNDB
2016-12-31,,,476000,,463000,19883000,25774000,0,2442000,3449000,,,,,13000,25774000,23332000,0,-1966000,,463000,463000,56220,RNDB
2019-12-31,42463000,,15495000,,8789000,105400000,172608000,15275000,15275000,,,,,,6706000,254570000,239295000,81962000,220000,,8789000,8789000,56221,OSPN
2018-12-31,32197000,,3553000,,3846000,103994000,147467000,1902000,1902000,,,,,,-293000,212280000,210378000,64813000,1651000,,3846000,3846000,56221,OSPN
2017-12-31,23119000,,8381000,,-22399000,96394000,134514000,6192000,6192000,,,,,,30780000,193291000,187099000,58777000,2189000,,-22399000,-22399000,56221,OSPN
2016-12-31,23214000,,11377000,,10514000,88995000,130657000,9599000,9599000,,,,,,863000,192304000,182705000,61647000,1778000,,10514000,10514000,56221,OSPN
2020-06-30,65192000,,276477000,,229296000,267240000,483194000,150762000,150762000,,-19197000,,,,47181000,738691000,587929000,255497000,125715000,,229296000,229072000,56222,TECH
2019-06-30,62413000,,112015000,,96072000,262077000,477230000,152740000,152740000,,-21705000,,,,15943000,714006000,561266000,236776000,-40725000,,96072000,95967000,56222,TECH
2018-06-30,55329000,,125952000,,126150000,215831000,434598000,163438000,163438000,,-10188000,,,,-198000,642993000,479555000,208395000,-37486000,,126150000,126042000,56222,TECH
2017-06-30,53514000,,111961000,,76086000,174654000,377578000,149410000,149410000,,-7361000,,,,35875000,563003000,413593000,185425000,-37449000,,76086000,76021000,56222,TECH
2019-12-31,,,67242000,30866000,120534000,770208000,831750000,61542000,61542000,,-23729000,,,,-69886000,3954812000,3893270000,3123062000,5700000,,137128000,120534000,56224,PSN
2018-12-31,,,259803000,46461000,222337000,591210000,765503000,174293000,174293000,,-20842000,,,,20367000,3560508000,3386215000,2795005000,85510000,,239436000,222337000,56224,PSN
2017-12-29,,,133001000,27494000,97326000,506255000,616871000,110616000,110616000,,-15798000,,,,21464000,3017011000,2906395000,2400140000,22385000,,111537000,97326000,56224,PSN
2016-12-30,,,12006000,27494000,-13147000,510513000,607998000,97485000,97485000,,-16509000,,,,13992000,3039191000,2941706000,2431193000,-85479000,,-1986000,-13147000,56224,PSN
2020-03-31,,,-770390000,19033000,-833808000,251216000,2480356000,-825147000,-825147000,2387918000,-162722000,,,,69805000,7259355000,8084502000,4778999000,54757000,,-840195000,-833808000,56225,YTRA
2019-03-31,,,-1145758000,19421000,-1148203000,1003344000,2434281000,-2097967000,-2097967000,2947158000,-145976000,,,,47837000,9358580000,11456547000,6924299000,952209000,,-1193595000,-1148203000,56225,YTRA
2018-03-31,,,-3995089000,-361000,-3993140000,4332570000,4323762000,-3067158000,-3067158000,2632750000,-122568000,,,,56887000,12248513000,15315671000,7924751000,-927931000,,-4051976000,-3993140000,56225,YTRA
2017-03-31,,,-5895976000,52082000,-5901483000,2605980000,2981601000,-1864037000,-1864037000,1964071000,-77421000,,,,40987000,9356813000,11220850000,6375212000,-4031939000,,-5936963000,-5901483000,56225,YTRA
2020-02-29,,,56700856,,55738861,27942048,58448191,30506143,30506143,,-14682611,,,,961995,58448191,27942048,0,26194713,,55738861,55738861,56226,SAR
2019-02-28,,,17482252,,18509370,17307154,47707963,30400809,30400809,,-13125718,,,,-1027118,47707963,17307154,0,-12918557,,18509370,18509370,56226,SAR
2018-02-28,,,17664407,,17679145,14959404,38614978,23655574,23655574,,-10938654,,,,-14738,38614978,14959404,0,-5991167,,17679145,17679145,56226,SAR
2017-02-28,,,11432251,,11387481,12108850,33157152,21048302,21048302,,-9888127,,,,44770,33157152,12108850,0,-9616051,,11387481,11387481,56226,SAR
2019-12-31,1516000,,-5497000,,-5497000,4516000,42000,-5990000,-5990000,,,,,,0,63000,6053000,21000,493000,,-5497000,-5497000,56227,MYSZ
2018-12-31,1105000,,-5969000,,-5969000,4070000,0,-5175000,-5175000,,-192000.0,,,,0,0,5175000,0,-794000,,-5969000,-5969000,56227,MYSZ
2017-12-31,845000,,-5404000,,-5404000,4765000,0,-5610000,-5610000,,-532000.0,,,,0,0,5610000,0,206000,,-5404000,-5404000,56227,MYSZ
2016-12-31,727000,,-4334000,,-4334000,1859000,0,-2586000,-2586000,,-528000.0,,,,0,0,2586000,0,-1748000,,-4334000,-4334000,56227,MYSZ
2019-12-31,1967007,,-10654768,,-10654768,8702596,0,-10682673,-10682673,,,,,,0,0,10682673,0,27905,,-10654768,-10654768,56228,GNPX
2018-12-31,971427,,-12372339,,-12372339,11386229,0,-12363541,-12363541,,-37982.0,,,,0,0,12363541,0,-8798,,-12372339,-12372339,56228,GNPX
2017-12-31,289934,,-3314157,,-3314157,3019171,0,-3312347,-3312347,,-1890.0,,,,0,0,3312347,0,-1810,,-3314157,-3314157,56228,GNPX
2016-12-31,354883,,-4132159,,-4132159,3776414,0,-4132159,-4132159,,-1890.0,,,,0,0,4132159,0,0,,-4132159,-4132159,56228,GNPX
2019-12-31,161943000,,-130370000,,-132972000,32372000,58946000,-135231000,-135231000,-138000,-223000,,,,2602000,58946000,194177000,0,4861000,,-132972000,-132972000,56229,LEGN
2018-12-31,60637000,,-1616000,,-2784000,3929000,49494000,-15072000,-15072000,-138000,-82000,,,,1168000,49494000,64566000,0,13456000,,-2784000,-2784000,56229,LEGN
2017-12-31,8195000,,13837000,,9365000,1618000,23690000,13877000,13877000,-138000,-2000,,,,4472000,23690000,9813000,0,-40000,,9365000,9365000,56229,LEGN
2020-03-31,47927000,,-66291000,,-66388000,15851000,0,-63778000,-63778000,,-625000,,,,97000,0,63778000,0,-2513000,,-66388000,-66388000,56234,IMVT
2019-03-31,25733000,,-28580000,,-28599000,2692000,0,-28425000,-28425000,,-625000,,,,19000,0,28425000,0,-155000,,-28599000,-28599000,56234,IMVT
2018-03-31,135263452,,-136740568,,-136740568,1477116,0,-136740568,-136740568,,-625000,,,,0,0,136740568,0,0,,-136740568,-136740568,56234,IMVT
2019-12-31,434566000,,-440054000,,-440667000,98712000,93243000,-440035000,-440035000,,-46354000,,,,613000,114617000,554652000,21374000,46316000,,-440667000,-440667000,56235,NKTR
2018-12-31,399536000,,682725000,,681313000,81443000,1168911000,687932000,687932000,,-42778000,,,,1412000,1193323000,505391000,24412000,-5207000,,681313000,681313000,56235,NKTR
2017-12-31,268461000,,-96076000,,-96692000,52364000,277164000,-43661000,-43661000,,-40954000,,,,616000,307711000,351372000,30547000,-52415000,,-96692000,-96692000,56235,NKTR
2016-12-31,203801000,,-152648000,,-153524000,44275000,135221000,-112855000,-112855000,,-42180000,,,,876000,165436000,278291000,30215000,-39793000,,-153524000,-153524000,56235,NKTR
2020-02-29,,,-12832721,,-12832721,6711228,23692122,16980894,16980894,,,,,,0,23692122,6711228,0,-29813615,,-12832721,-12832721,56238,IGD
2019-02-28,,,-26488970,,-26488970,8671884,22264404,13592520,13592520,,,,,,0,22264404,8671884,0,-40081490,,-26488970,-26488970,56238,IGD
2018-02-28,,,72879757,,72879757,9546446,24387018,14840572,14840572,,,,,,0,24387018,9546446,0,58039185,,72879757,72879757,56238,IGD
2017-02-28,,,132820284,,132820284,9155904,27352141,18196237,18196237,,,,,,0,27352141,9155904,0,114624047,,132820284,132820284,56238,IGD
2019-12-31,10661000,,-58760000,,-58789000,88712000,45040000,-54333000,-54333000,,-4532000,,,,29000,114451000,168784000,69411000,-4427000,,-58789000,-58789000,56240,MWK
2018-12-31,3655000,,-31768000,,-31823000,51757000,25983000,-29429000,-29429000,,-2354000,,,,55000,73279000,102708000,47296000,-2339000,,-31823000,-31823000,56240,MWK
2017-12-31,3698000,,-23029000,,-23067000,32573000,13678000,-22593000,-22593000,,-413000,,,,38000,36459000,59052000,22781000,-436000,,-23067000,-23067000,56240,MWK
2020-09-30,11399,,-9524184,,-9477091,9082733,-238953,-9333085,-9333085,,-21243,,,,0,1403131,10736216,1642084,-191099,,-9524184,-9477091,56241,NUZE
2019-09-30,1825,,-12214936,102903.0,-12187965,12397457,295117,-12104165,-12104165,,-5267,,,,0,1793590,13897755,1498473,-110771,,-12214936,-12187965,56241,NUZE
2018-09-30,1825,,-3569592,93131.0,-3577171,3685186,67217,-3617969,-3617969,,-2468,,,,0,1388972,5006941,1321755,48377,,-3569592,-3577171,56241,NUZE
2017-09-30,1825,,-1776190,92857.0,-1767139,2076654,309178,-1767476,-1767476,,-6976,,,,0,1628410,3395886,1319232,-8714,,-1776190,-1767139,56241,NUZE
2019-12-31,,,269929000,,222878000,167333000,521233000,335072000,335072000,,-46807000,,,,47051000,1114820000,779748000,593587000,-65143000,,222878000,221526000,56242,CHH
2018-12-31,,,273258000,,216355000,160348000,507038000,332360000,332360000,,-45908000,,,,56903000,1041304000,708944000,534266000,-59102000,,216355000,215107000,56242,CHH
2017-12-31,,,249217000,,122327000,155021000,461897000,300196000,300196000,,-45039000,,,,126890000,941297000,641101000,479400000,-50979000,,122327000,121482000,56242,CHH
2016-12-31,,,148140000,,106712000,148359000,348144000,192789000,192789000,,-44446000,,,,41428000,807909000,615120000,459765000,-44649000,,106712000,105965000,56242,CHH
2019-12-31,,,9162000,,5406000,139261000,148102000,0,9162000,-1397000,,,,,3756000,148102000,138940000,0,0,,5406000,5406000,56243,CPSS
2018-12-31,,,18703000,,14862000,135534000,154094000,0,18703000,-1135000,,,,,3841000,154094000,135391000,0,-26171000,,14862000,14862000,56243,CPSS
2017-12-31,,,32071000,,3765000,122320000,153896000,0,32071000,-1429000,,,,,28306000,153896000,121825000,0,0,,3765000,3765000,56243,CPSS
2016-12-31,,,49661000,,29300000,113392000,162253000,0,49661000,-1577000,,,,,20361000,162253000,112592000,0,0,,29300000,29300000,56243,CPSS
2019-12-31,,,-1198000000,5000000,-1255000000,193000000,948000000,-100000000,-100000000,,-660000000,,,,59000000,3088000000,3188000000,2140000000,-1098000000,,-1257000000,-1255000000,56244,RIG
2018-12-31,,,-1775000000,7000000,-1996000000,164000000,1219000000,237000000,237000000,,-620000000,,,,228000000,3018000000,2781000000,1799000000,-2012000000,,-2003000000,-1996000000,56244,RIG
2017-12-31,,,-3003000000,62000000,-3127000000,152000000,1342000000,358000000,358000000,,-491000000,,,,94000000,2731000000,2373000000,1389000000,-3361000000,,-3097000000,-3127000000,56244,RIG
2016-12-31,,,934000000,31000000,778000000,152000000,2230000000,1185000000,1185000000,,-409000000,,,,107000000,4161000000,2976000000,1931000000,-251000000,,827000000,764000000,56244,RIG
2019-12-31,,,101003000,,82047000,259163000,414873000,155710000,155710000,,-20107000,,,,18956000,1322934000,1167224000,908061000,-54707000,,82047000,82047000,56245,SXT
2018-12-31,,,181525000,,157360000,262751000,466129000,203378000,203378000,,-21853000,,,,24165000,1386815000,1183437000,920686000,-21853000,,157360000,157360000,56245,SXT
2017-12-31,,,148423000,,89600000,274057000,478379000,204322000,204322000,,-19383000,,,,58823000,1362265000,1157943000,883886000,-55899000,,89600000,89600000,56245,SXT
2016-12-31,,,167285000,,126256000,266532000,477492000,210960000,210960000,,-18324000,,,,44372000,1383210000,1172250000,905718000,-43675000,3343000.0,122913000,126256000,56245,SXT
2019-12-31,,,-11918000,,-11935000,31502000,18953000,-12549000,-12549000,,,,,,17000,68458000,81007000,49505000,631000,,-11935000,-11935000,56246,CDXS
2018-12-31,,,-10915000,,-10878000,29291000,17996000,-11295000,-11295000,,,,,,-37000,60594000,71889000,42598000,380000,,-10878000,-10878000,56246,CDXS
2017-12-31,,,-22915000,,-22996000,29008000,6038000,-22970000,-22970000,,,,,,81000,50024000,72994000,43986000,55000,,-22996000,-22996000,56246,CDXS
2016-12-31,,,-8598000,,-8558000,25419000,16855000,-8564000,-8564000,,,,,,-40000,48837000,57401000,31982000,-34000,,-8558000,-8558000,56246,CDXS
2020-06-30,,,25256000,,21410000,77381000,100151000,22770000,22770000,,-1891000,,,,3846000,350950000,328180000,250799000,2486000,,21410000,21410000,56248,DAVA
2019-06-30,,,30100000,,24007000,65857000,98827000,32970000,32970000,,-345000,,,,6093000,287930000,254960000,189103000,-2870000,,24007000,24007000,56248,DAVA
2018-06-30,,,24650000,,18975000,45504000,72170000,26666000,26666000,,-572000,,,,5675000,217613000,190947000,145443000,-2016000,,18975000,18975000,56248,DAVA
2017-06-30,,,21700000,,16832000,27001000,50608000,23607000,23607000,,-408000,,,,4868000,159368000,135761000,108760000,-1907000,,16832000,16832000,56248,DAVA
2019-12-31,44582136,,-53254817,,-53254817,12501048,0,-56768173,-56768173,-315011,,,,,0,0,56768173,0,3513356,,-53254817,-53254817,56251,IFRX
2018-12-31,25028554,,-29814634,,-29814634,12786869,0,-37516365,-37516365,-299058,,,,,0,0,37516365,0,7701731,,-29814634,-29814634,56251,IFRX
2017-12-31,14414628,,-24237748,,-24237748,5138498,0,-19445245,-19445245,-107881,-2229000.0,,,,0,0,19445245,0,-4792503,,-24237748,-24237748,56251,IFRX
2016-12-31,5278000,,-8939000,,-8939000,1844000,0,-6891000,-6891000,-231000,-1836000.0,,,,0,0,6891000,0,-2048000,,-8939000,-8939000,56251,IFRX
2019-12-31,46016000,,-9726000,,-1504000,117182000,203532000,7357000,7357000,,-12914000,,,,-8222000,242898000,235541000,39366000,-17083000,,-1504000,-1504000,56254,PING
2018-12-31,31029000,,-10071000,,-13446000,87895000,171347000,21686000,21686000,,-15837000,,,,3375000,201562000,179876000,30215000,-31757000,,-13446000,-13446000,56254,PING
2017-12-31,26215000,,5776000,,18961000,69683000,149330000,24280000,24280000,,-19277000,,,,-13185000,172539000,148259000,23209000,-18504000,,18961000,18961000,56254,PING
2020-12-31,,,-1665823000,,-1630135000,69461000,-626333000,0,-1660117000,964323000,,,,,-35688000,-532067000,1128050000,94266000,-5706000,,-1630135000,-1705937000,56255,TWO
2019-12-31,,,310402000,,323962000,60102000,1125218000,0,310402000,746054000,,,,,-13560000,1199825000,889423000,74607000,0,,323962000,248161000,56255,TWO
2018-12-31,,,-2467000,,-44290000,30272000,254762000,0,92474000,119724000,,,,,41823000,315898000,223424000,61136000,-94941000,,-44290000,-109685000,56255,TWO
2017-12-31,,,297757000,,348571000,40472000,483422000,0,297757000,145193000,,,,,-10482000,518711000,220954000,35289000,0,40332000.0,308239000,323449000,56255,TWO
2019-12-31,,,112679000,,82111000,325335000,451310000,112675000,112675000,,-103000,,,,30568000,2820034000,2707359000,2368724000,814000,,82111000,82111000,56257,CNXN
2018-12-31,,,88664000,,64592000,310333000,411086000,86653000,86653000,,-145000,,,,24072000,2699489000,2612836000,2288403000,4989000,,64592000,64592000,56257,CNXN
2017-12-31,,,77625000,,54857000,289113000,382076000,81163000,81163000,,-126000,,,,22768000,2911883000,2830720000,2529807000,-3538000,,54857000,54857000,56257,CNXN
2016-12-31,,,80453000,,48111000,276731000,371157000,83926000,83926000,,-107000,,,,32342000,2692592000,2608666000,2321435000,-3473000,,48111000,48111000,56257,CNXN
2019-12-31,,,-22870000,,-19582000,9642000,-13092000,-22734000,-22734000,,-33000,,,,-3288000,244000,22978000,13336000,-136000,,-19582000,-19582000,56258,SLN
2018-12-31,,,-20526000,,-18411000,10828000,-9743000,-20571000,-20571000,,-33000,,,,-2115000,0,20571000,9743000,45000,,-18411000,-18411000,56258,SLN
2017-12-31,,,-3775000,,-1618000,6464000,-7927000,-14391000,-14391000,,-15000,,,,-2157000,16000,14407000,7943000,10616000,,-1618000,-1618000,56258,SLN
2016-12-31,,,-10362000,,-8440000,3965000,-7941000,-11906000,-11906000,,-15000,,,,-1922000,770000,12676000,8711000,1544000,,-8440000,-8440000,56258,SLN
2019-12-28,,,26797000,,20747000,93613000,136894000,32633000,32633000,,-1254000,,,,6050000,451370000,418737000,314476000,-5836000,,20747000,20692000,56260,CRAI
2018-12-29,,,28933000,,22492000,89533000,128219000,28691000,28691000,,-647000,,,,6461000,417648000,388957000,289429000,242000,,22472000,22384000,56260,CRAI
2017-12-30,,,15164000,321000.0,7624000,85637000,111246000,16664000,16664000,,-484000,,,,7463000,370075000,353411000,258829000,-1500000,,7701000,7573000,56260,CRAI
2016-12-31,,,21889000,663000.0,12888000,70584000,97399000,18919000,18919000,,-469000,,,,7656000,324779000,305860000,227380000,2970000,,14233000,12793000,56260,CRAI
2019-12-31,,,4540000000,88000000,3982000000,4744000000,8673000000,4087000000,4087000000,-158000000,-64000000,,,,563000000,25434000000,21347000000,16761000000,453000000,,3977000000,3982000000,56264,TME
2018-12-31,,,2003000000,51000000,1833000000,3972000000,7277000000,1820000000,1820000000,-34000000,-35000000,,,,171000000,18985000000,17165000000,11708000000,183000000,,1832000000,1833000000,56264,TME
2017-12-31,,,1597000000,7000000,1326000000,2434000000,3810000000,1412000000,1412000000,-36000000,-35000000,,,,278000000,10981000000,9569000000,7171000000,185000000,,1319000000,1326000000,56264,TME
2016-12-31,,,114000000,9000000,82000000,1148000000,1232000000,94000000,94000000,-10000000,-35000000,,,,29000000,4361000000,4267000000,3129000000,20000000,,85000000,82000000,56264,TME
2019-12-31,,,87529000,111406000,79394000,5456000,252706000,138432000,138432000,,-72534000,,,,2415000,298815000,160383000,46109000,-50903000,,85114000,79394000,56265,BNL
2018-12-31,,,75962000,111821000,69375000,6162000,201620000,111464000,111464000,,-52855000,,,,857000,237479000,126015000,35859000,-35502000,,75105000,69375000,56265,BNL
2017-12-31,,,60179000,97376000,54799000,4939000,155316000,88114000,88114000,,-34751000,,,,624000,181563000,93449000,26247000,-27935000,,59555000,54799000,56265,BNL
2016-12-31,,,40714000,86749000,36354000,2790000,124075000,74964000,74964000,,-29963000,,,,446000,142869000,67905000,18794000,-34250000,,40268000,36354000,56265,BNL
2019-12-31,,,-139008000,,-123849000,39452000,-102510000,-141962000,-141962000,,,,,,-15159000,2908000,144870000,105418000,2954000,,-123849000,-123849000,56267,AUTL
2018-12-31,,,-66363000,,-57875000,25599000,-46827000,-72426000,-72426000,,,,,,-8488000,1472000,73898000,48299000,6063000,,-57875000,-57875000,56267,AUTL
2018-09-30,,,-52031000,,-44751000,22790000,-34743000,-57533000,-57533000,,,,,,-7280000,1407000,58940000,36150000,5502000,,-44751000,-44751000,56267,AUTL
2017-09-30,,,-23380000,,-19727000,9099000,-14319000,-23418000,-23418000,,,,,,-3653000,1693000,25111000,16012000,38000,,-19727000,-19727000,56267,AUTL
2020-02-01,,,25469000,,20215000,263937000,296633000,34126000,34126000,-1430000,-7995000,,,,5254000,886401000,852275000,589768000,-8657000,,20215000,20215000,56269,SPWH
2019-02-02,,,30813000,,23750000,241918000,284930000,44019000,44019000,-1007000,-13206000,,,,7063000,849129000,805110000,564199000,-13206000,,23750000,23750000,56269,SPWH
2018-02-03,,,32830000,,17742000,225469000,273860000,49728000,49728000,-1337000,-13738000,,,,15088000,809671000,759943000,535811000,-16898000,,17742000,17742000,56269,SPWH
2017-01-28,,,47285000,,29669000,202747000,263230000,60830000,60830000,-347000,-13402000,,,,17616000,779956000,719126000,516726000,-13545000,,29669000,29669000,56269,SPWH
2019-12-31,,,28255096,,28255096,1399648,16986533,15586885,15586885,,-2033957,,,,0,16986533,1399648,0,12668211,,28255096,28255096,56270,CIK
2018-12-31,,,-5610051,,-5610051,1414953,17490436,16075483,16075483,,-1888698,,,,0,17490436,1414953,0,-21685534,,-5610051,-5610051,56270,CIK
2017-12-31,,,19211849,,19211849,1671956,14586946,12914990,12914990,,-303557,,,,0,14586946,1671956,0,6296859,,19211849,19211849,56270,CIK
2016-12-31,,,27919160,,27919160,1265824,14315389,13049565,13049565,,-303557,,,,0,14315389,1265824,0,14869595,,27919160,27919160,56270,CIK
2020-09-30,,,101000000,,88600000,18200000,700700000,336800000,336800000,148400000,-105500000,,,,12400000,1855400000,1518600000,1154700000,-235800000,,88600000,73700000,56271,SR
2019-09-30,,,219100000,,184600000,-7700000,638000000,310000000,310000000,154000000,-104400000,,,,34500000,1952400000,1642400000,1314400000,-90900000,,184600000,178900000,56271,SR
2018-09-30,,,187700000,,214200000,14400000,616000000,279700000,279700000,153500000,-98400000,,,,-26500000,1965000000,1685300000,1349000000,-92000000,,214200000,213700000,56271,SR
2017-09-30,,,239200000,,161600000,19200000,632200000,321700000,321700000,137800000,-89100000,,,,77600000,1740700000,1419000000,1108500000,-82500000,,161600000,161200000,56271,SR
2020-06-30,95000,,-3435550,,-3425483,17266230,15097877,-2459455,-2459455,,-435607,,,,-10067,53409046,55868501,38311169,-976095,,-3425483,-4316873,56273,DYNT
2019-06-30,54000,,-916248,,-921722,19615685,19173599,-496086,-496086,,-512186,,,,5474,62565117,63061203,43391518,-420162,,-921722,-1716072,56273,DYNT
2018-06-30,1194013,,-1672570,,-1602256,19499123,20420675,-272461,-272461,,-428462,,,,-70314,64414910,64687371,43994235,-1400109,,-1602256,-3499000,56273,DYNT
2017-06-30,1081373,,-1866395,,-1866395,11919480,11508498,-1492355,-1492355,,-277630,,,,0,35758330,37250685,24249832,-374040,,-1866395,-4293128,56273,DYNT
2020-12-31,,,701600000,,572600000,1023400000,1912700000,0,775100000,114200000,,,,,129000000,1912700000,1137600000,0,-73500000,,572600000,558500000,56274,PBCTP
2019-12-31,,,652400000,,520400000,959200000,1812900000,0,765300000,88400000,,,,,132000000,1812900000,1047600000,0,-112900000,,520400000,506100000,56274,PBCTP
2018-12-31,,,576300000,,468100000,851100000,1571400000,0,645700000,74600000,,,,,108200000,1571400000,925700000,0,-69400000,,468100000,453800000,56274,PBCTP
2017-12-31,,,467100000,,337200000,792400000,1426500000,0,567700000,66400000,,,,,129900000,1426500000,858800000,0,-100600000,,337200000,322600000,56274,PBCTP
2020-12-31,,,21039000,,21040000,143583000,207683000,0,28470000,35630000,,,,,-1000,207683000,179213000,0,-7431000,,21040000,21040000,56275,STBA
2019-12-31,,,117360000,,98234000,128390000,281828000,0,129468000,23970000,,,,,19126000,281828000,152360000,0,-12108000,,98234000,97974000,56275,STBA
2018-12-31,,,123179000,,105334000,114245000,264050000,0,124544000,25261000,,,,,17845000,264050000,139506000,0,-1365000,,105334000,105030000,56275,STBA
2017-12-31,,,119405000,,72968000,116272000,264264000,0,123948000,24044000,,,,,46437000,264264000,140316000,0,-4543000,,72968000,72726000,56275,STBA
2019-12-28,,,462619000,,352240000,564956000,1103497000,538541000,538541000,,-82609000,,,,110379000,2959446000,2420905000,1855949000,-75922000,,352240000,352240000,56278,MIDD
2018-12-29,,,423513000,,317152000,500728000,1004140000,503412000,503412000,,-58670000,,,,106361000,2722931000,2219519000,1718791000,-79899000,,317152000,317152000,56278,MIDD
2017-12-30,,,383529000,,298128000,436491000,912741000,476250000,476250000,,-25983000,,,,85401000,2335542000,1859292000,1422801000,-92721000,,298128000,298128000,56278,MIDD
2016-12-31,,,421305000,,284216000,444431000,901180000,456749000,456749000,,-23880000,,,,137089000,2267852000,1811103000,1366672000,-35444000,,284216000,284216000,56278,MIDD
2020-09-30,,,66706307,,66706307,6575320,11575396,5000076,5000076,,,,,,0,11575396,6575320,0,61706231,,66706307,66706307,56279,EOI
2019-09-30,,,9717217,,9717217,6450030,10440963,3990933,3990933,,,,,,0,10440963,6450030,0,5726284,,9717217,9717217,56279,EOI
2018-09-30,,,95869399,,95869399,6572599,10125155,3552556,3552556,,,,,,0,10125155,6572599,0,92316843,,95869399,95869399,56279,EOI
2017-09-30,,,75639267,,75639267,6103406,10526386,4422980,4422980,,,,,,0,10526386,6103406,0,71216287,,75639267,75639267,56279,EOI
2019-12-31,,,-78194000,,-75920000,435828000,512999000,23481000,23481000,,-73724000,,,,-2274000,2310417000,2286936000,1797418000,-101675000,,-75920000,-75920000,56281,OPCH
2018-12-31,,,-8768000,,-6115000,345884000,422215000,38269000,38269000,,-45824000,,,,-2653000,1939791000,1901522000,1517576000,-47037000,,-6115000,-6115000,56281,OPCH
2017-12-31,,,-14707000,,3878000,338456000,400397000,27279000,27279000,,-44307000,,,,-18585000,1782444000,1755165000,1382047000,-41986000,,3878000,3878000,56281,OPCH
2016-12-31,,,10912000,,3910000,328928000,410779000,52448000,52448000,,-43388000,,,,7002000,1672910000,1620462000,1262131000,-41536000,,3910000,3910000,56281,OPCH
2019-12-31,,,-6597,,-6597,,0,0,,,,,,,0,0,0,0,-6597,,-6597,-6597,56282,GNRS
2019-12-31,,,265500000,1600000,194400000,1427300000,2008400000,340200000,340200000,,-73300000,,,,71100000,3711300000,3371100000,1702900000,-74700000,,194400000,194400000,56284,STN
2018-12-31,,,226300000,1800000,47400000,1420700000,1815200000,279400000,279400000,,-31600000,,,,55000000,3355200000,3075800000,1540000000,-53100000,-123900000.0,171300000,47400000,56284,STN
2017-12-31,,,263500000,3000000,97000000,1407700000,1761900000,229000000,229000000,,-29100000,,,,166500000,3173800000,2944800000,1411900000,34500000,-123900000.0,97000000,97000000,56284,STN
2016-12-31,,,180800000,800000,130500000,1320600000,1676300000,228800000,228800000,,-31400000,,,,50300000,3098400000,2869600000,1422100000,-48000000,-123900000.0,130500000,130500000,56284,STN
2020-12-31,,,8200000,,-3400000,625800000,906000000,153200000,153200000,,-36600000,,,,11500000,2482700000,2329500000,1576700000,-145000000,,-3300000,-3400000,56285,EEFT
2019-12-31,,,433807000,68000.0,346749000,606688000,1193626000,475194000,475194000,,-36237000,,,,87112000,2750109000,2274915000,1556483000,-41387000,,346695000,346749000,56285,EEFT
2018-12-31,,,294916000,169000.0,232851000,577239000,1048223000,364963000,364963000,,-37573000,,,,62785000,2536629000,2171666000,1488406000,-70047000,,232131000,232851000,56285,EEFT
2017-12-31,,,256335000,960000.0,156845000,501089000,896172000,300053000,300053000,,-32571000,,,,99395000,2252422000,1952369000,1356250000,-43718000,,156940000,156845000,56285,EEFT
2019-12-31,,,19662801,,15499138,58613607,85048759,26435152,26435152,,-3006663,,,,4163663,304201203,277766051,219152444,-6772351,,15499138,-19133698,56287,ASLE
2018-12-31,,,23498388,,8853211,46611982,72168805,25556823,25556823,,-2374881,,,,-3227061,290732049,265175226,218563244,-2058435,21260340.0,26725449,-24724325,56287,ASLE
2017-12-31,,,-16974799,-39132578.0,-10851134,46064938,35922435,-10142503,-10142503,,-7949461,,,,-1451422,174716210,184858713,138793775,-6832296,-9725633.0,-15523377,-41648640,56287,ASLE
2020-12-31,,,80378000,17000,72513000,,256085000,79487000,79487000,176598000,-5015000,,,,8061000,732265000,652778000,476180000,891000,,72317000,72513000,56288,FFG
2019-12-31,,,146237000,159000,126209000,,264054000,147631000,147631000,116423000,-4850000,,,,19929000,774681000,627050000,510627000,-1394000,,126308000,126059000,56288,FFG
2018-12-31,,,105472000,120000,93793000,,221429000,105884000,105884000,115545000,-4851000,,,,11650000,719626000,613742000,498197000,-412000,,93822000,93643000,56288,FFG
2017-12-31,,,147350000,58000,187305000,,253829000,149610000,149610000,104219000,-4850000,,,,-39983000,737911000,588301000,484082000,-2260000,,187333000,187155000,56288,FFG
2019-12-31,,,50442000,4000,37690000,156074000,214158000,54235000,54235000,,-6225000,,,,14228000,2071159000,2016924000,1857001000,-3793000,,36214000,37690000,56290,MYRG
2018-12-31,,,43068000,1480000,31087000,118737000,167060000,46480000,46480000,,-3652000,,,,11774000,1531169000,1484689000,1364109000,-3412000,,31294000,31087000,56290,MYRG
2017-12-31,,,24640000,1480000,21154000,98611000,125004000,25894000,25894000,,-2603000,,,,3486000,1403317000,1377423000,1278313000,-1254000,,21154000,21154000,56290,MYRG
2016-12-31,,,38345000,1480000,21431000,96424000,134723000,37413000,37413000,,-1299000,,,,16914000,1142487000,1105074000,1007764000,932000,,21431000,21431000,56290,MYRG
2019-12-31,,,-501474000,,-509116000,208365000,337602000,28334000,28334000,,-167749000,,,,7642000,1562337000,1534003000,1224735000,-529808000,,-509116000,-512425000,56292,XELA
2018-12-31,,,-161453000,,-169806000,197311000,372819000,37431000,37431000,,-153491000,,,,8353000,1586222000,1548791000,1213403000,-198884000,,-169806000,-173461000,56292,XELA
2017-12-31,,,-270552000,,-209484000,171386000,318347000,48071000,48071000,,-129676000,,,,-61068000,1145891000,1097820000,827544000,-318623000,,-209484000,-228348000,56292,XELA
2016-12-31,,,-59890000,,-48103000,140930000,270805000,50236000,50236000,,-109414000,,,,-11787000,789926000,739690000,519121000,-110126000,,-48103000,-48103000,56292,XELA
2020-09-30,23729000,,59293000,,46186000,70831000,156248000,61688000,61688000,,-2632000,,,,13107000,253667000,191979000,97419000,-2395000,,46186000,46186000,56294,VIVO
2019-09-30,17760000,,31557000,,24382000,62039000,118728000,38929000,38929000,,-1945000,,,,7175000,201014000,162085000,82286000,-7372000,,24382000,24382000,56294,VIVO
2018-09-30,16613000,,30380000,,23849000,69785000,131033000,44635000,44635000,,-1520000,,,,6531000,213571000,168936000,82538000,-14255000,,23849000,23849000,56294,VIVO
2017-09-30,16036000,,36429000,,21557000,63484000,124292000,44772000,44772000,,-1642000,,,,14872000,200771000,155999000,76479000,-8343000,,21557000,21557000,56294,VIVO
2017-12-31,,,-424,,-424,,0,0,,,,,,,0,0,0,0,-424,,-424,-424,56295,ANDAU
2016-12-31,,,-33122,,-33122,,0,0,,,,,,,0,0,0,0,-33122,,-33122,-33122,56295,ANDAU
2020-06-30,,,54074000,,20188000,148499000,215455000,66956000,66956000,,-7475000,,,,13060000,604535000,537579000,389080000,-12882000,-20826000,41014000,20188000,56297,SXI
2019-06-30,,,66974000,,67914000,150327000,234667000,83840000,83840000,500000.0,-10760000,,,,18688000,639931000,556091000,405264000,-16866000,19628000,48286000,67914000,56297,SXI
2018-06-30,,,68393000,,36604000,140680000,225999000,85319000,85319000,500000.0,-8029000,,,,38026000,595515000,510196000,369516000,-16926000,6237000,30367000,36604000,56297,SXI
2017-06-30,,,50959000,,46545000,145030000,215553000,70523000,70523000,500000.0,-4043000,,,,11822000,647885000,577362000,432332000,-19564000,7408000,39137000,46545000,56297,SXI
2019-12-31,,,-10281000,,-10352000,13481000,109417000,31971000,31971000,,-38390000,,,,71000,317220000,285249000,207803000,-42252000,,-10352000,-10352000,56298,NAT
2018-12-31,,,-95227000,,-95306000,12727000,43593000,-29829000,-29829000,,-34549000,,,,79000,289016000,318845000,245423000,-65398000,,-95306000,-95306000,56298,NAT
2017-12-31,,,-204886000,,-204969000,12575000,67013000,-46231000,-46231000,,-20464000,,,,83000,297141000,343372000,230128000,-158655000,,-204969000,-204969000,56298,NAT
2016-12-31,,,-4354000,,-4456000,12296000,151198000,48013000,48013000,,-11170000,,,,102000,357451000,309438000,206253000,-52367000,,-4456000,-4456000,56298,NAT
2019-12-31,,,-239926000,,-251576000,202541000,37393000,-192798000,-192798000,,-18304000,,,,11650000,306980000,499778000,269587000,-47128000,,-251576000,-251576000,56299,PTCT
2018-12-31,171984000.0,,-128110000,,-128081000,151848000,80080000,-94645000,-94645000,,-12554000,,,,-29000,264734000,359379000,184654000,-33465000,,-128081000,-128081000,56299,PTCT
2017-12-31,171984000.0,,-77665000,,-79000000,121271000,72359000,-64292000,-64292000,,-12094000,,,,1335000,194392000,258684000,122033000,-13373000,,-79000000,-79000000,56299,PTCT
2016-12-31,171984000.0,,-141541000,,-142110000,97130000,-34928000,-132058000,-132058000,,-8276000,,,,569000,82705000,214763000,117633000,-9483000,,-142110000,-142110000,56299,PTCT
2019-12-31,15926000,,-20012000,,33255000,58920000,53750000,-21096000,-21096000,,-1020000,,,,-4003000,157893000,178989000,104143000,1084000,49264000,-16009000,33255000,56300,KVHI
2018-12-31,14951000,,-11098000,,-8232000,53772000,58077000,-10646000,-10646000,,-1784000,,,,346000,153029000,163675000,94952000,-452000,3212000,-11444000,-8232000,56300,KVHI
2017-12-31,15858000,,-9938000,,-11034000,62828000,69922000,-8764000,-8764000,,-1467000,,,,1096000,160088000,168852000,90166000,-1174000,3212000,-11034000,-11034000,56300,KVHI
2016-12-31,16030000,,-1970000,,-7517000,62114000,76822000,-1322000,-1322000,,-1436000,,,,5547000,176122000,177444000,99300000,-648000,3212000,-7517000,-7517000,56300,KVHI
2019-12-31,46312000,,-43037000,,-43037000,16715000,-34370000,-51085000,-51085000,,-877000,,,,0,11942000,63027000,46312000,8048000,,-43037000,-43037000,56301,HOOK
2018-12-31,46312000,,-16213000,,-16237000,6844000,-14336000,-21180000,-21180000,,-778000,,,,24000,7629000,28809000,21965000,4967000,,-16237000,-16237000,56301,HOOK
2017-12-31,46312000,,-12719000,,-12723000,4385000,-9772000,-14157000,-14157000,,-606000,,,,4000,0,14157000,9772000,1438000,,-12723000,-12723000,56301,HOOK
2019-12-31,,,-39247000,,-39247000,11186000,-28550000,-39736000,-39736000,,-1076000,,,,0,2361000,42097000,30911000,489000,,-39247000,-39247000,56305,PHAS
2018-12-31,,,-23846000,,-23846000,4857000,-14787000,-19644000,-19644000,,-3924000,,,,0,668000,20312000,15455000,-4202000,,-23846000,-23846000,56305,PHAS
2017-12-31,,,-10247000,,-10247000,2328000,-6210000,-8538000,-8538000,,-2723000,,,,0,0,8538000,6210000,-1709000,,-10247000,-10247000,56305,PHAS
2016-12-31,6993000.0,,-9220000,,-9220000,2508000,0,-9501000,-9501000,,-2723000,,,,0,0,9501000,0,281000,,-9220000,-9220000,56305,PHAS
2020-07-31,,,13067596,,13067596,3503985,25748741,22244756,22244756,,-4049594,,,,0,25748741,3503985,0,-9177160,,13067596,13067596,56307,MYJ
2019-07-31,,,29759978,,29759978,3402685,26727761,23325076,23325076,,-5462555,,,,0,26727761,3402685,0,6434902,,29759978,29759978,56307,MYJ
2018-07-31,,,9312742,,9312742,2036695,17794140,15757445,15757445,,-3260276,,,,0,17794140,2036695,0,-6444703,,9312742,9312742,56307,MYJ
2017-07-31,,,-1930380,,-1930380,2136291,16097046,13960755,13960755,,-2273845,,,,0,16097046,2136291,0,-15891135,,-1930380,-1930380,56307,MYJ
2019-12-31,6099580,,-7380119,,-6998606,10981765,0,-17081345,-17081345,,-33559,,,,-381513,0,17081345,0,9701226,,-6998606,-6998606,56309,PDSB
2018-12-31,830744,,-3836481,,-3836481,2788016,0,-3646186,-3646186,,-3595,,,,0,0,3646186,0,-190295,,-3836481,-3836481,56309,PDSB
2017-12-31,1919050,,-3423188,,-3423188,1472524,0,-3420262,-3420262,,-1495,,,,0,0,3420262,0,-2926,,-3423188,-3423188,56309,PDSB
2016-12-31,2328536,,-4477468,,-4477468,1844685,0,-4217818,-4217818,,-257290,,,,0,0,4217818,0,-259650,,-4477468,-4477468,56309,PDSB
2019-12-31,,,-17847000,,-18150000,64072000,46868000,-17204000,-17204000,,-643000,,,,45000,53979000,71183000,7111000,-643000,-258000,-17892000,-18150000,56311,GAIA
2018-12-31,,,-36057000,,-33793000,73057000,36645000,-36412000,-36412000,,-643000,,,,-1944000,41997000,78409000,5352000,355000,320000,-34113000,-33793000,56311,GAIA
2017-12-31,,,-24626000,,-23272000,49504000,24363000,-25141000,-25141000,,-643000,,,,-925000,28290000,53431000,3927000,515000,429000,-23701000,-23272000,56311,GAIA
2016-12-31,,,-16926000,,87066000,30980000,14405000,-16575000,-16575000,,-351000,,,,-6144000,17247000,33822000,2842000,-351000,97848000,-10782000,87066000,56311,GAIA
2019-12-31,,,213915000,15175000,174452000,167689000,514513000,211124000,211124000,,,,,,32397000,2756163000,2545039000,2241650000,2791000,,181518000,174452000,56312,TXRH
2018-12-25,,,188551000,15139000,158225000,151763000,461597000,189567000,189567000,,-591000.0,,,,24257000,2457449000,2267882000,1995852000,-1016000,,164294000,158225000,56312,TXRH
2017-12-26,,,186117000,12312000,131526000,122894000,437427000,201760000,201760000,,-1577000.0,,,,48581000,2219531000,2017771000,1782104000,-15643000,,137536000,131526000,56312,TXRH
2016-12-27,,,171756000,8016000,115598000,116795000,398685000,179379000,179379000,,-1255000.0,,,,51183000,1990714000,1811335000,1592029000,-7623000,,120573000,115598000,56312,TXRH
2019-12-31,90774000,,-102686000,,-103130000,11284000,37000,-102021000,-102021000,,-1761000,,,,444000,37000,102058000,0,-665000,,-103130000,-103130000,56313,ITRM
2018-12-31,68647000,,-76584000,,-77056000,8781000,869000,-76559000,-76559000,,-1169000,,,,472000,869000,77428000,0,-25000,,-77056000,-77056000,56313,ITRM
2017-12-31,25499000,,-28962000,,-29406000,4464000,508000,-29455000,-29455000,,-1169000,,,,444000,508000,29963000,0,493000,,-29406000,-29406000,56313,ITRM
2016-12-31,10101000,,-13351000,,-13464000,3258000,0,-13359000,-13359000,,-1169000,,,,113000,0,13359000,0,8000,,-13464000,-13464000,56313,ITRM
2019-12-31,,,193800000,,157100000,,194400000,194400000,194400000,,-600000,,,,36700000,835900000,641500000,641500000,-600000,,157100000,157100000,56314,EIG
2018-12-31,,,169500000,,141300000,,171000000,171000000,171000000,,-1500000,,,,28200000,800400000,629400000,629400000,-1500000,,141300000,141300000,56314,EIG
2017-12-31,,,144000000,,101200000,,150800000,150800000,150800000,,-1400000,,,,42800000,799300000,648500000,648500000,-6800000,,101200000,101200000,56314,EIG
2016-12-31,,,140700000,,106700000,,142300000,142300000,142300000,,-1600000,,,,34000000,779800000,637500000,637500000,-1600000,,106700000,106700000,56314,EIG
2020-12-31,,,206795000,54845000,202147000,40072000,394052000,137213000,137213000,2029000,-62343000,,,,0,483411000,346198000,89359000,69582000,,206795000,196720000,56316,STAG
2019-12-31,,,50665000,58363000,49281000,35946000,330771000,107590000,107590000,1785000,-54647000,,,,0,405950000,298360000,75179000,-56925000,,50665000,43811000,56316,STAG
2018-12-31,,,96245000,55829000,92926000,34052000,281972000,79026000,79026000,1277000,-48817000,,,,0,350993000,271967000,69021000,17219000,,96245000,82385000,56316,STAG
2017-12-31,,,32200000,51267000,31259000,33349000,238000000,52673000,52673000,1097000,-42469000,,,,0,301087000,248414000,63087000,-20473000,,32200000,21131000,56316,STAG
2019-12-31,,,9388000,,9388000,11211000,10837000,-374000,-374000,,-1815000,,,,0,28795000,29169000,17958000,9762000,,9388000,9388000,56317,AVEO
2018-12-31,,,-5329000,,-5329000,10781000,-15243000,-26024000,-26024000,,-2191000,,,,0,5409000,31433000,20652000,20695000,,-5329000,-5329000,56317,AVEO
2017-12-31,,,-64924000,,-65025000,9138000,-17600000,-26738000,-26738000,,-2373000,,,,101000,7579000,34317000,25179000,-38186000,,-65025000,-65025000,56317,AVEO
2016-12-31,,,-26786000,,-26887000,8205000,-21188000,-29393000,-29393000,,-1949000,,,,101000,2515000,31908000,23703000,2607000,,-26887000,-26887000,56317,AVEO
2020-11-30,,,-10253000000,,-10236000000,1885000000,834000000,-4917000000,-4917000000,1625000000,-895000000,,,,-17000000,5594000000,10511000000,4760000000,-5336000000,,-10236000000,-10236000000,56319,CCL
2019-11-30,,,3061000000,,2990000000,2486000000,11110000000,3297000000,3297000000,3167000000,-206000000,,,,71000000,20825000000,17528000000,9715000000,-236000000,,2990000000,2990000000,56319,CCL
2018-11-30,,,3206000000,,3152000000,2459000000,10777000000,3389000000,3389000000,2912000000,-194000000,,,,54000000,18880000000,15491000000,8103000000,-183000000,,3152000000,3152000000,56319,CCL
2017-11-30,,,2666000000,,2606000000,2265000000,7313000000,3237000000,3237000000,-35000000,-198000000,,,,60000000,17510000000,14273000000,10197000000,-571000000,,2606000000,2606000000,56319,CCL
2020-12-31,,,-28883000000,,-22440000000,,827000000,-28883000000,-28883000000,28425000000,,,,,-5632000000,181502000000,210385000000,180675000000,0,,-23251000000,-22440000000,56321,XOM
2019-12-31,,,20056000000,7288000000.0,14340000000,12168000000.0,77152000000,11631000000,11631000000,33186000000,-830000000.0,,,,5282000000,255583000000,243952000000,178431000000,8425000000,,14774000000,14340000000,56321,XOM
2018-12-31,,,30953000000,6734000000.0,20840000000,12300000000.0,88580000000,21539000000,21539000000,35230000000,-766000000.0,,,,9532000000,279332000000,257793000000,190752000000,9414000000,,21421000000,20840000000,56321,XOM
2017-12-31,,,18674000000,6812000000.0,19710000000,11893000000.0,78109000000,14074000000,14074000000,32459000000,-601000000.0,,,,-1174000000,237162000000,223088000000,159053000000,4600000000,,19848000000,19710000000,56321,XOM
2019-12-31,,,-16738729,,-16738729,23457042,15610036,-14614747,-14614747,,-1197127,,,,0,26071995,40686742,10461959,-2123982,,-16738729,-16738729,56322,AESE
2018-12-31,,,-31019725,,-30616098,21839388,10408773,-18142013,-18142013,,-2117438,,,,0,20603255,38745268,10194482,-12877712,,-31019725,-30616098,56322,AESE
2017-12-31,,,-18087231,,-18087231,14694417,1360528,-17540832,-17540832,,-540370,,,,0,13673006,31213838,12312478,-546399,,-18087231,-18087231,56322,AESE
2016-12-31,,,-9330056,,-9330056,10003220,5482752,-9329911,-9329911,,-145,,,,0,19860683,29190594,14377931,-145,,-9330056,-9330056,56322,AESE
2020-12-31,375500000,,291200000,14200000,186900000,389200000,1246900000,480900000,480900000,-8700000,-73000000,,,,102900000,7447400000,6966500000,6200500000,-189700000,,188300000,186900000,56324,ALV
2019-12-31,405500000,,648400000,13200000,461500000,408000000,1584400000,973600000,973600000,-214200000,-69500000,,,,185600000,8547600000,7574000000,6963200000,-325200000,,462800000,461500000,56324,ALV
2018-12-31,412600000,,612400000,13100000,190400000,390700000,1711300000,904500000,904500000,-7800000,-66100000,,,,234900000,8678200000,7773700000,6966900000,-292100000,-185500000.0,377500000,190400000,56324,ALV
2017-12-31,370600000,,792400000,134300000,427100000,415900000,1679700000,872700000,872700000,9300000,-61100000,,,,204400000,8136800000,7264100000,6457100000,-80300000,-158900000.0,588000000,427100000,56324,ALV
2019-12-31,,,-77167000,,-89835000,188743000,150707000,-46418000,-46418000,,-3677000,,,,12668000,253708000,300126000,103001000,-30749000,,-89835000,-89835000,56325,NBEV
2018-12-31,,,-21062000,,-12135000,22369000,10795000,-13884000,-13884000,,-1068000,,,,-8927000,52160000,66044000,41365000,-7178000,,-12135000,-12135000,56325,NBEV
2017-12-31,,,-3536000,,-3536000,16143000,11700000,-6049000,-6049000,,-228000,,,,0,52188000,58237000,40488000,2513000,,-3536000,-3536000,56325,NBEV
2016-12-31,,,-3633079,,-3633079,7708520,5796226,-1912294,-1912294,,-299080,,,,0,25301806,27214100,19505580,-1720785,,-3633079,-3633079,56325,NBEV
2020-08-31,,,3889156,,2784525,8397335,12473183,3858136,3858136,,,,,,1104631,44945263,41087127,32472080,31020,,2784525,2784525,56327,JCTCF
2019-08-31,,,2888144,,2100452,7035062,9964431,2737550,2737550,,,,,,787692,45446362,42708812,35481931,150594,,2100452,2100452,56327,JCTCF
2018-08-31,,,4279423,,2920639,7047330,11597814,4276419,4276419,,,,,,1358784,53923152,49646733,42325338,3004,,2920639,2920639,56327,JCTCF
2017-08-31,,,4465251,,2726657,6366318,11079283,4437751,4437751,,,,,,1738594,47701056,43263305,36621773,27500,,2726657,2726657,56327,JCTCF
2020-12-31,,,13846000,,11357000,31471000,62777000,0,14946000,16360000,,,,,2489000,62777000,47831000,0,-1100000,,11357000,11357000,56328,PEBK
2019-12-31,,,17203000,,14067000,33113000,62720000,0,17322000,12285000,,,,,3136000,62720000,45398000,0,-119000,,14067000,14067000,56328,PEBK
2018-12-31,,,16006000,,13382000,31147000,58580000,0,16334000,11099000,,,,,2624000,58580000,42246000,0,-328000,,13382000,13382000,56328,PEBK
2017-12-31,,,14215000,,10268000,29190000,55443000,0,15070000,11183000,,,,,3947000,55443000,40373000,0,-855000,,10268000,10268000,56328,PEBK
2019-12-31,,,1006000000,5628000000,494000000,1495000000,3940000000,1628000000,1628000000,231000000,-435000000,,,,271000000,7794000000,6166000000,3854000000,-622000000,,735000000,494000000,56329,LSXMA
2018-12-31,,,1245000000,5108000000,676000000,878000000,2993000000,1623000000,1623000000,106000000,-388000000,,,,241000000,5771000000,4148000000,2778000000,-378000000,,1004000000,676000000,56329,LSXMA
2017-12-31,,,1193000000,5615000000,1124000000,812000000,2824000000,1547000000,1547000000,97000000,-356000000,,,,-466000000,5425000000,3878000000,2601000000,-354000000,,1659000000,1124000000,56329,LSXMA
2016-12-31,,,998000000,5945000000,413000000,761000000,2507000000,1352000000,1352000000,69000000,-342000000,,,,341000000,5014000000,3662000000,2507000000,-354000000,,657000000,413000000,56329,LSXMA
2019-12-31,207000,,5979000,-13875000,4175000,72467000,82899000,10225000,10225000,,-530000,,,,4600000,315291000,305066000,232392000,-4246000,,1379000,2694000,56330,GNE
2018-12-31,39000,,9024000,-11009000,22785000,63244000,76547000,13020000,13020000,,-401000,,,,-12376000,280309000,267289000,203762000,-3996000,,21400000,21304000,56330,GNE
2017-12-31,39000,,-6922000,-16885000,-6994000,80122000,85509000,508000,508000,,-310000,,,,1726000,264202000,263694000,178693000,-7430000,,-8648000,-8475000,56330,GNE
2016-12-31,-269000,,-29974000,-16669000,-24525000,61569000,76940000,9488000,9488000,64000.0,-19000,,,,2218000,212112000,202624000,135172000,-39462000,,-32192000,-26006000,56330,GNE
2020-08-31,1538000,,-547000,46000,-544000,2808000,1590000,-2756000,-2756000,,-358000,,,,0,6068000,8824000,4478000,2209000,,-547000,-544000,56331,LEDS
2019-08-31,1613000,,-3565000,47000,-3565000,2792000,452000,-3953000,-3953000,,-190000,,,,0,5902000,9855000,5450000,388000,,-3565000,-3565000,56331,LEDS
2018-08-31,957000,,-2981000,47000,-2981000,3184000,-435000,-4576000,-4576000,,-27000,,,,0,7495000,12071000,7930000,1595000,,-2981000,-2981000,56331,LEDS
2017-08-31,851000,,-4104000,47000,-4091000,3708000,82000,-4477000,-4477000,,-34000,,,,0,9214000,13691000,9132000,373000,,-4104000,-4091000,56331,LEDS
2020-12-31,,,-1162401000,,-1237574000,404610000,821618000,0,346020000,70988000,,,,,75173000,821618000,475598000,0,-1508421000,,-1237574000,-1239356000,56332,PACW
2019-12-31,,,632940000,,468636000,412644000,1135191000,0,664864000,57683000,,,,,164304000,1135191000,470327000,0,-31924000,,468636000,463454000,56332,PACW
2018-12-31,,,633317000,,465339000,406339000,1144549000,0,677547000,60663000,,,,,167978000,1144549000,467002000,0,-44230000,,465339000,460220000,56332,PACW
2017-12-31,,,554731000,,357818000,380125000,1050392000,0,610141000,60126000,,,,,196913000,1050392000,440251000,0,-55410000,,357818000,353634000,56332,PACW
2020-12-31,,,2505530,,2068225,8281419,14503264,0,5548030,673815,,,,,437305,14503264,8955234,0,-3042500,,2068225,2068225,56334,BSBK
2019-12-31,,,3278524,,2427912,7674135,11712671,0,3322981,715555,,,,,850612,11712671,8389690,0,-44457,,2427912,2427912,56334,BSBK
2018-12-31,,,5527268,,4136677,7359190,13843080,0,5720720,763170,,,,,1390591,13843080,8122360,0,-193452,,4136677,4136677,56334,BSBK
2017-12-31,,,6531550,,3901754,6905779,14424908,0,6723218,795911,,,,,2629796,14424908,7701690,0,-191668,,3901754,3901754,56334,BSBK
2020-12-31,65900000,,500000,3100000,-1800000,282900000,637200000,288400000,288400000,,-74900000,,,,2200000,1729800000,1441400000,1092600000,-287900000,,-1700000,-1800000,56335,GRA
2019-12-31,64500000,,183500000,6500000,126300000,378900000,797300000,353900000,353900000,,-74800000,,,,56800000,1958100000,1604200000,1160800000,-170400000,,126700000,126300000,56335,GRA
2018-12-31,62700000,,244900000,6100000,167600000,272600000,773600000,438300000,438300000,,-78500000,,,,78100000,1932100000,1493800000,1158500000,-193400000,,166800000,167600000,56335,GRA
2017-12-31,56300000,,210900000,6900000,11200000,307000000,676100000,312800000,312800000,,-78500000,,,,200500000,1716500000,1403700000,1040400000,-101900000,,10400000,11200000,56335,GRA
2019-12-31,,,108231000,,80925000,464285000,677628000,133202000,133202000,,-29014000,,,,27306000,4643404000,4510202000,3965776000,-24971000,,80925000,80925000,56336,BCC
2018-12-31,,,22102000,,20477000,456948000,687696000,138911000,138911000,,-25642000,,,,1625000,4995290000,4856379000,4307594000,-116809000,,20477000,20477000,56336,BCC
2017-12-31,,,117588000,,82957000,390508000,612417000,140953000,140953000,577000.0,-24832000,,,,34631000,4431991000,4291038000,3819574000,-23365000,,82957000,82957000,56336,BCC
2016-12-31,,,43301000,,38254000,360140000,515140000,81678000,81678000,475000.0,-22482000,,,,5047000,3911215000,3829537000,3396075000,-38377000,,38254000,38254000,56336,BCC
2019-12-31,2836000,,1830000,,6995000,6935000,11603000,1832000,1832000,,,,,,-5165000,14732000,12900000,3129000,-2000,,6995000,6995000,56338,ISNS
2018-12-31,3284000,,1852000,,1862000,6495000,11775000,1996000,1996000,,,,,,-10000,14561000,12565000,2786000,-144000,,1862000,1862000,56338,ISNS
2017-12-31,3010000,,2163000,,2078000,6164000,11599000,2425000,2425000,,,,,,85000,14524000,12099000,2925000,-262000,,2078000,2078000,56338,ISNS
2016-12-31,2946000,,662000,,687000,6285000,10134000,813000,813000,,,,,,-25000,14142000,13329000,4008000,-151000,,687000,687000,56338,ISNS
2019-12-31,2083000,,-125000,-293000,168000,33047500,34416000,-714500,-714500,,-2500000,,,,0,51165000,51879500,16749000,589500,,-125000,168000,56343,HROW
2018-12-31,825000,,14625000,-293000,14625000,28603000,24851000,-4577000,-4577000,,-2728000,,,,0,41372000,45949000,16521000,19202000,,14625000,14625000,56343,HROW
2017-12-31,413000,,-12920000,-293000,-11985000,25019000,13269000,-12163000,-12163000,,-3026000,,,,-935000,26774000,38937000,13505000,-757000,,-11985000,-11985000,56343,HROW
2016-12-31,739000,,-19198000,-293000,-19087000,24836000,10111000,-15464000,-15464000,,-2784000,,,,-111000,19942000,35406000,9831000,-3734000,,-19087000,-19087000,56343,HROW
2020-09-30,,,1516267000,,1117862000,1355065000,3837598000,1874073000,1874073000,66301000,-108684000,,,,398405000,12164115000,10290042000,8326517000,-357806000,,1117862000,1117862000,56344,GIB
2019-09-30,,,1676948000,,1263207000,1439915000,3711865000,1823416000,1823416000,60447000,-63312000,,,,413741000,12111236000,10287820000,8399371000,-146468000,,1263207000,1263207000,56344,GIB
2018-09-30,,,1489980000,,1141402000,1369420000,3517335000,1699280000,1699280000,64801000,-62875000,,,,348578000,11506825000,9807545000,7989490000,-209300000,,1141402000,1141402000,56344,GIB
2017-09-30,,,1417897000,,1035195000,1273944000,3262726000,1581829000,1581829000,40576000,-62022000,,,,382702000,10845066000,9263237000,7582340000,-163932000,,1035195000,1035195000,56344,GIB
2019-12-31,,,-4312,,-4312,,0,0,,,,,,,0,0,0,0,-4312,,-4312,-4312,56346,FIII
2020-11-30,,,1067083000,59308000,775239000,139131000,1314602000,1120528000,1120528000,,-53445000,,,,298673000,6955930000,5835402000,5641328000,-53445000,,768410000,764810000,56348,JEF
2019-11-30,,,478608000,48584000,964696000,137666000,674297000,531114000,531114000,3617363000.0,-53048000,,,,-483955000,5358656000,4827542000,4684359000,-52506000,,962563000,954017000,56348,JEF
2018-11-30,,,323018155,38170000,1120132270,153599987,307385429,148883988,148883988,3617363000.0,-68816722,,,,20735998,5223289747,5074405759,4915904318,174134167,844346111.0,302282157,1109684635,56348,JEF
2017-12-31,,,606502000,459615000,171726000,72510000,563189000,487209000,487209000,3617363000.0,-58943000,,,,642286000,4870670000,4383461000,4307481000,119293000,288631000.0,-35784000,166741000,56348,JEF
2019-12-31,38430000,,-115549000,,-115549000,72784000,-19448000,-130662000,-130662000,,-15143000,,,,0,21301000,151963000,40749000,15113000,,-115549000,-115549000,56349,SENS
2018-12-31,31863000,,-93971000,,-93971000,47569000,-8146000,-87578000,-87578000,,-8282000,,,,0,18913000,106491000,27059000,-6393000,,-93971000,-93971000,56349,SENS
2017-12-31,30735000,,-59101000,,-59101000,22193000,-3385000,-56313000,-56313000,,-3099000,,,,0,6373000,62686000,9758000,-2788000,,-59101000,-59101000,56349,SENS
2016-12-31,26347000,,-43930000,,-43930000,15758000,-328000,-42433000,-42433000,,-1602000,,,,0,332000,42765000,660000,-1497000,,-43930000,-43930000,56349,SENS
2019-12-31,,,-2415000,,-2415000,3929000,4223000,294000,294000,,,,,,0,4223000,3929000,0,-2709000,,-2415000,-2415000,56350,IIF
2018-12-31,,,-110555000,,-110555000,5704000,5148000,-556000,-556000,,,,,,0,5148000,5704000,0,-109999000,,-110555000,-110555000,56350,IIF
2017-12-31,,,185805000,,185805000,7328000,5929000,-1399000,-1399000,,,,,,0,5929000,7328000,0,187204000,,185805000,185805000,56350,IIF
2016-12-31,,,19364000,,19364000,6130000,4926000,-1204000,-1204000,,,,,,0,4926000,6130000,0,20568000,,19364000,19364000,56350,IIF
2020-12-31,,,1382837000,,649197000,396477000,1846463000,0,1308991000,,,,,,261924000,2913614000,1604623000,1067151000,73846000,,1120913000,649197000,56351,VIRT
2019-12-31,,,-115982000,297562000.0,-58595000,280945000,495071000,0,77887000,,,,,,-12277000,1207584000,1129697000,712513000,-193869000,,-103705000,-60521000,56351,VIRT
2018-12-31,,,696363000,442803000.0,289441000,207569000,693875000,0,399005000,,,,,,76171000,1313188000,914183000,619313000,297358000,,620192000,284023000,56351,VIRT
2017-12-31,,,113164000,321009000.0,2939000,139528000,288095000,0,85021000,,,,,,94266000,766377000,681356000,478282000,28143000,,18898000,1613000,56351,VIRT
2020-10-31,,,26070000,62071000,22183000,11016000,84467000,44969000,44969000,-705000,-13508000,,,,0,127473000,82504000,43006000,-18899000,,26070000,8533000,56353,UBA
2019-10-31,,,41613000,77876000,37280000,9751000,92850000,55390000,55390000,-221000,-14102000,,,,0,138364000,82974000,45514000,-13777000,,41613000,22128000,56353,UBA
2018-10-31,,,42183000,78258000,37467000,9567000,89610000,51811000,51811000,-95000,-13678000,,,,0,133012000,81201000,43402000,-9628000,,42183000,25217000,56353,UBA
2017-10-31,,,55432000,81361000,52933000,9504000,83490000,49323000,49323000,-2432000,-12981000,,,,0,123185000,73862000,39695000,6109000,,55432000,33898000,56353,UBA
2019-12-31,6794000,,-22426000,,-22426000,15045000,0,-21839000,-21839000,,,,,,0,0,21839000,0,-587000,,-22426000,-22426000,56354,OCX
2018-12-31,5889000,,-15754000,,-15754000,8688000,0,-14577000,-14577000,,-216000.0,,,,0,0,14577000,0,-1177000,,-15754000,-15754000,56354,OCX
2017-12-31,7174000,,-19375000,,-19375000,11675000,0,-18849000,-18849000,,-217000.0,,,,0,0,18849000,0,-526000,,-19375000,-19375000,56354,OCX
2016-12-31,5677000,,-11168000,,-11168000,5463000,0,-11140000,-11140000,,-28000.0,,,,0,0,11140000,0,-28000,,-11168000,-11168000,56354,OCX
2020-09-30,16935222,,-20051976,,-18973535,14498330,30786858,-646694,-646694,,-4621422,,,,-1078441,42592060,43238754,11805202,-19405282,,-18973535,-18973535,56355,VERU
2019-09-30,13743826,,-12321299,,-12017366,14348890,21656822,-6435894,-6435894,,-4706056,,,,-303933,31803387,38239281,10146565,-5885405,,-12017366,-12017366,56355,VERU
2018-09-30,10850958,,-23072287,,-23938389,14807472,8772541,-16885889,-16885889,,-2950501,,,,866102,15864483,32750372,7091942,-6186398,,-23938389,-23938389,56355,VERU
2017-09-30,3076390,,-8602490,,-6612047,11501453,7019512,-7558331,-7558331,,-2950501,,,,-1990443,13655592,21213923,6636080,-1044159,,-6612047,-8602818,56355,VERU
2019-12-31,292000000,,743000000,,600000000,2560000000,3807000000,955000000,955000000,,-65000000,,,,143000000,5138000000,4183000000,1331000000,-212000000,,600000000,600000000,56356,SNN
2018-12-31,246000000,,781000000,,663000000,2396000000,3606000000,964000000,964000000,,-59000000,,,,118000000,4904000000,3940000000,1298000000,-183000000,,663000000,663000000,56356,SNN
2017-12-31,223000000,,879000000,,767000000,2409000000,3517000000,885000000,885000000,,-57000000,,,,112000000,4765000000,3880000000,1248000000,-6000000,,767000000,767000000,56356,SNN
2016-12-31,230000000,,1062000000,,784000000,2255000000,3397000000,912000000,912000000,,-52000000,,,,278000000,4669000000,3757000000,1272000000,150000000,,784000000,784000000,56356,SNN
2019-12-31,24536000,,-43957000,,-43957000,20869000,0,-45405000,-45405000,,-945000,,,,0,0,45405000,0,1448000,,-43957000,-43957000,56357,KRTX
2018-12-31,11536000,,-17512000,,-17512000,2974000,0,-14510000,-14510000,,-2583000,,,,0,0,14510000,0,-3002000,,-17512000,-17512000,56357,KRTX
2017-12-31,3616000,,-6032000,,-6032000,1190000,0,-4806000,-4806000,,-1171000,,,,0,0,4806000,0,-1226000,,-6032000,-6032000,56357,KRTX
2020-03-31,492088000000,,-60754000000,4003000000,44241000000,964268000000,2201453000000,298349000000,298349000000,39405000000,-149010000000,,,,-105044000000,3291188000000,2992839000000,1089735000000,-359103000000,,44290000000,44241000000,56358,TAK
2019-03-31,366657000000,,127612000000,4006000000,135192000000,692128000000,1519330000000,292334000000,292334000000,-1708000000,-48158000000,,,,-7468000000,2097224000000,1804890000000,577894000000,-164722000000,,135080000000,135192000000,56358,TAK
2018-03-31,325441000000,,217205000000,19985000000,186886000000,628106000000,1274975000000,177829000000,177829000000,17579000000,-10036000000,,,,30497000000,1770531000000,1592702000000,495556000000,39376000000,,186708000000,186886000000,56358,TAK
2017-03-31,311625000000,,143346000000,54704000000,114940000000,615867000000,1174375000000,125450000000,125450000000,9325000000,-7560000000,,,,27833000000,1732051000000,1606601000000,557676000000,17896000000,,115513000000,114940000000,56358,TAK
2020-12-31,,,13820000,,10004000,,43801000,16651000,16651000,27150000,,,,,-106000,127034000,110383000,83233000,-2831000,,13926000,10004000,56363,MN
2019-12-31,,,10305000,-10527000.0,1433000,,45872000,13815000,13815000,32057000,-26000.0,,,,448000,136001000,122186000,90129000,-3510000,,9857000,1535000,56363,MN
2018-12-31,,,25632000,-13572000.0,3197000,3700000.0,55748000,21282000,21282000,34466000,-49000.0,,,,2647000,161331000,140049000,105583000,4350000,,22985000,3130000,56363,MN
2017-12-31,,,67877000,-21921000.0,3587000,4200000.0,83247000,51968000,51968000,27079000,-36000.0,,,,19352000,201527000,149559000,118280000,15909000,,48525000,3517000,56363,MN
2020-12-31,,,9734000,,8263000,,29208000,0,9734000,19474000,,,,,1471000,29208000,19474000,0,0,,8263000,8263000,56364,CLDB
2019-12-31,,,8641000,,7282000,15356000.0,28345000,0,8653000,4336000,,,,,1359000,28345000,19692000,0,-12000,,7282000,7282000,56364,CLDB
2018-12-31,,,10250000,,8835000,13943000.0,26785000,0,8878000,3964000,,,,,1415000,26785000,17907000,0,1372000,,8835000,8835000,56364,CLDB
2017-12-31,,,6767000,,4350000,14477000.0,24470000,0,6068000,3925000,,,,,2417000,24470000,18402000,0,699000,,4350000,4350000,56364,CLDB
2020-12-31,,,255668000,,225769000,314736000,748097000,0,320001000,90350000,,,,,29899000,748097000,428096000,0,-64333000,,225769000,217886000,56368,STL
2019-12-31,,,539966000,,427041000,324167000,991986000,0,583441000,64905000,,,,,112925000,991986000,408545000,0,-43475000,,427041000,419108000,56368,STL
2018-12-31,,,566230000,,447254000,335980000,1012800000,0,613179000,50657000,,,,,118976000,1012800000,399621000,0,-46949000,,447254000,439276000,56368,STL
2017-12-31,,,180970000,,93031000,216972000,614346000,0,353713000,35550000,,,,,87939000,614346000,260633000,0,-172743000,,93031000,91029000,56368,STL
2019-12-31,,,-203880000,302519000,-33809000,153318000,-20737000,-187275000,-187275000,5280000,-19412000,,,,439000,189125000,376400000,209862000,-16605000,,-204319000,-33809000,56369,NFE
2018-12-31,,,-78520000,14340000,-78076000,62397000,7230000,-58488000,-58488000,5280000,-11248000,,,,-338000,112301000,170789000,105071000,-20032000,,-78182000,-78076000,56369,NFE
2017-12-31,,,-31145000,14340000,-31671000,33628000,11399000,-24990000,-24990000,5280000,-6456000,,,,526000,97262000,122252000,85863000,-6155000,,-31671000,-31671000,56369,NFE
2016-12-31,,,-33287000,14340000,-32926000,18462000,-6255000,-27058000,-27058000,5280000,-5105000,,,,-361000,21395000,48453000,27650000,-6229000,,-32926000,-32926000,56369,NFE
2020-12-31,,,362210000,,351100000,58800000,1351600000,1002200000,1002200000,,-192200000,,,,8000000,8064500000,7062300000,6712900000,-639990000,,354210000,351100000,56370,IPG
2019-12-31,,,878700000,214400000.0,656000000,419900000,1811600000,1113200000,1113200000,,-199300000,,,,204800000,8625100000,7511900000,6813500000,-234500000,,673900000,656000000,56370,IPG
2018-12-31,,,836900000,207500000.0,618900000,131500000,1371700000,1037300000,1037300000,,-123000000,,,,199200000,8031600000,6994300000,6659900000,-200400000,,637700000,618900000,56370,IPG
2017-12-31,,,841700000,286900000.0,554400000,118500000,1199900000,924300000,924300000,,-90800000,,,,271300000,7473500000,6549200000,6273600000,-82600000,,570400000,554400000,56370,IPG
2019-12-31,,,10192000,,8009000,49221000,63976000,0,12138000,2617000,,,,,2183000,63976000,51838000,0,-1946000,,8009000,8009000,56372,MYFW
2018-12-31,,,7422000,,5647000,46993000,57617000,0,8253000,2371000,,,,,1775000,57617000,49364000,0,-831000,,5647000,4269000,56372,MYFW
2017-12-31,,,5007000,,2023000,45876000,53676000,0,5277000,2523000,,,,,2984000,53676000,48399000,0,-270000,,2023000,-268000,56372,MYFW
2016-12-31,,,3571000,,2302000,46288000,53394000,0,4498000,2608000,,,,,1269000,53394000,48896000,0,-927000,,2302000,-538000,56372,MYFW
2020-12-31,,,147432000,,147432000,18748000,260403000,187948000,187948000,,-46118000,,,,0,360255000,172307000,99852000,-40516000,,147432000,147432000,56373,PBFX
2019-12-31,,,108169000,,100288000,22819000,221598000,160178000,160178000,,-48335000,,,,0,340212000,180034000,118614000,-52009000,,108169000,100288000,56373,PBFX
2018-12-31,,,103280000,169472000.0,85461000,18475000,195050000,146766000,146766000,,-42258000,,,,0,283440000,136674000,88390000,-43486000,,103280000,75450000,56373,PBFX
2017-12-31,,,115002000,171903000.0,100437000,15751000,184067000,143912000,143912000,,-33363000,,,,0,257588000,113676000,73521000,-28910000,,115002000,91382000,56373,PBFX
2020-10-31,,,13834208,,13834208,1761484,4272708,2511224,2511224,,-1007190,,,,0,4272708,1761484,0,11322984,,13834208,13834208,56374,CGO
2019-10-31,,,9898472,,9898472,1754396,4929870,3175474,3175474,,-1683712,,,,0,4929870,1754396,0,6722998,,9898472,9898472,56374,CGO
2018-10-31,,,-5036740,,-5036740,1903367,4915815,3012448,3012448,,-1448404,,,,0,4915815,1903367,0,-8049188,,-5036740,-5036740,56374,CGO
2017-10-31,,,20447906,,20447906,1714710,4457320,2742610,2742610,,-760944,,,,0,4457320,1714710,0,17705296,,20447906,20447906,56374,CGO
2020-12-31,81711000,,75251000,,71176000,91392000,243590000,70487000,70487000,,,,,,4075000,488318000,417831000,244728000,4764000,,71176000,71176000,56375,POWI
2019-12-31,73470000,,222414000,,193468000,91879000,213402000,48053000,48053000,,,,,,28946000,420669000,372616000,207267000,174361000,,193468000,193468000,56375,POWI
2018-12-31,70580000,,59764000,,69984000,88560000,214788000,55648000,55648000,,,,,,-10220000,415955000,360307000,201167000,4116000,,69984000,69984000,56375,POWI
2017-12-31,68501000,,60299000,,27609000,87526000,213664000,57637000,57637000,,,,,,32690000,431755000,374118000,218091000,2662000,,27609000,27609000,56375,POWI
2019-12-28,,,146000000,,99000000,2082000000,2464000000,351000000,351000000,,-89000000,,,,47000000,10647000000,10296000000,8183000000,-205000000,,99000000,99000000,56376,ODP
2018-12-29,,,158000000,,104000000,2151000000,2551000000,369000000,369000000,,-121000000,,,,59000000,11015000000,10646000000,8464000000,-211000000,5000000.0,99000000,104000000,56376,ODP
2017-12-30,,,299000000,18000000.0,181000000,2013000000,2461000000,439000000,439000000,,-62000000,,,,153000000,10240000000,9801000000,7779000000,-140000000,35000000.0,146000000,181000000,56376,ODP
2016-12-31,,,459000000,18000000.0,529000000,2236000000,2708000000,462000000,462000000,,-80000000,,,,-220000000,11021000000,10559000000,8313000000,-3000000,-150000000.0,679000000,529000000,56376,ODP
2019-12-31,,,-1262304000,,-1166513000,41661000,105217000,-98376000,-98376000,51024000,-38881000,,,,-95791000,224685000,323061000,119468000,-1163928000,,-1166513000,-1166513000,56377,BATL
2018-12-31,,,141750000,,45959000,62056000,120083000,73125000,73125000,-92625000,-43015000,,,,95791000,226609000,153484000,106526000,68625000,,45959000,45959000,56377,BATL
2017-12-31,,,530686000,,535686000,110351000,222943000,3676000,3676000,-1291000,-71097000,,,,-5000000,377965000,374289000,155022000,527010000,,535686000,487679000,56377,BATL
2016-12-31,,,-471157000,,-467235000,125036000,234001000,-104227000,-104227000,45738000,-151110000,,,,-3922000,420205000,524432000,186204000,-366930000,,-467235000,-467235000,56377,BATL
2020-03-31,11559000,,-1090851000,,-947597000,39893000,112726000,-134197000,-134197000,164633000,-16652000,,,,-143254000,196792000,330989000,84066000,-956654000,,-947597000,-947597000,56378,CHNG
2019-03-31,11559000,,-70607000,,-52012000,1159000,0,-1159000,-1159000,164633000,-16652000,,,,-18595000,0,1159000,0,-69448000,,-52012000,-52012000,56378,CHNG
2018-03-31,11559000,,-58666000,,60955000,180000,0,-180000,-180000,164633000,-16652000,,,,-119621000,0,180000,0,-58486000,,60955000,60955000,56378,CHNG
2017-03-31,11559000,,-57470652,,-35058658,1100000,0,-1100000,-1100000,164633000,-16652000,,,,-22411994,0,1100000,0,-56370653,,-35058658,-35058658,56378,CHNG
2020-09-30,,,-105046000,,-123772000,24722000,873854000,454574000,454574000,88400000,-117077000,,,,18726000,1546291000,1091717000,672437000,-559620000,,-123772000,-123772000,56381,NFG
2019-09-30,,,389420000,,304290000,20427000,876355000,491382000,491382000,88886000,-106756000,,,,85130000,1693332000,1201950000,816977000,-101962000,,304290000,304290000,56381,NFG
2018-09-30,,,383922000,,391521000,26937000,845077000,492786000,492786000,84393000,-114522000,,,,-7599000,1592668000,1099882000,747591000,-108864000,,391521000,391521000,56381,NFG
2017-09-30,,,443991000,,283482000,34522000,902968000,559256000,559256000,84995000,-119837000,,,,160509000,1579881000,1020625000,676913000,-115265000,,283482000,283482000,56381,NFG
2020-12-31,50064000,,122042000,,103217000,257004000,465429000,158361000,158361000,,-35137000,,,,18825000,1702367000,1544006000,1236938000,-36319000,,103217000,103217000,56382,CRSR
2019-12-31,37547000,,-13399000,,-8394000,160049000,224287000,26691000,26691000,,-35548000,,,,-5005000,1097174000,1070483000,872887000,-40090000,,-8394000,-8394000,56382,CRSR
2018-12-31,31990000,,-10707000,,-13720000,137415000,192695000,23290000,23290000,,-32680000,,,,3013000,937553000,914263000,744858000,-33997000,,-13720000,-13720000,56382,CRSR
2017-12-31,21154000,,17191000,,11734000,135369000,184326000,27803000,27803000,,-11129000,,,,5457000,855549000,827746000,671223000,-10612000,,11734000,1920000,56382,CRSR
2020-08-31,,,6774331000,498637000,5107839000,7462514000,13976158000,6513644000,6513644000,,-33071000,,,,1589018000,44327039000,37813395000,30350881000,260687000,,5185313000,5107839000,56384,ACN
2019-08-31,,,6251797000,418683000,4779112000,7009614000,13314688000,6305074000,6305074000,,-22963000,,,,1405556000,43215013000,36909939000,29900325000,-53277000,,4846241000,4779112000,56384,ACN
2018-08-31,,,5808093000,359835000,4059907000,6594585000,12493364000,5898779000,5898779000,,-19539000,,,,1593499000,40992534000,35093755000,28499170000,-90686000,,4214594000,4059907000,56384,ACN
2017-08-31,,,4616032000,760723000,3445149000,5928090000,11071492000,5143402000,5143402000,,-15545000,,,,981100000,36176841000,31033439000,25105349000,-527370000,,3634932000,3445149000,56384,ACN
2019-12-31,,,58208478,,58208478,2331191,5615763,3284572,3284572,,,,,,0,5615763,2331191,0,54923906,,58208478,58208478,56385,FUND
2018-12-31,,,-39135673,,-39135673,2608124,6962389,4354265,4354265,,,,,,0,6962389,2608124,0,-43489938,,-39135673,-39135673,56385,FUND
2017-12-31,,,35536704,,35536704,2551255,4903812,2352557,2352557,,,,,,0,4903812,2551255,0,33184147,,35536704,35536704,56385,FUND
2016-12-31,,,39042274,,39042274,2148539,5410225,3261686,3261686,,,,,,0,5410225,2148539,0,35780588,,39042274,39042274,56385,FUND
2020-09-30,,,-38511460,,-35239498,9971015,-26341998,-36313013,-36313013,,-1756471,,,,-3271962,0,36313013,26341998,-2198447,,-35239498,-48873758,56386,OTLK
2019-09-30,,,-37934788,,-34523787,9369823,-15659128,-25028951,-25028951,,-3466688,,,,-3411001,8146123,33175074,23805251,-12905837,,-34523787,-36039670,56386,OTLK
2018-09-30,,,-33740177,,-30091961,14227828,-15416475,-29644303,-29644303,,-3891250,,,,-3648216,3087560,32731863,18504035,-4095874,,-30091961,-48018854,56386,OTLK
2017-09-30,,,-38347627,,-38849127,15882033,-19998230,-35880263,-35880263,,-5625833,,,,501500,3811519,39691782,23809749,-2467364,,-38849127,-40025870,56386,OTLK
2019-12-31,52866000,,-123702000,,-123846000,22154000,-52548000,-76250000,-76250000,,-39000,,,,144000,318000,76568000,52866000,-47452000,,-123846000,-123846000,56389,AUPH
2018-12-31,41382000,,-64047000,,-64120000,13674000,-40919000,-56158000,-56158000,,-39000,,,,73000,463000,56621000,41382000,-7889000,,-64120000,-64120000,56389,AUPH
2017-12-31,41382000,,-70792000,,-70792000,12096000,-33512000,-47064000,-47064000,,-39000,,,,0,418000,47482000,33930000,-23728000,,-70792000,-70792000,56389,AUPH
2016-12-31,41382000,,-23295000,,-23295000,6970000,-14365000,-22814000,-22814000,,-39000,,,,0,173000,22987000,14538000,-481000,,-23295000,-23295000,56389,AUPH
2019-12-31,397391,,6030370,,4761711,2148375,7941731,5395965,5395965,,,,,,1268659,13599084,8203119,5657353,634405,,4761711,4761711,56390,UG
2018-12-31,399517,,5465854,,4352331,2122746,8102106,5579843,5579843,,,,,,1113523,13445565,7865722,5343459,-113989,,4352331,4352331,56390,UG
2017-12-31,646079,,5550779,,3844290,1785160,7666853,5235614,5235614,,,,,,1706489,12968205,7732591,5301352,315165,,3844290,3844290,56390,UG
2016-12-31,651828,,3696067,,2581142,1852833,5894223,3389562,3389562,,,,,,1114925,10776867,7387305,4882644,306505,,2581142,2581142,56390,UG
2019-12-28,,,144370000,,110041000,460543000,616366000,155823000,155823000,,,,,,34329000,1249824000,1094001000,633458000,-11453000,,110041000,109074000,56397,SAM
2018-12-29,,,116286000,,92663000,395710000,512243000,116533000,116533000,,,,,,23623000,995649000,879116000,483406000,-247000,,92663000,91790000,56397,SAM
2017-12-30,,,116142000,,99049000,331775000,449901000,118126000,118126000,,,,,,17093000,862992000,744866000,413091000,-1984000,,99049000,98505000,56397,SAM
2016-12-31,,,137121000,,87349000,322246000,459670000,137424000,137424000,,,,,,49772000,906446000,769022000,446776000,-303000,,87349000,86907000,56397,SAM
2019-12-31,4520000,,-30679000,,-30679000,16763000,571000,-20712000,-20712000,,-9938000,,,,0,1084000,21796000,513000,-9967000,,-30679000,-30679000,56399,SLGG
2018-12-31,4183000,,-20627000,,-20627000,12339000,362000,-16160000,-16160000,,-4469000,,,,0,1046000,17206000,684000,-4467000,,-20627000,-20627000,56399,SLGG
2017-12-31,61543,,-14955408,,-14955408,13607142,-1286723,-14955408,-14955408,,-4469000,,,,0,201182,15156590,1487905,0,,-14955408,-14955408,56399,SLGG
2016-12-31,142380,,-12365402,,-12365402,11032476,-1190546,-12365402,-12365402,,-4469000,,,,0,269892,12635294,1460438,0,,-12365402,-12365402,56399,SLGG
2020-06-30,1346172,,-4170303,,-4170303,2795961,59749,-4082384,-4082384,,-105077,,,,0,59749,4142133,0,-87919,,-4170303,-4170303,56400,AMST
2019-06-30,904771,,-3938931,,-3938931,3080401,14920,-3970252,-3970252,,-105077,,,,0,14920,3985172,0,31321,,-3938931,-3938931,56400,AMST
2018-06-30,904771,,-980204,,-980204,841476,-138728,-980204,-980204,,-105077,,,,0,0,980204,138728,0,,-980204,-980204,56400,AMST
2017-12-31,904771,,-188790,,-188790,188790,0,-188790,-188790,,-105077,,,,0,0,188790,0,0,,-188790,-188790,56400,AMST
2020-09-30,,,2726906,,2726906,1888753,12166251,10277498,10277498,,-1268821,,,,0,12166251,1888753,0,-7550592,,2726906,2262060,56402,DMF
2019-09-30,,,19040520,,19040520,1862547,13026334,11163787,11163787,,-1696486,,,,0,13026334,1862547,0,7876733,,19040520,18240912,56402,DMF
2018-09-30,,,-486169,,-486169,2167442,13599682,11432240,11432240,,-1132876,,,,0,13599682,2167442,0,-11918409,,-486169,-1253713,56402,DMF
2017-09-30,,,834399,,834399,2161871,13666308,11504437,11504437,,-708635,,,,0,13666308,2161871,0,-10670038,,834399,201716,56402,DMF
2020-12-31,,,49500000,-600000,5900000,357200000,468900000,100000000,100000000,,-33900000,,,,6200000,1350600000,1250600000,881700000,-50500000,-36800000,43300000,5900000,56403,FLOW
2019-12-31,,,85500000,10700000,-95100000,378500000,520400000,130500000,130500000,,-36600000,,,,28900000,1506600000,1376100000,986200000,-45000000,-149700000,56600000,-95100000,56403,FLOW
2018-12-31,,,71800000,10300000,44000000,364800000,513200000,135200000,135200000,,-41200000,,,,61300000,1593900000,1458700000,1080700000,-63400000,34200000,10500000,44000000,56403,FLOW
2017-12-31,,,36600000,9700000,46400000,376100000,487500000,97600000,97600000,,-50700000,,,,2600000,1483200000,1385600000,995700000,-61000000,12800000,34000000,46400000,56403,FLOW
2019-12-31,870780,,-679020,,-871800,19308612,23252570,67572,67572,,-382673,,,,192780,64438594,64371022,41186024,-746592,,-871800,-7257954,56407,MTBC
2018-12-31,1029510,,-2295865,,-2138480,17631455,19293246,-2221546,-2221546,,-351168,,,,-157385,50545781,52767327,31252535,-74319,,-2138480,-6962467,56407,MTBC
2017-12-31,1081832,,-5497351,,-5565156,12814899,14131565,-4065109,-4065109,,-1324219,,,,67805,31810635,35875744,17679070,-1432242,,-5565156,-7595451,56407,MTBC
2016-12-31,902186,,-8599921,,-8796723,13207063,11076816,-8140468,-8140468,,-682083,,,,196802,24493443,32633911,13416627,-459453,,-8796723,-9549248,56407,MTBC
2019-12-31,811000,,186000,,187000,3586000,4366000,-31000,-31000,,-2000,,,,-1000,8258000,8289000,3892000,217000,,187000,187000,56409,ELSE
2018-12-31,813000,,-18000,,-10000,3379000,4047000,-145000,-145000,,-1000,,,,-8000,7495000,7640000,3448000,127000,,-10000,-10000,56409,ELSE
2017-12-31,812000,,458000,,295000,3122000,4299000,365000,365000,,-1000,,,,163000,7840000,7475000,3541000,93000,,295000,295000,56409,ELSE
2016-12-31,767000,,204000,,202000,3207000,3884000,-90000,-90000,,-1000,,,,2000,7174000,7264000,3290000,294000,,202000,202000,56409,ELSE
2019-12-31,2236985,,-8325488,,-8325488,6653465,276774,-8613676,-8613676,,,,,,0,696790,9310466,420016,288188,,-8325488,-8325488,56410,WRAP
2018-12-31,734776,,-3336435,,-3336435,2607397,4539,-3337634,-3337634,,-1304.0,,,,0,23150,3360784,18611,1199,,-3336435,-3336435,56410,WRAP
2017-12-31,311335,,-833545,,-833545,522210,0,-833545,-833545,,-1304.0,,,,0,0,833545,0,0,,-833545,-833545,56410,WRAP
2016-12-31,260693,,-281227,,-281227,20534,0,-281227,-281227,,-1304.0,,,,0,0,281227,0,0,,-281227,-281227,56410,WRAP
2019-12-31,,,-5288000,,-7652000,6153000,8419000,-3426000,-3426000,,-2805000,,,,32000,43026000,46452000,34607000,-1862000,-2332000,-5320000,-7652000,56411,ENSV
2018-12-31,,,-4026000,,-5865000,4969000,9282000,-558000,-558000,,-2228000,,,,32000,42760000,43318000,33478000,-3468000,-1807000,-4058000,-5865000,56411,ENSV
2017-12-31,,,-6481000,,-6893000,4392000,7443000,-2782000,-2782000,,-2261000,,,,-561000,37068000,39850000,29625000,-3699000,-973000,-5920000,-6893000,56411,ENSV
2016-12-31,,,-12489000,,-8551000,3780000,-213000,-10858000,-10858000,,-1766000,,,,-3938000,24608000,35466000,24821000,-1631000,-973000,-8551000,-8551000,56411,ENSV
2019-12-31,20650000,,-12434000,,-12443000,74726000,99756000,4380000,4380000,,-3071000,,,,9000,297897000,293517000,198141000,-16814000,,-12443000,-12443000,56412,BYND
2018-12-31,9587000,,-29885000,,-29886000,34461000,17574000,-26474000,-26474000,,-1128000,,,,1000,87934000,114408000,70360000,-3411000,,-29886000,-29886000,56412,BYND
2017-12-31,5722000,,-30379000,,-30384000,15930000,249000,-21403000,-21403000,,-1002000,,,,5000,32581000,53984000,32332000,-8976000,,-30384000,-30384000,56412,BYND
2016-12-31,5782000,,-25146000,,-25149000,12672000,-6312000,-24766000,-24766000,,-380000,,,,3000,16182000,40948000,22494000,-380000,,-25149000,-25149000,56412,BYND
2019-12-31,20374000,,-255131000,,-255131000,6944000,0,-27318000,-27318000,,-4177000,,,,0,0,27318000,0,-227813000,,-255131000,-255131000,56413,PHAT
2018-12-31,20000,,-1288000,,-1288000,1205000,0,-1225000,-1225000,,-13000,,,,0,0,1225000,0,-63000,,-1288000,-1288000,56413,PHAT
2019-12-31,,,757701000,,617662000,372093000,1255901000,872461000,872461000,11347000,-130155000,,,,135198000,4929103000,4056642000,3673202000,-114760000,-4841000,622503000,617662000,56415,VMC
2018-12-31,,,623290000,,515805000,339277000,1100945000,756763000,756763000,4905000,-137977000,,,,105449000,4382869000,3626106000,3281924000,-133473000,-2036000,517841000,515805000,56415,VMC
2017-12-31,,,361316000,,601185000,327887000,993513000,643802000,643802000,21824000,-295522000,,,,-232075000,3890296000,3246494000,2896783000,-282486000,7794000,593391000,601185000,56415,VMC
2016-12-31,,,547257000,,419491000,303054000,988885000,677457000,677457000,8374000,-134076000,,,,124851000,3592667000,2915210000,2603782000,-130200000,-2915000,422406000,419491000,56415,VMC
2019-12-31,78439000,,-401402000,390577000,-1316797000,1138350000,1430601000,-328091000,-328091000,541903000,-57646000,,,,446257000,10467931000,10796022000,9037330000,-73311000,-446427000,-847659000,-1316797000,56417,ERJ
2018-12-31,70872000,,-1064388000,365734000,-669025000,1053940000,711979000,-789683000,-789683000,376850000,-168760000,,,,-87955000,7888033000,8677716000,7176054000,-274705000,332865000,-976433000,-669025000,56417,ERJ
2017-12-31,157564000,,988576000,375269000,850699000,1582358000,3513589000,1477750000,1477750000,295917000,-695583000,,,,86289000,18776086000,17298336000,15262497000,-489174000,332865000,902287000,850699000,56417,ERJ
2016-12-31,161989000,,555821000,301258000,585433000,1863172000,4269592000,1229635000,1229635000,1014796000,-708852000,,,,-35990000,21435696000,20206061000,17166104000,-673814000,332865000,591811000,585433000,56417,ERJ
2019-12-31,368815000,,-680238000,,-680238000,345777000,-362347000,-708124000,-708124000,,,,,,0,6868000,714992000,369215000,27886000,,-680238000,-680238000,56419,SAGE
2018-12-31,368815000,,-372882000,,-372882000,201404000,-191834000,-393238000,-393238000,,,,,,0,90273000,483511000,282107000,20356000,,-372882000,-372882000,56419,SAGE
2017-12-31,210277000,,-270120000,,-270120000,62878000,-210277000,-273155000,-273155000,,,,,,0,0,273155000,210277000,3035000,,-270120000,-270120000,56419,SAGE
2016-12-31,120756000,,-158987000,,-158987000,39407000,-120756000,-160163000,-160163000,,,,,,0,0,160163000,120756000,1176000,,-158987000,-158987000,56419,SAGE
2019-12-31,,,-13834000,4759000,-13855000,33611000,58460000,-6986000,-6986000,7293000,-2367000,,,,1540000,206082000,213068000,147622000,-6848000,,-15374000,-29057000,56421,AINC
2018-12-31,,,-2544000,3989000,10182000,27551000,40896000,2718000,2718000,2708000,-1200000,,,,-10364000,150969000,148251000,110073000,-5262000,,7820000,4965000,56421,AINC
2017-12-31,,,-10471000,5883000,-18352000,8886000,3406000,-8384000,-8384000,946000,-122000,,,,9723000,60498000,68882000,57092000,-2087000,,-20194000,-18352000,56421,AINC
2016-12-31,,,-11623000,54252000,-2396000,16454000,15171000,-2457000,-2457000,946000,-122000,,,,780000,67607000,70064000,52436000,-9166000,,-12403000,-2396000,56421,AINC
2019-12-31,,,46924000,,33343000,83125000,303617000,104721000,104721000,,-60729000,,,,13581000,448737000,344016000,145120000,-57797000,,33343000,33343000,56423,VRRM
2018-12-31,,,-74635000,,-58394000,65478000,252028000,83197000,83197000,,-69550000,,,,-16241000,370146000,286949000,118118000,-157832000,,-58394000,-58394000,56423,VRRM
2017-12-31,,,-9947000,,19478000,45662000,139812000,48424000,48424000,,-21733000,,,,-29425000,232110000,183686000,92298000,-58371000,,19478000,18238000,56423,VRRM
2016-12-31,,,47657114,,28996084,53033871,134843644,48392837,48392837,,-2706499,,,,18661030,230749586,182356749,95905942,-735723,,28996084,28996084,56423,VRRM
2020-04-30,4995000,,-107854000,,-96201000,79888000,71016000,-13867000,-13867000,,,,,,-11653000,167379000,181246000,96363000,-93987000,,-96201000,-96201000,56424,AOUT
2019-04-30,4859000,,-8787000,,-9521000,82256000,83474000,-3641000,-3641000,,,,,,734000,177363000,181004000,93889000,-5146000,,-9521000,-9521000,56424,AOUT
2018-04-30,3803000,,1007000,,8165000,78719000,79906000,-2616000,-2616000,,,,,,-7158000,171681000,174297000,91775000,3623000,,8165000,8165000,56424,AOUT
2020-12-31,359900000,,225000000,,493600000,620700000,1280100000,299500000,299500000,,-84700000,,,,-268600000,1926700000,1627200000,646600000,-74500000,,493600000,493600000,56425,DXCM
2019-12-31,273500000,,104200000,,101100000,515700000,931500000,142300000,142300000,,-60300000,,,,3100000,1476000000,1333700000,544500000,-38100000,,101100000,101100000,56425,DXCM
2018-12-31,417400000,,-126500000,,-127100000,432800000,663900000,-186300000,-186300000,,-22700000,,,,600000,1031600000,1217900000,367700000,59800000,,-127100000,-127100000,56425,DXCM
2017-12-31,185400000,,-48600000,,-50200000,349200000,492100000,-42500000,-42500000,,-12800000,,,,1600000,718500000,761000000,226400000,-6100000,,-50200000,-50200000,56425,DXCM
2019-12-31,,,-391078000,2012002000,-307049000,345375000,-15830000,-361205000,-361205000,,-28700000,,,,-38986000,198363000,559568000,214193000,-29873000,,-352092000,-307049000,56426,CCM
2018-12-31,,,-225246000,2270675000,-234875000,313572000,19762000,-293810000,-293810000,,-46232000,,,,34051000,190898000,484708000,171136000,68564000,,-259297000,-359230000,56426,CCM
2017-12-31,,,-253895000,477150000,-284320000,281254000,97998000,-183256000,-183256000,,-89959000,,,,31789000,330977000,514233000,232979000,-70639000,,-285684000,-284320000,56426,CCM
2016-12-31,,,-204598000,65592000,-261867000,276001000,168499000,-107502000,-107502000,,-89327000,,,,60486000,455042000,562544000,286543000,-97096000,,-265084000,-261867000,56426,CCM
2020-09-30,3061000,,6681000,,5531000,10356000,18953000,5536000,5536000,,,,,,1150000,77420000,71884000,58467000,1145000,,5531000,5531000,56428,GENC
2019-09-30,3295000,,12824000,,10196000,9647000,22412000,9470000,9470000,,,,,,2628000,81329000,71859000,58917000,3354000,,10196000,10196000,56428,GENC
2018-09-30,2915000,,15064000,,12694000,9991000,26796000,13890000,13890000,,,,,,2370000,98614000,84724000,71818000,1174000,,12694000,12694000,56428,GENC
2017-09-30,2147000,,12178000,,8418000,8776000,21159000,10236000,10236000,,,,,,3760000,80608000,70372000,59449000,1942000,,8418000,8418000,56428,GENC
2020-12-31,,,-671983000,,-671983000,25671000,39810000,-34230000,-34230000,,-30063000,,,,0,163732000,197962000,123922000,-637753000,,-671983000,-671983000,56429,NETI
2019-12-31,,,44654000,,44654000,31973000,102034000,15837000,15837000,,-47897000,,,,0,224579000,208742000,122545000,28817000,,44654000,44654000,56429,NETI
2018-12-31,,,-12698000,,-12698000,32385000,132302000,43310000,43310000,,-45637000,,,,0,242502000,199192000,110200000,-56008000,,-12698000,-12698000,56429,NETI
2017-12-31,,,-59726000,,-59726000,29081000,69720000,-7871000,-7871000,,-34274000,,,,0,162205000,170076000,92485000,-51855000,,-59726000,-59726000,56429,NETI
2019-12-31,,,-790153000,,-789608000,271362000,-540717000,-812079000,-812079000,,,,,,-545000,44674000,856753000,585391000,21926000,,-789608000,-789608000,56430,BLUE
2018-12-31,448589000.0,,-555438000,,-555625000,174129000,-394895000,-569024000,-569024000,,-15500000.0,,,,187000,54579000,623603000,449474000,13586000,,-555625000,-555625000,56430,BLUE
2017-12-31,448589000.0,,-335433000,,-335643000,93550000,-239140000,-332690000,-332690000,,-11400000.0,,,,210000,35427000,368117000,274567000,-2743000,,-335643000,-335643000,56430,BLUE
2016-12-31,448589000.0,,-264119000,,-263507000,65119000,-198620000,-263739000,-263739000,,-11400000.0,,,,-612000,6155000,269894000,204775000,-380000,,-263507000,-263507000,56430,BLUE
2020-12-31,,,72195000,,72195000,30704000,299787000,78952000,78952000,-304000,-56174000,,,,0,498862000,419910000,199075000,-6757000,,72195000,70112000,56431,HR
2019-12-31,,,39185000,,39185000,31972000,288377000,78701000,78701000,-155000,-55435000,,,,0,470124000,391423000,181747000,-39516000,,39185000,37110000,56431,HR
2018-12-31,,,69771000,,69771000,34511000,279035000,80377000,80377000,-114000,-52804000,,,,0,450279000,369902000,171244000,-10606000,,69771000,67451000,56431,HR
2017-12-31,,,23092000,,23092000,32992000,265191000,89682000,89682000,-114000,-56402000,,,,0,424623000,334941000,159432000,-66590000,,23092000,20943000,56431,HR
2021-01-02,,,177948000,,124664000,749042000,925533000,176491000,176491000,,,,,,53284000,1134644000,958153000,209111000,1457000,,124664000,124664000,56433,USNA
2019-12-28,,,150496000,,100526000,727209000,873399000,146190000,146190000,,-66000.0,,,,49970000,1060902000,914712000,187503000,4306000,,100526000,100526000,56433,USNA
2018-12-29,,,191510000,,126224000,800185000,988538000,188353000,188353000,,-36000.0,,,,65286000,1189248000,1000895000,200710000,3157000,,126224000,126224000,56433,USNA
2017-12-30,,,134640000,,62535000,735357000,867861000,132504000,132504000,,-46000.0,,,,72105000,1047265000,914761000,179404000,2136000,,62535000,62535000,56433,USNA
2020-12-31,1087000000,,3420000000,,5667000000,3636000000,7798000000,2717000000,2717000000,331000000,-305000000,,,,878000000,10271000000,7554000000,2473000000,703000000,3125000000,2542000000,5667000000,56434,EBAY
2019-12-31,976000000,,1749000000,,1786000000,3309000000,6500000000,1925000000,1925000000,262000000,-311000000,,,,233000000,8636000000,6711000000,2136000000,-176000000,270000000,1516000000,1786000000,56434,EBAY
2018-12-31,1051000000,,2249000000,,2530000000,3486000000,6627000000,1821000000,1821000000,247000000,-326000000,,,,121000000,8650000000,6829000000,2023000000,428000000,402000000,2128000000,2530000000,56434,EBAY
2017-12-31,1224000000,,2275000000,,-1017000000,3908000000,7706000000,2264000000,2264000000,272000000,-292000000,,,,3288000000,9927000000,7663000000,2221000000,11000000,-4000000,-1013000000,-1017000000,56434,EBAY
2019-12-31,,,3463024,,2510901,11567058,15294582,3727524,3727524,,-440999,,,,952123,24749263,21021739,9454681,-264500,,2510901,1484838,56436,WVVI
2018-12-31,,,3939586,,2858580,10598784,14781499,4182715,4182715,,-457689,,,,1081006,23079739,18897024,8298240,-243129,,2858580,1839665,56436,WVVI
2017-12-31,,,3446505,,2993779,9245807,12881851,3636044,3636044,,-473608,,,,452726,20853527,17217483,7971676,-189539,,2993779,2289730,56436,WVVI
2016-12-31,,,4107285,,2628975,8163127,12220528,4057401,4057401,,-291370,,,,1478310,19425412,15368011,7204884,49884,,2628975,2166446,56436,WVVI
2019-12-29,,,-44042000,,-31919000,134923000,211007000,-543000,-543000,1953000,-27856000,,,,-12123000,1462765000,1463308000,1251758000,-43499000,,-31919000,-31919000,56437,TAST
2018-12-30,,,9947000,,10104000,113482000,210011000,37876000,37876000,185000,-23638000,,,,-157000,1179307000,1141431000,969296000,-27929000,,10104000,7855000,56437,TAST
2017-12-31,,,7763000,,7159000,103232000,191151000,32804000,32804000,956000,-21710000,,,,604000,1088532000,1055728000,897381000,-25041000,,7159000,5562000,56437,TAST
2017-01-01,,,17387000,,45472000,94402000,181945000,40005000,40005000,243000,-18315000,,,,-28085000,943583000,903578000,761638000,-22618000,,45472000,35395000,56437,TAST
2019-12-31,,,19861513,-3041481,11521996,607164835,624307123,17740141,17740141,-597853,,,,,8989662,692604955,674864814,68297832,2121372,,10871851,11521996,56438,LEJU
2018-12-31,,,-14185723,-2523424,-13480527,402257946,389120822,-10973681,-10973681,-2163443,,,,,-1334340,462030656,473004337,72909834,-3212042,,-12851383,-13480527,56438,LEJU
2017-12-31,,,-182371486,-3265330,-160901216,434275879,288477509,-142726505,-142726505,-3071865,,,,,-20328252,362532033,505258538,74054524,-39644981,,-162043234,-160901216,56438,LEJU
2016-12-31,,,-13668807,-2109234,-9788839,521797022,502019715,-15190561,-15190561,-4586746,,,,,-2067739,559511110,574701671,57491395,1521754,,-11601068,-9788839,56438,LEJU
2019-12-31,,,84329000,26838000,58656000,95759000,169182000,70523000,70523000,,,,,,20027000,791660000,721137000,622478000,13806000,,64302000,58656000,56439,GRBK
2018-12-31,,,81671000,25812000,51623000,77502000,154302000,74100000,74100000,,,,,,17136000,623647000,549547000,469345000,7571000,,64535000,51623000,56439,GRBK
2017-12-31,,,64237000,16691000,14970000,58142000,118560000,60118000,60118000,,,,,,39031000,458250000,398132000,339690000,4119000,,25206000,14970000,56439,GRBK
2016-12-31,,,50554000,16913000,23756000,38329000,87762000,49133000,49133000,,,,,,15381000,390985000,341852000,303223000,1421000,,35173000,23756000,56439,GRBK
2019-12-31,1647000,,-10018000,,-10018000,8682000,42000,-10287000,-10287000,,-42000,,,,0,143000,10430000,101000,269000,,-10018000,-10029000,56440,SNES
2018-12-31,2170000,,-11908000,,-11908000,9766000,56000,-11880000,-11880000,,-74000,,,,0,297000,12177000,241000,-28000,,-11908000,-12241000,56440,SNES
2017-12-31,2898000,,-12286000,,-12286000,9425000,7000,-12316000,-12316000,,-86000,,,,0,52000,12368000,45000,30000,,-12286000,-12286000,56440,SNES
2016-12-31,2487000,,-10795000,,-10795000,7347000,318000,-9516000,-9516000,,-87000,,,,0,318000,9834000,0,-1279000,,-10795000,-10954000,56440,SNES
2020-12-31,,,651160000,,503472000,2523740000,3497440000,0,681419000,292281000,,,,,147688000,3718136000,3036717000,220696000,-30259000,,503472000,476211000,56442,SF
2019-12-31,,,599138000,54999000.0,448396000,2221009000,3124691000,0,599138000,304544000,,,,,149152000,3316130000,2716992000,191439000,0,,449986000,431077000,56442,SF
2018-12-31,,,534362000,30000000.0,393968000,1993146000,2842660000,0,534362000,315152000,,,,,140394000,3024881000,2490519000,182221000,0,,393968000,384593000,56442,SF
2017-12-31,,,269536000,30000000.0,182871000,2181637000,2748807000,0,269536000,297634000,,,,,86665000,2926432000,2656896000,177625000,-34528000,,182871000,173496000,56442,SF
2020-12-31,,,1455000000,910000000,1081000000,1894000000,3850000000,1894000000,1894000000,,-189000000,,,,384000000,19456000000,17562000000,15606000000,-439000000,,1071000000,1081000000,56443,WHR
2019-12-31,,,1552000000,923000000,1184000000,2147000000,3533000000,1317000000,1317000000,,-187000000,,,,354000000,20419000000,19102000000,16886000000,235000000,,1198000000,1184000000,56443,WHR
2018-12-31,,,-21000000,914000000,-183000000,2201000000,3537000000,1261000000,1261000000,,-192000000,,,,138000000,21037000000,19776000000,17500000000,-1282000000,,-159000000,-183000000,56443,WHR
2017-12-31,,,887000000,930000000,350000000,2135000000,3602000000,1388000000,1388000000,,-162000000,,,,550000000,21253000000,19865000000,17651000000,-501000000,,337000000,350000000,56443,WHR
2019-12-31,,,99765000,952478000,50196000,69432000,807430000,127940000,127940000,59240000,-28356000,,,,14760000,936142000,808202000,128712000,-28175000,,85005000,47433000,56444,MGY
2018-12-31,,,225367200,1031186000,93828000,69122400,931248000,332556000,332556000,59611200,-29889600,,,,27492000,1039723200,707167200,108475200,-107188800,,197875200,93828000,56444,MGY
2017-12-31,,,2830308,1031186000,1671485,980828,0,-1147311,-1147311,166484,-29889600,,,,1158822,0,1147311,0,3977619,,1671485,1671485,56444,MGY
2019-12-31,,,167472,,167472,,0,0,,,,,,,0,0,0,0,167472,,167472,167472,56445,AGBA
2018-12-31,,,-10064,,-10064,,0,0,,,,,,,0,0,0,0,-10064,,-10064,-10064,56445,AGBA
2020-12-31,,,354245000,67925000,224402000,13883000,335006000,321123000,321123000,,-18331000,,,,60431000,336794000,15671000,1788000,33122000,,293814000,224402000,56448,INVA
2019-12-31,,,232895000,28621000,157288000,14656000,261016000,246360000,246360000,,-18660000,,,,41902000,261016000,14656000,0,-13465000,,190993000,157288000,56448,INVA
2018-12-31,,,210255000,5469000,395056000,18753000,261004000,242251000,242251000,,-23954000,,,,-196073000,261004000,18753000,0,-31996000,,406328000,395056000,56448,INVA
2017-12-31,,,134276000,152000,134143000,32258000,215862000,183604000,183604000,,-43601000,,,,4000,217217000,33613000,1355000,-49328000,,134272000,134143000,56448,INVA
2020-12-31,,,15224000,,12805000,22659000,45406000,0,15224000,7523000,,,,,2419000,45406000,30182000,0,0,,12805000,12805000,56449,UNB
2019-12-31,,,12478000,,10648000,20851000,39803000,0,12347000,6605000,,,,,1830000,39803000,27456000,0,131000,,10648000,10648000,56449,UNB
2018-12-31,,,8345000,,7072000,23069000,37370000,0,8093000,6208000,,,,,1273000,37370000,29277000,0,252000,,7072000,7072000,56449,UNB
2017-12-31,,,12052000,,8449000,18057000,35957000,0,12052000,5848000,,,,,3603000,35957000,23905000,0,-627000,,8449000,8449000,56449,UNB
2019-12-31,,,-60294195,206162035,-40032163,96959657,78730578,-48208884,-48208884,,-9067060,,,,-4990989,104603387,152812271,25872809,-12085311,,-55303206,-16289633,56453,RPAY
2018-12-31,,,10537443,206162035,10537443,29097302,55026648,15508346,15508346,,-6072837,,,,0,130012940,114504594,74986292,-4970903,,10537443,10537443,56453,RPAY
2017-12-31,,,9448244,206162035,9448244,14604261,36349785,14289086,14289086,,-5706232,,,,0,93951121,79662035,57601336,-4840842,,9448244,9448244,56453,RPAY
2016-12-31,,,-511707,206162035,-511707,23574850,29057195,1745781,1745781,,-2250421,,,,0,82295293,80549512,53238098,-2257488,,-511707,-511707,56453,RPAY
2019-12-31,,,201000000,262000000,226000000,531000000,1127000000,601000000,601000000,-17000000,-122000000,,,,-32000000,8620000000,8019000000,7493000000,-400000000,,233000000,226000000,56454,DAN
2018-12-31,,,518000000,197000000,427000000,514000000,1157000000,635000000,635000000,-17000000,-96000000,,,,78000000,8143000000,7508000000,6986000000,-117000000,,440000000,427000000,56454,DAN
2017-12-31,,,399000000,148000000,111000000,515000000,1080000000,554000000,554000000,-17000000,-102000000,,,,283000000,7209000000,6655000000,6129000000,-155000000,,116000000,105000000,56454,DAN
2016-12-31,,,229000000,85000000,640000000,397000000,835000000,430000000,430000000,-17000000,-113000000,,,,-424000000,5826000000,5396000000,4991000000,-201000000,,653000000,640000000,56454,DAN
2020-03-31,,,113291000,42619000,71680000,228202000,370466000,142264000,142264000,,-19854000,,,,35288000,1909979000,1767715000,1539513000,-28973000,,78003000,71680000,56455,UVV
2019-03-31,,,151322000,42791000,104121000,224286000,406591000,182305000,182305000,,-17510000,,,,41188000,2227153000,2044848000,1820562000,-30983000,,110134000,104121000,56455,UVV
2018-03-31,,,166677000,42873000,105662000,200461000,371948000,171487000,171487000,,-15621000,,,,50509000,2033947000,1862460000,1661999000,-4810000,,116168000,105662000,56455,UVV
2017-03-31,,,169238000,40089000,106304000,212881000,394679000,181798000,181798000,,-16284000,,,,56732000,2071218000,1889420000,1676539000,-12560000,,112506000,20890000,56455,UVV
2020-12-31,,,-782000000,,-1232000000,3464000000,11778000000,3604000000,3604000000,,-1668000000,,,,450000000,20712000000,17108000000,8934000000,-4386000000,,-1232000000,-1232000000,56456,LUMN
2019-12-31,,,-4766000000,,-5269000000,3550000000,12324000000,3945000000,3945000000,,-2021000000,,,,503000000,22401000000,18456000000,10077000000,-8711000000,,-5269000000,-5269000000,56456,LUMN
2018-12-31,,,-1563000000,,-1733000000,3560000000,12581000000,3901000000,3901000000,,-2177000000,,,,170000000,23443000000,19542000000,10862000000,-5464000000,,-1733000000,-1733000000,56456,LUMN
2017-12-31,,,540000000,,1389000000,3844000000,10003000000,2223000000,2223000000,,-1481000000,,,,-849000000,17656000000,15433000000,7653000000,-1683000000,,1389000000,1389000000,56456,LUMN
2019-12-31,15470000,,-19457000,,-19457000,4943000,399000,-20014000,-20014000,,-124000,,,,0,562000,20576000,163000,557000,,-19457000,-19457000,56458,VBLT
2018-12-31,15940000,,-20458000,,-20458000,5617000,350000,-21207000,-21207000,,-124000,,,,0,585000,21792000,235000,749000,,-20458000,-20458000,56458,VBLT
2017-12-31,17770000,,-10138000,,-10138000,6409000,13524000,-10655000,-10655000,,-124000,,,,0,13864000,24519000,340000,517000,,-10138000,-10138000,56458,VBLT
2016-12-31,12447000,,-16002000,,-16002000,3828000,0,-16275000,-16275000,,-124000,,,,0,0,16275000,0,273000,,-16002000,-16002000,56458,VBLT
2020-12-31,,,47459000,72000,32928000,51959000,106894000,0,49146000,5789000,,,,,14531000,106894000,57748000,0,-1687000,,32928000,32928000,56463,RBB
2019-12-31,,,55321000,72000,39209000,50755000,112794000,0,57029000,5010000,,,,,16112000,112794000,55765000,0,-1708000,,39209000,39209000,56463,RBB
2018-12-31,,,46206000,72000,36105000,33878000,86843000,0,48839000,4126000,,,,,10101000,86843000,38004000,0,-2633000,,36105000,36105000,56463,RBB
2017-12-31,,,46797000,72000,25528000,23230000,74420000,0,47661000,3529000,,,,,21269000,74420000,26759000,0,-864000,,25528000,25528000,56463,RBB
2020-12-31,,,94826000,,74327000,315641000,432776000,0,108325000,8810000,,,,,20499000,432776000,324451000,0,-13499000,,74327000,67815000,56465,OFG
2019-12-31,,,75250000,,53841000,149286000,308186000,0,113803000,45097000,,,,,21409000,308186000,194383000,0,-38553000,,53841000,47329000,56465,OFG
2018-12-31,,,132800000,,84410000,142114000,334881000,0,147601000,45166000,,,,,48390000,334881000,187280000,0,-14801000,,84410000,72386000,56465,OFG
2017-12-31,,,68089000,,52646000,145264000,302200000,0,118418000,38518000,,,,,15443000,302200000,183782000,0,-50329000,,52646000,38784000,56465,OFG
2019-12-31,,,378117000,,378117000,52648000,423365000,0,378117000,-7400000,,,,,0,467827000,89710000,44462000,0,,378117000,362030000,56466,MFA
2018-12-31,,,301801000,,301801000,46076000,340177000,0,301801000,-7700000,,,,,0,373764000,71963000,33587000,0,,301801000,285858000,56466,MFA
2017-12-31,,,322393000,,322393000,49633000,372026000,0,322393000,-7700000,,,,,0,394294000,71901000,22268000,0,,322393000,306502000,56466,MFA
2016-12-31,,,312668000,,312668000,45612000,362578000,0,312668000,4298000,,,,,0,376950000,64282000,14372000,0,,312668000,296040000,56466,MFA
2019-12-31,,,-144123000,128453000,-147413000,137947000,309450000,47277000,47277000,,-73886000,,,,6164000,1037933000,990656000,728483000,-191400000,-10213000,-150287000,-147413000,56470,TTI
2018-12-31,,,-36426000,139349000,-61617000,132446000,280844000,33473000,33473000,,-72066000,,,,6299000,998775000,965302000,717931000,-69899000,-41515000,-42725000,-61617000,56470,TTI
2017-12-31,,,-44043000,144481000,-39048000,115414000,224967000,5500000,5500000,,-58027000,,,,751000,723098000,717598000,498131000,-49543000,-17389000,-44794000,-39048000,56470,TTI
2016-12-31,,,-223220000,166943000,-161462000,108422000,195080000,-30489000,-30489000,,-59984000,,,,2156000,617391000,647880000,422311000,-192731000,-14017000,-225376000,-161462000,56470,TTI
2020-06-30,,,-5671099,,-5671099,2455918,0,-6490294,-6490294,,-157271,,,,0,0,6490294,0,819195,,-5671099,-5671099,56474,PLL
2019-06-30,,,-9822626,,-9822626,2639572,0,-10185093,-10185093,,-157271,,,,0,0,10185093,0,362467,,-9822626,-9822626,56474,PLL
2018-06-30,,,-9957817,,-9957817,2368515,0,-9562185,-9562185,,-157271,,,,0,0,9562185,0,-395632,,-9957817,-9957817,56474,PLL
2017-06-30,,,-2639428,,-2639428,677926,0,-2672745,-2672745,,-157271,,,,0,0,2672745,0,33317,,-2639428,-2639428,56474,PLL
2019-12-31,23794000,,-120199000,,-120199000,91523000,2422000,-112895000,-112895000,,-4327000,,,,0,87782000,200677000,85360000,-7304000,,-120199000,-120199000,56475,VRAY
2018-12-31,16520000,,-76396000,,-76396000,65175000,6603000,-75092000,-75092000,,-7701000,,,,0,80962000,156054000,74359000,-1304000,,-76396000,-79124000,56475,VRAY
2017-12-31,14709000,,-72176000,,-72176000,39787000,6332000,-48164000,-48164000,,-7247000,,,,0,34042000,82206000,27710000,-24012000,,-72176000,-72176000,56475,VRAY
2016-12-31,11442000,,-50636000,,-50636000,29104000,-3629000,-44175000,-44175000,,-5951000,,,,0,22237000,66412000,25866000,-6461000,,-50636000,-50636000,56475,VRAY
2020-12-31,,,34072000,,28223000,12168000,47587000,33869000,33869000,,-248000,,,,5849000,160704000,126835000,113117000,203000,,28223000,28223000,56478,USLM
2019-12-31,,,30900000,,26056000,11500000,59070000,29246000,29246000,,-244000,,,,4844000,158277000,129031000,99207000,1654000,,26056000,26056000,56478,USLM
2018-12-31,,,21568000,,19685000,10484000,47877000,20002000,20002000,,-243000,,,,1883000,144435000,124433000,96558000,1566000,,19685000,19685000,56478,USLM
2017-12-31,,,24943000,,27148000,10153000,50720000,24227000,24227000,10153000.0,-241000,,,,-2205000,144844000,120617000,94124000,716000,,27148000,27148000,56478,USLM
2020-12-31,124273000,,106886000,35545000,71679000,430645000,688018000,133100000,133100000,,-1939000,,,,32197000,2072617000,1939517000,1384599000,-26214000,,74689000,71679000,56479,CRTO
2019-12-31,150564000,,135465000,30721000,90745000,516876000,829036000,161596000,161596000,,-1756000,,,,39496000,2261516000,2099920000,1432480000,-26131000,,95969000,90745000,56479,CRTO
2018-12-31,160418000,,142023000,24221000,88644000,525026000,834236000,148792000,148792000,,-1796000,,,,46144000,2300314000,2151522000,1466078000,-6769000,,95879000,88644000,56479,CRTO
2017-12-31,158639000,,128310000,16173000,91214000,518147000,821992000,145206000,145206000,,-2459000,,,,31651000,2296692000,2151486000,1474700000,-16896000,,96659000,91214000,56479,CRTO
2019-12-31,,,-12066000,18935000,-32823000,87833000,97455000,-814000,-814000,,-1925000,,,,10752000,205485000,206299000,108030000,-11252000,,-22818000,-32823000,56483,NCSM
2018-12-31,,,-208283000,14930000,-190317000,82813000,118657000,18007000,18007000,,-1963000,,,,-23052000,226963000,208956000,108306000,-226290000,,-185231000,-190317000,56483,NCSM
2017-12-31,,,1962000,12144000,2102000,63707000,102842000,11484000,11484000,,-2884000,,,,670000,201634000,190150000,98792000,-9522000,,1292000,2047000,56483,NCSM
2016-12-31,,,-26745000,12144000,-17927000,36061000,44646000,-16982000,-16982000,,-6286000,,,,-8818000,98479000,115461000,53833000,-9763000,,-17927000,-17927000,56483,NCSM
2020-12-31,,,995920000,3388319000,762405000,279257000,1324557000,1045300000,1045300000,,-52753000,,,,2862000,5146843000,4101543000,3822286000,-49380000,,993058000,722514000,56486,RNR
2019-12-31,,,967482000,3071308000,748798000,267155000,1348239000,1081084000,1081084000,,-60964000,,,,17215000,4207492000,3126408000,2859253000,-113602000,,950267000,703497000,56486,RNR
2018-12-31,,,262615000,2051700000,227364000,212250000,534362000,322112000,322112000,,-47069000,,,,-6302000,2087369000,1765257000,1553007000,-59497000,,268917000,195155000,56486,RNR
2017-12-31,,,-328184000,1296506000,-222389000,179350000,-115269000,-294619000,-294619000,,-44193000,,,,26487000,2093051000,2387670000,2208320000,-33565000,,-354671000,-245227000,56486,RNR
2020-10-03,,,-9003000,626000,-4688000,10160000,21541000,-7295000,-7295000,14757000,-1421000,,,,-4385000,106490000,113785000,84949000,-1708000,,-4618000,-4688000,56487,ARKR
2019-09-28,,,1870000,843000,2676000,12011000,44831000,7255000,7255000,20378000,-1437000,,,,-591000,162354000,155099000,117523000,-5385000,,2461000,2676000,56487,ARKR
2018-09-29,,,3926000,1440000,4655000,11214000,42757000,5032000,5032000,21437000,-1163000,,,,-1147000,159990000,154958000,117233000,-1106000,,5073000,4655000,56487,ARKR
2017-09-30,,,6425000,1996000,4039000,11504000,42106000,5774000,5774000,20645000,-753000,,,,1668000,153877000,148103000,111771000,651000,,4757000,4039000,56487,ARKR
2020-12-31,,,376180000,3085000,291898000,276263000,788985000,0,375572000,137150000,,,,,84314000,788985000,413413000,0,608000,,291866000,291898000,56488,OZK
2019-12-31,,,564337000,3117000,425906000,259111000,962273000,0,561143000,142019000,,,,,138429000,962273000,401130000,0,3194000,,425908000,425906000,56488,OZK
2018-12-31,,,554058000,3035000,417106000,238397000,931599000,0,555762000,137440000,,,,,136977000,931599000,375837000,0,-1704000,,417081000,417106000,56488,OZK
2017-12-31,,,580523000,3060000,421891000,211381000,912764000,0,580092000,121291000,,,,,158586000,912764000,332672000,0,-12149000,,421937000,421891000,56488,OZK
2019-12-31,3956317,,-8297659,,-8307965,5519922,221375,-9254864,-9254864,,,,,,10306,1681076,10935940,1459701,957205,,-8307965,-8307965,56493,DYAI
2018-12-31,3317164,,-6697913,,-5691756,4354676,268173,-7403667,-7403667,,,,,,-1006157,1295451,8699118,1027278,705754,,-5691756,-5691756,56493,DYAI
2017-12-31,2203095,,-2202513,,-2135819,5030354,78223,-7375941,-7375941,220715.0,,,,,-66694,758420,8134361,680197,5173428,,-2135819,-2135819,56493,DYAI
2016-12-31,885602,,-3370666,,-3608739,4562115,76724,-5807909,-5807909,436916.0,,,,,238073,592886,6400795,516162,2437243,,-3608739,-3608739,56493,DYAI
2019-12-31,,,-2010000,,-10366000,3270000,4602000,-1812000,-1812000,,-198000,,,,4999000,10045000,11857000,5443000,-198000,-3357000,-7009000,-10366000,56494,MLP
2018-12-31,,,-4652000,,498000,3410000,1944000,-4496000,-4496000,,-156000,,,,-4999000,8860000,13356000,6916000,-156000,151000,347000,498000,56494,MLP
2017-12-31,,,10900000,,10900000,3386000,17551000,11090000,11090000,,-190000,,,,0,24582000,13492000,7031000,-190000,151000,10900000,10900000,56494,MLP
2016-12-31,,,21814000,,21814000,7223000,34161000,23470000,23470000,,-1656000,,,,0,47364000,23894000,13203000,-1656000,151000,21814000,21814000,56494,MLP
2020-10-31,,,-7521970,,-7521970,10783958,72552074,61768116,61768116,,-6946717,,,,0,72552074,10783958,0,-69290086,,-7521970,-7521970,56495,NMZ
2019-10-31,,,126233334,,126233334,9202227,69075321,59873094,59873094,,-10136888,,,,0,69075321,9202227,0,66360240,,126233334,126233334,56495,NMZ
2018-10-31,,,2809128,,2809128,8890294,68970272,60079978,60079978,,-7703196,,,,0,68970272,8890294,0,-57270850,,2809128,2809128,56495,NMZ
2017-10-31,,,37552453,,37552453,8373087,60754774,52381687,52381687,,-3838765,,,,0,60754774,8373087,0,-14829234,,37552453,37552453,56495,NMZ
2019-12-31,,,-24576000,,-24609000,8276000,-17674000,-25950000,-25950000,,,,,,33000,22904000,48854000,40578000,1374000,,-24609000,-24609000,56497,SLGL
2018-12-31,,,-32203000,,-32203000,5504000,-28017000,-33521000,-33521000,,,,,,0,129000,33650000,28146000,1318000,,-32203000,-32203000,56497,SLGL
2017-12-31,,,-31568000,,-31568000,6002000,-25631000,-31633000,-31633000,,,,,,0,174000,31807000,25805000,65000,,-31568000,-31568000,56497,SLGL
2016-12-31,17023000.0,,-20771000,,-20771000,3733000,0,-20756000,-20756000,,-15000.0,,,,0,0,20756000,0,-15000,,-20771000,-20771000,56497,SLGL
2019-12-31,,,1635046,,1635046,202747,1837793,1635046,1635046,,,,,,0,1837793,202747,0,0,,1635046,1635046,56498,MTR
2018-12-31,,,2138132,,2138132,217138,2355270,2138132,2138132,,,,,,0,2355270,217138,0,0,,2138132,2138132,56498,MTR
2017-12-31,,,2938219,,2938219,100795,3039014,2938219,2938219,,,,,,0,3039014,100795,0,0,,2938219,2938219,56498,MTR
2016-12-31,,,1213912,,1213912,152778,1366690,1213912,1213912,,,,,,0,1366690,152778,0,0,,1213912,1213912,56498,MTR
2019-12-31,3714000,,-10012000,,-9323000,6207000,0,-9921000,-9921000,,-92000,,,,-689000,0,9921000,0,-91000,,-9323000,-9323000,56499,TLSA
2018-12-31,5510000,,-9879000,,-7934000,4357000,0,-9867000,-9867000,,-12000,,,,-1945000,0,9867000,0,-12000,,-7934000,-7934000,56499,TLSA
2017-12-31,6015000,,-10505000,,-8593000,4478000,0,-10493000,-10493000,,-12000,,,,-1912000,0,10493000,0,-12000,,-8593000,-8593000,56499,TLSA
2016-12-31,2956000,,-7297000,,-7208000,4332000,0,-7288000,-7288000,,-9000,,,,-89000,0,7288000,0,-9000,,-7208000,-7208000,56499,TLSA
2020-06-30,,,57252000,,44965000,90544000,164876000,0,60874000,13458000,,,,,12287000,164876000,104002000,0,-3622000,,44965000,44965000,56500,KRNY
2019-06-30,,,56069000,,42142000,92617000,165312000,0,58919000,13776000,,,,,13927000,165312000,106393000,0,-2850000,,42142000,42142000,56500,KRNY
2018-06-30,,,34000000,,19596000,78176000,131850000,0,42259000,11415000,,,,,14404000,131850000,89591000,0,-8259000,,19596000,19596000,56500,KRNY
2017-06-30,,,27423000,,18603000,68597000,108541000,0,28757000,11187000,,,,,8820000,108541000,79784000,0,-1334000,,18603000,18603000,56500,KRNY
2020-12-31,,,645034000,,528904000,375014000,1142267000,0,676247000,91006000,,,,,116130000,1142267000,466020000,0,-31213000,,528904000,528904000,56501,PB
2019-12-31,,,419208000,,332552000,276932000,815750000,0,480688000,58130000,,,,,86656000,815750000,335062000,0,-61480000,,332552000,332552000,56501,PB
2018-12-31,,,403035000,,321812000,255512000,729255000,0,422977000,50766000,,,,,81223000,729255000,306278000,0,-19955000,,321812000,321812000,56501,PB
2017-12-31,,,406070000,,272165000,240550000,719171000,0,430594000,48027000,,,,,133905000,719171000,288577000,0,-21254000,,272165000,272165000,56501,PB
2020-03-31,,,2312000,,1872000,16520000,18148000,1519000,1519000,98000,-12000,,,,440000,90604000,89085000,72456000,793000,,1872000,1872000,56503,GHM
2019-03-31,,,-145000,,-308000,16818000,21909000,4854000,4854000,98000,-12000,,,,163000,91831000,86977000,69922000,-4999000,,-308000,-308000,56503,GHM
2018-03-31,,,-12854000,,-9844000,15055000,16975000,1684000,1684000,98000,-12000,,,,-3010000,77534000,75850000,60559000,-14538000,,-9844000,-9844000,56503,GHM
2017-03-31,,,7049000,,5023000,14630000,22157000,7293000,7293000,98000,-10000,,,,2026000,91769000,84476000,69612000,-244000,,5023000,5023000,56503,GHM
2020-10-31,,,3229782,,3229782,2886684,18421151,15534467,15534467,,-2809906,,,,0,18421151,2886684,0,-12304685,,3229782,3229782,56505,NBH
2019-10-31,,,29298115,,29298115,2990015,20000243,17010228,17010228,,-4558587,,,,0,20000243,2990015,0,12287887,,29298115,29298115,56505,NBH
2018-10-31,,,-3733000,,-3733000,2968000,20524000,17556000,17556000,,-4662000,,,,0,20524000,2968000,0,-21289000,,-3733000,-3733000,56505,NBH
2017-10-31,,,4877000,,4877000,2993000,20537000,17544000,17544000,,-3664000,,,,0,20537000,2993000,0,-12667000,,4877000,4877000,56505,NBH
2019-12-31,4100000,,-126100000,,-110000000,114100000,25400000,-92800000,-92800000,,-15700000,,,,-16100000,1208800000,1301600000,1183400000,-33300000,,-110000000,-110000000,56507,TMST
2018-12-31,8100000,,-8200000,,-10000000,106700000,126600000,11800000,11800000,,-17100000,,,,1800000,1610600000,1598800000,1484000000,-20000000,,-10000000,-10000000,56507,TMST
2017-12-31,8000000,,-29800000,,-31300000,86800000,80300000,-14500000,-14500000,,-14800000,,,,1500000,1329200000,1343700000,1248900000,-15300000,,-31300000,-31300000,56507,TMST
2016-12-31,8000000,,-142000000,,-105500000,148500000,27900000,-128600000,-128600000,,-11400000,,,,-36500000,869500000,998100000,841600000,-13400000,,-105500000,-105500000,56507,TMST
2019-12-31,18816000,,-24544000,,-24522000,11415000,9894000,-20337000,-20337000,,-6514000,,,,-22000,12839000,33176000,2945000,-4207000,,-24522000,-24522000,56508,KMPH
2018-12-31,41286000,,-56592000,,-56466000,12981000,0,-54267000,-54267000,,-7087000,,,,-126000,0,54267000,0,-2325000,,-56466000,-56466000,56508,KMPH
2017-12-31,20137000,,-43429000,,-43386000,13229000,0,-33366000,-33366000,,-7337000,,,,-43000,0,33366000,0,-10063000,,-43386000,-43386000,56508,KMPH
2016-12-31,20078000,,-16531000,,-16516000,14394000,0,-34472000,-34472000,,-7127000,,,,-15000,0,34472000,0,17941000,,-16516000,-16516000,56508,KMPH
2019-12-31,,,58531964,,58191634,18995808,75648345,56652537,56652537,,-26100941,,,,340330,75648345,18995808,0,1879427,,58191634,58191634,56509,BBDC
2018-12-31,,,-115214308,,-114282136,28797016,80223625,51426609,51426609,,-23887331,,,,-932172,80223625,28797016,0,-166640917,,-114282136,-114282136,56509,BBDC
2017-12-31,,,-27779051,,-28650461,21505785,123004632,101498847,101498847,,-29261030,,,,871410,123004632,21505785,0,-129277898,,-28650461,-28650461,56509,BBDC
2016-12-31,,,34691677,,34256432,21082112,113679557,92597445,92597445,,-26720572,,,,435245,113679557,21082112,0,-57905768,,34256432,34256432,56509,BBDC
2020-10-31,,,-82148997,,-82148997,10997168,55248643,44251475,44251475,,-6415513,,,,0,55248643,10997168,0,-126400472,,-82148997,-82148997,56510,NMCO
2019-10-31,,,50348448,,50348448,10445316,39059064,28613748,28613748,,-544944,,,,0,39059064,10445316,0,21734700,,50348448,50348448,56510,NMCO
2019-07-18,,,50348448,,0,10445316,0,0,28613748,,-544944,,,,0,0,0,0,0,,50348448,50348448,56510,NMCO
2019-12-31,,,36272000,-1446000,34488000,570688000,720126000,138007000,138007000,,-89856000,,,,1094000,13081730000,12943723000,12361604000,-101735000,,35178000,27760000,56511,GLP
2018-12-31,,,108026000,-646000,102872000,488217000,650409000,151232000,151232000,,-89145000,,,,5623000,12672602000,12521370000,12022193000,-43206000,,102403000,100181000,56511,GLP
2017-12-31,,,33554000,387000,58358000,437983000,583052000,119669000,119669000,16194000.0,-86230000,,,,-23563000,8920552000,8800883000,8337500000,-86115000,,57117000,58358000,56511,GLP
2016-12-31,,,-238570000,2238000,-198076000,438220000,546490000,98881000,98881000,16194000.0,-86319000,,,,53000,8239639000,8140758000,7693149000,-337451000,,-238623000,-198076000,56511,GLP
2019-12-31,,,-375000,-66000,-455000,9430000,12085000,133000,133000,,-837000,,,,160000,68357000,68224000,56272000,-508000,,-535000,-455000,56512,AWX
2018-12-31,,,-3089000,14000,-1144000,9000000,12440000,563000,563000,,-675000,,,,167000,62234000,61671000,49794000,-3652000,,-3256000,-1144000,56512,AWX
2017-12-31,,,-694000,2126000,-307000,8451000,11176000,-271000,-271000,,-699000,,,,122000,55848000,56119000,44672000,-423000,,-816000,-307000,56512,AWX
2016-12-31,,,-284000,2635000,-69000,8203000,10833000,-186000,-186000,,-379000,,,,125000,61352000,61538000,50519000,-98000,,-409000,-69000,56512,AWX
2020-09-30,9877555,,-24265115,,-24265115,7533722,0,-17411277,-17411277,,,,,,0,0,17411277,0,-6853838,,-24265115,-65604049,56513,SONN
2019-09-30,2199297,,-4871211,,-4871211,2509041,0,-4708338,-4708338,,-162873.0,,,,0,0,4708338,0,-162873,,-4871211,-4871211,56513,SONN
2018-09-30,154717,,-900270,,-900270,363877,0,-518594,-518594,,-381676.0,,,,0,0,518594,0,-381676,,-900270,-900270,56513,SONN
2020-12-31,,,218505000,7294000,154905000,613195000,1228728000,221129000,221129000,375188000,-2624000,,,,48833000,2288432000,2067303000,1059704000,-2624000,,169672000,154905000,56514,STC
2019-12-31,,,116967000,6453000,78615000,603189000,1056356000,143346000,143346000,287295000,-4341000,,,,26695000,1940008000,1796662000,883652000,-26381000,,90272000,78615000,56514,STC
2018-12-31,,,72529000,6312000,47523000,602280000,1009112000,92016000,92016000,289884000,-3875000,,,,13507000,1907672000,1815656000,898560000,-19487000,,59022000,47523000,56514,STC
2017-12-31,,,75067000,6599000,48659000,605288000,1022092000,86111000,86111000,304815000,-3458000,,,,14921000,1955724000,1869613000,933632000,-11044000,,60146000,48659000,56514,STC
2019-12-31,,,-2020000,,-2047000,13175000,12323000,-1212000,-1212000,,-249000,,,,27000,19806000,21018000,7483000,-808000,,-2047000,-2063000,56516,NTN
2018-12-31,,,-323000,,-259000,14463000,15265000,487000,487000,,-389000,,,,-64000,23335000,22848000,8070000,-810000,,-259000,-275000,56516,NTN
2017-12-31,,,-1011000,,-1077000,15582000,14519000,-1397000,-1397000,,-498000,,,,66000,21274000,22671000,6755000,386000,,-1077000,-1093000,56516,NTN
2016-12-31,,,-2885000,,-2923000,16458000,14602000,-2278000,-2278000,,-576000,,,,38000,22312000,24590000,7710000,-607000,,-2923000,-2923000,56516,NTN
2019-12-31,4969000,,2066000,,4955000,9306000,19940000,5665000,5665000,,-925000,,,,0,31789000,26124000,11849000,-3599000,2889000,2066000,4955000,56517,MDWD
2018-12-31,4072000,,-5665000,,-1057000,7987000,1313000,-10746000,-10746000,,-892000,,,,0,3401000,14147000,2088000,5081000,4608000,-5665000,-1057000,56517,MDWD
2017-12-31,5462000,,-14533000,,-22149000,9143000,918000,-13687000,-13687000,,-827000,,,,0,2496000,16183000,1578000,-846000,-7616000,-14533000,-22149000,56517,MDWD
2016-12-31,7068000,,-18885000,,-18885000,12487000,-600000,-20155000,-20155000,,-847000,,,,0,1558000,21713000,2158000,1270000,-7616000,-18885000,-18885000,56517,MDWD
2019-12-31,,,20938000,16112000,16353000,117516000,176483000,33198000,33198000,,-12288000,,,,2190000,343091000,309893000,166608000,-12260000,,18748000,13699000,56518,LIND
2018-12-31,,,12168000,6502000,11352000,109885000,155991000,25338000,25338000,,-10830000,,,,616000,309734000,284396000,153743000,-13170000,,11552000,11352000,56518,LIND
2017-12-31,,,2473000,6302000,-8661000,101474000,130978000,12153000,12153000,,-9736000,,,,10002000,266504000,254351000,135526000,-9680000,,-7529000,-8661000,56518,LIND
2016-12-31,,,1859000,5170000,4864000,90025000,123369000,19924000,19924000,,-10146000,,,,-3200000,242346000,222422000,118977000,-18065000,,5059000,4864000,56518,LIND
2019-12-31,3045000,,10439000,200000,6060000,168621000,239097000,28898000,28898000,,-13698000,,,,4359000,748586000,719688000,509489000,-18459000,,6080000,6060000,56519,MG
2018-12-31,3310000,,14271000,177000,6836000,165702000,230330000,26905000,26905000,,-7950000,,,,7426000,742354000,715449000,512024000,-12634000,,6845000,6836000,56519,MG
2017-12-31,2272000,,-226000,173000,-2175000,151825000,208732000,23252000,23252000,,-4386000,,,,1942000,700970000,677718000,492238000,-23478000,,-2168000,-2175000,56519,MG
2016-12-31,2703429,,26538862,162000,16402288,156099455,222622323,30906862,30906862,,-3517715,,,,10062859,692847544,661940682,470225221,-4368001,,16476003,16402288,56519,MG
2020-12-31,,,18439000,,14944000,39979000,65111000,0,22024000,3108000,,,,,3495000,65111000,43087000,0,-3585000,,14944000,14944000,56520,SBFG
2019-12-31,,,14632000,,11973000,34440000,53136000,0,15726000,2970000,,,,,2659000,53136000,37410000,0,-1094000,,11973000,11006000,56520,SBFG
2018-12-31,,,14444000,,11638000,32142000,49352000,0,14505000,2705000,,,,,2806000,49352000,34847000,0,-61000,,11638000,10648000,56520,SBFG
2017-12-31,,,13625000,,11065000,29445000,45126000,0,13548000,2133000,,,,,2560000,45126000,31578000,0,77000,,11065000,10077000,56520,SBFG
2020-12-31,122847000,,85356000,,58711000,198279000,454936000,110884000,110884000,,-18483000,,,,26645000,990533000,879649000,535597000,-25528000,,58711000,58711000,56521,CSGS
2019-12-31,127994000,,105723000,,82770000,191329000,471688000,130943000,130943000,,-20567000,,,,22953000,996810000,865867000,525122000,-25220000,,82770000,82770000,56521,CSGS
2018-12-31,124034000,,86987000,,66130000,169308000,425239000,113593000,113593000,,-20331000,,,,20857000,875059000,761466000,449820000,-26606000,,66130000,66130000,56521,CSGS
2017-12-31,113215000,,87710000,,61364000,153695000,394771000,114481000,114481000,,-19584000,,,,26346000,789582000,675101000,394811000,-26771000,,61364000,61364000,56521,CSGS
2019-12-31,,,-394611000,,-395924000,385541000,786696000,-142285000,-142285000,,-260014000,,,,1313000,1155981000,1298266000,369285000,-252326000,,-395924000,-395924000,56525,VVNT
2018-12-31,,,-474246000,,-472635000,422643000,694628000,-242097000,-242097000,,-245214000,,,,-1611000,1050441000,1292538000,355813000,-232149000,,-472635000,-472635000,56525,VVNT
2017-12-31,,,-409121000,,-410199000,376733000,560507000,-145481000,-145481000,,-225772000,,,,1078000,881983000,1027464000,321476000,-263640000,,-410199000,-410199000,56525,VVNT
2016-12-31,,,-275890000,,-275957000,274589000,493042000,-70089000,-70089000,,-197965000,,,,67000,757907000,827996000,264865000,-205801000,,-275957000,-275957000,56525,VVNT
2020-12-31,,,564352000,26708000,447836000,1229045000,2018155000,0,564352000,224758000,,,,,133071000,2018155000,1453803000,0,0,38396000,431281000,447836000,56526,HTH
2019-12-31,,,300309000,25757000,225291000,1070352000,1638116000,0,307609000,260155000,,,,,67332000,1638116000,1330507000,0,-7300000,38396000,232977000,225291000,56526,HTH
2018-12-31,,,160777000,24423000,121441000,1005560000,1454026000,0,160777000,287689000,,,,,35050000,1454026000,1293249000,0,0,38396000,125727000,121441000,56526,HTH
2017-12-31,,,243286000,2726000,132544000,1051077000,1585784000,0,216529000,318178000,,,,,110142000,1585784000,1369255000,0,26757000,38396000,133144000,132544000,56526,HTH
2019-12-31,,,-92953000,,-93040000,304157000,215411000,-88746000,-88746000,,-3188000,,,,87000,439258000,528004000,223847000,-4207000,,-93040000,-93040000,56535,CSPR
2018-12-31,,,-92053000,,-92092000,249712000,157752000,-91960000,-91960000,,-3188000,,,,39000,357891000,449851000,200139000,-93000,,-92092000,-92092000,56535,CSPR
2017-12-31,,,-73369000,,-73392000,188132000,116871000,-71261000,-71261000,,-3188000,,,,23000,250909000,322170000,134038000,-2108000,,-73392000,-73392000,56535,CSPR
2020-09-30,,,-18500000,20400000,-60100000,458000000,858700000,328800000,328800000,,-77400000,,,,34900000,2517000000,2188200000,1658300000,-347300000,,-53400000,-60100000,56536,HI
2019-09-30,,,176700000,15700000,121400000,353800000,624400000,238100000,238100000,,-33800000,,,,50500000,1807300000,1569200000,1182900000,-61400000,,126200000,121400000,56536,HI
2018-09-30,,,146500000,13000000,76600000,372300000,642100000,239600000,239600000,,-21000000,,,,65300000,1770100000,1530500000,1128000000,-93100000,,81200000,76600000,56536,HI
2017-09-30,,,188300000,14500000,126200000,338700000,598200000,230300000,230300000,,-25200000,,,,59900000,1590200000,1359900000,992000000,-42000000,,128400000,126200000,56536,HI
2020-03-31,,,235647000,,183793000,804159000,1089638000,0,228720000,39468000,,,,,51854000,1158487000,929767000,68849000,6927000,,183793000,183793000,56537,HLI
2019-03-31,,,224320000,,159106000,753780000,1019143000,0,218230000,32658000,,,,,65214000,1083517000,865287000,64374000,6090000,,159106000,159106000,56537,HLI
2018-03-31,,,217836000,,172283000,682308000,917907000,0,213792000,13902000,,,,,45553000,962833000,749041000,44926000,4044000,,172283000,172283000,56537,HLI
2017-03-31,,,178487000,3838000.0,108343000,622411000,831134000,0,180006000,19864000,,,,,70144000,870469000,690463000,39335000,-1519000,,108343000,108343000,56537,HLI
2019-12-31,,,30538138,735128,28389277,15732403,33295161,0,14471341,,,,,,45987,37600719,23129378,4305558,16066797,,30492151,25423398,56538,ATAX
2018-12-31,,,40218432,344590,38853586,13250023,47518169,0,30711881,,,,,,-921097,52650465,21938584,5132296,9506551,,41139529,35755806,56538,ATAX
2017-12-31,,,36681997,437256,28451124,12769757,37358181,0,19375565,,,,,,6019146,45073478,25697913,7715297,17306432,,30662851,26293975,56538,ATAX
2016-12-31,,,28742684,107199,20792401,10837188,32423494,0,14723776,,,,,,4959000,41646602,26922826,9223108,14018908,,23783684,20176693,56538,ATAX
2019-12-31,,,5257032,,5257032,702643,5959675,5257032,5257032,,,,,,0,5959675,702643,0,0,,5257032,5257032,56539,CRT
2018-12-31,,,8558526,,8558526,595606,9154132,8558526,8558526,,,,,,0,9154132,595606,0,0,,8558526,8558526,56539,CRT
2017-12-31,,,6053790,,6053790,575144,6628934,6053790,6053790,,,,,,0,6628934,575144,0,0,,6053790,6053790,56539,CRT
2016-12-31,,,6364800,,6364800,1200015,7564815,6364800,6364800,,,,,,0,7564815,1200015,0,0,,6364800,6364800,56539,CRT
2019-12-31,114443000,,58896000,11210000,53531000,116815000,318764000,65372000,65372000,,-2974000,,,,5566000,502363000,436991000,183599000,-6476000,,53330000,53531000,56542,ALRM
2018-12-31,89204000,,11699000,11210000,21524000,105923000,274779000,57931000,57931000,,-2918000,,,,-9825000,420494000,362563000,145715000,-46232000,,21524000,21521000,56542,ALRM
2017-12-31,72755000,,32241000,11210000,29251000,85779000,222749000,46481000,46481000,,-2199000,,,,2990000,338937000,292456000,116188000,-14240000,,29251000,29238000,56542,ALRM
2016-12-31,44272000,,14381000,11210000,10154000,72651000,161726000,38313000,38313000,,-190000,,,,4227000,261106000,222793000,99380000,-23932000,,10154000,10142000,56542,ALRM
2019-12-31,,,-5487000,,-5021000,8376000,4761000,-3615000,-3615000,,,,,,-466000,21954000,25569000,17193000,-1872000,,-5021000,-5021000,56547,ISIG
2018-12-31,,,1883000,,1399000,10729000,12561000,1832000,1832000,,,,,,484000,33236000,31404000,20675000,51000,,1399000,1399000,56547,ISIG
2017-12-31,,,-909000,,-639000,9309000,8401000,-908000,-908000,,,,,,-270000,26430000,27338000,18029000,-1000,,-639000,-639000,56547,ISIG
2016-12-31,,,-2100000,,-1286000,9139000,7146000,-1993000,-1993000,,,,,,-814000,24912000,26905000,17766000,-107000,,-1286000,-1286000,56547,ISIG
2020-12-31,,,810000000,,696000000,785000000,1670000000,886000000,886000000,-1000000,-114000000,,,,114000000,9361000000,8475000000,7691000000,-76000000,,696000000,696000000,56548,HII
2019-12-31,,,683000000,,549000000,776000000,1531000000,755000000,755000000,-1000000,-70000000,,,,134000000,8899000000,8144000000,7368000000,-72000000,,549000000,549000000,56548,HII
2018-12-31,,,971000000,,836000000,797000000,1791000000,1008000000,1008000000,-14000000,-58000000,,,,135000000,8176000000,7168000000,6385000000,-37000000,,836000000,836000000,56548,HII
2017-12-31,,,772000000,,479000000,775000000,1628000000,853000000,853000000,-14000000,-94000000,,,,293000000,7441000000,6588000000,5813000000,-81000000,,479000000,479000000,56548,HII
2019-12-31,518800000,,154400000,,16800000,2499600000,4551900000,1533500000,1533500000,,-517300000,,,,137600000,11500500000,9967000000,6948600000,-1379100000,,16800000,16800000,56550,VTRS
2018-12-31,586300000,,298400000,,352500000,2397300000,4572000000,1588400000,1588400000,,-542300000,,,,-54100000,11433900000,9845500000,6861900000,-1290000000,,352500000,352500000,56550,VTRS
2017-12-31,665600000,,903000000,,696000000,2564000000,4976200000,1746600000,1746600000,,-534600000,,,,207000000,11907700000,10161100000,6931500000,-843600000,,696000000,696000000,56550,VTRS
2016-12-31,697800000,,121700000,1400000.0,480000000,2351400000,4998500000,1949300000,1949300000,,-454800000,,,,-358300000,11076900000,9127600000,6078400000,-1827600000,,480000000,480000000,56550,VTRS
2020-02-01,,,43207000,,35897000,263303000,316428000,37641000,37641000,,-29000,,,,7310000,825335000,787694000,508907000,5566000,,35897000,34617000,56551,CATO
2019-02-02,,,33051000,,30461000,260962000,307107000,29704000,29704000,,-96000,,,,2590000,829664000,799960000,522557000,3347000,,30461000,29599000,56551,CATO
2018-02-03,,,15973000,,8540000,258606000,296884000,18674000,18674000,,-114000,,,,7433000,849981000,831307000,553097000,-2701000,,8540000,8368000,56551,CATO
2017-01-28,,,49114000,,47212000,276058000,354535000,55810000,55810000,,-176000,,,,1902000,956569000,900759000,602034000,-6696000,,47212000,46256000,56551,CATO
2019-12-31,,,-132694000,,-132694000,34417000,-95180000,-129597000,-129597000,,-13612000,,,,0,18662000,148259000,113842000,-3097000,,-132694000,-132694000,56552,NVAX
2018-12-31,,,-184748000,,-184748000,34409000,-139509000,-173918000,-173918000,,-13612000,,,,0,34288000,208206000,173797000,-10830000,,-184748000,-184748000,56552,NVAX
2017-12-31,,,-183769000,,-183769000,34451000,-137259000,-171710000,-171710000,,-14072000,,,,0,31176000,202886000,168435000,-12059000,,-183769000,-183769000,56552,NVAX
2016-12-31,,,-279966000,,-279966000,46527000,-222586000,-269113000,-269113000,,-12965000,,,,0,15353000,284466000,237939000,-10853000,,-279966000,-279966000,56552,NVAX
2019-12-31,,,680000000,6000000,507000000,1154000000,2103000000,828000000,828000000,,-162000000,,,,191000000,4043000000,3215000000,1940000000,-148000000,18000000,489000000,507000000,56554,WYND
2018-12-31,,,396000000,5000000,672000000,1122000000,2018000000,758000000,758000000,,-170000000,,,,130000000,3931000000,3173000000,1913000000,-362000000,406000000,266000000,672000000,56554,WYND
2017-12-31,,,318000000,5000000,854000000,1126000000,1946000000,684000000,684000000,,-155000000,,,,-328000000,3806000000,3122000000,1860000000,-366000000,209000000,646000000,854000000,56554,WYND
2016-12-31,,,542000000,4000000,611000000,1067000000,1864000000,670000000,670000000,,-133000000,,,,190000000,3692000000,3022000000,1828000000,-128000000,260000000,352000000,611000000,56554,WYND
2019-12-31,28310000,,-61389000,,-61389000,37926000,3669000,-62567000,-62567000,,,,,,0,4256000,66823000,587000,1178000,,-61389000,-61389000,56555,KIN
2018-12-31,26399000,,-49690000,,-49690000,26499000,1642000,-51256000,-51256000,,,,,,0,1966000,53222000,324000,1566000,,-49690000,-49690000,56555,KIN
2017-12-31,17665000,,-30879000,,-30879000,13988000,0,-31653000,-31653000,,,,,,0,0,31653000,0,774000,,-30879000,-30879000,56555,KIN
2016-12-31,13861000,,-22499000,,-22499000,8308000,0,-22169000,-22169000,,,,,,0,0,22169000,0,-330000,,-22499000,-22499000,56555,KIN
2019-12-31,,,-16859000,,-16859000,16860000,1904000,-17858000,-17858000,1738000,-725000,,,,0,3584000,21442000,1680000,999000,,-16859000,-16859000,56556,SRAX
2018-12-31,,,8744000,,8744000,16562000,6724000,-11719000,-11719000,1113000,-7351000,,,,0,9881000,21600000,3157000,20463000,,8744000,8744000,56556,SRAX
2017-12-31,,,-13032117,,-13032117,17016789,14019821,-2996968,-2996968,1113000,-4128524,,,,0,23348714,26345682,9328893,-10035149,,-13032117,-13032117,56556,SRAX
2016-12-31,,,-4248233,,-4248233,16648705,12536052,-4112653,-4112653,1113000,-3210076,,,,0,35763047,39875700,23226995,-135580,,-4248233,-4248233,56556,SRAX
2020-09-30,,,201998000,,152302000,219554000,491314000,239498000,239498000,,-40062000,,,,49696000,1765421000,1525923000,1274107000,-37500000,,152302000,148946000,56560,ATKR
2019-09-30,,,184669000,,139051000,234110000,497200000,230214000,230214000,,-50473000,,,,45618000,1916538000,1686324000,1419338000,-45545000,,139051000,135325000,56560,ATKR
2018-09-30,,,166352000,,136645000,222458000,438084000,183522000,183522000,,-40694000,,,,29707000,1835139000,1651617000,1397055000,-17170000,,136645000,134189000,56560,ATKR
2017-09-30,,,126125000,,84639000,170973000,361270000,167890000,167890000,,-26598000,,,,41486000,1503934000,1336044000,1142664000,-41765000,,84639000,84398000,56560,ATKR
2020-12-31,,,6890000000,40000000,4467000000,1902000000,13488000000,11514000000,11514000000,,-1205000000,,,,2436000000,20841000000,9327000000,7353000000,-4624000000,,4454000000,4467000000,56562,MO
2019-12-31,,,766000000,135000000,-1293000000,1903000000,12713000000,10810000000,10810000000,,-1317000000,,,,2064000000,19796000000,8986000000,7083000000,-10044000000,,-1298000000,-1300000000,56562,MO
2018-12-31,,,9341000000,41000000,6963000000,2342000000,12176000000,9834000000,9834000000,,-679000000,,,,2374000000,19627000000,9793000000,7451000000,-493000000,,6967000000,6955000000,56562,MO
2017-12-31,,,9828000000,41000000,10222000000,2042000000,12003000000,9961000000,9961000000,,-728000000,,,,-399000000,19494000000,9533000000,7491000000,-133000000,,10227000000,10208000000,56562,MO
2020-12-31,,,1711000000,528000000,1207000000,,5615000000,2643000000,2643000000,-17000000,-730000000,,,,451000000,15341000000,12698000000,9726000000,-932000000,,1260000000,1207000000,56563,TU
2019-12-31,,,2244000000,111000000,1746000000,,5618000000,3070000000,3070000000,-24000000,-708000000,,,,468000000,14589000000,11519000000,8971000000,-826000000,,1776000000,1746000000,56563,TU
2018-12-31,,,2176000000,82000000,1600000000,,5131000000,2887000000,2887000000,-23000000,-625000000,,,,552000000,14095000000,11208000000,8964000000,-711000000,,1624000000,1600000000,56563,TU
2017-12-31,,,2168000000,42000000,1559000000,,4918000000,2781000000,2781000000,-32000000,-579000000,,,,590000000,13305000000,10524000000,8387000000,-613000000,,1578000000,1559000000,56563,TU
2020-06-30,,,401637000,135000,321480000,1429602000,2000986000,460696000,460696000,,-56059000,,,,80157000,5720042000,5259346000,3719056000,-59059000,,321480000,321480000,56564,CACI
2019-06-30,,,327909000,135000,265604000,1206144000,1682288000,390267000,390267000,,-49958000,,,,62305000,4986341000,4596074000,3304053000,-62358000,,265604000,265604000,56564,CACI
2018-06-30,,,298664000,135000,301171000,1076356000,1489252000,340700000,340700000,,-42036000,,,,-2507000,4467860000,4127160000,2978608000,-42036000,,301171000,301171000,56564,CACI
2017-06-30,,,248619000,135000,163671000,1050792000,1419813000,297261000,297261000,,-48642000,,,,84948000,4354617000,4057356000,2934804000,-48642000,,163671000,163671000,56564,CACI
2020-02-29,,,3922722,,3922722,278887,1294228,1015341,1015341,,,,,,0,1294228,278887,0,2907381,,3922722,3922722,56566,NYV
2019-02-28,,,1761807,,1761807,266490,1515328,1248838,1248838,,,,,,0,1515328,266490,0,512969,,1761807,1761807,56566,NYV
2018-02-28,,,801594,,801594,274702,1558660,1283958,1283958,,,,,,0,1558660,274702,0,-482364,,801594,801594,56566,NYV
2017-02-28,,,-2208391,,-2208391,307529,1721378,1413850,1413850,,,,,,0,1721378,307529,0,-3622241,,-2208391,-2208391,56566,NYV
2019-12-28,935938000,,478968000,,988979000,619179000,2069962000,502717000,502717000,,-18829000,,,,-510011000,2336319000,1833602000,266357000,-23749000,,988979000,988979000,56567,CDNS
2018-12-29,884816000,,376390000,,345777000,572475000,1879275000,407898000,407898000,,-23139000,,,,30613000,2138022000,1730124000,258747000,-31508000,,345777000,345777000,56567,CDNS
2017-12-30,804223000,,315046000,,204101000,552242000,1705642000,334461000,334461000,,-25664000,,,,110945000,1943032000,1608571000,237390000,-19415000,,204101000,204101000,56567,CDNS
2016-12-31,735340000,,237153000,,203086000,519200000,1559591000,286956000,286956000,,-23670000,,,,34067000,1816083000,1529127000,256492000,-49803000,,203086000,203086000,56567,CDNS
2019-12-31,,,-407000,,-386000,,13477000,1723000,1723000,11754000,-2130000,,,,-21000,198179000,196456000,184702000,-2130000,,-386000,-785000,56568,AAME
2018-12-31,,,-971000,,-704000,,13861000,1066000,1066000,12795000,-2037000,,,,-267000,185553000,184487000,171692000,-2037000,,-704000,-1103000,56568,AAME
2017-12-31,,,5356000,,4528000,,47167000,7079000,7079000,40088000,-1723000,,,,828000,181114000,174035000,133947000,-1723000,,4528000,4129000,56568,AAME
2016-12-31,,,3524000,,2636000,,46443000,5086000,5086000,41357000,-1562000,,,,888000,166077000,160991000,119634000,-1562000,,2636000,2237000,56568,AAME
2019-12-31,89921000,,-47995000,,-48134000,168680000,212879000,-45722000,-45722000,,-6366000,,,,139000,297891000,343613000,85012000,-2273000,,-48134000,-48134000,56570,WK
2018-12-31,81602000,,-49824000,,-50071000,137170000,178484000,-40288000,-40288000,,-1827000,,,,247000,244344000,284632000,65860000,-9536000,,-50071000,-50071000,56570,WK
2017-12-31,68172000,,-44365000,,-44426000,123755000,147624000,-44303000,-44303000,,-1845000,,,,61000,207869000,252172000,60245000,-62000,,-44426000,-44426000,56570,WK
2016-12-31,57438000,,-43953000,,-43977000,113161000,127021000,-43578000,-43578000,,-1875000,,,,24000,178646000,222224000,51625000,-375000,,-43977000,-43977000,56570,WK
2019-12-28,78617000,,45065000,,43493000,82542000,238422000,63705000,63705000,,-11731000,,,,1572000,404093000,340388000,165671000,-18640000,,43493000,43493000,56571,LSCC
2018-12-29,82449000,,-23969000,,-26322000,89654000,219439000,29646000,29646000,,-20600000,,,,2353000,398799000,369153000,179360000,-53615000,,-26322000,-26322000,56571,LSCC
2017-12-30,103357000,,-69713000,,-70562000,90718000,216579000,-8836000,-8836000,,-18807000,,,,849000,385961000,394797000,169382000,-60877000,,-70562000,-70562000,56571,LSCC
2016-12-31,117518000,,-44182000,,-54099000,98602000,246957000,-2738000,-2738000,,-20327000,,,,9917000,427054000,429792000,180097000,-41444000,,-54099000,-54099000,56571,LSCC
2020-09-30,8812810,,-17548085,,-17548085,8897875,0,-17710685,-17710685,,-15673,,,,0,0,17710685,0,162600,,-17548085,-17548085,56572,CTXR
2019-09-30,8596898,,-15562144,,-15562144,7001463,0,-15598361,-15598361,,-16443,,,,0,0,15598361,0,36217,,-15562144,-15562144,56572,CTXR
2018-09-30,6562925,,-12536638,,-12536638,7226218,0,-13789143,-13789143,,-15838,,,,0,0,13789143,0,1252505,,-12536638,-12536638,56572,CTXR
2017-09-30,2936252,,-10384953,,-10384953,7050059,0,-9986311,-9986311,,-850789,,,,0,0,9986311,0,-398642,,-10384953,-10384953,56572,CTXR
2020-12-31,,,57247000,,43502000,56516000,123395000,0,57816000,9063000,,,,,13745000,123395000,65579000,0,-569000,,43502000,43502000,56575,ALTA
2019-12-31,,,57827000,,44324000,50266000,118099000,0,58076000,9757000,,,,,13503000,118099000,60023000,0,-249000,,44324000,44324000,56575,ALTA
2018-12-31,,,52686000,,40632000,50715000,114682000,0,53937000,10030000,,,,,12054000,114682000,60745000,0,-1251000,,40632000,40632000,56575,ALTA
2017-12-31,,,36323000,,19846000,43398000,92282000,0,41679000,7205000,,,,,16477000,92282000,50603000,0,-5356000,,19846000,19846000,56575,ALTA
2020-12-31,99030000,,-85898000,,-94010000,223895000,248728000,-78090000,-78090000,3893000,-6113000,,,,8112000,292689000,370779000,43961000,-7808000,,-94010000,-94010000,56576,VRNS
2019-12-31,80602000,,-76376000,,-78764000,212018000,219281000,-75987000,-75987000,2648000,-389000,,,,2388000,254190000,330177000,34909000,-389000,,-78764000,-78764000,56576,VRNS
2018-12-31,69971000,,-28165000,,-28578000,201769000,242605000,-29135000,-29135000,2648000,-389000,,,,413000,270288000,299423000,27683000,970000,,-28578000,-28578000,56576,VRNS
2017-12-31,47369000,,-11057000,,-13844000,160726000,194676000,-13419000,-13419000,1158000,-389000,,,,2787000,215390000,228809000,20714000,2362000,,-13844000,-13844000,56576,VRNS
2019-12-31,4572000,,-9533000,,-9533000,7039000,-753000,-12364000,-12364000,,-427000,,,,0,140000,12504000,893000,2831000,,-9533000,-9533000,56579,AIM
2018-12-31,4737000,,-9827000,,-9827000,6201000,-517000,-11455000,-11455000,,-502000,,,,0,367000,11822000,884000,1628000,,-9827000,-9827000,56579,AIM
2017-12-31,4091000,,-8259000,,-8259000,6572000,-746000,-11409000,-11409000,,-139000,,,,0,437000,11846000,1183000,3150000,,-8259000,-8259000,56579,AIM
2016-12-31,4973000,,-7502000,,-7502000,6831000,-1016000,-12820000,-12820000,,-139000,,,,0,92000,12912000,1108000,5318000,,-7502000,-7502000,56579,AIM
2020-12-31,,,421882000,,306276000,1666041000,2012611000,345351000,345351000,,,,,,115606000,5109000000,4763649000,3096389000,76531000,,306276000,306276000,56581,RHI
2019-12-31,,,625515000,,454433000,1958295000,2525129000,565473000,565473000,,,,,,171082000,6074432000,5508959000,3549303000,60042000,,454433000,454433000,56581,RHI
2018-12-31,,,591602000,,434288000,1810601000,2411012000,598706000,598706000,,,,,,157314000,5800271000,5201565000,3389259000,-7104000,,434288000,434288000,56581,RHI
2017-12-31,,,517516000,,290584000,1646532000,2163812000,515717000,515717000,,,,,,226932000,5266789000,4751072000,3102977000,1799000,,290584000,290584000,56581,RHI
2020-12-31,,,232685000,1683000,232688000,27464000,320091000,88758000,88758000,,-54990000,,,,0,535024000,446266000,214933000,143927000,,232685000,232688000,56582,PDM
2019-12-31,,,229416000,1726000,229261000,34720000,321798000,104397000,104397000,,-61594000,,,,160000,533178000,428781000,211380000,125019000,,229256000,229261000,56582,PDM
2018-12-31,,,130194000,1772000,130296000,29713000,316629000,115665000,115665000,,-61023000,,,,-97000,525967000,410302000,209338000,14529000,,130291000,130296000,56582,PDM
2017-12-31,,,133562000,1822000,133564000,29319000,351732000,127758000,127758000,,-68124000,,,,13000,574173000,446415000,222441000,5804000,,133549000,133564000,56582,PDM
2019-12-31,,,-171600000,,-149100000,234000000,918600000,234600000,234600000,,-300400000,,,,-22500000,5471000000,5236400000,4552400000,-406200000,,-149100000,-149100000,56583,AMC
2018-12-31,,,123700000,,110100000,180100000,1027200000,309300000,309300000,,-300800000,,,,13600000,5460800000,5151500000,4433600000,-185600000,,110100000,110100000,56583,AMC
2017-12-31,,,-333100000,,-487200000,133400000,880400000,208400000,208400000,,-274000000,,,,154100000,5079200000,4870800000,4198800000,-541500000,,-487200000,-487200000,56583,AMC
2016-12-31,,,149700000,,111700000,83700000,630400000,278500000,278500000,,-121500000,,,,38000000,3235900000,2957400000,2605500000,-128800000,,111700000,111700000,56583,AMC
2019-12-31,,,76040000,,49380000,475486000,882350000,219148000,219148000,,-78293000,,,,9190000,1762235000,1543087000,879885000,-143108000,-17470000,66850000,49380000,56584,CLGX
2018-12-31,,,168142000,,121864000,440414000,866949000,234539000,234539000,,-75551000,,,,45691000,1788378000,1553839000,921429000,-66397000,-587000,122451000,121864000,56584,CLGX
2017-12-31,,,167706000,,152162000,455342000,876266000,243118000,243118000,,-63356000,,,,18172000,1851117000,1607999000,974851000,-75412000,2628000,149534000,152162000,56584,CLGX
2016-12-31,,,164470000,,106550000,451202000,908620000,287727000,287727000,,-63392000,,,,54524000,1952557000,1664830000,1043937000,-123257000,-3396000,109946000,106550000,56584,CLGX
2020-03-31,,,282751000000,60296000000,212416000000,1638393000000,2245153000000,0,345325000000,261435000000,,,,,51768000000,2245153000000,1899828000000,0,-62574000000,,230983000000,212416000000,56585,SMFG
2019-03-31,,,831892000000,494123000000,553807000000,1716657000000,2888035000000,0,890826000000,280552000000,,,,,184306000000,2888035000000,1997209000000,0,-58934000000,,647586000000,553807000000,56585,SMFG
2018-03-31,,,1118976000000,1232980000000,769720000000,1834651000000,3274127000000,0,1134399000000,305077000000,,,,,229378000000,3274127000000,2139728000000,0,-15423000000,,889598000000,769720000000,56585,SMFG
2017-03-31,,,880352000000,1505001000000,635799000000,1791728000000,2973691000000,0,932978000000,248985000000,,,,,139766000000,2973691000000,2040713000000,0,-52626000000,,740586000000,635799000000,56585,SMFG
2019-12-31,,,113456000,59304000,80586000,42293000,265650000,62731000,62731000,2532000,-46958000,,,,39771000,617823000,555092000,352173000,50725000,,73685000,80586000,56586,EGO
2018-12-31,,,-466129000,63414000,-361884000,57350000,173061000,-367414000,-367414000,2038000,-3599000,,,,-86498000,459016000,826430000,285955000,-98715000,,-379631000,-361884000,56586,EGO
2017-12-31,,,792000,79940000,-9935000,69243000,193336000,35463000,35463000,-21761000,-3199000,,,,19383000,391406000,355943000,198070000,-34671000,-2797000.0,-18591000,-9935000,56586,EGO
2016-12-31,,,48698000,88786000,-344151000,54012000,221918000,72451000,72451000,1795000,-9757000,,,,56205000,432727000,360276000,210809000,-23753000,-339369000.0,-7507000,-344151000,56586,EGO
2020-12-31,399400000,,775800000,,625200000,708600000,2093800000,985800000,985800000,,-245900000,,,,150600000,4667900000,3682100000,2574100000,-210000000,,625200000,625200000,56587,SSNC
2019-12-31,382200000,,531700000,,438500000,713100000,2025600000,930300000,930300000,,-409600000,,,,93200000,4632900000,3702600000,2607300000,-398600000,,438500000,438500000,56587,SSNC
2018-12-31,305500000,,125100000,,103200000,513800000,1408800000,589500000,589500000,,-280100000,,,,21900000,3421100000,2831600000,2012300000,-464400000,,103200000,103200000,56587,SSNC
2017-12-31,153300000,,282700000,,328900000,238100000,788900000,397500000,397500000,,-108600000,,,,-46200000,1675300000,1277800000,886400000,-114800000,,328900000,328900000,56587,SSNC
2020-10-03,,,-14080000,-524000,-10577000,65983000,83075000,17925000,17925000,-833000,-7005000,,,,-3260000,381035000,363110000,297960000,-32005000,,-10820000,-10577000,56589,DLA
2019-09-28,,,8345000,-281000,8242000,70220000,85152000,16295000,16295000,-1363000,-7550000,,,,477000,431730000,415435000,346578000,-7950000,,7868000,8242000,56589,DLA
2018-09-29,,,11690000,93000,1337000,66969000,82021000,15052000,15052000,-1363000,-5713000,,,,10460000,395450000,380398000,313429000,-3362000,,1230000,1337000,56589,DLA
2017-09-30,,,11168000,93000,10511000,67408000,80722000,13314000,13314000,-1363000,-5011000,,,,657000,385082000,371768000,304360000,-2146000,,10511000,10511000,56589,DLA
2020-06-30,,,-14516000,,-14516000,1587000,14723000,13136000,13136000,,-2501000,,,,0,14723000,1587000,0,-27652000,,-14516000,-14516000,56590,PGP
2019-06-30,,,7989000,,7989000,1631000,14859000,13228000,13228000,,-3308000,,,,0,14859000,1631000,0,-5239000,,7989000,7989000,56590,PGP
2018-06-30,,,9719000,,9719000,1765000,14547000,12782000,12782000,,-2161000,,,,0,14547000,1765000,0,-3063000,,9719000,9719000,56590,PGP
2017-06-30,,,34471000,,34471000,2076000,15793000,13717000,13717000,,915000,,,,0,15793000,2076000,0,20754000,,34471000,34471000,56590,PGP
2019-12-31,,,1123636000,204753000,857801000,74830000,3595583000,1231093000,1231093000,2255826000,-99957000,,,,233435000,9040716000,7809623000,5445133000,-107457000,,890201000,857801000,56593,Y
2018-12-31,,,39592000,169762000,39539000,15732000,1749396000,130316000,130316000,1579309000,-90724000,,,,-15062000,6887160000,6756844000,5137764000,-90724000,,54654000,39539000,56593,Y
2017-12-31,,,36690000,106530000,90133000,46998000,1153281000,119760000,119760000,967104000,-83070000,,,,-63802000,6424655000,6304895000,5271374000,-83070000,,100492000,90133000,56593,Y
2016-12-31,,,647805000,74720000,456921000,42960000,1556602000,729404000,729404000,765226000,-81599000,,,,187141000,6131019000,5401615000,4574417000,-81599000,,460664000,456921000,56593,Y
2020-12-31,,,102780000,,70457000,174105000,321308000,134370000,134370000,,-6233000,,,,30123000,1049497000,915127000,728189000,-31590000,,72657000,70457000,56595,WDR
2019-12-31,,,158383000,19205000.0,114992000,176498000,354860000,158533000,158533000,,-6195000,,,,41418000,1070315000,911782000,715455000,-150000,,116965000,114992000,56595,WDR
2018-12-31,,,238292000,11463000.0,183588000,191243000,440140000,223248000,223248000,,-6461000,,,,55480000,1160301000,937053000,720161000,15044000,,182812000,183588000,56595,WDR
2017-12-31,,,245577000,14509000.0,141279000,211349000,453604000,221272000,221272000,,-11279000,,,,101368000,1157144000,935872000,703540000,24305000,,144209000,141279000,56595,WDR
2017-12-31,,,-41260,,-41260,365215,0,-365215,-365215,,,,,,0,0,365215,0,323955,,-41260,-41260,56597,BCACU
2016-12-31,,,-7204,,-7204,7204,0,-7204,-7204,,,,,,0,0,7204,0,0,,-7204,-7204,56597,BCACU
2019-12-31,,,-69075000,662000,-58491000,59586000,160741000,-22903000,-22903000,290000,-27383000,,,,-10741000,527555000,550458000,366814000,-46172000,,-58334000,-60340000,56598,CVEO
2018-12-31,,,-113212000,662000,-82243000,59836000,135278000,-51194000,-51194000,790000,-26258000,,,,-31365000,466692000,517886000,331414000,-62018000,,-81847000,-131832000,56598,CVEO
2017-12-31,,,-118744000,117000,-105713000,61131000,125018000,-64067000,-64067000,1511000,-21439000,,,,-13490000,382276000,446343000,257258000,-54677000,,-105254000,-105713000,56598,CVEO
2016-12-31,,,-115932000,523000,-96388000,55297000,137580000,-49631000,-49631000,612000,-22667000,,,,-20105000,397230000,446861000,259650000,-66301000,,-95827000,-96388000,56598,CVEO
2019-12-31,,,28111000,222045000,18307000,427923000,517892000,88850000,88850000,,-59691000,,,,13051000,8170191000,8081341000,7652299000,-60739000,,15060000,18307000,56600,ANDE
2018-12-31,,,53156000,46442000,41484000,251372000,302005000,50633000,50633000,,-27848000,,,,11931000,3045382000,2994749000,2743377000,2523000,,41225000,41484000,56600,ANDE
2017-12-31,,,-20525000,7697000,42511000,286993000,318799000,31806000,31806000,,-21567000,,,,-63134000,3686345000,3654539000,3367546000,-52331000,,42609000,42510000,56600,ANDE
2016-12-31,,,21381000,16336000,11594000,316093000,345506000,29413000,29413000,,-21119000,,,,6911000,3924790000,3895377000,3579284000,-8032000,,14470000,11585000,56600,ANDE
2020-02-01,,,1981000000,-29000000,1659000000,22577000000,27846000000,2620000000,2620000000,,-603000000,,,,469000000,122286000000,119666000000,94440000000,-639000000,,1512000000,1640000000,56601,KR
2019-02-02,,,3978000000,-51000000,3110000000,22359000000,27501000000,2677000000,2677000000,,-620000000,,,,900000000,121852000000,119175000000,94351000000,1301000000,,3078000000,3076000000,56601,KR
2018-02-03,,,1484000000,-26000000,1907000000,23290000000,28176000000,2450000000,2450000000,,-601000000,,,,-405000000,123280000000,120830000000,95104000000,-966000000,,1889000000,1890000000,56601,KR
2017-01-28,,,2914000000,12000000,1975000000,20750000000,26552000000,3462000000,3462000000,,-522000000,,,,957000000,115337000000,111875000000,88785000000,-548000000,,1957000000,1959000000,56601,KR
2020-12-31,,,22702000,,18394000,,83862000,0,28667000,55195000,,,,,4308000,83862000,55195000,0,-5965000,,18394000,18394000,56603,ACNB
2019-12-31,,,29366000,,23721000,39150000.0,76987000,0,31795000,6042000,,,,,5645000,76987000,45192000,0,-2429000,,23721000,23721000,56603,ACNB
2018-12-31,,,26720000,,21748000,37463000.0,71371000,0,28230000,5678000,,,,,4972000,71371000,43141000,0,-1510000,,21748000,21748000,56603,ACNB
2017-12-31,,,16422000,,9788000,33112000.0,60501000,0,22424000,4965000,,,,,6634000,60501000,38077000,0,-6002000,,9788000,9788000,56603,ACNB
2019-12-31,320402000,,-563899000,9391000,-537929000,464054000,249191000,-535265000,-535265000,,-54946000,,,,-27010000,326552000,861817000,77361000,-28634000,,-536889000,-537929000,56605,GSUM
2018-12-31,533586000,,-537710000,8351000,-521325000,348465000,330380000,-551671000,-551671000,,-35215000,,,,-15165000,431247000,982918000,100867000,13961000,,-522545000,-521325000,56605,GSUM
2017-12-31,257921000,,-234849000,10003000,-238996000,336156000,374893000,-219184000,-219184000,,-5430000,,,,4275000,469533000,688717000,94640000,-15665000,,-239124000,-238996000,56605,GSUM
2016-12-31,160387000,,-83826000,331000,-98574000,227889000,308116000,-80160000,-80160000,,-614000,,,,14801000,363823000,443983000,55707000,-3666000,,-98627000,-128289000,56605,GSUM
2020-12-31,,,-1818000000,,-1307000000,101000000,-784000000,-1712000000,-1712000000,407000000,-87000000,,,,-511000000,3566000000,5278000000,4350000000,-106000000,,-1307000000,-1307000000,56609,ALK
2019-12-31,,,1016000000,,769000000,313000000,2491000000,1071000000,1071000000,684000000,-63000000,,,,247000000,8781000000,7710000000,6290000000,-55000000,,769000000,769000000,56609,ALK
2018-12-31,,,585000000,,437000000,326000000,2202000000,793000000,793000000,685000000,-73000000,,,,148000000,8264000000,7471000000,6062000000,-208000000,,437000000,437000000,56609,ALK
2017-12-31,,,1159000000,,960000000,368000000,2626000000,1324000000,1324000000,562000000,-86000000,,,,199000000,7894000000,6570000000,5268000000,-165000000,,960000000,960000000,56609,ALK
2020-06-27,193600000,,94000000,,28700000,346500000,699900000,92000000,92000000,,-33700000,,,,65300000,1136300000,1044300000,436400000,2000000,,28700000,28700000,56610,VIAV
2019-06-29,187000000,,39300000,,5400000,349400000,686300000,77400000,77400000,,-34300000,,,,31500000,1130300000,1052900000,444000000,-38100000,-2400000.0,7800000,5400000,56610,VIAV
2018-06-30,133300000,,-35700000,,-48600000,323900000,528800000,23900000,23900000,,-47300000,,,,12900000,875700000,851800000,346900000,-59600000,-2400000.0,-48600000,-48600000,56610,VIAV
2017-07-01,136300000,,180000000,,160200000,300100000,495700000,31000000,31000000,,-43200000,,,,21400000,805000000,774000000,309300000,149000000,1600000.0,158600000,160200000,56610,VIAV
2019-12-31,3692000,,-17736000,,-17736000,16610000,2597000,-17705000,-17705000,,-31000,,,,0,7559000,25264000,4962000,-31000,,-17736000,-20891000,56611,DRIO
2018-12-31,3676000,,-17803000,,-17803000,15777000,1765000,-17688000,-17688000,,-31000,,,,0,7394000,25082000,5629000,-115000,,-17803000,-18296000,56611,DRIO
2017-12-31,3297000,,-15743000,,-15743000,12433000,1311000,-14419000,-14419000,,-31000,,,,0,5170000,19589000,3859000,-1324000,,-15743000,-15998000,56611,DRIO
2016-12-31,2154000,,-10887000,,-10887000,8117000,-561000,-10832000,-10832000,,-31000,,,,0,2803000,13635000,3364000,-55000,,-10887000,-11607000,56611,DRIO
2019-12-31,,,63517000,,46514000,272180000,335945000,63765000,63765000,,-248000,,,,17003000,939351000,875586000,603406000,-248000,,46514000,46504000,56612,UVE
2018-12-31,,,152873000,,117051000,262642000,409361000,146719000,146719000,,-346000,,,,35822000,823816000,677097000,414455000,6154000,,117051000,117041000,56612,UVE
2017-12-31,,,170484000,,106935000,230656000,401488000,170832000,170832000,,-348000,,,,63549000,751916000,581084000,350428000,-348000,,106935000,106925000,56612,UVE
2016-12-31,,,162883000,,99410000,220756000,384060000,163304000,163304000,,-421000,,,,63473000,685289000,521985000,301229000,-421000,,99410000,99400000,56612,UVE
2020-12-31,,,380000000,279000000,279000000,1789000000,3859000000,783000000,783000000,,-416000000,,,,72000000,11359000000,10576000000,7500000000,-403000000,,308000000,279000000,56613,IQV
2019-12-31,,,343000000,260000000,191000000,1711000000,3788000000,875000000,875000000,,-447000000,,,,116000000,11088000000,10213000000,7300000000,-532000000,,227000000,191000000,56613,IQV
2018-12-31,,,343000000,240000000,259000000,1692000000,3666000000,833000000,833000000,,-414000000,,,,59000000,10412000000,9579000000,6746000000,-490000000,,284000000,259000000,56613,IQV
2017-12-31,,,304000000,249000000,1277000000,1605000000,3401000000,785000000,785000000,,-346000000,,,,-992000000,9702000000,8917000000,6301000000,-481000000,,1296000000,1277000000,56613,IQV
2020-10-31,,,26070000,62071000,22183000,11016000,84467000,44969000,44969000,-705000,-13508000,,,,0,127473000,82504000,43006000,-18899000,,26070000,8533000,56614,UBP
2019-10-31,,,41613000,77876000,37280000,9751000,92850000,55390000,55390000,-221000,-14102000,,,,0,138364000,82974000,45514000,-13777000,,41613000,22128000,56614,UBP
2018-10-31,,,42183000,78258000,37467000,9567000,89610000,51811000,51811000,-95000,-13678000,,,,0,133012000,81201000,43402000,-9628000,,42183000,25217000,56614,UBP
2017-10-31,,,55432000,81361000,52933000,9504000,83490000,49323000,49323000,-2432000,-12981000,,,,0,123185000,73862000,39695000,6109000,,55432000,33898000,56614,UBP
2019-12-31,,,10189000,,7796000,10204000,32691000,14844000,14844000,,-5271000,,,,2393000,62766000,47922000,30075000,-4655000,,7796000,7796000,56617,OTEL
2018-12-31,,,12212000,,9467000,10451000,35476000,17793000,17793000,,-5844000,,,,2745000,66068000,48275000,30592000,-5581000,,9467000,9467000,56617,OTEL
2017-12-31,,,4259000,,12115000,10147000,37131000,19607000,19607000,,-13249000,,,,-7856000,68526000,48919000,31395000,-15348000,,12115000,12115000,56617,OTEL
2016-12-31,,,8804000,,5146000,10234000,37069000,18813000,18813000,,-10634000,,,,3658000,68944000,50131000,31875000,-10009000,,5146000,5146000,56617,OTEL
2020-09-25,239045000,,239715000,5762000,231363000,555686000,1015294000,220563000,220563000,,-186000,,,,8096000,1161792000,941229000,146498000,19152000,,231619000,231363000,56618,DLB
2019-09-27,237871000,,282307000,5679000,255151000,549260000,1080766000,293635000,293635000,,-170000,,,,26802000,1241620000,947985000,160854000,-11328000,,255505000,255151000,56618,DLB
2018-09-28,236794000,,196374000,6567000,41746000,507185000,927038000,183059000,183059000,,-198000,,,,154069000,1054600000,871541000,127562000,13315000,,42305000,41746000,56618,DLB
2017-09-29,233312000,,255145000,7100000,206481000,468347000,961648000,259989000,259989000,,-127000,,,,48039000,1080177000,820188000,118529000,-4844000,,207106000,206481000,56618,DLB
2020-12-31,,,37000000,1150000000,-552000000,33000000,1186000000,870000000,870000000,,-214000000,,,,269000000,1430000000,560000000,244000000,-833000000,,-232000000,-552000000,56619,BIPC
2019-12-31,,,842000000,1623000000,197000000,30000000,1375000000,1037000000,1037000000,,-156000000,,,,272000000,1619000000,582000000,244000000,-195000000,,570000000,197000000,56619,BIPC
2018-12-31,,,815000000,1787000000,202000000,24000000,1325000000,982000000,982000000,,-127000000,,,,234000000,1561000000,579000000,236000000,-167000000,,581000000,202000000,56619,BIPC
2017-12-31,,,753000000,3298000000,207000000,25000000,1128000000,840000000,840000000,,-71000000,,,,176000000,1323000000,483000000,195000000,-87000000,,577000000,207000000,56619,BIPC
2020-02-01,,,82435000,,61384000,966028000,1063115000,97113000,97113000,-26000,-3339000,,,,20678000,2197066000,2099953000,1133951000,-14678000,-373000,61757000,61384000,56620,GCO
2019-02-02,,,78259000,,-51930000,961696000,1047056000,85397000,85397000,-37000,-4115000,,,,27035000,2188553000,2103156000,1141497000,-7138000,-103154000,51224000,-51930000,56620,GCO
2018-02-03,,,68989000,1530000.0,-111839000,929209000,1011383000,82201000,82201000,-27000,-5420000,,,,32281000,2127547000,2045346000,1116164000,-13212000,-148547000,36708000,-111839000,56620,GCO
2017-01-28,,,112758000,1468000.0,97431000,878242000,975919000,97708000,97708000,-31000,-5294000,,,,39876000,2020831000,1923123000,1044912000,15050000,24549000,72882000,97431000,56620,GCO
2020-01-31,238400000,,505700000,4100000,371400000,644700000,1454000000,570300000,570300000,600000,-78500000,,,,135100000,6052700000,5482400000,4598700000,-64600000,,370600000,371400000,56622,DOOO
2019-01-31,221700000,,328900000,5200000,227000000,554600000,1253400000,476500000,476500000,600000,-65000000,,,,101600000,5243800000,4767300000,3990400000,-147600000,,227300000,227000000,56622,DOOO
2018-01-31,198600000,,376600000,5000000,238900000,460400000,1045100000,385100000,385100000,1000000,-47200000,,,,137500000,4452500000,4067400000,3407400000,-8500000,,239100000,238900000,56622,DOOO
2017-01-31,184100000,,327100000,4600000,257200000,452100000,1008900000,373200000,373200000,-500000,-52300000,,,,70100000,4171500000,3798300000,3162600000,-46100000,,257000000,257200000,56622,DOOO
2020-12-31,,,76257000,,57603000,128632000,234396000,0,85665000,20099000,,,,,18654000,234396000,148731000,0,-9408000,,57603000,57603000,56624,CLBK
2019-12-31,,,71082000,,54717000,113282000,199783000,0,74732000,11769000,,,,,16365000,199783000,125051000,0,-3650000,,54717000,54717000,56624,CLBK
2018-12-31,,,33659000,,22736000,103129000,179045000,0,70319000,5597000,,,,,10923000,179045000,108726000,0,-71427000,,22736000,22736000,56624,CLBK
2017-12-31,,,44831500,,24247500,85886500,150304000,0,49736000,14681500,,,,,20584000,150304000,100568000,0,-8413500,,24247500,24247500,56624,CLBK
2019-12-31,7285000,,-19373000,,-19292000,9923000,0,-17208000,-17208000,,,,,,-81000,0,17208000,0,-2165000,,-19292000,-27951000,56625,SLS
2018-12-31,8767000,,-29048000,,-27670000,13272000,0,-22039000,-22039000,,-266000.0,,,,-1378000,0,22039000,0,-7009000,,-27670000,-41251000,56625,SLS
2017-12-31,6067000,,-23501000,,-23754000,9389000,0,-15456000,-15456000,,-462000.0,,,,253000,0,15456000,0,-8045000,,-23754000,-24429000,56625,SLS
2016-12-31,11395000,,-17680000,,-17681000,4593000,0,-15988000,-15988000,,-1166000.0,,,,1000,0,15988000,0,-1692000,,-17681000,-17681000,56625,SLS
2019-12-31,,,-51000000,,-51000000,20817000,-33725000,-54542000,-54542000,,,,,,0,20492000,75034000,54217000,3542000,,-51000000,-51000000,56626,SRRK
2018-12-31,,,-49326000,,-49326000,14382000,-36310000,-50692000,-50692000,,,,,,0,0,50692000,36310000,1366000,,-49326000,-49326000,56626,SRRK
2017-12-31,,,-24995000,,-24995000,5085000,-19944000,-25029000,-25029000,,,,,,0,0,25029000,19944000,34000,,-24995000,-24995000,56626,SRRK
2016-12-31,,,-16207000,,-16207000,4112000,-12098000,-16210000,-16210000,,-42000.0,,,,0,379000,16589000,12477000,3000,,-16207000,-16207000,56626,SRRK
2019-12-31,16306000,,-19209000,,-19243000,3313000,436000,-19183000,-19183000,,-21000,,,,34000,4796000,23979000,4360000,-26000,,-19243000,-23271000,56627,ALXO
2018-12-31,11270000,,-13686000,,-13731000,2601000,187000,-13684000,-13684000,,-21000,,,,45000,2067000,15751000,1880000,-2000,,-13731000,-17402000,56627,ALXO
2020-12-31,,,7420000,,7482000,7676000,13322000,2600000,2600000,,-35000,,,,-62000,38543000,35943000,25221000,4820000,,7482000,7482000,56628,DVD
2019-12-31,,,7286000,,5500000,8462000,17722000,6079000,6079000,,-35000,,,,1786000,45963000,39884000,28241000,1207000,,5500000,5413000,56628,DVD
2018-12-31,,,9067000,,6889000,8430000,18944000,7229000,7229000,,-62000,,,,2178000,47016000,39787000,28072000,1838000,,6889000,6778000,56628,DVD
2017-12-31,,,6537000,,8426000,8509000,19173000,7284000,7284000,,-169000,,,,-1889000,46742000,39458000,27569000,-747000,,8426000,8293000,56628,DVD
2019-12-31,1905504,,-10853435,52777,-10767523,5432807,622526,-7762145,-7762145,,-777196,,,,0,22194348,29956493,21571822,-3091290,,-10853435,-10767523,56629,CBAT
2018-12-31,2481038,,-1957482,11977,-1943177,6578476,-3298597,-12520599,-12520599,,-1013457,,,,0,24433304,36953903,27731901,10563117,,-1957482,-1943177,56629,CBAT
2017-12-31,1738767,,-21467341,11977,-21467341,7545668,-10195472,-20205282,-20205282,,-87819,,,,0,58375399,78580681,68570871,-1262059,,-21467341,-21467341,56629,CBAT
2016-12-31,1571337,,-12113405,11977,-12713918,8594730,-2045991,-12256919,-12256919,,153,,,,600513,8369371,20626290,10415362,143514,,-12713918,-12713918,56629,CBAT
2020-12-31,,,-13346000,,-16991000,42612000,76116000,0,25661000,7843000,,,,,3645000,76116000,50455000,0,-39007000,,-16991000,-16991000,56630,HBMD
2019-12-31,,,22073000,,16881000,47739000,85401000,0,30840000,6822000,,,,,5192000,85401000,54561000,0,-8767000,,16881000,16881000,56630,HBMD
2018-12-31,,,-4725000,,-3828000,51470000,78387000,0,18148000,8769000,,,,,-897000,78387000,60239000,0,-22873000,,-3828000,-3828000,56630,HBMD
2017-12-31,,,10352000,,7200000,35964000,55552000,0,12729000,6859000,,,,,3152000,55552000,42823000,0,-2377000,,7200000,7200000,56630,HBMD
2019-12-31,,,8979258000,14873767000,4722139000,24462202000,42766819000,17828113000,17828113000,476504000,-10402021000,,,,2776445000,101492181000,83664068000,58725362000,-8848855000,,6202813000,4722139000,56631,TV
2018-12-31,,,12005774000,15013771000,6009414000,24752791000,43443065000,17883625000,17883625000,806649000,-9449687000,,,,4390504000,101282333000,83398708000,57839268000,-5877851000,,7615270000,6009414000,56631,TV
2017-12-31,,,10851642000,13995150000,4524496000,24110146000,40739682000,15731626000,15731626000,897910000,-9151191000,,,,4274120000,94274235000,78542609000,53534553000,-4879984000,,6577522000,4524496000,56631,TV
2016-12-31,,,8205589000,12492484000,3721406000,24174092000,43909573000,18328258000,18328258000,1407223000,-8497919000,,,,2872235000,96287363000,77959105000,52377790000,-10122669000,,5333354000,3721406000,56631,TV
2019-12-31,,,92889000,,70714000,44406000,124928000,80522000,80522000,,-5765000,,,,21840000,948424000,867902000,823496000,12367000,-335000,71049000,70714000,56632,CBZ
2018-12-31,,,79840000,,61570000,39173000,131720000,92547000,92547000,,-6645000,,,,18267000,922003000,829456000,790283000,-12707000,-3000,61573000,61570000,56632,CBZ
2017-12-31,,,74320000,,50377000,33295000,99756000,66461000,66461000,,-6675000,,,,23288000,855340000,788879000,755584000,7859000,-655000,51032000,50377000,56632,CBZ
2016-12-31,,,67006000,,40065000,36319000,102106000,65787000,65787000,,-6593000,,,,26399000,799832000,734045000,697726000,1219000,-542000,40607000,40065000,56632,CBZ
2020-12-31,,,2120000000,,1737000000,4480000000,7012000000,2460000000,2460000000,,-236000000,,,,383000000,20523000000,18063000000,13511000000,-340000000,,1737000000,1716000000,56633,HIG
2019-12-31,,,2560000000,,2085000000,4472000000,7642000000,3013000000,3013000000,91000000.0,-255000000,,,,475000000,20736000000,17723000000,13094000000,-453000000,,2085000000,2064000000,56633,HIG
2018-12-31,,,1753000000,,1807000000,4234000000,6376000000,2074000000,2074000000,91000000.0,-268000000,,,,268000000,18925000000,16851000000,12549000000,-321000000,322000000.0,1485000000,1801000000,56633,HIG
2017-12-31,,,723000000,,-3131000000,4546000000,5579000000,1019000000,1019000000,91000000.0,-279000000,,,,985000000,17125000000,16106000000,11546000000,-296000000,-2869000000.0,-262000000,-3131000000,56633,HIG
2019-12-31,,,52435000,,39364000,63840000,151586000,71814000,71814000,,-18971000,,,,13071000,658385000,586571000,506799000,-19379000,,39364000,39364000,56634,NESR
2018-12-31,,,76133156,67000.0,60245153,62922868,170453171,91462301,91462301,,-24656576,,,,16167431,597582957,506120656,427129785,-15329146,,59965724,60245153,56634,NESR
2017-12-31,,,-3124397,67000.0,-3124397,4597952,0,-4597952,-4597952,,-24656576,,,,0,0,4597952,0,1473554,,-3124397,-4201115,56634,NESR
2020-12-31,,,667000000,,609000000,,3460000000,716000000,716000000,2317000000,-49000000,,,,58000000,3460000000,2744000000,0,-49000000,,609000000,608000000,56635,RACE
2019-12-31,699211000.0,,875364000,5998000.0,695818000,343179000.0,1961305000,917385000,917385000,1530000,-39746000,,,,176656000,3766615000,2849230000,1805310000,-42021000,,698708000,695818000,56635,RACE
2018-12-31,643038000.0,,802944000,5117000.0,784678000,327341000.0,1795965000,822108000,822108000,3478000,-25685000,,,,16317000,3420321000,2598213000,1624356000,-19164000,,786627000,784678000,56635,RACE
2017-12-31,657119000.0,,746156000,5258000.0,535393000,329065000.0,1766030000,770394000,770394000,9452000,-35697000,,,,208760000,3416890000,2646496000,1650860000,-24238000,,537396000,535393000,56635,RACE
2020-01-31,31558000,,40034000,21302000,35196000,53419000,124159000,39182000,39182000,,-21000,,,,5421000,382530000,343348000,258371000,852000,,34613000,35196000,56636,RAVN
2019-01-31,26174000,,61570000,2000,51794000,46918000,133257000,60165000,60165000,,-21000,,,,9697000,406668000,346503000,273411000,1405000,,51873000,51794000,56636,RAVN
2018-01-31,16936000,,58986000,2000,41022000,45200000,122022000,59886000,59886000,,-21000,,,,17967000,377317000,317431000,255295000,-900000,,41019000,41022000,56636,RAVN
2017-01-31,16312000,,27853000,5000,20191000,33378000,80504000,30814000,30814000,,-21000,,,,7661000,277395000,246581000,196891000,-2961000,,20192000,20191000,56636,RAVN
2019-12-31,9738819,,-34470677,514828,-34054828,24810712,0,-34603880,-34603880,,,,,,0,0,34603880,0,133203,,-34470677,-34079991,56638,BSGM
2018-12-31,4368784,,-17251317,514828,-17251317,12881027,0,-17262214,-17262214,,,,,,0,0,17262214,0,10897,,-17251317,-18136053,56638,BSGM
2017-12-31,4756468,,-12695743,514828,-12695743,8138117,0,-12906283,-12906283,,,,,,0,0,12906283,0,210540,,-12695743,-12815620,56638,BSGM
2016-12-31,2654501,,-11587187,514828,-11587187,8499304,0,-11164280,-11164280,,,,,,0,0,11164280,0,-422907,,-11587187,-11697210,56638,BSGM
2019-12-31,,,4477531000000,1921700000000,3117351000000,6513616000000,12010078000000,0,4503117000000,993345000000,,,,,1262964000000,12609597000000,8106480000000,599519000000,-25586000000,,3214567000000,3117351000000,56643,CIB
2018-12-31,,,3615870000000,1806305000000,2658864000000,6078359000000,10419739000000,0,3381207000000,960173000000,,,,,829435000000,11005116000000,7623909000000,585377000000,234663000000,,2786435000000,2658864000000,56643,CIB
2017-12-31,,,3992771000000,1316586000000,2615000000000,5499901000000,10613091000000,0,4136506000000,976684000000,,,,,1238598000000,11143375000000,7006869000000,530284000000,-143735000000,,2754173000000,2615000000000,56643,CIB
2016-12-31,,,3968282000000,1209397000000,2865328000000,5530057000000,10335382000000,0,3804349000000,1000976000000,,,,,1176832000000,10783399000000,6979050000000,448017000000,163933000000,163497000000.0,2791450000000,2865328000000,56643,CIB
2019-12-31,54500000,,662900000,500000,530100000,209600000,1080500000,816400000,816400000,,-84500000,,,,132800000,7863100000,7046700000,6782600000,-153500000,,530100000,529700000,56644,SPR
2018-12-31,42500000,,756800000,500000,617000000,176100000,1088000000,869400000,869400000,,-58200000,,,,139800000,7222000000,6352600000,6134000000,-112600000,,617000000,616500000,56644,SPR
2017-12-31,31200000,,534900000,500000,354900000,167500000,795900000,597200000,597200000,,-39800000,,,,180000000,6983000000,6385800000,6187100000,-62300000,,354900000,354700000,56644,SPR
2016-12-31,23800000,,661800000,500000,469700000,231600000,1016200000,760800000,760800000,,-57300000,,,,192100000,6792900000,6032100000,5776700000,-99000000,,469700000,469400000,56644,SPR
2020-12-31,,,34175000,,29354000,42975000,88443000,0,34181000,11287000,,,,,4821000,88443000,54262000,0,-6000,,29354000,29354000,56646,PFIS
2019-12-31,,,28891000,,25736000,45916000,84533000,0,31713000,6904000,,,,,3155000,84533000,52820000,0,-2822000,,25736000,25736000,56646,PFIS
2018-12-31,,,28311000,,24920000,42438000,80430000,0,31256000,6736000,,,,,3391000,80430000,49174000,0,-2945000,,24920000,24920000,56646,PFIS
2017-12-31,,,26637000,,18457000,39864000,77930000,0,29685000,8381000,,,,,8180000,77930000,48245000,0,-3048000,,18457000,18457000,56646,PFIS
2020-03-31,,,-18708000,,-18710000,12332000,-3416000,-15748000,-15748000,,,,,,2000,2196000,17944000,5612000,-2960000,,-18710000,-18710000,56648,ONVO
2019-03-31,,,-26632000,,-26635000,14690000,-12143000,-26833000,-26833000,,,,,,3000,3091000,29924000,15234000,201000,,-26635000,-26635000,56648,ONVO
2018-03-31,,,-34801000,,-34803000,20888000,-14383000,-35271000,-35271000,,,,,,2000,4603000,39874000,18986000,470000,,-34803000,-34803000,56648,ONVO
2017-03-31,,,-38424000,,-38447000,22304000,-16271000,-38575000,-38575000,,,,,,23000,4230000,42805000,20501000,151000,,-38447000,-38447000,56648,ONVO
2020-12-31,,,1883000000,96000000,1772000000,2679000000,4453000000,1774000000,1774000000,,-339000000,,,,101000000,64355000000,62581000000,59902000000,109000000,,1782000000,1772000000,56650,ADM
2019-12-31,,,1588000000,75000000,1379000000,2542000000,4147000000,1587000000,1587000000,18000000.0,-402000000,,,,209000000,64656000000,63069000000,60509000000,1000000,,1379000000,1379000000,56650,ADM
2018-12-31,,,2060000000,64000000,1810000000,2239000000,4181000000,1924000000,1924000000,18000000.0,-364000000,,,,245000000,64341000000,62417000000,60160000000,136000000,,1815000000,1810000000,56650,ADM
2017-12-31,,,1609000000,62000000,1595000000,1984000000,3518000000,1524000000,1524000000,10000000.0,-330000000,,,,7000000,60828000000,59304000000,57310000000,85000000,,1602000000,1595000000,56650,ADM
2019-12-31,19450000,,26151000,,21411000,91613000,152629000,41566000,41566000,,-9292000,,,,4740000,270245000,228679000,117616000,-15415000,,21411000,21411000,56651,RGEN
2018-12-31,15821000,,21436000,,16617000,62764000,107501000,28916000,28916000,,-6709000,,,,4819000,194032000,165116000,86531000,-7480000,,16617000,16617000,56651,RGEN
2017-12-31,8672000,,7248000,,28353000,51509000,74186000,14005000,14005000,,-6441000,,,,-21105000,141236000,127231000,67050000,-6757000,,28353000,28353000,56651,RGEN
2016-12-31,7355000,,11692000,,11681000,30853000,57424000,19216000,19216000,,-3768000,,,,11000,104541000,85325000,47117000,-7524000,,11681000,11681000,56651,RGEN
2020-12-31,1491000000,,1154000000,1454000000,721000000,3188000000,6630000000,1951000000,1951000000,,-784000000,,,,292000000,31536000000,29585000000,24906000000,-797000000,,862000000,690000000,56652,TSLA
2019-12-31,1343000000,,-665000000,1492000000,-862000000,2646000000,4069000000,80000000,80000000,,-725000000,,,,110000000,24578000000,24498000000,20509000000,-745000000,,-775000000,-870000000,56652,TSLA
2018-12-31,1460000000,,-1005000000,1390000000,-976000000,2835000000,4042000000,-253000000,-253000000,,-653000000,,,,58000000,21461000000,21714000000,17419000000,-752000000,,-1063000000,-976000000,56652,TSLA
2017-12-31,1378000000,,-2209000000,1395080000,-1962000000,2477000000,2223000000,-1632000000,-1632000000,,-477000000,,,,32000000,11759000000,13391000000,9536000000,-577000000,,-2241000000,-1962000000,56652,TSLA
2020-12-31,5529000000,,14163000000,146000000,12314000000,9390000000,25212000000,8029000000,8029000000,583000000,-390000000,,,,1813000000,37369000000,29340000000,12157000000,6134000000,,12350000000,12314000000,56653,SNY
2019-12-31,6018000000,,3077000000,174000000,2806000000,9970000000,25658000000,6846000000,6846000000,678000000,-544000000,,,,139000000,37631000000,30785000000,11973000000,-3769000000,-101000000.0,2938000000,2806000000,56653,SNY
2018-12-31,5894000000,,4904000000,159000000,4306000000,9934000000,24356000000,6024000000,6024000000,334000000,-471000000,,,,481000000,35677000000,29653000000,11321000000,-1120000000,-13000000.0,4423000000,4306000000,56653,SNY
2017-12-31,5472000000,,5616000000,169000000,8416000000,10164000000,24774000000,7273000000,7273000000,-1000000,-346000000,,,,1722000000,36221000000,28948000000,11447000000,-1657000000,4643000000.0,3894000000,8416000000,56653,SNY
2019-12-31,,,174581760,,174581760,13408233,120445812,107037579,107037579,,-14733534,,,,0,120445812,13408233,0,67544181,,174581760,174581760,56657,HYT
2019-08-31,,,90752936,,90752936,13068757,128558891,115490134,115490134,,-17313485,,,,0,128558891,13068757,0,-24737198,,90752936,90752936,56657,HYT
2018-12-31,,,90752936,,90752936,13068757,128558891,115490134,115490134,,-18018998,,,,0,128558891,13068757,0,-24737198,,90752936,90752936,56657,HYT
2018-08-31,,,63349003,,63349003,14250439,134841086,120590647,120590647,,-15894056,,,,0,134841086,14250439,0,-57241644,,63349003,63349003,56657,HYT
2019-12-31,,,-16582877,1805552,-15646147,3251529,-4567645,-10980163,-10980163,-13795,-1561625,,,,117322,1275425,12255588,5843070,-5602714,,-16700199,-15646147,56661,IMTE
2018-12-31,,,-17350280,2807963,-15962278,3464669,-1752716,-7846882,-7846882,600124,-1383399,,,,-507057,1324406,9171288,3077122,-9503398,,-16843223,-15962278,56661,IMTE
2017-12-31,,,1505453,-53851,1695567,1489833,1326955,-2405382,-2405382,221373,-107101,,,,-187213,5762711,8168093,4435756,3910835,,1692666,1695567,56661,IMTE
2016-12-31,,,5614007,-55621,3627757,1795679,10186240,5787468,5787468,455862,-73666,,,,2018939,13929670,8142202,3743430,-173461,,3595068,3627757,56661,IMTE
2019-12-31,11032000,,-15068000,,-13267000,6441000,0,-17473000,-17473000,,,,,,-1801000,0,17473000,0,2405000,,-13267000,-13267000,56662,BLPH
2018-12-31,20259000,,-2625000,,2814000,7621000,0,-27880000,-27880000,,,,,,-5439000,0,27880000,0,25255000,,2814000,2814000,56662,BLPH
2017-12-31,17854000,,-54818000,,-54818000,6745000,0,-24599000,-24599000,,,,,,0,0,24599000,0,-30219000,,-54818000,-54818000,56662,BLPH
2016-12-31,16250000,,-24252000,,-23814000,7507000,0,-23757000,-23757000,,,,,,-438000,0,23757000,0,-143000,,-23814000,-23814000,56662,BLPH
2019-12-31,,,-2167111,,-2167544,3034885,1340543,-1694342,-1694342,,-379019,,,,433,1480213,3174555,139670,-472769,,-2167544,-2167544,56663,INVO
2018-12-31,,,-3076091,,-3076091,3038068,404008,-2634060,-2634060,,-442031,,,,0,494375,3128435,90367,-442031,,-3076091,-3076091,56663,INVO
2017-12-31,,,-702163,,-702163,870612,230191,-640421,-640421,,-20873,,,,0,282145,922566,51954,-61742,,-702163,-702163,56663,INVO
2016-12-31,,,-2124252,,-2124252,2146221,35807,-2110414,-2110414,,-13838,,,,0,50901,2161315,15094,-13838,,-2124252,-2124252,56663,INVO
2019-12-31,8993000,,-13373000,,-13373000,11294000,8143000,-12144000,-12144000,,-1530000,,,,0,17972000,30116000,9829000,-1229000,,-13373000,-13482000,56665,MASS
2018-12-31,9528000,,-7536000,,-7536000,9304000,12393000,-6439000,-6439000,,-1147000,,,,0,22054000,28493000,9661000,-1097000,,-7536000,-7612000,56665,MASS
2019-12-31,,,2442000,1124000,1798000,9966000,98981000,29856000,29856000,,-29726000,,,,0,156297000,126441000,57316000,-27414000,,2442000,-5622000,56666,CIO
2018-12-31,,,38669000,964000,38168000,8137000,79612000,19123000,19123000,,-23937000,,,,0,129484000,110361000,49872000,19546000,,38669000,30748000,56666,CIO
2017-12-31,,,9158000,208000,5756000,6792000,63601000,15215000,15215000,,-20173000,,,,0,106487000,91272000,42886000,-6057000,,9158000,-1655000,56666,CIO
2016-12-31,,,376000,1857000,-843000,13474000,44047000,395000,395000,,-14761000,,,,0,72461000,72066000,28414000,-19000,,376000,-2624000,56666,CIO
2020-06-30,17954073,,-25062404,,-16529281,6834181,-393700,-25383126,-25383126,201172,,,,,-8533123,149575,25532701,543275,320722,,-16529281,-16529281,56669,OPT
2019-06-30,31347891,,-35547034,,-20910061,5196412,-37134,-36668684,-36668684,87247,,,,,-14636973,236809,36905493,273943,1121650,,-20910061,-20910061,56669,OPT
2018-06-30,24891534,,-28919488,,-16902240,4671305,-113223,-29764564,-29764564,88502,,,,,-12017248,145079,29909643,258302,845076,,-16902240,-16902240,56669,OPT
2017-06-30,4838300,,-9360808,,-6192896,4711658,-182604,-9824787,-9824787,92225,,,,,-3167912,74860,9899647,257464,463979,,-6192896,-6192896,56669,OPT
2019-12-31,,,290188000,,245451000,181635000,469158000,287523000,287523000,3708000,,,,,44737000,579650000,292127000,110492000,3379000,,245451000,245451000,56671,CIH
2018-12-31,20761000.0,,195468000,,165420000,123963000,337296000,188567000,188567000,4005000,,,,,30048000,421024000,232457000,83728000,6901000,,165420000,165420000,56671,CIH
2017-12-31,17219000.0,,149023000,,128153000,90502000,270808000,144198000,144198000,18889000,,,,,20870000,335037000,190839000,64229000,4825000,,128153000,128153000,56671,CIH
2016-12-31,9041000.0,,129483000,,111030000,70128000,225493000,129901000,129901000,16423000,-2108000.0,,,,18453000,275296000,145395000,49803000,-418000,,111030000,111030000,56671,CIH
2019-12-31,,,-604000000,,-612000000,1320000000,792000000,-644000000,-644000000,,-60000000,,,,8000000,3940000000,4584000000,3148000000,40000000,,-612000000,-612000000,56672,APG
2018-08-31,,,-163597211,,-163597211,1805560,17771946,15966386,15966386,,-60000000,,,,0,17771946,1805560,0,-179563597,,-163597211,-163597211,56672,APG
2019-12-31,,,-9648500,,-9648500,8993854,520340,-10388808,-10388808,1787365,,,,,0,2759190,13147998,2238850,740308,,-9648500,-9648500,56673,BLNK
2018-12-31,,,-3421203,,-3421203,11364183,1162071,-11611709,-11611709,1150016,-1420189.0,,,,0,2686237,14297946,1524166,8190506,,-3421203,-26880134,56673,BLNK
2017-12-31,,,-75363496,,-75363496,7407467,1425980,-7123448,-7123448,761652,-3231304.0,,,,0,2500357,9623805,1074377,-68240048,,-75363496,-79630596,56673,BLNK
2016-12-31,,,-7699127,-3831314.0,-7699127,6524452,1317948,-7212908,-7212908,1200797,-1218510.0,,,,0,3326021,10538929,2008073,-486219,,-7699127,-9167627,56673,BLNK
2019-12-31,,,24318000,,21639000,21963000,90121000,37218000,37218000,,-5609000,,,,2679000,101515000,64297000,11394000,-12900000,,21639000,6053000,56674,MNRL
2018-12-31,,,33142000,,32815000,6638000,59784000,39231000,39231000,-7506000.0,-7446000,,,,327000,67264000,28033000,7480000,-6089000,,32815000,1839000,56674,MNRL
2017-12-31,,,116620000,,115612000,3935000,37553000,26663000,26663000,-10842000.0,-556000,,,,1008000,40908000,14245000,3355000,89957000,,32815000,1839000,56674,MNRL
2020-06-30,19269000000,,53036000000,,44281000000,24709000000,96937000000,52959000000,52959000000,,-2591000000,,,,8755000000,143015000000,90056000000,46078000000,77000000,,44281000000,44281000000,56676,MSFT
2019-06-30,16876000000,,43688000000,,39240000000,23098000000,82933000000,42959000000,42959000000,,-2686000000,,,,4448000000,125843000000,82884000000,42910000000,729000000,,39240000000,39240000000,56676,MSFT
2018-06-30,14726000000,,36474000000,,16571000000,22223000000,72007000000,35058000000,35058000000,,-2733000000,,,,19903000000,110360000000,75302000000,38353000000,1416000000,,16571000000,16571000000,56676,MSFT
2017-06-30,13037000000,,29901000000,,25489000000,19942000000,62310000000,29331000000,29331000000,,-2222000000,,,,4412000000,96571000000,67240000000,34261000000,570000000,,25489000000,25489000000,56676,MSFT
2019-12-31,4333000,,-12866000,,-12871000,18109000,10130000,-12312000,-12312000,,-581000,,,,5000,19150000,31462000,9020000,-554000,,-12871000,-12871000,56677,PHUN
2018-12-31,6965000,,-10177000,,-9803000,18979000,19081000,-6863000,-6863000,,-724000,,,,-374000,30883000,37746000,11802000,-3314000,,-9803000,-9803000,56677,PHUN
2017-12-31,11108000,,-26026000,,-25938000,25516000,11008000,-25616000,-25616000,,-397000,,,,-88000,26722000,52338000,15714000,-410000,,-25938000,-25938000,56677,PHUN
2016-12-31,9877000,,-16229000,,-16297000,24101000,18542000,-15436000,-15436000,,-686000,,,,68000,47370000,62806000,28828000,-793000,,-16297000,-16297000,56677,PHUN
2019-12-31,,,66100000,,48500000,259200000,325700000,66500000,66500000,,,,,,16100000,946900000,880400000,621200000,-400000,-1500000,50000000,48500000,56679,SYX
2018-12-31,,,62900000,,224700000,247300000,307700000,60400000,60400000,,,,,,13400000,896900000,836500000,589200000,2500000,175200000,49500000,224700000,56679,SYX
2017-12-31,,,45500000,,40400000,227200000,273200000,46000000,46000000,,-200000.0,,,,-20000000,791800000,745800000,518600000,-500000,-25100000,65500000,40400000,56679,SYX
2016-12-31,,,6500000,,-32600000,226300000,238200000,11900000,11900000,,-300000.0,,,,2600000,753100000,741200000,514900000,-5400000,-36500000,3900000,-32600000,56679,SYX
2019-12-31,,,-31209000,,-31209000,7062000,-22969000,-30031000,-30031000,,-1209000,,,,0,0,30031000,22969000,-1178000,,-31209000,-31209000,56680,YMTX
2018-12-31,,,-23587000,,-23587000,5567000,-17822000,-23389000,-23389000,,-740000,,,,0,0,23389000,17822000,-198000,,-23587000,-23587000,56680,YMTX
2019-12-31,,,480000000,,891000000,167000000,998000000,573000000,573000000,-213000000,-66000000,,,,-411000000,3038000000,2465000000,2040000000,-93000000,,891000000,891000000,56681,SWN
2018-12-31,,,538000000,,537000000,197000000,1848000000,882000000,882000000,209000000,-122000000,,,,1000000,3862000000,2980000000,2014000000,-344000000,,537000000,535000000,56681,SWN
2017-12-31,,,953000000,,1046000000,229000000,1556000000,1151000000,1151000000,-328000000,-135000000,,,,-93000000,3203000000,2052000000,1647000000,-198000000,,1046000000,815000000,56681,SWN
2016-12-31,,,-2672000000,,-2643000000,244000000,980000000,-2453000000,-2453000000,432000000,-88000000,,,,-29000000,2436000000,4889000000,1456000000,-219000000,,-2643000000,-2751000000,56681,SWN
2019-12-31,8739420,,-17105791,,-17105791,8223700,0,-16963120,-16963120,,,,,,0,0,16963120,0,-142671,,-17105791,-17105791,56682,AKTX
2018-12-31,11795376,,-16466780,,-16466780,10896158,0,-22691534,-22691534,,,,,,0,0,22691534,0,6224754,,-16466780,-16466780,56682,AKTX
2017-12-31,23285279,,-35399257,,-35399257,11798910,0,-35084189,-35084189,,,,,,0,0,35084189,0,-315068,,-35399257,-35399257,56682,AKTX
2016-12-31,17306001,,-18140997,,-18140997,9940557,0,-27246558,-27246558,,,,,,0,0,27246558,0,9105561,,-18140997,-18140997,56682,AKTX
2019-12-29,,,-1906000,-598000,-649000,10417000,13278000,170000,170000,,-494000,,,,-659000,82269000,82099000,68991000,-2076000,,-1247000,-649000,56684,BBQ
2018-12-30,,,5591000,-598000,4862000,7988000,15388000,6136000,6136000,,-493000,,,,729000,54888000,48752000,39500000,-545000,,4862000,4862000,56684,BBQ
2017-12-31,,,-7524000,-598000,-8123000,14634000,17502000,83000,83000,,-661000,,,,-858000,64595000,64512000,47093000,-7607000,-1457000.0,-6666000,-8123000,56684,BBQ
2017-01-01,,,-6377000,-598000,-2431000,16569000,18588000,-854000,-854000,,-886000,,,,-2272000,76624000,77478000,58036000,-5523000,1674000.0,-4105000,-2431000,56684,BBQ
2020-10-31,5800000,,-46100000,,-30500000,203300000,228100000,5700000,5700000,,-25700000,,,,-15600000,2277600000,2271900000,2049500000,-51800000,,-30500000,-30500000,56685,REVG
2019-10-31,4800000,,-16600000,200000.0,-12300000,199300000,251800000,30500000,30500000,,-32500000,,,,-3500000,2403700000,2373200000,2151900000,-47100000,,-13100000,-12300000,56685,REVG
2018-10-31,6500000,,2200000,1000000.0,13000000,182800000,278000000,70600000,70600000,,-25600000,,,,-10800000,2381300000,2310700000,2103300000,-68400000,,13000000,13000000,56685,REVG
2017-10-31,4200000,,50100000,1000000.0,31400000,188300000,294600000,87200000,87200000,,-20700000,,,,18700000,2267800000,2180600000,1973200000,-37100000,,31400000,31400000,56685,REVG
2020-12-31,,,3647000000,358000000,2695000000,6096000000,10021000000,3801000000,3801000000,124000000,-164000000,,,,787000000,16471000000,12670000000,6450000000,-154000000,,2860000000,2695000000,56686,CL
2019-12-31,,,3301000000,441000000,2367000000,5616000000,9336000000,3614000000,3614000000,106000000,-192000000,,,,774000000,15693000000,12079000000,6357000000,-313000000,,2527000000,2367000000,56686,CL
2018-12-31,,,3464000000,299000000,2400000000,5434000000,9262000000,3759000000,3759000000,69000000,-193000000,,,,906000000,15544000000,11785000000,6282000000,-295000000,,2558000000,2400000000,56686,CL
2017-12-31,,,3487000000,303000000,2024000000,5412000000,9355000000,3925000000,3925000000,18000000,-153000000,,,,1313000000,15454000000,11529000000,6099000000,-438000000,,2174000000,2024000000,56686,CL
2020-11-30,,,882700000,13800000,870700000,1159600000,2697800000,948300000,948300000,-1700000,-236600000,,,,13300000,4287800000,3339500000,1590000000,-65600000,,869400000,870700000,56688,INFO
2019-11-30,,,742000000,15100000,502700000,1200700000,2757600000,976300000,976300000,7500000,-259700000,,,,242600000,4414600000,3438300000,1657000000,-234300000,,499400000,502700000,56688,INFO
2018-11-30,,,423800000,5900000,542300000,1187200000,2513500000,783400000,783400000,1700000,-225700000,,,,-115400000,4009200000,3225800000,1495700000,-359600000,,539200000,542300000,56688,INFO
2017-11-30,,,367100000,19100000,416900000,1102900000,2251300000,637200000,637200000,18700000,-154300000,,,,-49900000,3599700000,2962500000,1348400000,-270100000,,417000000,416900000,56688,INFO
2019-12-31,,,-72251000,,-72240000,66052000,26843000,-39209000,-39209000,,-11627000,,,,-11000,195992000,235201000,169149000,-33042000,,-72240000,-72240000,56689,HALO
2018-12-31,150252000.0,,-79793000,,-80330000,60804000,-8526000,-69330000,-69330000,,-18041000,,,,537000,151862000,221192000,160388000,-10463000,,-80330000,-80330000,56689,HALO
2017-12-31,150252000.0,,61610000,,62971000,53816000,134818000,81002000,81002000,,-21984000,,,,-1361000,316613000,235611000,181795000,-19392000,,62971000,62971000,56689,HALO
2016-12-31,150252000.0,,-101861000,,-103023000,45853000,-37357000,-83210000,-83210000,,-19977000,,,,1162000,146691000,229901000,184048000,-18651000,,-103023000,-103023000,56689,HALO
2020-12-31,,,171109000,,131771000,166567000,429810000,220627000,220627000,,-35601000,,,,39338000,974207000,753580000,544397000,-49518000,,131771000,131771000,56690,WWE
2019-12-31,,,94678000,,77061000,171606000,324766000,119033000,119033000,,-26121000,,,,17617000,960442000,841409000,635676000,-24355000,,77061000,77061000,56690,WWE
2018-12-31,,,106037000,,99588000,181431000,328387000,121887000,121887000,,-15405000,,,,6449000,930160000,808273000,601773000,-15850000,,99588000,99588000,56690,WWE
2017-12-31,,,64060000,,32640000,160806000,267906000,81050000,81050000,,-14736000,,,,31420000,800959000,719909000,533053000,-16990000,,32640000,32640000,56690,WWE
2019-12-31,23563000,,-399240000,673266000,26335000,402442000,212749000,-218011000,-218011000,,-174246000,,,,-8218000,858578000,1076589000,645829000,-181229000,,-391022000,26335000,56695,RUN
2018-12-31,18844000,,-250864000,460377000,26657000,323891000,225058000,-121881000,-121881000,,-131771000,,,,9322000,759981000,881862000,534923000,-128983000,,-260186000,26657000,56695,RUN
2017-12-31,15079000,,-275262000,482735000,125489000,253826000,91976000,-181133000,-181133000,,-92255000,,,,12353000,532542000,713675000,440566000,-94729000,,-287615000,125489000,56695,RUN
2016-12-31,10199000,,-264576000,389132000,75129000,261153000,83482000,-192076000,-192076000,,-73340000,,,,56263000,477107000,669183000,393625000,-72500000,,-320839000,75129000,56695,RUN
2019-12-31,,,-5742000,,-5822000,56052000,70607000,6224000,6224000,,-10728000,,,,80000,165432000,159208000,94825000,-11966000,,-5822000,-5822000,56696,FLL
2018-12-31,,,-3895000,,-4371000,54439000,70615000,7505000,7505000,,-10306000,,,,476000,163887000,156382000,93272000,-11400000,,-4371000,-4371000,56696,FLL
2017-12-31,,,-5178000,,-5028000,53485000,69143000,7056000,7056000,13000.0,-10856000,,,,-150000,161267000,154211000,92124000,-12234000,,-5028000,-5028000,56696,FLL
2016-12-31,,,-4464000,,-5094000,49756000,64817000,7133000,7133000,13000.0,-9486000,,,,630000,145992000,138859000,81175000,-11597000,,-5094000,-5094000,56696,FLL
2020-12-31,,,39761000,,31334000,228877000,283260000,0,39761000,12454000,,,,,8427000,296191000,256430000,12931000,0,,31334000,31334000,56698,GHL
2019-12-31,,,18423000,,10978000,211252000,250129000,0,18998000,17314000,,,,,7445000,273592000,254594000,23463000,-575000,,10978000,10978000,56698,GHL
2018-12-31,,,58430000,,39222000,227593000,306166000,0,62961000,12742000,,,,,19208000,329547000,266586000,23381000,-4531000,,39222000,39222000,56698,GHL
2017-12-31,,,-298000,,-26651000,189126000,209313000,0,-1630000,18703000,,,,,26353000,231984000,233614000,22671000,1332000,,-26651000,-26651000,56698,GHL
2019-12-31,,,29231569,,29231569,2591424,5218795,2627371,2627371,,,,,,0,5218795,2591424,0,26604198,,29231569,27285590,56700,SPE
2018-12-31,,,-10501015,,-10501015,2698019,3081360,383341,383341,,,,,,0,3081360,2698019,0,-10884356,,-10501015,-12446994,56700,SPE
2017-12-31,,,22949472,,22949472,2734487,6231313,3496826,3496826,,,,,,0,6231313,2734487,0,19452646,,22949472,21003493,56700,SPE
2016-12-31,,,11122001,,11122001,2598182,7950496,5352314,5352314,,,,,,0,7950496,2598182,0,5769687,,11122001,10447063,56700,SPE
2019-12-29,,,34225000,104164000,11375000,1501231000,1676127000,173879000,173879000,-3536000,-46349000,,,,15665000,4826549000,4652670000,3150422000,-139654000,,18560000,11375000,56702,COKE
2018-12-30,,,-13287000,96979000,-19930000,1482931000,1555712000,63932000,63932000,4349000,-50506000,,,,1869000,4625364000,4561432000,3069652000,-77219000,,-15156000,-19930000,56702,COKE
2017-12-31,,,63006000,92205000,96535000,1403635000,1504867000,101547000,101547000,-315000,-41869000,,,,-39841000,4287588000,4186041000,2782721000,-38541000,,102847000,96535000,56702,COKE
2017-01-01,,,92712000,85893000,50146000,1063412000,1189439000,127859000,127859000,-1832000,-36325000,,,,36049000,3130145000,3002286000,1940706000,-35147000,,56663000,50146000,56702,COKE
2019-12-31,15791000,,-19091000,10073000,-18112000,5794000,419000,-21166000,-21166000,,-302000,,,,24000,753000,21919000,334000,2075000,,-19115000,-18112000,56703,EVGN
2018-12-31,14686000,,-20782000,253000,-20758000,5598000,295000,-19989000,-19989000,,-302000,,,,30000,1747000,21736000,1452000,-793000,,-20812000,-20758000,56703,EVGN
2017-12-31,16987000,,-20827000,253000,-20838000,5496000,536000,-21947000,-21947000,,-302000,,,,11000,3381000,25328000,2845000,1120000,,-20838000,-20838000,56703,EVGN
2016-12-31,16405000,,-19556000,253000,-19592000,5585000,901000,-21089000,-21089000,,-302000,,,,36000,6540000,27629000,5639000,1533000,,-19592000,-19592000,56703,EVGN
2020-02-29,,,32965306,,32965306,17871255,84091273,66220018,66220018,,-14421753,,,,0,84091273,17871255,0,-33254712,,32965306,32965306,56704,VTA
2019-02-28,,,30805298,,30805298,18863943,78934275,60070332,60070332,,-14746449,,,,0,78934275,18863943,0,-29265034,,30805298,30805298,56704,VTA
2018-02-28,,,53962746,,53962746,18871075,82555898,63587325,63587325,97498.0,-10767740,,,,0,82555898,18968573,0,-9624579,,53962746,53962746,56704,VTA
2017-02-28,,,194171119,,194171119,18174308,91785565,73611257,73611257,97498.0,-7941268,,,,0,91785565,18174308,0,120559862,,194171119,194171119,56704,VTA
2019-12-31,10106000,,-222484000,,-217201000,109054000,220021000,-3726000,-3726000,2813000,-58389000,,,,-5283000,229526000,233252000,9505000,-218758000,,-217201000,-217201000,56705,ASRT
2018-12-31,8042000,,37975000,,36908000,119733000,237589000,63745000,63745000,-55705000,-68881000,,,,1067000,256065000,192320000,18476000,-25770000,,36908000,36908000,56705,ASRT
2017-12-31,13718000,,-103925000,,-102496000,203404000,308126000,-11741000,-11741000,-55705000,-73552000,,,,-1429000,380724000,392465000,72598000,-92184000,,-102496000,-102496000,56705,ASRT
2016-12-31,32631000,,-64502000,,-88720000,204620000,368483000,24387000,24387000,-55705000,-83719000,,,,24218000,455897000,431510000,87414000,-88851000,,-88720000,-88720000,56705,ASRT
2019-12-31,853000,,1145000,,1139000,8097000,10085000,1135000,1135000,,-12000,,,,6000,14436000,13301000,4351000,10000,,1139000,1139000,56706,CXDO
2018-12-31,801000,,-208000,,-223000,7494000,8089000,-206000,-206000,,-12000,,,,15000,11908000,12114000,3819000,-2000,,-223000,-223000,56706,CXDO
2017-12-31,750000,,-922000,,-929000,6905000,6921000,-734000,-734000,,-209000,,,,7000,10187000,10921000,3266000,-188000,,-929000,-929000,56706,CXDO
2016-12-31,826000,,-2780000,,-2792000,7431000,5494000,-2763000,-2763000,,-138000,,,,12000,9119000,11882000,3625000,-17000,,-2792000,-2792000,56706,CXDO
2020-08-31,,,8919147,,6750354,4249315,8911218,2938834,2938834,,,,,,2168793,25855215,22916381,16943997,5980313,,6750354,6750354,56707,PCYO
2019-08-31,,,3527953,,4811148,3106547,7386039,2998661,2998661,,,,,,-1283195,20361509,17362848,12975470,529292,,4811148,4811148,56707,PCYO
2018-08-31,,,132680,,414680,2837395,3449047,-308727,-308727,17700.0,,,,,-282000,6959199,7267926,3510152,441407,,414680,414680,56707,PCYO
2017-08-31,,,-1678843,,-1710868,2194244,804863,-2131202,-2131202,7500.0,,,,,0,1227787,3358989,422924,452359,-32025.0,-1678843,-1710868,56707,PCYO
2019-12-31,,,-22993058,,-25800045,13285355,-10009028,-23294383,-23294383,,-145445,,,,2806987,10596521,33890904,20605549,301325,,-25800045,-25800045,56708,GURE
2018-12-31,,,-83051841,,-69963986,12096624,-23040098,-35136722,-35136722,407973.0,-160422,,,,-13087855,2594941,37731663,25635039,-47915119,,-69963986,-69963986,56708,GURE
2017-12-31,195195.0,,11563453,,7953313,9674331,38340768,28133743,28133743,-281613.0,-164321,,,,3610140,107522441,79388698,69181673,-16570290,,7953313,7953313,56708,GURE
2016-12-31,261931.0,,48036038,,36225831,6552110,55263581,48883332,48883332,-433792.0,-174921,,,,11810207,149275002,100391670,94011421,-847294,,36225831,36225831,56708,GURE
2020-02-01,,,54748000,,42914000,256417000,311869000,55409000,55409000,,-191000,,,,11834000,1036551000,981142000,724682000,-661000,,42914000,42851000,56709,SCVL
2019-02-02,,,50357000,,38135000,259024000,308992000,49760000,49760000,,-150000,,,,12222000,1029650000,979890000,720658000,597000,,38135000,37983000,56709,SCVL
2018-02-03,,,37413000,,18933000,252641000,296269000,42801000,42801000,,-292000,,,,18480000,1019154000,976353000,722885000,-5388000,,18933000,18683000,56709,SCVL
2017-01-28,,,37749000,,23517000,245937000,289235000,42412000,42412000,,-169000,,,,14232000,1001102000,958690000,711867000,-4663000,,23517000,23030000,56709,SCVL
2020-03-31,21109000,,578812000,6364000,470717000,452190000,1032332000,559033000,559033000,,,,,,101084000,1221460000,662427000,189128000,19779000,,477728000,470717000,56710,CO
2019-03-31,14688000,,356461000,5427000,291124000,404382000,800727000,381657000,381657000,,,,,,61260000,986754000,605097000,186027000,-25196000,,295201000,291124000,56710,CO
2018-03-31,12718000,,303535000,5389000,237098000,462704000,755285000,279863000,279863000,,-3257000.0,,,,62656000,936768000,656905000,181483000,23672000,,240879000,237098000,56710,CO
2017-03-31,10367000,,166311000,4694000,126190000,368422000,600552000,221763000,221763000,,-119418000.0,,,,37622000,759978000,538215000,159426000,-55452000,,128689000,116171000,56710,CO
2019-12-31,,,-1673735,,-1673735,2434099,1709124,-1601651,-1601651,,-42000,,,,0,4183354,5785005,2474230,-72084,,-1673735,-1673735,56713,INDO
2018-12-31,,,140988,,145723,2016110,3315988,143384,143384,,-48662,,,,0,5856341,5712957,2540353,-2396,,140988,145723,56713,INDO
2017-12-31,,,-1619040,-158666.0,-1604105,1258069,892820,-1552466,-1552466,,-44430,,,,0,3703826,5256292,2811006,-66574,,-1619040,-1604105,56713,INDO
2016-12-31,,,-3219627,-166615.0,-3187447,870013,-870022,-2680903,-2680903,,-44430,,,,0,2446761,5127664,3316783,-538724,,-3219627,-3187447,56713,INDO
2019-12-31,5000000,,-104000000,413000000,-11000000,29000000,690000000,314000000,314000000,,-404000000,,,,-8000000,1032000000,718000000,342000000,-418000000,,-96000000,-11000000,56715,CWEN
2018-12-31,3000000,,112000000,402000000,48000000,20000000,721000000,367000000,367000000,,-306000000,,,,62000000,1053000000,686000000,332000000,-255000000,,50000000,48000000,56715,CWEN
2017-12-31,3000000,,41000000,412000000,-16000000,19000000,683000000,330000000,330000000,,-307000000,,,,72000000,1009000000,679000000,326000000,-289000000,,-31000000,-16000000,56715,CWEN
2016-12-31,3000000,,5000000,749000000,57000000,16000000,727000000,408000000,408000000,,-284000000,,,,-1000000,1035000000,627000000,308000000,-403000000,,6000000,57000000,56715,CWEN
2020-12-31,4207000000,,8133000000,,7264000000,5730000000,19265000000,9328000000,9328000000,,-1038000000,,,,869000000,25424000000,16096000000,6159000000,-1195000000,,7264000000,7264000000,56716,AMGN
2019-12-31,4116000000,,9138000000,,7842000000,5150000000,19006000000,9721000000,9721000000,19000000.0,-1289000000,,,,1296000000,23362000000,13641000000,4356000000,-583000000,,7842000000,7842000000,56716,AMGN
2018-12-31,3737000000,,9545000000,,8394000000,5332000000,19646000000,10551000000,10551000000,26000000.0,-1392000000,,,,1151000000,23747000000,13196000000,4101000000,-1006000000,,8394000000,8394000000,56716,AMGN
2017-12-31,3562000000,,9597000000,,1979000000,4870000000,18780000000,10340000000,10340000000,8000000.0,-1303000000,,,,7618000000,22849000000,12509000000,4069000000,-743000000,,1979000000,1979000000,56716,AMGN
2019-12-31,894411000,,-1267703000,583976000,-1288973000,1791013000,1190249000,-1495175000,-1495175000,,-46543000,,,,35867000,6777922000,8273097000,5587673000,227472000,,-1303570000,-1288973000,56718,BILI
2018-12-31,537488000,,-603638000,240406000,-616325000,1046923000,855438000,-728973000,-728973000,,-46543000,,,,25988000,4128931000,4857904000,3273493000,125335000,,-629626000,-616325000,56718,BILI
2017-12-31,280093000,,-562667000,240406000,-571548000,493387000,549208000,-224272000,-224272000,,-46543000,,,,8881000,2468449000,2692721000,1919241000,-338395000,,-571548000,-571548000,56718,BILI
2016-12-31,91222000,,-1183439000,357000,-1185150000,553993000,-249502000,-894717000,-894717000,,-46543000,,,,3141000,523310000,1418027000,772812000,-288722000,,-1186580000,-1185150000,56718,BILI
2019-12-31,,,-5485553,5174267,-5048579,24182407,28588452,-2774044,-2774044,,-3070071,,,,0,163365565,166139609,134777113,-2711509,,-5485553,-11445628,56719,VTNR
2018-12-31,,,-1983579,1438213,-2217767,21927264,29406622,488348,488348,,-3281855,,,,0,180720661,180232313,151314039,-2471927,,-1983579,-8037304,56719,VTNR
2017-12-31,,,-8412548,399005,-8433233,21685542,21272603,-7056263,-7056263,,-3483062,,,,-274423,145499092,152555355,124226489,-1356285,,-8138125,-11824602,56719,VTNR
2016-12-31,,,-4068288,103897,-3952821,20154399,16319100,-10112514,-10112514,,-3094956,,,,-117646,98078914,108191428,81759814,6044226,,-3950642,-15537395,56719,VTNR
2019-12-31,,,86129000,,57315000,30929000,277040000,113900000,113900000,3743000,-25591000,,,,30372000,606850000,492950000,329810000,-27771000,,55757000,57315000,56720,SSRM
2018-12-31,,,8090000,31829000.0,6379000,32941000,175564000,23665000,23665000,3459000,-28202000,,,,8121000,420675000,397010000,245111000,-15575000,,-31000,6379000,56720,SSRM
2017-12-31,,,74587000,23043000.0,69316000,20307000,109069000,72798000,72798000,-923000,-28382000,,,,3121000,448773000,375975000,339704000,1789000,,71466000,69316000,56720,SSRM
2016-12-31,,,80985000,23043000.0,64957000,22091000,161210000,119430000,119430000,5136000,-20101000,,,,16028000,490986000,371556000,329776000,-38445000,,64957000,64957000,56720,SSRM
2019-12-31,25342000,,-50874000,,-50874000,25213000,0,-50555000,-50555000,,-1616000,,,,0,0,50555000,0,-319000,,-50874000,-50874000,56721,ELOX
2018-12-31,20489000,,-47063000,,-47185000,26482000,0,-46971000,-46971000,,-7000,,,,122000,0,46971000,0,-92000,,-47185000,-47185000,56721,ELOX
2017-12-31,16398000,,-21214000,,-21214000,2702000,0,-19100000,-19100000,,-43000,,,,0,0,19100000,0,-2114000,,-21214000,-23618000,56721,ELOX
2016-12-31,8886000,,-9847000,,-9847000,954000,0,-9840000,-9840000,,-43000,,,,0,0,9840000,0,-7000,,-9847000,-10947000,56721,ELOX
2020-11-01,1589000000,,3835000000,7000000,2751000000,2747000000,8955000000,4548000000,4548000000,71000000,-305000000,,,,1082000000,35514000000,30966000000,26559000000,-713000000,,2753000000,2751000000,56722,DE
2019-11-03,1782000000,,4109000000,18000000,3253000000,3008000000,9187000000,4310000000,4310000000,87000000,-232000000,,,,852000000,39233000000,34923000000,30046000000,-201000000,,3257000000,3253000000,56722,DE
2018-10-28,1658000000,,4098000000,17000000,2368000000,2897000000,8985000000,4159000000,4159000000,271000000,-268000000,,,,1727000000,37318000000,33159000000,28333000000,-61000000,,2371000000,2368000000,56722,DE
2017-10-29,1356680000,,3130000000,17200000,2159000000,2493920000,6777600000,2926000000,2926000000,1000000,-230000000,,,,971000000,29071000000,26145000000,22293400000,204000000,,2159000000,2159000000,56722,DE
2019-12-31,343919000,,-95815000,,-124842000,645082000,865643000,-141147000,-141147000,17789000,,,,,29027000,1578173000,1719320000,712530000,45332000,,-124842000,-124842000,56725,SHOP
2018-12-31,226263000,,-64553000,,-64553000,454091000,596267000,-91920000,-91920000,7833000,,,,,0,1073229000,1165149000,476962000,27367000,,-64553000,-64553000,56725,SHOP
2017-12-31,132775000,,-39995000,,-39995000,290775000,380253000,-49157000,-49157000,5860000,,,,,0,673304000,722461000,293051000,9162000,,-39995000,-39995000,56725,SHOP
2016-12-31,73290000,,-35355000,,-35355000,171536000,209495000,-37165000,-37165000,1834000,,,,,0,389330000,426495000,179835000,1810000,,-35355000,-35355000,56725,SHOP
2020-12-31,,,-4259000000,19000000,-5510000000,706000000,15936000000,2228000000,2228000000,,-1392000000,,,,1237000000,45753000000,43525000000,29817000000,-6487000000,,-5496000000,-5510000000,56726,EQNR
2019-12-31,,,9292000000,20000000,1843000000,927000000,23719000000,10714000000,10714000000,456000000.0,-733000000,,,,7441000000,62911000000,52197000000,39192000000,-1422000000,,1851000000,1843000000,56726,EQNR
2018-12-31,,,18873000000,19000000,7535000000,798000000,30512000000,17994000000,17994000000,461000000.0,-411000000,,,,11335000000,78556000000,60562000000,48044000000,879000000,,7538000000,7535000000,56726,EQNR
2017-12-31,,,13420000000,24000000,4590000000,738000000,23997000000,12088000000,12088000000,413000000.0,-889000000,,,,8822000000,60972000000,48884000000,36975000000,1332000000,,4598000000,4590000000,56726,EQNR
2019-12-31,26064000,,-24446000,,-25834000,30090000,37618000,-18536000,-18536000,,-1522000,,,,1388000,116251000,134787000,78633000,-5910000,,-25834000,-25834000,56730,SONM
2018-12-31,23247000,,2031000,,1277000,19448000,48089000,5394000,5394000,,-1828000,,,,754000,135665000,130271000,87576000,-3363000,,1277000,-8875000,56730,SONM
2017-12-31,13008000,,-8385000,,-8519000,14073000,20311000,-6770000,-6770000,,-820000,,,,134000,59031000,65801000,38720000,-1615000,,-8519000,-15355000,56730,SONM
2020-12-31,48590000,,-51834000,,-51923000,63621000,65140000,-47071000,-47071000,,-5413000,,,,89000,138923000,185994000,73783000,-4763000,,-51923000,-51923000,56732,PI
2019-12-31,38880000,,-22789000,,-22987000,56783000,74002000,-21661000,-21661000,,-1794000,,,,198000,152836000,174497000,78834000,-1128000,,-22987000,-22987000,56732,PI
2018-12-31,34168000,,-35464000,,-35231000,55233000,58281000,-31120000,-31120000,,-1403000,,,,-233000,122633000,153753000,64352000,-4344000,,-35231000,-35231000,56732,PI
2017-12-31,32220000,,-17419000,,-17322000,49740000,64941000,-17019000,-17019000,,-908000,,,,-97000,125300000,142319000,60359000,-400000,,-17322000,-17322000,56732,PI
2019-12-31,,,390622000,48205000,278115000,117180000,560052000,443850000,443850000,-978000,-71492000,,,,110019000,1943655000,1499805000,1383603000,-53228000,,280603000,278115000,56733,SQM
2018-12-31,,,621038000,52311000,439830000,118126000,780172000,668005000,668005000,-5959000,-55666000,,,,178975000,2265803000,1597798000,1485631000,-46967000,,442063000,439830000,56733,SQM
2017-12-31,,,594590000,59647000,427697000,101171000,762501000,656622000,656622000,4708000,-48643000,,,,166173000,2157323000,1500701000,1394822000,-62032000,,428417000,427697000,56733,SQM
2016-12-31,,,414889000,61198000,278290000,88436000,610222000,471873000,471873000,49913000,-57438000,,,,132965000,1939322000,1467449000,1329100000,-56984000,,281924000,278290000,56733,SQM
2019-12-31,,,-50940000,,-51142000,18961000,58597000,12277000,12277000,2026000,-39789000,,,,202000,76028000,63751000,17431000,-63217000,,-51142000,27676000,56734,SNMP
2018-12-31,,,15881000,,15691000,25591000,63426000,10251000,10251000,1597000,-10961000,,,,190000,82506000,72255000,19080000,5630000,,15691000,-23592000,56734,SNMP
2017-12-31,,,-3040000,,-3040000,26028000,62902000,-4317000,-4317000,1673000,-8341000,,,,0,86673000,90990000,23771000,1277000,,-3040000,-40711000,56734,SNMP
2016-12-31,,,19231000,,19231000,24842000,41731000,-25683000,-25683000,1127000,-5093000,,,,0,69518000,95201000,27787000,44914000,,19231000,-44484000,56734,SNMP
2019-12-31,12453000,,9222000,,6643000,56805000,78469000,9211000,9211000,,,,,,2579000,113871000,104660000,35402000,11000,,6643000,439000,56735,PUBM
2018-12-31,12619000,,5630000,,4425000,50442000,68029000,4968000,4968000,,,,,,1205000,99264000,94296000,31235000,662000,,6643000,439000,56735,PUBM
2019-12-31,,,-44475000,,-81306000,33126000,365402000,43144000,43144000,144620000,-65680000,,,,36218000,1717763000,1674619000,1352361000,-87619000,,-80693000,-81306000,56736,ATTO
2018-12-31,,,33900000,8541000.0,18540000,81758000,396219000,77331000,77331000,140853000,-43351000,,,,13414000,1818360000,1741029000,1422141000,-43431000,,20486000,18540000,56736,ATTO
2017-12-31,,,-1035000,9476000.0,-16790000,78812000,429597000,98416000,98416000,150121000,-52404000,,,,12533000,1921683000,1823267000,1492086000,-99451000,,-13568000,-16790000,56736,ATTO
2016-12-31,,,8564000,-718000.0,65000,72479000,385375000,74814000,74814000,138816000,-75090000,,,,5207000,1757498000,1682684000,1372123000,-66250000,-3206000.0,3357000,65000,56736,ATTO
2020-03-31,,,95959000,,69082000,262430000,373712000,97266000,97266000,,-294000,,,,26877000,1588404000,1491138000,1214692000,-1307000,,69082000,69082000,56737,PLUS
2019-03-31,,,86230000,,63192000,224262000,317458000,81384000,81384000,,-294000,,,,23038000,1372673000,1291289000,1055215000,4846000,,63192000,63192000,56737,PLUS
2018-03-31,,,83891000,,55122000,213407000,309137000,85812000,85812000,,-294000,,,,28769000,1418802000,1332990000,1109665000,-1921000,,55122000,55122000,56737,PLUS
2017-03-31,,,86112000,,50556000,193594000,286569000,85732000,85732000,,-294000,,,,35556000,1331778000,1246046000,1045209000,380000,,50556000,50556000,56737,PLUS
2019-12-31,,,346403000,505000,345673000,6354000,58184000,24456000,24456000,,-12175000,,,,882000,139989000,115533000,81805000,321947000,,345521000,322696000,56740,CMCT
2018-12-31,,,2067000,837000,1121000,9167000,91180000,28785000,28785000,,-26894000,,,,925000,196486000,167701000,105306000,-26718000,,1142000,-14298000,56740,CMCT
2017-12-31,,,381134000,890000,379737000,5479000,85296000,21453000,21453000,,-34484000,,,,1376000,228677000,207224000,143381000,359681000,,379758000,377813000,56740,CMCT
2016-12-31,,,32358000,912000,34547000,7961000,107006000,27077000,27077000,,-34385000,,,,1646000,265931000,238854000,158925000,5281000,3853000.0,30712000,34538000,56740,CMCT
2020-06-30,,,-1524000000,807000000,-1269000000,3065000000,4081000000,372000000,372000000,,-25000000,,,,21000000,9008000000,8636000000,4927000000,-1896000000,,-1545000000,-1269000000,56742,NWSA
2019-06-30,,,354000000,1167000000,155000000,3177000000,4435000000,599000000,599000000,,-59000000,,,,126000000,10074000000,9475000000,5639000000,-245000000,,228000000,155000000,56742,NWSA
2018-06-30,,,-1089000000,1186000000,-1514000000,3081000000,4120000000,567000000,567000000,,-7000000,,,,355000000,9024000000,8457000000,4904000000,-1656000000,,-1444000000,-1516000000,56742,NWSA
2017-06-30,,,-615000000,284000000,-738000000,2710000000,3610000000,451000000,451000000,,-7000000,,,,28000000,8139000000,7688000000,4529000000,-1066000000,,-643000000,-740000000,56742,NWSA
2019-12-31,9089000,,-17816000,-31000,-17788000,6593000,0,-15682000,-15682000,,-2863000,,,,-28000,0,15682000,0,-2134000,,-17788000,-17788000,56744,BPTS
2018-12-31,9513000,,-14059000,-31000,-13987000,4348000,0,-13861000,-13861000,,-223000,,,,-72000,0,13861000,0,-198000,,-13987000,-13987000,56744,BPTS
2017-12-31,7043000,,-11408000,-31000,-11408000,2865000,0,-9908000,-9908000,,-3263000,,,,0,0,9908000,0,-1500000,,-11408000,-11408000,56744,BPTS
2016-12-31,5121000,,-7954000,-30000,-7954000,2820000,0,-7941000,-7941000,,-33000,,,,0,0,7941000,0,-13000,,-7954000,-7954000,56744,BPTS
2020-06-30,7042385,,-19840282,10614526,-19246701,30537512,19606396,-20177032,-20177032,,-1451890,,,,282322,65760651,85937683,46154255,336750,,-20122604,-19246701,56745,RCON
2019-06-30,3133545,,-25383929,11085429,-25355905,50364617,29865364,-24243574,-24243574,,-1589045,,,,398477,102384327,126627901,72518963,-1140355,,-25782406,-25355905,56745,RCON
2018-06-30,3215653,,-45359004,10861930,-44072321,42700670,4150185,-40924896,-40924896,,-897521,,,,16230,84712046,125636942,80561861,-4434108,,-45375234,-44072321,56745,RCON
2017-06-30,7599340,,-30895901,8464843,-31445147,37209360,15963502,-30611484,-30611484,,-548878,,,,307900,60054462,90665946,44090960,-284417,,-31203801,-31445147,56745,RCON
2019-12-31,16497000,,-33592000,,-33592000,15327000,1227000,-30597000,-30597000,,,,,,0,3379000,33976000,2152000,-2995000,,-33592000,-33592000,56746,EYES
2018-12-31,14605000,,-35094000,,-35094000,22028000,2008000,-34625000,-34625000,,,,,,0,6896000,41521000,4888000,-469000,,-35094000,-35094000,56746,EYES
2017-12-31,10955000,,-28516000,,-28516000,20501000,2847000,-28609000,-28609000,,,,,,0,7964000,36573000,5117000,93000,,-28516000,-28516000,56746,EYES
2016-12-31,8050000,,-33179000,,-33179000,19069000,-6091000,-33210000,-33210000,,,,,,0,3985000,37195000,10076000,31000,,-33179000,-33179000,56746,EYES
2020-09-29,,,-12794000,1293000,-13916000,7100000,15780000,3520000,3520000,,-755000,,,,0,109858000,106338000,94078000,-16314000,,-12794000,-13916000,56748,GTIM
2019-09-24,,,-4248000,1522000,-5137000,8063000,14461000,279000,279000,,-756000,,,,0,110755000,110476000,96294000,-4527000,,-4248000,-5137000,56748,GTIM
2018-09-25,,,-17000,3238000,-1034000,7857000,14755000,409000,409000,,-392000,,,,0,99571000,99162000,84816000,-426000,,-17000,-1034000,56748,GTIM
2017-09-26,,,-1605000,2713000,-2255000,7002000,11261000,-1226000,-1226000,,-191000,,,,0,79080000,80306000,67819000,-379000,,-1605000,-2255000,56748,GTIM
2020-09-30,34361000,,-12852000,,-13664000,67805000,95560000,-6606000,-6606000,,-6322000,,,,812000,161056000,167662000,65496000,-6246000,,-13664000,-13664000,56749,MODN
2019-09-30,30009000,,-18263000,,-19293000,60107000,75105000,-15011000,-15011000,,-2933000,,,,1030000,141235000,156246000,66130000,-3252000,,-19293000,-19293000,56749,MODN
2018-09-30,32416000,,-28234000,,-28207000,77660000,89298000,-20778000,-20778000,,-8178000,,,,-27000,154632000,175410000,65334000,-7456000,,-28207000,-28207000,56749,MODN
2017-09-30,31064000,,-42832000,,-39547000,75420000,70073000,-36411000,-36411000,,-4159000,,,,-3285000,131169000,167580000,61096000,-6421000,,-39547000,-39547000,56749,MODN
2020-12-31,58063000,,19139000,,17816000,99583000,175686000,18040000,18040000,,-1000,,,,1323000,225527000,207487000,49841000,1099000,,17816000,17816000,56752,ATEN
2019-12-31,61824000,,-16412000,,-17819000,116487000,163747000,-14564000,-14564000,,-237000,,,,1407000,212628000,227192000,48881000,-1848000,,-17819000,-17819000,56752,ATEN
2018-12-31,65157000,,-26535000,,-27617000,142849000,180327000,-27679000,-27679000,,-129000,,,,1082000,232223000,259902000,51896000,1144000,,-27617000,-27617000,56752,ATEN
2017-12-31,62991000,,-9545000,,-10751000,129492000,182111000,-10372000,-10372000,,-162000,,,,1206000,235429000,245801000,53318000,827000,,-10751000,-10751000,56752,ATEN
2020-12-31,,,4159000000,,4778000000,,4159000000,4159000000,4159000000,,,,,,-619000000,22147000000,17988000000,17988000000,0,,4778000000,4778000000,56760,AFL
2019-12-31,,,4445000000,,3304000000,3089000000.0,7762000000,4673000000,4673000000,,-228000000.0,,,,1141000000,22307000000,17634000000,14545000000,-228000000,,3304000000,3304000000,56760,AFL
2018-12-31,,,3983000000,,2920000000,2988000000.0,7193000000,4205000000,4205000000,,-222000000.0,,,,1063000000,21758000000,17553000000,14565000000,-222000000,,2920000000,2920000000,56760,AFL
2017-12-31,,,4018000000,,4604000000,2780000000.0,7038000000,4258000000,4258000000,,-240000000.0,,,,-586000000,21667000000,17409000000,14629000000,-240000000,,4604000000,4604000000,56760,AFL
2019-12-31,,,78942392,,78942392,2981343,5211844,2230501,2230501,,,,,,0,5211844,2981343,0,76711891,,78942392,78942392,56761,GF
2018-12-31,,,-68166617,,-68166617,3798213,5506528,1708315,1708315,,,,,,0,5506528,3798213,0,-69874932,,-68166617,-68166617,56761,GF
2017-12-31,,,115406630,,115406630,3427794,11414211,7986417,7986417,,,,,,0,11414211,3427794,0,107420213,,115406630,115406630,56761,GF
2016-12-31,,,-663601,,-663601,2989440,4858938,1869498,1869498,,,,,,0,4858938,2989440,0,-2533099,,-663601,-663601,56761,GF
2020-12-31,,,1797000000,,1427000000,3536000000,6515000000,0,1797000000,1182000000,,,,,370000000,6515000000,4718000000,0,0,,1427000000,1317000000,56764,FITBO
2019-12-31,,,3202000000,,2512000000,3412000000,7893000000,0,3457000000,1024000000,,,,,690000000,7893000000,4436000000,0,-255000000,,2512000000,2398000000,56764,FITBO
2018-12-31,,,2765000000,,2193000000,3031000000,6772000000,0,2841000000,900000000,,,,,572000000,6772000000,3931000000,0,-76000000,,2193000000,2095000000,56764,FITBO
2017-12-31,,,2979000000,20000000.0,2180000000,2847000000,6820000000,0,3052000000,921000000,,,,,799000000,6820000000,3768000000,0,-73000000,,2180000000,2082000000,56764,FITBO
2019-12-31,11671000,,-16943000,,-16943000,7012000,0,-18683000,-18683000,,,,,,0,0,18683000,0,1740000,,-16943000,-22269000,56765,CABA
2018-12-31,4467000,,-12202000,,-12202000,1726000,0,-6193000,-6193000,,,,,,0,0,6193000,0,-6009000,,-12202000,-12202000,56765,CABA
2017-12-31,4467000,,-333333,,-333333,333333,0,-333333,-333333,,,,,,0,0,333333,0,0,,-333333,-333333,56765,CABA
2019-12-31,66170000,,-65720000,,-65144000,30973000,38976000,-59835000,-59835000,1668000,-11437000,,,,-576000,38976000,98811000,0,-5885000,,-65144000,-65144000,56770,GNFT
2018-12-31,67024000,,-79875000,,-79521000,9793000,7494000,-69487000,-69487000,164000,-10976000,,,,-354000,7494000,76981000,0,-10388000,,-79521000,-79521000,56770,GNFT
2017-12-31,54189000,,-59148000,,-55728000,9421000,6856000,-56686000,-56686000,-68000,-2319000,,,,-3420000,6856000,63542000,0,-2462000,,-55728000,-55728000,56770,GNFT
2016-12-31,32959000,,-33632000,,-33667000,7938000,6659000,-34158000,-34158000,-80000,-110000,,,,35000,6659000,40817000,0,526000,,-33667000,-33667000,56770,GNFT
2020-03-28,218277000,,-896583000,,-827182000,595463000,738096000,-75644000,-75644000,,-92640000,,,,-69401000,1696990000,1772634000,958894000,-820939000,,-827182000,-827182000,56773,PLT
2019-03-30,201886000,,-185692000,,-135561000,567879000,725591000,-44174000,-44174000,,-83000000,,,,-50131000,1674535000,1718709000,948944000,-141518000,,-135561000,-135561000,56773,PLT
2018-03-31,84193000,,100227000,,-869000,229390000,439115000,125532000,125532000,,-29297000,,,,101096000,856903000,731371000,417788000,-25305000,,-869000,-869000,56773,PLT
2017-03-31,88318000,,101665000,,82599000,223830000,441370000,129222000,129222000,,-29230000,,,,19066000,881176000,751954000,439806000,-27557000,,82599000,82599000,56773,PLT
2020-02-01,,,-32697000,,-31197000,98030000,108576000,-8850000,-8850000,,-6962000,,,,-1500000,196462000,205312000,87886000,-23847000,,-31197000,-31197000,56774,DTEA
2019-02-02,,,-28657000,,-33539000,99488000,97979000,-10263000,-10263000,552000.0,-1300000,,,,4882000,212753000,223016000,114774000,-18394000,,-33539000,-33539000,56774,DTEA
2018-02-03,,,-26491000,,-28501000,96987000,107243000,-7503000,-7503000,7854000.0,-1300000,,,,2010000,224015000,231518000,116772000,-18988000,,-28501000,-28501000,56774,DTEA
2017-01-28,,,-5903000,,-3668000,89082000,108450000,2401000,2401000,8140000.0,-75000,,,,-2235000,215984000,213583000,107534000,-8304000,,-3668000,-3668000,56774,DTEA
2019-12-31,25765533,,-41975811,,-34959312,12294739,3922134,-34026849,-34026849,-111289,-184762,,,,-7016499,21882228,55909077,17960094,-7948962,,-34959312,-32560958,56775,FSTX
2018-12-31,25765533,,15904730,,13268598,398926,16104171,15705245,15705245,-111289,-184762,,,,2636132,29996604,14291359,13892433,199485,,13268598,13268598,56775,FSTX
2017-12-31,25765533,,4136124,,3479260,616048,4681511,4065463,4065463,-111289,-184762,,,,656864,11027179,6961716,6345668,70661,,3479260,3479260,56775,FSTX
2019-12-31,372818000,,255192000,1259432000,-70542000,800630000,1669527000,496079000,496079000,,-34595000,,,,146465000,2162955000,1666876000,493428000,-240887000,,108727000,-70542000,56776,SINA
2018-12-31,345942000,,555410000,1045081000,125562000,820146000,1656287000,490199000,490199000,,-20749000,,,,129084000,2108327000,1618128000,452040000,65211000,,426326000,125562000,56776,SINA
2017-12-31,267392000,,424239000,752887000,156569000,513779000,1169747000,388576000,388576000,,-4557000,,,,74676000,1583884000,1195308000,414137000,35663000,,349563000,156569000,56776,SINA
2016-12-31,216228000,,304527000,411389000,225087000,346542000,676240000,113470000,113470000,,-13118000,,,,27219000,1030936000,917466000,354696000,191057000,,277308000,225087000,56776,SINA
2020-12-31,,,140737000,18164000,137670000,123787000,264524000,0,140737000,,,,,,323000,264524000,123787000,0,0,,140414000,137670000,56778,BXMT
2019-12-31,,,306887000,22098000,305567000,117289000,424176000,0,306887000,,,,,,-506000,424176000,117289000,0,0,,307393000,305567000,56778,BXMT
2018-12-31,,,286121000,10483000,285078000,110363000,396484000,0,286121000,,,,,,308000,396484000,110363000,0,0,,285813000,285078000,56778,BXMT
2017-12-31,,,218282000,6340000,217631000,84763000,303045000,0,218282000,,,,,,314000,303045000,84763000,0,0,,217968000,217631000,56778,BXMT
2019-12-31,,,-5836652,,2947196,1958748,1133349,-5850433,-5850433,,-9742,,,,0,4113077,9963510,2979728,13781,8783848,-5836652,2947196,56779,PLAG
2018-12-31,,,-149081,-1019552.0,20589664,889084,304659,-584425,-584425,,-13,,,,164384,6828887,7413312,6524228,435344,17144686,-313465,20589664,56779,PLAG
2017-12-31,,,-47190910,-7745353.0,-63232092,40998360,-354981,-41353341,-41353341,,-4076495,,,,161192,5109998,46463339,5464979,-5837569,-30953252,-47352102,-63232092,56779,PLAG
2016-12-31,,,-85274517,7327909.0,-135973101,46922829,-10336427,-57259256,-57259256,,-4569019,,,,1898616,79666740,136925996,90003167,-28015261,-49187947,-87173133,-135973101,56779,PLAG
2019-12-31,32497000,,-21343000,,-21903000,85646000,109279000,-8864000,-8864000,,,,,,560000,184455000,193319000,75176000,-12479000,,-21903000,-21903000,56780,BCOV
2018-12-31,31716000,,-13427000,,-14028000,78878000,98209000,-12385000,-12385000,,,,,,601000,164833000,177218000,66624000,-1042000,,-14028000,-14028000,56780,BCOV
2017-12-31,31850000,,-19149000,,-19519000,79141000,91295000,-19696000,-19696000,,,,,,370000,155913000,175609000,64618000,547000,,-19519000,-19519000,56780,BCOV
2016-12-31,30171000,,-9576000,,-9986000,73205000,94419000,-8957000,-8957000,,-63000.0,,,,410000,150266000,159223000,55847000,-619000,,-9986000,-9986000,56780,BCOV
2019-12-31,16549693,,-21899054,,-21899054,5521754,0,-22071447,-22071447,,,,,,0,0,22071447,0,172393,,-21899054,-21900323,56785,ATNM
2018-12-31,17094778,,-23653963,,-23653963,6732544,0,-23827322,-23827322,,,,,,0,0,23827322,0,173359,,-23653963,-23653963,56785,ATNM
2017-12-31,17719855,,-26601235,,-26601235,9190933,0,-26910788,-26910788,,,,,,0,0,26910788,0,309553,,-26601235,-26601235,56785,ATNM
2016-12-31,17828287,,-24321724,,-24321724,9019194,0,-26847481,-26847481,,-5007.0,,,,0,0,26847481,0,2525757,,-24321724,-24321724,56785,ATNM
2019-12-31,24961000,,-46971000,,-46971000,22327000,0,-47954000,-47954000,,,,,,0,0,47954000,0,983000,,-46971000,-46971000,56787,PLSE
2018-12-31,17253000,,-37545000,,-37545000,20045000,0,-37963000,-37963000,,,,,,0,0,37963000,0,418000,,-37545000,-37545000,56787,PLSE
2017-12-31,9646000,,-25567000,,-25567000,15503000,0,-25814000,-25814000,,,,,,0,0,25814000,0,247000,,-25567000,-25567000,56787,PLSE
2016-12-31,5506000,,-9518000,,-9518000,3415000,0,-9586000,-9586000,,,,,,0,0,9586000,0,68000,,-9518000,-9518000,56787,PLSE
2020-10-31,,,31998928,,31998928,7902303,9059824,1216413,1216413,-58892,-2963705,,,,0,9059824,7843411,0,30782515,,31998928,31998928,56788,GLO
2019-10-31,,,31694286,,31694286,7863119,12662837,4498607,4498607,301111,-5899650,,,,0,12662837,8164230,0,27195679,,31694286,31694286,56788,GLO
2018-10-31,,,-9450608,,-9450608,8978899,14959384,5919300,5919300,61185,-5963609,,,,0,14959384,9040084,0,-15369908,,-9450608,-9450608,56788,GLO
2017-10-31,,,107779626,,107779626,13401669,18142573,4740904,4740904,61185,-5530980,,,,0,18142573,13401669,0,103038722,,107779626,107779626,56788,GLO
2020-12-31,,,-2076000000,9846000000,-8771000000,21130000000,31840000000,0,8332000000,2378000000,,,,,5632000000,31840000000,23508000000,0,-10408000000,,-7708000000,-8771000000,56793,SAN
2019-12-31,,,12543000000,10588000000,6515000000,22758000000,40936000000,0,14152000000,4026000000,,,,,4427000000,40936000000,26784000000,0,-1609000000,,8116000000,5920000000,56793,SAN
2018-12-31,,,14201000000,10889000000,7810000000,22222000000,39326000000,0,14334000000,2770000000,,,,,4886000000,39326000000,24992000000,0,-133000000,,9315000000,7250000000,56793,SAN
2017-12-31,,,12091000000,12344000000,6619000000,22410000000,39402000000,0,13236000000,3756000000,,,,,3884000000,39402000000,26166000000,0,-1145000000,,8207000000,6224000000,56793,SAN
2020-12-31,,,1002300000,,788500000,2022400000,3210100000,1187700000,1187700000,,-154900000,,,,213800000,18467500000,17279800000,15257400000,-185400000,,788500000,788500000,56794,CDW
2019-12-31,,,949700000,,736800000,1906300000,3039900000,1133600000,1133600000,,-159400000,,,,212900000,18032400000,16898800000,14992500000,-183900000,,736800000,736800000,56794,CDW
2018-12-31,,,840500000,,643000000,1719600000,2706900000,987300000,987300000,,-148600000,,,,197500000,16240500000,15253200000,13533600000,-146800000,,643000000,643000000,56794,CDW
2017-12-31,,,660700000,,523100000,1583700000,2450200000,866500000,866500000,,-150500000,,,,137600000,14832900000,13966400000,12382700000,-263200000,,523100000,523100000,56794,CDW
2020-02-29,,,93084171,,93084171,7235072,49455383,42220311,42220311,,-10911132,,,,0,49455383,7235072,0,50863860,,93084171,93084171,56795,VKQ
2019-02-28,,,22751336,,22751336,7162620,50941043,43682934,43682934,95489.0,-10159097,,,,0,50941043,7258109,0,-20931598,,22751336,22751336,56795,VKQ
2018-02-28,,,26244008,,26244008,7275369,56051783,48501335,48501335,275079.0,-9170847,,,,0,56051783,7550448,0,-22257327,,26244008,26244008,56795,VKQ
2017-02-28,,,2669933,,2669933,7501739,56488860,48868612,48868612,118509.0,-6947867,,,,0,56488860,7620248,0,-46198679,,2669933,2669933,56795,VKQ
2020-12-31,,,-17642129000,105556000,-10724828000,3528178000,11588970000,8118288000,8118288000,-57496000,-3377359000,,,,-6927194000,30460277000,22341989000,18871307000,-25760417000,,-10714935000,-10724828000,56797,SUZ
2019-12-31,,,-4097203000,115339000,-2817518000,3078637000,7448371000,4430511000,4430511000,-60777000,-3579448000,,,,-1282461000,26012950000,21582439000,18564579000,-8527714000,,-2814742000,-2817518000,56797,SUZ
2018-12-31,,,165298000,13928000,319693000,1423935000,6521045000,5090821000,5090821000,6289000,-1077984000,,,,-154516000,13443376000,8352555000,6922331000,-4925523000,,319814000,319693000,56797,SUZ
2017-12-31,,,2259612000,13928000,1820994000,952299000,4084369000,3136192000,3136192000,-4122000,-1037899000,,,,438618000,10580673000,7444481000,6496304000,-876580000,,1820994000,1820994000,56797,SUZ
2020-04-30,,,-8857859,,-8857859,2315524,15620529,13305005,13305005,,-2818272,,,,0,15620529,2315524,0,-22162864,,-8857859,-8857859,56799,MHD
2019-04-30,,,14605592,,14605592,2316973,17233858,14916885,14916885,,-3391975,,,,0,17233858,2316973,0,-311293,,14605592,14605592,56799,MHD
2018-04-30,,,7049855,,7049855,2418385,17647742,15229357,15229357,,-2772539,,,,0,17647742,2418385,0,-8179502,,7049855,7049855,56799,MHD
2017-04-30,,,-1811757,,-1811757,2460309,18052667,15592358,15592358,,-2168747,,,,0,18052667,2460309,0,-17404115,,-1811757,-1811757,56799,MHD
2019-12-31,,,53683000,112480000,48844000,17831000,218990000,103145000,103145000,455000,-61687000,,,,0,295040000,191895000,76050000,-49462000,,53683000,48391000,56801,ROIC
2018-12-31,,,47141000,120214000,42736000,14918000,219598000,103364000,103364000,478000,-62113000,,,,0,295798000,192434000,76200000,-56223000,,47141000,42335000,56801,ROIC
2017-12-31,,,42688000,125674000,38477000,14103000,204446000,93669000,93669000,418000,-50977000,,,,0,273260000,179591000,68814000,-50981000,,42688000,38158000,56801,ROIC
2016-12-31,,,36430000,127324000,32754000,13120000,179930000,77995000,77995000,456000,-40741000,,,,0,237189000,159194000,57259000,-41565000,,36430000,32484000,56801,ROIC
2020-11-30,,,6499255,,6499255,1120811,5693760,4572949,4572949,,-694394,,,,0,5693760,1120811,0,1926306,,6499255,6499255,56802,CEV
2019-11-30,,,12272853,,12272853,1104574,5989437,4884863,4884863,,-1196285,,,,0,5989437,1104574,0,7387990,,12272853,12272853,56802,CEV
2018-11-30,,,-1413855,,-1413855,1225240,5987253,4762013,4762013,,-1444822,,,,0,5987253,1225240,0,-6175868,,-1413855,-1432720,56802,CEV
2017-11-30,,,4925351,,4925351,1476577,6402151,4925574,4925574,,-1327950,,,,0,6402151,1476577,0,-223,,4925351,4885168,56802,CEV
2019-12-31,,,117909000,1028000,82327000,190051000,330926000,140875000,140875000,,-20097000,,,,33812000,3106329000,2965454000,2775403000,-22966000,,84097000,82327000,56803,PRIM
2018-12-31,,,113358000,2763000,77461000,182006000,325737000,143731000,143731000,,-18746000,,,,25765000,2939478000,2795747000,2613741000,-30373000,,87593000,77461000,56803,PRIM
2017-12-31,,,105283000,5715000,72354000,169895000,278434000,108539000,108539000,,-8146000,,,,28433000,2379995000,2271456000,2101561000,-3256000,,76850000,72354000,56803,PRIM
2016-12-31,,,48871000,1219000,26723000,140027000,201307000,61280000,61280000,,-8914000,,,,21146000,1996948000,1935668000,1795641000,-12409000,,27725000,26723000,56803,PRIM
2019-12-31,24107000,,-40023000,-5758000,-40020000,19155000,3345000,-39917000,-39917000,,-1523000,,,,0,3345000,43262000,0,-106000,,-40023000,-40020000,56806,CTIC
2018-12-31,36467000,,-29352000,-5755000,-29320000,22062000,26290000,-32239000,-32239000,,-1734000,,,,0,26290000,58529000,879000,2887000,,-29352000,-29400000,56806,CTIC
2017-12-31,32866000,,-40831000,-5723000,-40670000,31435000,24782000,-39519000,-39519000,,-2035000,,,,0,25146000,64665000,364000,-1312000,,-40831000,-45020000,56806,CTIC
2016-12-31,62961000,,-52953000,-5562000,-52009000,47306000,56028000,-54239000,-54239000,,-2828000,,,,0,57405000,111644000,1377000,1286000,,-52953000,-52009000,56806,CTIC
2019-12-31,,,1394839000,,1155611000,5189159000,7951701000,1137491000,1137491000,,,,,,239228000,8616784000,7479293000,665083000,257348000,,1155611000,1155611000,56807,YRD
2018-12-31,,,1774097000,,1579810000,7994517000,10182825000,1195727000,1195727000,,,,,,194287000,11244114000,10048387000,1061289000,578416000,,1579810000,1579810000,56807,YRD
2017-12-31,,,193136000,,-188074000,10328567000,10291880000,-36687000,-36687000,,,,,,381210000,11534808000,11571495000,1242928000,229878000,,-188074000,-188074000,56807,YRD
2016-12-31,,,1102449000,,1116398000,1891886000,3057915000,1166029000,1166029000,,,,,,-13949000,3237991000,2071962000,180076000,-63580000,,1116398000,1116398000,56807,YRD
2020-09-30,,,97440000,,74634000,290298000,398713000,108415000,108415000,,-9275000,,,,22806000,1509713000,1401298000,1111000000,-10975000,,74634000,74634000,56808,HZO
2019-09-30,,,48953000,,35985000,259200000,322832000,63632000,63632000,,-11579000,,,,12968000,1237153000,1173521000,914321000,-14679000,,35985000,35985000,56808,HZO
2018-09-30,,,53280000,,39312000,235290000,298233000,62943000,62943000,,-9903000,,,,13968000,1177371000,1114428000,879138000,-9663000,,39312000,39312000,56808,HZO
2017-09-30,,,37808000,,23547000,217126000,265315000,48189000,48189000,,-7481000,,,,14261000,1052320000,1004131000,787005000,-10381000,,23547000,23547000,56808,HZO
2019-12-31,,,-1611576,,-1193377,22339603,20871993,-3414570,-3414570,,-1206201,,,,-418199,25001867,28416437,4129874,1802994,,-1193377,-1495069,56809,DLPN
2018-12-31,,,-4003935,,-2913321,20687144,20574371,-2091577,-2091577,,-1050478,,,,-1090614,22551339,24642916,1976968,-1912358,,-2913321,-3071325,56809,DLPN
2017-12-31,,,7251391,,6912524,17483270,18043778,-694135,-694135,,-1594940,,,,338867,22413044,23107179,4369266,7945526,,6912524,6912524,56809,DLPN
2016-12-31,,,-37189679,,-37189679,16416423,809384,-15627264,-15627264,,-4718091,,,,0,9395625,25022889,8586241,-21562415,,-37189679,-42436906,56809,DLPN
2020-12-31,227851000,,4907638000,,3806267000,785484000,1444619000,431284000,431284000,,-21861000,,,,1101371000,2545626000,2114342000,1101007000,4476354000,,3806267000,3806267000,56810,BIO
2019-12-31,196710000,,2261081000,,1758675000,811825000,1261396000,252861000,252861000,,-23416000,,,,502406000,2311659000,2058798000,1050263000,2008220000,,1758675000,1758675000,56810,BIO
2018-12-31,198896000,,512659000,,365614000,834483000,1228451000,195072000,195072000,,-23962000,,,,147045000,2289415000,2094343000,1060964000,317587000,,365614000,365614000,56810,BIO
2017-12-31,234657000,,97805000,,122249000,802790000,1189803000,152356000,152356000,,-23014000,,,,-24444000,2160153000,2007797000,970350000,-54551000,,122249000,122249000,56810,BIO
2019-12-31,27363000,,-35087000,,-35087000,9979000,0,-37342000,-37342000,,,,,,0,0,37342000,0,2255000,,-35087000,-35087000,56812,KZR
2018-12-31,18136000,,-23167000,,-23167000,6590000,0,-24726000,-24726000,,,,,,0,0,24726000,0,1559000,,-23167000,-23167000,56812,KZR
2017-12-31,6469000,,-8517000,,-8517000,2280000,0,-8749000,-8749000,,,,,,0,0,8749000,0,232000,,-8517000,-8517000,56812,KZR
2016-12-31,7373000,,-8990000,,-8990000,1617000,0,-8990000,-8990000,,,,,,0,0,8990000,0,0,,-8990000,-8990000,56812,KZR
2019-12-31,,,273000000,,216000000,98000000,477000000,328000000,328000000,,-43000000,,,,57000000,1670000000,1342000000,1193000000,-55000000,,216000000,216000000,56814,HGV
2018-12-31,,,403000000,,298000000,106000000,587000000,445000000,445000000,,-30000000,,,,105000000,1852000000,1407000000,1265000000,-42000000,,298000000,298000000,56814,HGV
2017-12-31,,,311000000,,327000000,96000000,470000000,345000000,345000000,,-27000000,,,,-16000000,1576000000,1231000000,1106000000,-34000000,,327000000,327000000,56814,HGV
2016-12-31,,,293000000,,168000000,62000000,439000000,353000000,353000000,,-29000000,,,,125000000,1457000000,1104000000,1018000000,-60000000,,168000000,168000000,56814,HGV
2020-12-31,453000000,,560000000,,504000000,787000000,2003000000,685000000,685000000,,-76000000,,,,56000000,4448000000,3763000000,2445000000,-125000000,,504000000,504000000,56817,ZBRA
2019-12-31,447000000,,598000000,,544000000,826000000,2100000000,724000000,724000000,,-86000000,,,,54000000,4485000000,3761000000,2385000000,-126000000,,544000000,544000000,56817,ZBRA
2018-12-31,444000000,,524000000,,421000000,798000000,1981000000,642000000,642000000,,-90000000,,,,103000000,4218000000,3576000000,2237000000,-118000000,,421000000,421000000,56817,ZBRA
2017-12-31,389000000,,88000000,,17000000,749000000,1710000000,388000000,388000000,,-162000000,,,,71000000,3722000000,3334000000,2012000000,-300000000,,17000000,17000000,56817,ZBRA
2019-12-31,,,1066337000,79099000,814854000,107809000,4538020000,1313539000,1313539000,2626280000,-163202000,,,,238794000,11378259000,10064720000,6840239000,-247202000,,827543000,812826000,56819,UHS
2018-12-31,,,1034525000,80823000,779705000,106094000,4349088000,1228572000,1228572000,2561377000,-156487000,,,,236642000,10772278000,9543706000,6423190000,-194047000,,797883000,778614000,56819,UHS
2017-12-31,,,1135009000,68624000,752303000,103127000,4324132000,1280178000,1280178000,2493062000,-145250000,,,,363697000,10409865000,9129687000,6085733000,-145169000,,771312000,751941000,56819,UHS
2016-12-31,,,1156358000,73693000,702409000,97324000,4149343000,1281411000,1281411000,2354000000,-125203000,,,,409187000,9766210000,8484799000,5616867000,-125053000,,747171000,702095000,56819,UHS
2020-02-01,,,30494000,,30396000,173344000,178430000,3490000,3490000,,-4958000,,,,98000,375187000,371697000,196757000,27004000,,30396000,30396000,56820,VNCE
2019-02-02,,,-1802000,,-1958000,159829000,169406000,7041000,7041000,,-6922000,,,,156000,361679000,354638000,192273000,-8843000,,-1958000,-1958000,56820,VNCE
2018-02-03,,,58025000,,58597000,133360000,121789000,-12170000,-12170000,,-5540000,,,,-572000,272582000,284752000,150793000,70195000,,58597000,58597000,56820,VNCE
2017-01-28,,,-68933000,,-162659000,126384000,122819000,-4163000,-4163000,,-3932000,,,,93726000,268199000,272362000,145380000,-64770000,,-162659000,-162659000,56820,VNCE
2019-12-31,30580000,,-37037000,,-37037000,6922000,0,-37502000,-37502000,,,,,,0,0,37502000,0,465000,,-37037000,-44092000,56821,GRAY
2018-12-31,22971000,,-28378000,,-28378000,5599000,0,-28570000,-28570000,,,,,,0,0,28570000,0,192000,,-28378000,-32695000,56821,GRAY
2020-06-30,,,1309189,,1163668,4386307,5558615,1172308,1172308,,,,,,145521,31526231,30353923,25967616,136881,,1163668,1163668,56822,ESP
2019-06-30,,,2881633,,2342694,4410234,7063173,2652939,2652939,,,,,,538939,36477851,33824912,29414678,228694,,2342694,2342694,56822,ESP
2018-06-30,,,4069076,,3075797,3808395,7662252,3853857,3853857,,,,,,993279,32517883,28664026,24855631,215219,,3075797,3075797,56822,ESP
2017-06-30,,,1651405,,1135736,3188112,4714568,1526456,1526456,,,,,,515669,22521012,20994556,17806444,124949,,1135736,1135736,56822,ESP
2020-01-31,,,2727000,,2382000,66452000,71675000,5223000,5223000,,-2462000,,,,345000,191063000,185840000,119388000,-2496000,,2382000,2382000,56823,VIRC
2019-01-31,,,-1117000,,-1614000,66008000,67081000,1073000,1073000,,-2191000,,,,497000,200716000,199643000,133635000,-2190000,,-1614000,-1614000,56823,VIRC
2018-01-31,,,2414000,,-3209000,61528000,65471000,3943000,3943000,,-1545000,,,,5623000,189287000,185344000,123816000,-1529000,,-3209000,-3209000,56823,VIRC
2017-01-31,,,4727000,,22760000,56601000,62543000,5942000,5942000,,-1217000,,,,-18033000,173417000,167475000,110874000,-1215000,,22760000,22760000,56823,VIRC
2020-10-31,,,586901000,52241000,446624000,862591000,1473585000,610994000,610994000,,-2440000,,,,140277000,7077659000,6466665000,5604074000,-24093000,,446624000,446624000,56824,TOL
2019-10-31,,,787170000,46877000,590007000,881167000,1602405000,721238000,721238000,,-2440000,,,,197163000,7223966000,6502728000,5621561000,65932000,,590007000,590007000,56824,TOL
2018-10-31,,,933916000,8713000,748151000,822381000,1631902000,809521000,809521000,,-3760000,,,,185765000,7143258000,6333737000,5511356000,124395000,,748151000,748151000,56824,TOL
2017-10-31,,,814311000,5896000,535495000,606678000,1267549000,660871000,660871000,,-4823000,,,,278816000,5815058000,5154187000,4547509000,153440000,,535495000,535495000,56824,TOL
2020-12-31,,,154645000,,127923000,250636000,441240000,0,177489000,13115000,,,,,26722000,441240000,263751000,0,-22844000,,127923000,127923000,56826,PRK
2019-12-31,,,124771000,,102700000,232898000,388536000,0,140207000,15431000,,,,,22071000,388536000,248329000,0,-15436000,,102700000,102700000,56826,PRK
2018-12-31,,,131299000,,110387000,202939000,357354000,0,140770000,13645000,,,,,20912000,357354000,216584000,0,-9471000,,110387000,110387000,56826,PRK
2017-12-31,,,118469000,,84242000,183922000,321153000,0,124345000,12886000,,,,,34227000,321153000,196808000,0,-5876000,,84242000,84242000,56826,PRK
2020-12-31,,,443900000,,344900000,666800000,1108200000,441400000,441400000,,-7300000,,,,99000000,2895300000,2453900000,1787100000,2500000,,344900000,344900000,56827,AOS
2019-12-31,,,472100000,,370000000,721000000,1180700000,459700000,459700000,,-11000000,,,,102100000,2992700000,2533000000,1812000000,12400000,,370000000,370000000,56827,AOS
2018-12-31,,,557800000,,444200000,755200000,1305500000,550300000,550300000,,-8400000,,,,113600000,3187900000,2637600000,1882400000,7500000,,444200000,444200000,56827,AOS
2017-12-31,,,520800000,,296500000,723700000,1232400000,508700000,508700000,,-10100000,,,,224300000,2996700000,2488000000,1764300000,12100000,,296500000,296500000,56827,AOS
2019-12-31,8034000,,-40438000,2500000,-40619000,76706000,76653000,-18078000,-18078000,,-7846000,,,,1857000,110406000,128484000,33753000,-22360000,,-42295000,-40619000,56830,VERO
2018-12-31,7047000,,-11994000,4022000,-14959000,64747000,79355000,-3367000,-3367000,,-5361000,,,,2215000,102614000,105981000,23259000,-8627000,,-14209000,-14959000,56830,VERO
2017-12-31,5678000,,7883000,2816000,5726000,47264000,68208000,12801000,12801000,,-5503000,,,,479000,89074000,76273000,20866000,-4918000,,7404000,2798000,56830,VERO
2016-12-31,4693000,,-12098000,2816000,-12600000,41860000,40384000,-6472000,-6472000,,-2733000,,,,390000,53142000,59614000,12758000,-5626000,,-12488000,-12600000,56830,VERO
2020-12-31,,,672000000,,539000000,1415000000,2405000000,0,698000000,292000000,,,,,133000000,2405000000,1707000000,0,-26000000,,539000000,505000000,56831,ZIONO
2019-12-31,,,1053000000,,816000000,1450000000,2797000000,0,1113000000,234000000,,,,,237000000,2797000000,1684000000,0,-60000000,,816000000,777000000,56831,ZIONO
2018-12-31,,,1143000000,,884000000,1403000000,2821000000,0,1197000000,221000000,,,,,259000000,2821000000,1624000000,0,-54000000,,884000000,845000000,56831,ZIONO
2017-12-31,,,936000000,,592000000,1344000000,2585000000,0,1000000000,241000000,,,,,344000000,2585000000,1585000000,0,-64000000,,592000000,546000000,56831,ZIONO
2019-12-31,,,-98408000,,-97634000,34819000,-69794000,-104613000,-104613000,,,,,,-774000,15963000,120576000,85757000,6205000,,-97634000,-97634000,56832,ASMB
2018-12-31,,,-89652000,,-90751000,30498000,-57937000,-88435000,-88435000,,,,,,1099000,14804000,103239000,72741000,-1217000,,-90751000,-90751000,56832,ASMB
2017-12-31,,,-51859000,,-42809000,17021000,-35206000,-52227000,-52227000,,,,,,-9050000,9019000,61246000,44225000,368000,,-42809000,-42809000,56832,ASMB
2016-12-31,,,-44879000,,-44261000,12185000,-33093000,-45278000,-45278000,,,,,,-618000,0,45278000,33093000,399000,,-44261000,-44261000,56832,ASMB
2019-12-31,,,-4548000,,-4523000,16086000,15424000,-1474000,-1474000,,-2309000,,,,38000,178220000,179694000,162796000,-3074000,63000,-4586000,-4523000,56833,BWEN
2018-12-31,,,-24207000,,-24146000,13625000,3696000,-11813000,-11813000,,-1501000,,,,-205000,125380000,137193000,121684000,-12394000,-144000,-24002000,-24146000,56833,BWEN
2017-12-31,,,-8228000,,-3641000,13828000,8159000,-7433000,-7433000,,-803000,,,,-5045000,146785000,154218000,138626000,599000,-458000,-3183000,-3641000,56833,BWEN
2016-12-31,,,1333000,,319000,15786000,18139000,1909000,1909000,,-673000,,,,-2000,180840000,178931000,162701000,-576000,-1016000,1335000,319000,56833,BWEN
2020-01-31,74398000,,-82953000,,-83394000,153100000,141876000,-85622000,-85622000,,,,,,441000,276057000,361679000,134181000,2669000,,-83394000,-83394000,56836,ZUO
2019-01-31,54417000,,-70834000,,-72741000,134399000,118399000,-70417000,-70417000,,-417000.0,,,,1907000,234989000,305406000,116590000,-417000,,-72741000,-72741000,56836,ZUO
2018-01-31,38639000,,-37826000,,-39377000,90639000,91200000,-38078000,-38078000,,-417000.0,,,,1551000,171106000,209184000,79906000,-548000,,-39377000,-39377000,56836,ZUO
2017-01-31,26355000,,-38814000,,-39098000,77524000,64846000,-39033000,-39033000,,-417000.0,,,,284000,113008000,152041000,48162000,219000,,-39098000,-39098000,56836,ZUO
2020-09-30,,,109300000,2021600000,23500000,149900000,338000000,165900000,165900000,,-54700000,,,,9200000,988300000,822400000,650300000,-56600000,,100100000,23500000,56837,BRBR
2019-09-30,,,162500000,2021600000,0,120400000,311800000,169200000,169200000,,-54700000,,,,39400000,854400000,685200000,542600000,-6700000,,100100000,23500000,56837,BRBR
2018-09-30,,,119800000,2021600000,0,135100000,277700000,119800000,119800000,,-54700000,,,,23700000,827500000,707700000,549800000,0,,100100000,23500000,56837,BRBR
2017-09-30,,,65600000,2021600000,35200000,131000000,245800000,92100000,92100000,-100000.0,-54700000,,,,30400000,713200000,621100000,467400000,-26500000,,35200000,35200000,56837,BRBR
2020-06-30,,,-771851,,-662242,10466123,9637882,-851895,-851895,,,,,,7836,31058737,31910632,21420855,80044,117445,-779687,-662242,56838,RSSS
2019-06-30,,,-1147655,,-959958,9559608,8343461,-1254963,-1254963,,,,,,27040,28793922,30048885,20450461,107308,214737,-1174695,-959958,56838,RSSS
2018-06-30,,,-1895957,,-1678741,9147064,7349325,-1950136,-1950136,,-4000.0,,,,39779,28018441,29968577,20669116,54179,256995,-1935736,-1678741,56838,RSSS
2017-06-30,,,-3072709,,-2293563,9055070,6104194,-3084570,-3084570,,-12000.0,,,,35495,25747276,28831846,19643082,11861,814641,-3108204,-2293563,56838,RSSS
2020-12-31,,,6944000,,5877000,,30464000,0,8175000,22289000,,,,,1067000,30464000,22289000,0,-1231000,,5877000,5877000,56842,FBSS
2019-12-31,,,7824000,,6820000,18569000.0,30278000,0,8282000,3427000,,,,,1004000,30278000,21996000,0,-458000,,6820000,6820000,56842,FBSS
2018-12-31,,,6881000,,6135000,18368000.0,29032000,0,7250000,3414000,,,,,746000,29032000,21782000,0,-369000,,6135000,6135000,56842,FBSS
2017-12-31,,,5375000,,2496000,17345000.0,26219000,0,5687000,3187000,,,,,2879000,26219000,20532000,0,-312000,,2496000,2496000,56842,FBSS
2019-12-31,15771000,,-19724000,,-19724000,5035000,0,-20806000,-20806000,,,,,,0,0,20806000,0,1082000,,-19724000,-19724000,56846,INZY
2018-12-31,7808000,,-6964000,,-6964000,3785000,0,-11593000,-11593000,,,,,,0,0,11593000,0,4629000,,-6964000,-6964000,56846,INZY
2017-12-31,2768000,,-11197000,,-11197000,8575000,0,-11343000,-11343000,,,,,,0,0,11343000,0,146000,,-11197000,-11197000,56847,ENTXW
2016-12-31,2648000,,-1199000,,-1199000,2719000,0,-5367000,-5367000,,,,,,0,0,5367000,0,4168000,,-1199000,-1199000,56847,ENTXW
2015-12-31,2115000,,-4282000,,-4282000,1586000,0,-3701000,-3701000,,,,,,0,0,3701000,0,-581000,,-4282000,-4282000,56847,ENTXW
2019-12-31,,,-18591000,,-18592000,11317000,-5517000,-16834000,-16834000,,-2131000,,,,1000,6832000,23666000,12349000,-1757000,,-18592000,-18592000,56848,RGLS
2018-12-31,,,-48647000,,-48709000,12860000,-33903000,-46763000,-46763000,,-2343000,,,,62000,72000,46835000,33975000,-1900000,,-48709000,-48709000,56848,RGLS
2017-12-31,,,-72102000,,-71905000,13332000,-54519000,-67851000,-67851000,,-2723000,,,,-197000,72000,67923000,54591000,-4251000,,-71905000,-71905000,56848,RGLS
2016-12-31,,,-81840000,,-81836000,18391000,-63111000,-81502000,-81502000,,-1182000,,,,-4000,1194000,82696000,64305000,-338000,,-81836000,-81836000,56848,RGLS
2019-12-31,,,57631000,,38890000,105686000,192263000,85526000,85526000,1051000,-12795000,,,,12137000,878059000,792533000,685796000,-27895000,-6604000,45494000,38890000,56849,PROS
2018-12-31,,,67118000,,54543000,100118000,179613000,79495000,79495000,1051000,-12377000,,,,13389000,785872000,706377000,606259000,-12377000,814000,53729000,54543000,56849,PROS
2017-12-31,,,31329000,,-43993000,87821000,131275000,43454000,43454000,1051000,-12125000,,,,38233000,651039000,607585000,519764000,-12125000,-37089000,-6904000,-43993000,56849,PROS
2016-12-31,,,-44722000,,-100328000,88950000,56353000,-32597000,-32597000,1051000,-12125000,,,,-23988000,698740000,731337000,642387000,-12125000,-79594000,-20734000,-100328000,56849,PROS
2020-09-30,,,123053000,,123053000,5506323,3391631,-2114692,-2114692,,,,,,0,3391631,5506323,0,125167692,,123053000,123053000,56850,HQL
2019-09-30,,,-70478618,,-70478618,5319624,2440586,-2879038,-2879038,,,,,,0,2440586,5319624,0,-67599580,,-70478618,-70478618,56850,HQL
2018-09-30,,,28664229,,28664229,5592934,1985823,-3607111,-3607111,,,,,,0,1985823,5592934,0,32271340,,28664229,28664229,56850,HQL
2017-09-30,,,68555677,,68555677,5560935,1682164,-3878771,-3878771,,,,,,0,1682164,5560935,0,72434448,,68555677,68555677,56850,HQL
2020-12-31,,,96859000,,69468000,51575000,154217000,0,96865000,5777000,,,,,27391000,154217000,57352000,0,-6000,,69468000,69274000,56851,PFBC
2019-12-31,,,111406000,,78371000,51038000,162947000,0,112626000,-717000,,,,,33035000,162947000,50321000,0,-1220000,,78371000,77705000,56851,PFBC
2018-12-31,,,98698000,,70993000,48309000,147641000,0,99313000,19000,,,,,27705000,147641000,48328000,0,-615000,,70993000,69827000,56851,PFBC
2017-12-31,,,80480000,,43394000,41596000,126066000,0,81043000,3427000,,,,,37086000,126066000,45023000,0,-563000,,43394000,42895000,56851,PFBC
2019-12-31,19072000,,-62756000,,-62762000,61043000,62201000,-26793000,-26793000,,-18044000,,,,-112000,95961000,122754000,33760000,-35963000,-118000,-62644000,-62762000,56852,NH
2018-12-31,20916000,,-194106000,,-192152000,70763000,50128000,-50701000,-50701000,,-17120000,,,,-3673000,89464000,140165000,39336000,-143405000,-1719000,-190433000,-192152000,56852,NH
2017-12-31,33862000,,-133602000,,-175211000,74976000,50326000,-67900000,-67900000,,-16168000,,,,-2203000,86676000,154576000,36350000,-65702000,-43812000,-131399000,-175211000,56852,NH
2016-12-31,47310000,,-164318000,,-184102000,105258000,44789000,-120488000,-120488000,,-6429000,,,,-23797000,80404000,200892000,35615000,-43830000,-43581000,-140521000,-189060000,56852,NH
2019-12-28,,,-172366500,26370000,-102640500,233274000,102391500,-130882500,-130882500,,-14023500,,,,-15667500,224265000,355147500,121873500,-41484000,,-156699000,-102640500,56854,FRG
2019-04-30,,,-3995000,26370000,-2156000,122774000,132546000,9772000,9772000,,-3023000,,,,-1839000,132546000,122774000,54473000,-13767000,,-2156000,-2156000,56854,FRG
2018-04-30,,,4481000,26370000,125000,162212000,174872000,12660000,12660000,,-3181000,,,,4346000,174872000,162212000,63602000,-8179000,,135000,125000,56854,FRG
2017-04-30,,,20767000,26370000,13013000,66532000,107786000,32929000,32929000,,-2557000,,,,7754000,173985000,141056000,66199000,-12162000,,13013000,13013000,56854,FRG
2019-12-31,,,-289523000,152814000,-363304000,665269000,1231633000,258202000,258202000,-1162000,-419518000,,,,72254000,2683810000,2425608000,1452177000,-547725000,,-361777000,-363304000,56855,CCO
2018-12-31,,,-170330000,160362000,-218240000,675008000,1251037000,259575000,259575000,-2498000,-388133000,,,,32515000,2721705000,2462130000,1470668000,-429905000,,-202845000,-218240000,56855,CCO
2017-12-31,,,-906428000,157040000,-644348000,642891000,1178935000,236444000,236444000,-26391000,-379701000,,,,-280218000,2588702000,2352258000,1409767000,-1142872000,,-626210000,-644348000,56855,CCO
2016-12-31,,,235376000,149886000,135070000,632857000,1261503000,289910000,289910000,-5388000,-375029000,,,,77499000,2679822000,2389912000,1418319000,-54534000,,157877000,135070000,56855,CCO
2019-12-31,,,-27365000,,-27365000,10140000,-18927000,-26635000,-26635000,-2432000,-1239000,,,,0,59000,26694000,18986000,-730000,,-27365000,-27365000,56859,IMV
2018-12-31,12852000.0,,-21935000,,-21935000,9243000,-12770000,-20951000,-20951000,-1062000,-1385000,,,,0,82000,21033000,12852000,-1603000,,-21935000,-21935000,56859,IMV
2017-12-31,12852000.0,,-12027000,,-12027000,6423000,-5905000,-11250000,-11250000,-1078000,-966000,,,,0,33000,11283000,5938000,-777000,,-12027000,-12027000,56859,IMV
2016-12-31,12852000.0,,-8895821,,-8895821,4236984,-4042437,-7274325,-7274325,-1005096,-1505723,,,,0,129703,7404028,4172140,-1621496,,-8895821,-8895821,56859,IMV
2019-12-31,15801000,,-18130000,,-18018000,23602000,23058000,-16345000,-16345000,,-565000,,,,-112000,38391000,54736000,15333000,-1785000,,-18018000,-18018000,56860,CYRN
2018-12-31,16116000,,-19567000,,-19414000,24545000,21360000,-19301000,-19301000,,-135000,,,,-153000,35900000,55201000,14540000,-266000,,-19414000,-19414000,56860,CYRN
2017-12-31,9825000,,-15690000,,-15648000,22837000,18900000,-13762000,-13762000,,-735000,,,,-42000,30799000,44561000,11899000,-1928000,,-15648000,-15648000,56860,CYRN
2016-12-31,8656000,,-6215000,,-6213000,17459000,20941000,-5174000,-5174000,,-20000,,,,-2000,30983000,36157000,10042000,-1041000,,-6213000,-6213000,56860,CYRN
2020-12-31,,,-4964000000,,-3975000000,6107000000,6422000000,-1566000000,-1566000000,486000000,-499000000,,,,-1250000000,64129000000,65695000000,57707000000,-3398000000,,-3714000000,-3975000000,56861,PSX
2019-12-31,,,4178000000,2259000000.0,3076000000,6755000000,11764000000,3269000000,3269000000,399000000,-458000000,,,,801000000,107293000000,104024000000,95529000000,909000000,,3377000000,3070000000,56861,PSX
2018-12-31,,,7445000000,2500000000.0,5595000000,6557000000,13531000000,5155000000,5155000000,463000000,-504000000,,,,1572000000,111461000000,106306000000,97930000000,2290000000,,5873000000,5589000000,56861,PSX
2017-12-31,,,3555000000,2343000000.0,5106000000,6394000000,22945000000,1776000000,1776000000,13457000000,-438000000,,,,-1693000000,89300000000,87524000000,66355000000,1779000000,,5248000000,5100000000,56861,PSX
2019-12-31,,,475200000,3000000,401800000,684200000,1252300000,568100000,568100000,,-56000000,,,,73100000,2854000000,2285900000,1601700000,-92900000,,402100000,401800000,56863,ALLE
2018-12-31,,,475200000,3000000,434900000,634700000,1173300000,538600000,538600000,,-54000000,,,,39800000,2731700000,2193100000,1558400000,-63400000,,435400000,434900000,56863,ALLE
2017-12-31,,,395700000,3900000,273300000,580000000,1072900000,492900000,492900000,,-105700000,,,,119000000,2408200000,1915300000,1335300000,-97200000,,276700000,273300000,56863,ALLE
2016-12-31,,,295000000,3100000,229100000,564200000,989700000,425500000,425500000,,-64300000,,,,63800000,2238000000,1812500000,1248300000,-130500000,,231200000,229100000,56863,ALLE
2019-12-31,,,71039000,,54935000,112540000,369239000,97046000,97046000,,-29468000,,,,16104000,633906000,536860000,264667000,-26007000,,54935000,54935000,56864,SHEN
2018-12-31,,,62112000,,46595000,113222000,372873000,93246000,93246000,,-34847000,,,,15517000,630854000,537608000,257981000,-31134000,,46595000,46595000,56864,SHEN
2017-12-31,,,13257000,,66390000,165937000,400484000,57540000,57540000,,-38237000,,,,-53133000,611991000,554451000,211507000,-44283000,,66390000,66390000,56864,SHEN
2016-12-31,,,1945000,,-895000,122953000,343796000,77158000,77158000,,-25102000,,,,2840000,535288000,458130000,191492000,-75213000,,-895000,-895000,56864,SHEN
2020-03-31,,,20816000,5000,10987000,71587000,92635000,21048000,21048000,,,,,,9829000,145650000,124602000,53015000,-232000,,10987000,10987000,56865,MIXT
2019-03-31,,,24625000,5000,14810000,72529000,96820000,24291000,24291000,,,,,,9815000,143705000,119414000,46885000,334000,,14810000,14810000,56865,MIXT
2018-03-31,,,16488000,846,13947000,71506000,87672000,16166000,16166000,,,,,,2536000,131781000,115615000,44109000,322000,,13952000,13947000,56865,MIXT
2017-03-31,,,148253000,-1558000,121458000,886110000,1041273000,155851000,155851000,-688000.0,-2309000.0,,,,26812000,1540058000,1384207000,498785000,-7598000,,121441000,121458000,56865,MIXT
2020-12-31,,,24366000,,20413000,52204000,84598000,0,27907000,4487000,,,,,3953000,84598000,56691000,0,-3541000,,20413000,19763000,56867,LEVLP
2019-12-31,,,19514000,,16111000,39343000,63883000,0,20053000,4487000,,,,,3403000,63883000,43830000,0,-539000,,16111000,15952000,56867,LEVLP
2018-12-31,,,17389000,,14386000,35498000,57067000,0,17389000,4180000,,,,,3003000,57067000,39678000,0,0,,14386000,14386000,56867,LEVLP
2017-12-31,,,16564000,,9841000,31396000,52615000,0,16564000,4655000,,,,,6723000,52615000,36051000,0,0,,9841000,9841000,56867,LEVLP
2020-03-31,,,-6380041,-132124,-6373948,6580175,650187,-5929988,-5929988,,-54232,,,,0,650187,6580175,0,-450053,,-6380041,-6373948,56868,AEMD
2019-03-31,,,-6219504,-126031,-6194719,6228642,229625,-5999017,-5999017,,-220487,,,,0,229625,6228642,0,-220487,,-6219504,-6194719,56868,AEMD
2018-03-31,,,-5699837,-101246,-5679558,4980741,149625,-4831116,-4831116,,-361597,,,,0,149625,4980741,0,-868721,,-5699837,-5679558,56868,AEMD
2017-03-31,,,-7306726,-80967,-7276113,6490430,392073,-6098357,-6098357,,-304330,,,,0,392073,6490430,0,-1208369,,-7306726,-7276113,56868,AEMD
2019-12-31,,,9839545,47902882,3771163,5862424,21579619,15717195,15717195,,-3564964,,,,1627061,120385274,104668079,98805655,-5877650,,8212484,3771163,56869,CRHM
2018-12-31,,,15727803,59739165,4679921,6535613,26937743,20402130,20402130,,-3429125,,,,2711886,112749380,92347250,85811637,-4674327,,13015917,4679921,56869,CRHM
2017-12-31,,,26334135,57451848,12078853,7053863,28318148,21264285,21264285,,-3526378,,,,7159065,95006145,73741860,66687997,5069850,,19175070,12078853,56869,CRHM
2016-12-31,,,20331478,36410456,10564233,3866696,29048230,25181534,25181534,,-4638712,,,,4255150,78354632,53173098,49306402,-4850056,,16076328,10564233,56869,CRHM
2019-12-31,,,-13987000,,-13933000,6396000,-156000,-14625000,-14625000,40000,-150000,,,,-54000,0,14625000,156000,638000,,-13933000,-13933000,56870,FURY
2018-12-31,,,-17674000,,-17674000,4837000,-138000,-19667000,-19667000,39000,-150000,,,,0,0,19667000,138000,1993000,,-17674000,-17674000,56870,FURY
2017-12-31,,,-36500000,,-36500000,5876000,-105000,-42190000,-42190000,39000,-150000,,,,0,0,42190000,105000,5690000,,-36500000,-36500000,56870,FURY
2016-12-31,,,-4255000,,-4255000,6085000,-224000,-6334000,-6334000,25000,-150000,,,,0,0,6334000,224000,2079000,,-4255000,-4255000,56870,FURY
2019-12-31,130732000,,-344904000,,-422636000,632420000,1350719000,587567000,587567000,,-558680000,,,,15680000,2914364000,2326797000,1563645000,-932471000,-62052000,-360584000,-422636000,56871,ENDP
2018-12-31,185826000,,-938832000,,-1031469000,646037000,1375830000,543967000,543967000,,-534850000,,,,22935000,2947078000,2403111000,1571248000,-1482799000,-69702000,-961767000,-1031469000,56871,ENDP
2017-12-31,172067000,,-1483004000,,-2035433000,614774000,1240328000,453487000,453487000,,-488228000,,,,-250293000,3468858000,3015371000,2228530000,-1936491000,-802722000,-1232711000,-2035433000,56871,ENDP
2016-12-31,183372000,,-3923856000,,-3347066000,770728000,1552783000,598683000,598683000,,-456396000,,,,-700084000,4010274000,3411591000,2457491000,-4522539000,-123278000,-3223772000,-3347066000,56871,ENDP
2020-01-31,1549906000,,-482447000,,-480674000,1514272000,2561948000,-502230000,-502230000,,-58685000,,,,-1773000,3627206000,4129436000,1065258000,19783000,,-480674000,-480674000,56872,WDAY
2019-01-31,1211832000,,-423752000,,-418258000,1213682000,1987230000,-438284000,-438284000,,-60209000,,,,-5494000,2822180000,3260464000,834950000,14532000,,-418258000,-418258000,56872,WDAY
2018-01-31,910584000,,-314786000,,-321222000,906276000,1513637000,-303223000,-303223000,,-44549000,,,,6436000,2143050000,2446273000,629413000,-11563000,,-321222000,-321222000,56872,WDAY
2017-01-31,680531000,,-385513000,,-384699000,763450000,1090895000,-353086000,-353086000,,-30103000,,,,-814000,1574440000,1927526000,483545000,-32427000,,-384699000,-384699000,56872,WDAY
2020-12-31,121784000,,85558000,,79746000,40409000,260156000,97963000,97963000,,,,,,5812000,539521000,441558000,279365000,-12405000,,79746000,79746000,56874,SIMO
2019-12-31,110305000,,72074000,,64398000,42986000,222172000,68115000,68115000,,-3000.0,,,,7676000,457253000,389138000,235081000,3959000,,64398000,64398000,56874,SIMO
2018-12-31,102028000,,109861000,,98070000,46912000,260807000,108903000,108903000,,-378000.0,,,,11791000,530348000,421445000,269541000,958000,,98070000,98070000,56874,SIMO
2017-12-31,102053000,,99001000,,74955000,42801000,251194000,103806000,103806000,,-423000.0,,,,24046000,523404000,419598000,272210000,-4805000,,74955000,74955000,56874,SIMO
2020-12-31,,,8877000,,8877000,32631000,320321000,178990000,178990000,,-68702000,,,,0,460319000,281329000,139998000,-170113000,,8877000,-21586000,56875,CMRE
2019-12-31,,,98999000,,98999000,30749000,342487000,198276000,198276000,,-89163000,,,,0,478109000,279833000,135622000,-99277000,,98999000,67730000,56875,CMRE
2018-12-31,,,67239000,,67239000,28696000,245338000,120381000,120381000,,-64024000,,,,0,380397000,260016000,135059000,-53142000,,67239000,36736000,56875,CMRE
2017-12-31,,,72876000,,72876000,28210000,286836000,162178000,162178000,,-70667000,,,,0,412433000,250255000,125597000,-89302000,,72876000,51813000,56875,CMRE
2020-12-31,768000000,,2071000000,570000000,1225000000,1368000000,5185000000,2648000000,2648000000,,-827000000,,,,777000000,38542000000,35894000000,33357000000,-577000000,,1294000000,1216000000,56876,DOW
2019-12-31,765000000,,-1247000000,553000000,-1359000000,1385000000,6330000000,3761000000,3761000000,,-933000000,,,,470000000,42951000000,39190000000,36621000000,-5008000000,445000000.0,-1717000000,-1365000000,56876,DOW
2018-12-31,800000000,,3749000000,1138000000,4641000000,1659000000,8530000000,5602000000,5602000000,,-1063000000,,,,809000000,49604000000,44002000000,41074000000,-1853000000,1835000000.0,2940000000,4641000000,56876,DOW
2017-12-31,803000000,,237000000,1138000000,465000000,2471000000,7380000000,3706000000,3706000000,,-914000000,,,,1524000000,43730000000,40024000000,36350000000,-3469000000,1882000000.0,-1287000000,451000000,56876,DOW
2019-12-31,,,3292000000,336000000,3308000000,5752000000,10589000000,4414000000,4414000000,,-962000000,,,,-9000000,27812000000,23398000000,17223000000,-1122000000,38000000,3301000000,3308000000,56877,VIAC
2018-12-31,,,4077000000,293000000,3455000000,5274000000,11333000000,5626000000,5626000000,,-1030000000,,,,617000000,27250000000,21624000000,15917000000,-1549000000,32000000,3460000000,3455000000,56877,VIAC
2017-12-31,,,4124000000,293000000,2321000000,5252000000,11052000000,5357000000,5357000000,,-1088000000,,,,804000000,26535000000,21178000000,15483000000,-1233000000,-947000000,3320000000,2321000000,56877,VIAC
2016-12-31,,,2180000000,293000000,1261000000,2124000000,5210000000,2852000000,2852000000,9000000.0,-411000000,,,,628000000,13166000000,10314000000,7956000000,-672000000,-291000000,1552000000,1261000000,56877,VIAC
2019-12-31,209947000,,-288585000,67522000,-260587000,94353000,38060000,-266240000,-266240000,,-8765000,,,,0,40560000,306800000,2500000,-22345000,,-288585000,-260587000,56881,BBIO
2018-12-31,140073000,,-169451000,62483000,-130749000,43587000,0,-183660000,-183660000,,-2547000,,,,0,0,183660000,0,14209000,,-169451000,-130749000,56881,BBIO
2017-12-31,30556000,,-43832000,3331000,-30565000,13302000,0,-43858000,-43858000,,-13000,,,,0,0,43858000,0,26000,,-43832000,-30565000,56881,BBIO
2019-12-31,,,52674000,,37520000,146913000,326358000,99198000,99198000,,-57453000,,,,15154000,531259000,432061000,204901000,-46524000,,37520000,37520000,56882,CCOI
2018-12-31,,,41382000,,28667000,133858000,300667000,85576000,85576000,,-51056000,,,,12715000,507693000,422117000,207026000,-44194000,,28667000,28667000,56882,CCOI
2017-12-31,,,31118000,,5876000,127915000,275897000,72056000,72056000,,-48467000,,,,25242000,474275000,402219000,198378000,-40938000,,5876000,5876000,56882,CCOI
2016-12-31,,,24260000,,14929000,117609000,252834000,59990000,59990000,,-40803000,,,,9331000,437800000,377810000,184966000,-35730000,,14929000,14929000,56882,CCOI
2020-12-31,204302000,,-80815000,,-85031000,560761000,716067000,-48996000,-48996000,,-37049000,,,,4216000,883026000,932022000,166959000,-31819000,,-85031000,-85031000,56884,HUBS
2019-12-31,158237000,,-50773000,,-53746000,433129000,544902000,-46464000,-46464000,,-22818000,,,,2973000,674860000,721324000,129958000,-4309000,,-53746000,-53746000,56884,HUBS
2018-12-31,117603000,,-61960000,,-63828000,343278000,412623000,-48258000,-48258000,,-21386000,,,,1868000,512980000,561238000,100357000,-13702000,,-63828000,-63828000,56884,HUBS
2017-12-31,70373000,,-50039000,,-39714000,269646000,299883000,-40136000,-40136000,,-13181000,,,,-10325000,375612000,415748000,75729000,-9903000,,-39714000,-39714000,56884,HUBS
2020-12-31,,,24366000,,20413000,52204000,84598000,0,27907000,4487000,,,,,3953000,84598000,56691000,0,-3541000,,20413000,19763000,56888,LEVL
2019-12-31,,,19514000,,16111000,39343000,63883000,0,20053000,4487000,,,,,3403000,63883000,43830000,0,-539000,,16111000,15952000,56888,LEVL
2018-12-31,,,17389000,,14386000,35498000,57067000,0,17389000,4180000,,,,,3003000,57067000,39678000,0,0,,14386000,14386000,56888,LEVL
2017-12-31,,,16564000,,9841000,31396000,52615000,0,16564000,4655000,,,,,6723000,52615000,36051000,0,0,,9841000,9841000,56888,LEVL
2019-12-31,,,1692781,,1692781,220386,115062,-105324,-105324,,-1532,,,,0,115062,220386,0,1798105,,1692781,1692781,56889,RCG
2018-12-31,,,1930433,,1930433,215756,63670,-152086,-152086,,-5397,,,,0,63670,215756,0,2082519,,1930433,1930433,56889,RCG
2017-12-31,,,-793412,,-793412,378196,26002,-352194,-352194,,-25634,,,,0,26002,378196,0,-441218,,-793412,-793412,56889,RCG
2016-12-31,,,1218859,,1218859,729459,9053,-720406,-720406,,-19690,,,,0,9053,729459,0,1939265,,1218859,1218859,56889,RCG
2019-12-31,,,-16450000,289000,-14974000,24386000,38515000,13289000,13289000,,-5139000,,,,-3566000,258959000,245670000,220444000,-29739000,-2090000,-12884000,-14974000,56899,TREC
2018-12-31,,,-2374000,289000,-2332000,22532000,27818000,4546000,4546000,,-4100000,,,,-646000,287932000,283386000,260114000,-6920000,-604000,-1728000,-2332000,56899,TREC
2017-12-31,,,15284000,289000,18009000,22414000,41561000,18275000,18275000,,-2931000,,,,-6228000,245143000,226868000,203582000,-2991000,-3503000,21512000,18009000,56899,TREC
2016-12-31,,,29932000,289000,19428000,20434000,39902000,18707000,18707000,,-1985000,,,,10504000,212399000,193692000,172497000,11225000,-3503000,19428000,19428000,56899,TREC
2020-12-31,,,93386000,,69500000,47454000,265647000,82795000,82795000,32505000,,,,,23886000,874374000,791579000,608727000,10591000,,69500000,69500000,56900,MRTN
2019-12-31,,,77688000,,61071000,40101000,234380000,67818000,67818000,31324000,,,,,16617000,843271000,775453000,608891000,9870000,,61071000,61071000,56900,MRTN
2018-12-31,,,71029000,,55027000,38657000,221816000,63104000,63104000,31470000,,,,,16002000,787594000,724490000,565778000,7925000,,55027000,55027000,56900,MRTN
2017-12-31,,,56473000,,90284000,38585000,200630000,50363000,50363000,26562000,,,,,-33811000,698120000,647757000,497490000,6110000,,90284000,90284000,56900,MRTN
2019-12-31,,,318400000,,294300000,11400000,790400000,391400000,391400000,60900000,-126900000,,,,24100000,2089600000,1698200000,1299200000,-73000000,,294300000,284100000,56903,IPLDP
2018-12-31,,,271000000,,274200000,3500000,688200000,347300000,347300000,53900000,-119400000,,,,-3200000,2042300000,1695000000,1354100000,-76300000,,274200000,264000000,56903,IPLDP
2017-12-31,,,216100000,,227000000,9800000,604100000,294300000,294300000,55000000,-112400000,,,,-10900000,1870300000,1576000000,1266200000,-78200000,,227000000,216800000,56903,IPLDP
2016-12-31,,,219900000,,225800000,9400000,542300000,268200000,268200000,53900000,-103200000,,,,-5900000,1820400000,1552200000,1278100000,-48300000,,225800000,215600000,56903,IPLDP
2019-12-31,,,37908000000000,17689000000000,18663000000000,10420000000000,75252000000000,42542000000000,42542000000000,-629000000000,-4240000000000,,,,10316000000000,135567000000000,93025000000000,60315000000000,-4634000000000,,27592000000000,18663000000000,56904,TLK
2018-12-31,,,36405000000000,18393000000000,18032000000000,10351000000000,69532000000000,38624000000000,38624000000000,-849000000000,-3507000000000,,,,9426000000000,130784000000000,92160000000000,61252000000000,-2219000000000,,26979000000000,18032000000000,56904,TLK
2017-12-31,,,42659000000000,19417000000000,22145000000000,10528000000000,75137000000000,43727000000000,43727000000000,436000000000,-2769000000000,,,,9958000000000,128256000000000,84529000000000,53119000000000,-1068000000000,,32701000000000,22145000000000,56904,TLK
2016-12-31,,,38189000000000,21160000000000,19352000000000,8742000000000,68868000000000,40000000000000,40000000000000,1594000000000,-2810000000000,,,,9017000000000,116333000000000,76333000000000,47465000000000,-1811000000000,,29172000000000,19352000000000,56904,TLK
2019-12-31,,,-10575106,42830403,-8831223,16507608,34226048,9521660,9521660,8196780,-9159818,,,,1105049,119117024,109595364,84890976,-20096766,,-11680155,-8831223,56905,SOL
2018-12-31,,,4907689,33995782,1759711,11085327,28069747,15241159,15241159,1743261,-8703904,,,,-188791,96906335,81665176,68836588,-10333470,,5096480,1759711,56905,SOL
2017-12-31,,,3521899,33995782,34457538,7889298,14131755,6555610,6555610,-313153,-3936302,,,,322068,102973999,96418389,88842244,-3033711,31257707.0,3199831,34457538,56905,SOL
2016-12-31,,,226574,33995782,-34698251,7378116,7232881,-177909,-177909,32674,-1842227,,,,132092,80504734,80682643,73271853,404483,-34792733.0,94482,-34698251,56905,SOL
2019-12-31,212197000,,243587000,,226630000,1151012000,1578943000,215734000,215734000,,,,,,16957000,2114855000,1899121000,535912000,27853000,,226630000,188160000,56906,GSX
2018-12-31,74050000,,22266000,,19650000,161349000,254553000,19154000,19154000,,,,,,2616000,397306000,378152000,142753000,3112000,,19650000,-19280000,56906,GSX
2017-12-31,52451000,,-91575000,,-86955000,112533000,72557000,-92427000,-92427000,,,,,,-4620000,97580000,190007000,25023000,852000,,-86955000,-125885000,56906,GSX
2019-12-31,45607000,,-50274000,,-50274000,8546000,0,-54153000,-54153000,,-40000,,,,0,0,54153000,0,3879000,,-50274000,-50274000,56907,PCVX
2018-12-31,30145000,,-29485000,,-29485000,5388000,0,-35533000,-35533000,,-75000,,,,0,0,35533000,0,6048000,,-29485000,-29485000,56907,PCVX
2017-12-31,12785000,,-17238000,,-17238000,5048000,0,-17833000,-17833000,,-69000,,,,0,0,17833000,0,595000,,-17238000,-17238000,56907,PCVX
2019-12-29,17800000,,101816000,,79200000,363804000,525454000,138847000,138847000,5003000,-25656000,,,,22616000,1343029000,1204182000,817575000,-37031000,,79200000,79200000,56908,TILE
2018-12-30,16400000,,54991000,,50253000,305749000,451023000,128874000,128874000,5003000,-15436000,,,,4738000,1179573000,1050699000,728550000,-73883000,,50253000,50253000,56908,TILE
2017-12-31,14000000,,100539000,,53246000,253151000,386021000,118870000,118870000,5003000,-7128000,,,,47293000,996443000,877573000,610422000,-18331000,,53246000,53246000,56908,TILE
2017-01-01,14300000,,79136000,,54162000,247403000,368644000,106941000,106941000,5003000,-6130000,,,,24974000,958617000,851676000,589973000,-27805000,,54162000,54162000,56908,TILE
2019-12-31,9395000000,,90016000000,137736000000,57591000000,125628000000,475914000000,86582000000,86582000000,242535000000,-15585000000,,,,17894000000,2966193000000,2879611000000,2490279000000,3434000000,,72122000000,57591000000,56909,SNP
2018-12-31,7956000000,,100502000000,139304000000,63089000000,132786000000,484746000000,86621000000,86621000000,246498000000,-5883000000,,,,20213000000,2891179000000,2804558000000,2406433000000,13881000000,,80289000000,63089000000,56909,SNP
2017-12-31,7956000000,,86697000000,126770000000,51244000000,139827000000,588749000000,76842000000,76842000000,236849000000,-7146000000,,,,16279000000,2359400000000,2282558000000,1770651000000,9855000000,,70418000000,51244000000,56909,SNP
2016-12-31,7956000000,,80151000000,120241000000,46672000000,128247000000,550311000000,63965000000,63965000000,228059000000,-9219000000,,,,20707000000,1930002000000,1866037000000,1379691000000,16186000000,,59444000000,46672000000,56909,SNP
2019-12-31,,,46862000,,36186000,76237000,142249000,0,51251000,12918000,,,,,10676000,142249000,90998000,0,-4389000,,36186000,36002000,56911,DCOM
2018-12-31,,,66715000,,51288000,70523000,153605000,0,68684000,12874000,,,,,15427000,153605000,84921000,0,-1969000,,51288000,51128000,56911,DCOM
2017-12-31,,,88738000,,51882000,65291000,173724000,0,92976000,13770000,,,,,36856000,173724000,80748000,0,-4238000,,51882000,51751000,56911,DCOM
2016-12-31,,,133471000,,72514000,56272000,217302000,0,135986000,10393000,,,,,60957000,217302000,81316000,0,-2515000,,72514000,72405000,56911,DCOM
2019-12-31,,,259954000,,205104000,248093000,569597000,0,267747000,53757000,,,,,54850000,569597000,301850000,0,-7793000,,205104000,205104000,56912,IBOC
2018-12-31,,,272583000,,215931000,231314000,572472000,0,280738000,60420000,,,,,56652000,572472000,291734000,0,-8155000,,215931000,215931000,56912,IBOC
2017-12-31,,,221642000,,157436000,227163000,515390000,0,231691000,56536000,,,,,64206000,515390000,283699000,0,-10049000,,157436000,157436000,56912,IBOC
2016-12-31,,,197003000,,133932000,216555000,486274000,0,215638000,54081000,,,,,63071000,486274000,270636000,0,-18635000,,133932000,133932000,56912,IBOC
2020-03-28,,,154139000,,126036000,122593000,289503000,157918000,157918000,8992000,-1885000,,,,28103000,727461000,569543000,437958000,-3779000,,126036000,126036000,56914,ROLL
2019-03-30,,,126090000,,105193000,117752000,276653000,149546000,149546000,9355000,-6173000,,,,20897000,702516000,552970000,425863000,-23456000,,105193000,105193000,56914,ROLL
2018-03-31,,,119851000,,87141000,113660000,258537000,136164000,136164000,8713000,-7507000,,,,32710000,674949000,538785000,416412000,-16313000,,87141000,87141000,56914,ROLL
2017-04-01,,,104884000,,70623000,103815000,230211000,117872000,117872000,8524000,-8706000,,,,34261000,615388000,497516000,385177000,-12988000,,70623000,70623000,56914,ROLL
2020-12-31,,,11328000,,8937000,16622000,34006000,0,11923000,5461000,,,,,2391000,34006000,22083000,0,-595000,,8937000,8937000,56915,SFBC
2019-12-31,,,8330000,,6679000,16942000,31115000,0,8644000,5529000,,,,,1651000,31115000,22471000,0,-314000,,6679000,6679000,56915,SFBC
2018-12-31,,,8745000,,7039000,17077000,31568000,0,9263000,5228000,,,,,1706000,31568000,22305000,0,-518000,,7039000,7039000,56915,SFBC
2017-12-31,,,8193000,,5125000,14358000,27440000,0,8734000,4348000,,,,,3068000,27440000,18706000,0,-541000,,5125000,5125000,56915,SFBC
2020-08-31,,,951704,,951704,1151822,5881182,4729360,4729360,,-1011052,,,,0,5881182,1151822,0,-3777656,,951704,951704,56919,BSE
2019-08-31,,,9641762,,9641762,1111029,5873163,4762134,4762134,,-1487486,,,,0,5873163,1111029,0,4879628,,9641762,9641762,56919,BSE
2018-08-31,,,-876544,,-876544,1049587,5899432,4849845,4849845,,-1251416,,,,0,5899432,1049587,0,-5726389,,-876544,-876544,56919,BSE
2017-08-31,,,-1144494,,-1144494,1065667,6141797,5076130,5076130,,-967489,,,,0,6141797,1065667,0,-6220624,,-1144494,-1144494,56919,BSE
2019-12-31,14424000,,-17486000,,-17792000,4336000,1049000,-17711000,-17711000,,,,,,306000,2334000,20045000,1285000,225000,,-17792000,-17792000,56922,AYLA
2018-12-31,5741000,,-8587000,,-8873000,3294000,0,-9035000,-9035000,,-10000.0,,,,286000,0,9035000,0,448000,,-8873000,-8873000,56922,AYLA
2019-12-31,,,10171522,14193616,12176093,16024225,25931099,8925390,8925390,,-2814,,,,66621,68793651,59868261,42862552,1246132,3621170,10104901,12164156,56928,CWCO
2018-12-31,,,10716158,8784722,11293487,14326802,23886460,8032868,8032868,,-8427,,,,-157291,65719857,57686989,41833397,2683290,1115825,10873449,11281131,56928,CWCO
2017-12-31,,,3802362,8088935,6144062,14142815,20986851,5316162,5316162,,-5722,,,,-888977,59367022,54050860,38380171,-1513800,1041234,4691339,6132644,56928,CWCO
2016-12-31,,,2241256,8500424,3960501,13871407,21238897,5573302,5573302,,-104048,,,,-536057,57875707,52302405,36636810,-3332046,1041234,2777313,3948938,56928,CWCO
2019-12-31,,,67306000,,66858000,63488000,110228000,46740000,46740000,,,,,,448000,289590000,242850000,179362000,20566000,,66858000,66858000,56929,CRSP
2018-12-31,,,-164428000,,-164981000,48294000,-110649000,-158943000,-158943000,,,,,,553000,3124000,162067000,113773000,-5485000,,-164981000,-164981000,56929,CRSP
2017-12-31,,,-66608000,,-68357000,35845000,-28803000,-64648000,-64648000,,,,,,1749000,40997000,105645000,69800000,-1960000,,-68357000,-68357000,56929,CRSP
2016-12-31,,,-22718000,,-23177000,31056000,-37074000,-68130000,-68130000,,-8050000.0,,,,484000,5164000,73294000,42238000,45412000,,-23202000,-23177000,56929,CRSP
2019-12-31,11100000,,-22740000,,-17332000,13369000,-9100000,-22469000,-22469000,,-1528000,,,,-1473000,0,22469000,9100000,-271000,3935000,-21267000,-17332000,56932,MACK
2018-12-31,49974000,,-68462000,,-40506000,15301000,-48974000,-64275000,-64275000,,-956000,,,,-7695000,0,64275000,48974000,-4187000,20261000,-60767000,-40506000,56932,MACK
2017-12-31,49974000,,-118403000,,472028000,28452000,-67314000,-95766000,-95766000,,-34650000,,,,-42399000,0,95766000,67314000,-22637000,546872000,-76004000,472028000,56932,MACK
2016-12-31,49974000,,-169508000,-1539000.0,-151740000,32052000,-106765000,-138817000,-138817000,,-22449000,,,,-13224000,0,138817000,106765000,-30691000,2766000,-156284000,-151740000,56932,MACK
2020-12-31,137598000,,169342000,,164375000,157077000,465954000,171279000,171279000,,,,,,4967000,844452000,673173000,378498000,-1937000,,164375000,164375000,56935,MPWR
2019-12-31,107757000,,113120000,,108839000,133542000,346325000,105026000,105026000,,,,,,4281000,627921000,522895000,281596000,8094000,,108839000,108839000,56935,MPWR
2018-12-31,93455000,,118482000,,105268000,113803000,322668000,115410000,115410000,,4994000.0,,,,13214000,582382000,466972000,259714000,3072000,,105268000,105268000,56935,MPWR
2017-12-31,82359000,,82944000,,65203000,97257000,258283000,78667000,78667000,,4994000.0,,,,17741000,470929000,392262000,212646000,4277000,,65203000,65203000,56935,MPWR
2020-10-31,,,102857310,,102857310,35331197,207967880,172636683,172636683,,-25509900,,,,0,207967880,35331197,0,-69779373,,102857310,102857310,56936,NAD
2019-10-31,,,430134867,,430134867,34811759,210092484,175280725,175280725,,-40834254,,,,0,210092484,34811759,0,254854142,,430134867,430134867,56936,NAD
2018-10-31,,,-59940673,,-59940673,34982340,209824335,174841995,174841995,,-35964856,,,,0,209824335,34982340,0,-234782668,,-59940673,-59940673,56936,NAD
2017-10-31,,,88231678,,88231678,35158238,207837126,172678888,172678888,,-23256757,,,,0,207837126,35158238,0,-84447210,,88231678,88231678,56936,NAD
2020-12-31,,,-2892000000,10548000000,-2738000000,152000000,2125000000,908000000,908000000,,-816000000,,,,-73000000,3186000000,2278000000,1061000000,-3800000000,,-2819000000,-2738000000,56937,BEPC
2019-12-31,,,494000000,6994000000,184000000,82000000,1466000000,875000000,875000000,,-381000000,,,,69000000,2267000000,1392000000,801000000,-381000000,,425000000,184000000,56937,BEPC
2018-12-31,,,330000000,6613000000,76000000,56000000,1364000000,777000000,777000000,,-402000000,,,,-32000000,2180000000,1403000000,816000000,-447000000,,362000000,76000000,56937,BEPC
2017-12-31,,,177000000,2582000000,-6000000,60000000,1230000000,611000000,611000000,,-438000000,,,,114000000,2062000000,1451000000,832000000,-434000000,,63000000,-6000000,56937,BEPC
2020-01-31,93089000,,-101767000,,-90832000,227239000,250503000,-69825000,-69825000,,-37658000,,,,-10935000,389719000,459544000,139216000,-31942000,,-90832000,-90832000,56941,COUP
2019-01-31,61608000,,-56061000,,-55524000,160820000,176912000,-45516000,-45516000,,-12518000,,,,-537000,260366000,305882000,83454000,-10545000,,-55524000,-55524000,56941,COUP
2018-01-31,44536000,,-42157000,,-43805000,127300000,126874000,-44962000,-44962000,,-502000,,,,1648000,186780000,231742000,59906000,1834000,,-43805000,-43805000,56941,COUP
2017-01-31,30262000,,-36759000,,-37607000,92517000,87506000,-35273000,-35273000,,-14000,,,,848000,133775000,169048000,46269000,-1486000,,-37607000,-37607000,56941,COUP
2020-12-31,,,4300000000,,3299000000,5596000000,11338000000,0,4693000000,445000000,,,,,1001000000,11691000000,6998000000,353000000,-393000000,,3299000000,3043000000,56942,SCHW
2019-12-31,,,4848000000,,3704000000,4948000000,10468000000,0,4910000000,261000000,,,,,1144000000,10721000000,5811000000,253000000,-62000000,,3704000000,3526000000,56942,SCHW
2018-12-31,,,4562000000,,3507000000,4709000000,9890000000,0,4562000000,313000000,,,,,1055000000,10132000000,5570000000,242000000,0,,3507000000,3329000000,56942,SCHW
2017-12-31,,,3650000000,,2354000000,4200000000,8387000000,0,3650000000,268000000,,,,,1296000000,8618000000,4968000000,231000000,0,,2354000000,2180000000,56942,SCHW
2019-12-31,,,1235000,,453000,23890000,25295000,-1933000,-1933000,,-249000,,,,782000,93662000,95595000,68367000,3168000,,453000,453000,56945,LWAY
2018-12-31,,,-3311000,,-3086000,27093000,28704000,-1866000,-1866000,,-271000,,,,-225000,103350000,105216000,74646000,-1445000,,-3086000,-3086000,56945,LWAY
2017-12-31,,,-804000,,-346000,30550000,33136000,-526000,-526000,,-242000,,,,-458000,118893000,119419000,85757000,-278000,,-346000,-346000,56945,LWAY
2016-12-31,,,5637000,,3479000,28250000,37355000,6085000,6085000,,-220000,,,,2158000,123879000,117794000,86524000,-448000,,3479000,3479000,56945,LWAY
2019-12-31,,,-90407000,311951000,-59397000,39156000,69921000,-73816000,-73816000,,-94519000,,,,196000,150639000,224455000,80718000,-34585000,,-90603000,-64297000,56946,SRG
2018-12-31,,,-114557000,369688000,-73472000,34788000,133155000,-128565000,-128565000,,-90020000,,,,321000,204306000,332871000,71151000,14008000,,-114878000,-78375000,56946,SRG
2017-12-31,,,-120542000,434164000,-73754000,27902000,167876000,-122355000,-122355000,,-70112000,,,,271000,233229000,355584000,65353000,1813000,,-120813000,-73999000,56946,SRG
2016-12-31,,,-90504000,619754000,-51558000,17469000,188129000,-6728000,-6728000,,-63591000,,,,505000,253320000,260048000,65191000,-83776000,,-91009000,-51558000,56946,SRG
2019-12-31,,,2270000,,1160000,3028000,0,-3028000,-3028000,,,,,,1110000,0,3028000,0,10821000,,1160000,1160000,56947,GOEVW
2018-12-31,,,-7200,,-7200,7200,0,-7200,-7200,,,,,,0,0,7200,0,0,,-7200,-7200,56947,GOEVW
2020-12-31,,,1577549000,881555000,1405521000,68492000,2830834000,1818135000,1818135000,875176000,-143456000,,,,111838000,8525275000,6707140000,5694441000,-240586000,,1465711000,1363909000,56948,ACGLP
2019-12-31,,,1849110000,818181000,1636319000,65667000,2953803000,2005035000,2005035000,800997000,-120872000,,,,155810000,6928200000,4923165000,3974397000,-155925000,,1693300000,1594707000,56948,ACGLP
2018-12-31,,,841772000,997852000,757971000,58608000,1755327000,913240000,913240000,677809000,-120484000,,,,113951000,5450568000,4537328000,3695241000,-71468000,,727821000,713616000,56948,ACGLP
2017-12-31,,,757277000,1049333000,619278000,61602000,1884471000,1012640000,1012640000,684451000,-117431000,,,,127568000,5627375000,4614735000,3742904000,-255363000,,629709000,566502000,56948,ACGLP
2020-12-31,,,-15730000,,1298000,895321000,1035009000,139688000,139688000,,,,,,-17028000,4054377000,3914689000,3019368000,-155418000,,1298000,1298000,56951,HOG
2019-12-31,,,557415000,,423635000,1005701000,1622059000,616358000,616358000,,-31078000.0,,,,133780000,5361789000,4745431000,3739730000,-58943000,,423635000,423635000,56951,HOG
2018-12-31,,,686629000,,531451000,1090436000,1913299000,822863000,822863000,,-30884000.0,,,,155178000,5716875000,4894012000,3803576000,-133195000,,531451000,531451000,56951,HOG
2017-12-31,,,863839000,,521759000,1016761000,1908025000,891264000,891264000,,-31004000.0,,,,342080000,5647224000,4755960000,3739199000,-27425000,,521759000,521759000,56951,HOG
2019-12-31,3162000,,-4669000,,-4670000,1136000,0,-4298000,-4298000,,-100000,,,,1000,0,4298000,0,-371000,,-4670000,-4670000,56953,TARS
2018-12-31,901000,,-1318000,,-1319000,449000,0,-1350000,-1350000,,-100000,,,,1000,0,1350000,0,32000,,-1319000,-1319000,56953,TARS
2019-12-31,5141805,,-7641817,,-7641817,3597111,-4136777,-7733888,-7733888,,,,,,0,1005028,8738916,5141805,92071,,-7641817,-7641817,56958,CAPR
2018-12-31,5141805,,-15191095,,-15191095,4931642,-10395444,-15327086,-15327086,,,,,,0,1671356,16998442,12066800,135991,,-15191095,-15191095,56958,CAPR
2017-12-31,5141805,,2431423,,2431423,4762642,-8099755,-12862397,-12862397,,-398807.0,,,,0,2666340,15528737,10766095,15293820,,2431423,2431423,56958,CAPR
2016-12-31,5141805,,-18806776,,-18806776,4933054,-12043464,-16976518,-16976518,,-344665.0,,,,0,3998618,20975136,16042082,-1830258,,-18806776,-18806776,56958,CAPR
2019-12-31,,,80817000,,55902000,,227166000,95657000,95657000,,-36153000,,,,24915000,7159423000,7063766000,6932257000,-14840000,,55902000,55902000,56963,MGLN
2018-12-31,,,43194000,,24181000,,199019000,66359000,66359000,,-35396000,,,,19013000,7314151000,7247792000,7115132000,-23165000,,24181000,24181000,56963,MGLN
2017-12-31,,,135224000,,110207000,,290931000,175225000,175225000,,-25977000,,,,25083000,5838583000,5663358000,5547652000,-40001000,,110141000,110207000,56963,MGLN
2016-12-31,,,145517000,4770000.0,77879000,,282815000,176769000,176769000,,-10193000,,,,69728000,4836884000,4660115000,4554069000,-31252000,,75789000,77879000,56963,MGLN
2019-12-31,,,94617000,-517000,938484000,672422000,999150000,326728000,326728000,,-167331000,,,,80656000,3250326000,2923598000,2251176000,-232111000,923703000,13961000,938276000,56964,LAUR
2018-12-31,,,121237000,4263000,370067000,700757000,994618000,293861000,293861000,,-235041000,,,,131771000,3290213000,2996352000,2295595000,-172624000,381464000,-10534000,381352000,56964,LAUR
2017-12-31,,,-76615000,25839000,91465000,708229000,947829000,239600000,239600000,,-334725000,,,,-92989000,3333073000,3093473000,2385244000,-316215000,77390000,16374000,-207032000,56964,LAUR
2016-12-31,,,367180000,56058000,371847000,615652000,905870000,290218000,290218000,,-390526000,,,,34440000,3301864000,3011646000,2395994000,76962000,33446000,332740000,370310000,56964,LAUR
2020-12-31,,,-1481900000,120300000,-1572600000,245700000,300000000,54300000,54300000,,-94400000,,,,77700000,2982100000,2927800000,2682100000,-1536200000,,-1559600000,-1572600000,56966,ATI
2019-12-31,,,241600000,103100000,257600000,340800000,637800000,297000000,297000000,,-104900000,,,,-28500000,4122500000,3825500000,3484700000,-55400000,,270100000,257600000,56966,ATI
2018-12-31,,,247700000,105900000,222400000,302100000,630300000,328200000,328200000,,-102100000,,,,11000000,4046600000,3718400000,3416300000,-80500000,,236700000,222400000,56966,ATI
2017-12-31,,,-86500000,105100000,-91900000,302300000,497000000,194700000,194700000,,-134900000,,,,-6800000,3525100000,3330400000,3028100000,-281200000,,-79700000,-91900000,56966,ATI
2019-12-31,20384049,,-32943583,,-32943583,13935761,0,-34319810,-34319810,,,,,,0,0,34319810,0,1376227,,-32943583,-32943583,56967,ZYNE
2018-12-31,27245043,,-39911175,,-39911175,13238787,86000,-40397830,-40397830,,,,,,0,86000,40483830,0,486655,,-39911175,-39911175,56967,ZYNE
2017-12-31,22806107,,-32012304,,-32012304,10016902,0,-32823009,-32823009,,,,,,0,0,32823009,0,810705,,-32012304,-32012304,56967,ZYNE
2016-12-31,16784626,,-23416050,,-23388507,6430252,7250,-23207628,-23207628,,,,,,-27543,7250,23214878,0,-208422,,-23388507,-23388507,56967,ZYNE
2020-02-02,,,14715000000,,11242000000,19740000000,37572000000,15843000000,15843000000,,-1201000000,,,,3473000000,110225000000,94382000000,72653000000,-1128000000,,11242000000,11242000000,56968,HD
2019-02-03,,,14556000000,,11121000000,19513000000,37160000000,15777000000,15777000000,,-1051000000,,,,3435000000,108203000000,92426000000,71043000000,-1221000000,,11121000000,11121000000,56968,HD
2018-01-28,,,13698000000,,8630000000,17864000000,34356000000,14681000000,14681000000,,-1057000000,,,,5068000000,100904000000,86223000000,66548000000,-983000000,,8630000000,8630000000,56968,HD
2017-01-29,,,12491000000,,7957000000,17132000000,32313000000,13427000000,13427000000,,-972000000,,,,4534000000,94595000000,81168000000,62282000000,-936000000,,7957000000,7957000000,56968,HD
2020-12-31,,,-2010000000,,-1421000000,756000000,1266000000,-1549000000,-1549000000,-262000000,-563000000,,,,-903000000,64912000000,66461000000,63646000000,-461000000,,-1107000000,-1421000000,56970,VLO
2019-12-31,,,3486000000,733000000.0,2422000000,819000000,6531000000,3885000000,3885000000,-428000000,-454000000,,,,702000000,102729000000,98844000000,96198000000,-399000000,,2784000000,2415000000,56970,VLO
2018-12-31,,,4232000000,1064000000.0,3122000000,965000000,7441000000,4547000000,4547000000,-125000000,-470000000,,,,879000000,111407000000,106860000000,103966000000,-315000000,,3353000000,3113000000,56970,VLO
2017-12-31,,,3207000000,909000000.0,4065000000,793000000,6439000000,3599000000,3599000000,61000000,-468000000,,,,-949000000,88407000000,84808000000,81968000000,-453000000,,4156000000,4051000000,56970,VLO
2020-12-31,258276000,,-55290000,,-59744000,103376000,375700000,14048000,14048000,,-24926000,,,,4454000,682954000,668906000,307254000,-69338000,,-59744000,-59744000,56971,IPHI
2019-12-31,183875000,,-72515000,,-72911000,78394000,212821000,-49448000,-49448000,,-34920000,,,,396000,365635000,415083000,152814000,-23067000,,-72911000,-72911000,56971,IPHI
2018-12-31,167924000,,-103962000,,-95751000,71382000,165145000,-74161000,-74161000,,-32209000,,,,-8211000,294490000,368651000,129345000,-29801000,,-95751000,-95751000,56971,IPHI
2017-12-31,163699000,,-96080000,,-74904000,66163000,206677000,-23185000,-23185000,,-29842000,,,,-21176000,348201000,371386000,141524000,-72895000,,-74904000,-74904000,56971,IPHI
2020-03-31,,,-22328000,,-28126000,230008000,592724000,224548000,224548000,,-122129000,,,,5798000,2900117000,2675569000,2307393000,-246876000,,-28126000,-28126000,56973,TGI
2019-03-31,,,-327193000,,-321767000,232249000,500410000,118257000,118257000,,-121419000,,,,-5426000,3364930000,3246673000,2864520000,-445450000,,-321767000,-321767000,56973,TGI
2018-03-31,,,-461848000,,-425391000,215670000,591395000,217357000,217357000,,-99442000,,,,-36457000,3198951000,2981594000,2607556000,-679205000,,-425391000,-425391000,56973,TGI
2017-03-31,,,-23612000,,-42952000,196916000,758350000,395286000,395286000,,-80501000,,,,19340000,3532799000,3137513000,2774449000,-418898000,,-42952000,-42952000,56973,TGI
2019-12-31,,,27932000,,19609000,49355000,60963000,-1081000,-1081000,,-8510000,,,,8323000,275333000,276414000,214370000,29013000,,19609000,19609000,56974,IMXI
2018-12-31,,,-5376000,,-7244000,44950000,50265000,2144000,2144000,,-18448000,,,,1868000,234136000,231992000,183871000,-7520000,,-7244000,-7244000,56974,IMXI
2017-12-31,,,-15161000,,-13492000,38157000,36990000,-3594000,-3594000,,-12062000,,,,-1669000,183000000,186594000,146010000,-11567000,,-13492000,-10174000,56974,IMXI
2016-12-31,,,13484000,,9400000,30064000,30737000,-1857000,-1857000,,-9540000,,,,4084000,139613000,141470000,108876000,15341000,,9400000,9400000,56974,IMXI
2019-12-25,,,27514000,23168000,19827000,63213000,217081000,29473000,29473000,69169000,-434000,,,,3386000,594519000,565046000,377438000,-1959000,,24128000,19827000,56975,SHAK
2018-12-26,,,30810000,47380000,15179000,48869000,178410000,36479000,36479000,51783000,-2415000,,,,8862000,459310000,422831000,280900000,-5669000,,21948000,15179000,56975,SHAK
2017-12-27,,,160293000,54987000,-320000,39003000,140536000,34421000,34421000,35805000,-1643000,,,,151409000,358810000,324389000,218274000,126774000,,8884000,-320000,56975,SHAK
2016-12-28,,,28496000,49165000,12446000,30556000,107363000,27839000,27839000,24946000,-374000,,,,6350000,268475000,240636000,161112000,1345000,,22146000,12446000,56975,SHAK
2019-12-31,11040000,,-14859000,,-14859000,2786000,0,-13826000,-13826000,,,,,,0,0,13826000,0,-1033000,,-14859000,-14859000,56976,DYN
2018-12-31,4278000,,-4811000,,-4811000,517000,0,-4795000,-4795000,,,,,,0,0,4795000,0,-16000,,-4811000,-4811000,56976,DYN
2020-12-31,,,399795000,293083000,269579000,833051000,1222821000,401034000,401034000,-11264000,-1239000,,,,76623000,5054928000,4653894000,3832107000,-1239000,,323172000,246439000,56982,WSO
2019-12-31,,,362852000,279340000,245950000,775276000,1156956000,357168000,357168000,-10256000,-4032000,,,,67077000,4770362000,4413194000,3613406000,5684000,,295775000,225538000,56982,WSO
2018-12-31,,,369342000,253864000,242932000,735486000,1120252000,362671000,362671000,-9282000,-2740000,,,,72813000,4546653000,4183982000,3426401000,6671000,,296529000,223140000,56982,WSO
2017-12-31,,,347511000,253024000,208221000,692809000,1065659000,350817000,350817000,-3886000,-6363000,,,,90221000,4341955000,3991138000,3276296000,-3306000,,257290000,190791000,56982,WSO
2019-12-28,13900000,,209673000,45407000,153769000,437363000,692496000,241233000,241233000,,-40153000,,,,50207000,2766976000,2525743000,2074480000,-31560000,,159466000,153769000,56984,VMI
2018-12-29,11500000,,143441000,75761000,94351000,408318000,676660000,256842000,256842000,,-44237000,,,,43135000,2757144000,2500302000,2080484000,-113401000,,100306000,94351000,56984,VMI
2017-12-30,11600000,,228464000,38959000,116240000,406336000,681768000,263832000,263832000,,-44645000,,,,106145000,2745967000,2482135000,2064199000,-35368000,,122319000,116240000,56984,VMI
2016-12-31,8300000,,220454000,39104000,173232000,400848000,661816000,252668000,252668000,,-44409000,,,,42063000,2521676000,2269008000,1859860000,-32214000,,178391000,173232000,56984,VMI
2020-10-31,93300000,,266500000,200000,238400000,992500000,1624900000,401900000,401900000,,-36800000,,,,28100000,2430900000,2029000000,806000000,-135400000,,238400000,238400000,56985,COO
2019-10-31,86700000,,477400000,200000,466700000,969500000,1785000000,583000000,583000000,,-68000000,,,,10700000,2653400000,2070400000,868400000,-105600000,,466700000,466700000,56985,COO
2018-10-31,84800000,,331900000,200000,139900000,973300000,1632300000,427500000,427500000,,-82700000,,,,192000000,2532800000,2105300000,900500000,-95600000,,139900000,139900000,56985,COO
2017-10-31,69200000,,394000000,100000,372900000,799100000,1365800000,429100000,429100000,,-33400000,,,,21100000,2139000000,1709900000,773200000,-60600000,,372900000,372900000,56985,COO
2019-12-31,94253000,,-7556000,622000,-10849000,231138000,314434000,-10957000,-10957000,,,,,,3523000,636080000,647037000,321646000,3401000,,-11079000,-10849000,56987,SSYS
2018-12-31,98964000,,-6489000,852000,-10964000,235107000,325235000,-8836000,-8836000,,-1323000.0,,,,4736000,663237000,672073000,338002000,2347000,,-11225000,-11899000,56987,SSYS
2017-12-31,96237000,,-31186000,1652000,-39981000,257063000,324288000,-29012000,-29012000,,-1323000.0,,,,9273000,668362000,697374000,344074000,-2174000,,-40459000,-39981000,56987,SSYS
2016-12-31,97778000,,-87067000,2160000,-77219000,287118000,323148000,-61748000,-61748000,,-1323000.0,,,,-9446000,672458000,734206000,349310000,-25319000,,-77621000,-77219000,56987,SSYS
2019-12-31,,,-430000000,579000000,-675000000,321000000,5112000000,904000000,904000000,3279000000,-1044000000,,,,160000000,13210000000,12306000000,8098000000,-1334000000,,-590000000,-675000000,56988,CYH
2018-12-31,,,-715000000,576000000,-788000000,337000000,5416000000,892000000,892000000,3487000000,-983000000,,,,-11000000,14155000000,13263000000,8739000000,-1607000000,,-704000000,-788000000,56988,CYH
2017-12-31,,,-2833000000,602000000,-2459000000,394000000,5305000000,216000000,216000000,3834000000,-942000000,,,,-449000000,15353000000,15137000000,10048000000,-3049000000,-12000000.0,-2384000000,-2459000000,56988,CYH
2016-12-31,,,-1715000000,667000000,-1721000000,450000000,6803000000,1082000000,1082000000,4171000000,-976000000,,,,-104000000,18438000000,17356000000,11635000000,-2797000000,-15000000.0,-1611000000,-1721000000,56988,CYH
2018-12-31,,,35678000,,35678000,39445000,49515000,9586000,9586000,,-16066000,,,,0,49515000,39929000,0,26092000,,35678000,35678000,56991,NEWTL
2017-12-31,,,38976000,,38976000,35451000,38914000,3061000,3061000,,-11397000,,,,0,38914000,35853000,0,35915000,,38976000,38976000,56991,NEWTL
2016-12-31,,,27305000,,27305000,31489000,30965000,-820000,-820000,,-8440000,,,,0,30965000,31785000,0,28125000,,27305000,27305000,56991,NEWTL
2015-12-31,,,35736000,,35736000,25450000,26070000,294000,294000,,-6479000,,,,0,26070000,25776000,0,35442000,,35736000,35736000,56991,NEWTL
2020-12-31,121419000,,-124973000,,-119370000,309074000,330004000,-100489000,-100489000,,-24964000,,,,-5603000,431059000,531548000,101055000,-24484000,,-119370000,-119370000,56992,NET
2019-12-31,90669000,,-104713000,,-105828000,240876000,223599000,-107946000,-107946000,,-1112000,,,,1115000,287022000,394968000,63423000,3233000,,-105828000,-105828000,56992,NET
2018-12-31,54463000,,-86087000,,-87164000,179573000,149137000,-84899000,-84899000,,-992000,,,,1077000,192674000,277573000,43537000,-1188000,,-87164000,-87164000,56992,NET
2017-12-31,33650000,,-9715000,,-10748000,82207000,106127000,-9730000,-9730000,,-862000,,,,1033000,134915000,144645000,28788000,15000,,-10748000,-10748000,56992,NET
2020-06-30,62766000,,67118000,,64455000,246682000,379319000,69871000,69871000,,-695000,,,,2663000,561329000,491458000,182010000,-2753000,,64455000,64455000,56993,PCTY
2019-06-30,50329000,,58046000,,53823000,207229000,313782000,56224000,56224000,,-695000,,,,4223000,467633000,411409000,153851000,3644000,,53823000,53823000,56993,PCTY
2018-06-30,37645000,,16751000,,38598000,174736000,228330000,15949000,15949000,,-695000,,,,-21847000,377527000,361578000,149197000,802000,,38598000,38598000,56993,PCTY
2017-06-30,29098000,,7369000,,6718000,139629000,176023000,7296000,7296000,,-695000,,,,651000,300010000,292714000,123987000,73000,,6718000,6718000,56993,PCTY
2019-12-31,,,1422813,,1124021,659755,0,-659755,-659755,,,,,,298791,0,659755,0,2082567,,1124021,-445601,56994,NPA
2019-12-31,836175,,-2473627,,-2473627,1342324,0,-2178499,-2178499,,-295128,,,,0,0,2178499,0,-295128,,-2473627,-2473627,56995,VIRI
2018-12-31,854109,,-2113592,,-2113592,1107386,0,-1961495,-1961495,,-152103,,,,0,0,1961495,0,-152097,,-2113592,-2113592,56995,VIRI
2019-12-31,,,4841000,,4841000,2130000,8585000,0,4998000,1457000,,,,,0,8585000,3587000,0,-157000,,4841000,4841000,56997,TRMT
2018-12-31,,,-1608000,,-1608000,2548000,2400000,0,-1608000,1460000,,,,,0,2400000,4008000,0,0,,-1608000,-1608000,56997,TRMT
2017-12-31,,,-2221715,,-2221715,1868572,380571,0,-2221715,733714,,,,,0,380571,2602286,0,0,,-2221715,-2221715,56997,TRMT
2019-12-31,,,-2210696,,-2210696,4011528,1498604,-4117008,-4117008,,-209196,,,,0,11611543,15728551,10112939,1906312,,-2210696,-2210696,56999,ABCL
2018-12-31,,,308854,,308854,2862189,3028036,-752612,-752612,,-212625,,,,0,8830557,9583169,5802521,1061466,,308854,291907,56999,ABCL
2020-09-26,,,713000000,,559000000,835000000,2408000000,1273000000,1273000000,,-460000000,,,,154000000,11709000000,10436000000,9301000000,-560000000,,559000000,559000000,57001,BERY
2019-09-28,,,490000000,,404000000,577000000,1619000000,848000000,848000000,,-348000000,,,,86000000,8878000000,8030000000,7259000000,-358000000,,404000000,404000000,57001,BERY
2018-09-29,,,477000000,3000000.0,496000000,476000000,1431000000,801000000,801000000,,-264000000,,,,-19000000,7869000000,7068000000,6438000000,-324000000,,496000000,496000000,57001,BERY
2017-09-30,,,449000000,3000000.0,340000000,491000000,1404000000,759000000,759000000,,-269000000,,,,109000000,7095000000,6336000000,5691000000,-310000000,,340000000,340000000,57001,BERY
2020-12-31,,,444800000,,358700000,,1031100000,488100000,488100000,543000000,-37100000,,,,82800000,4827300000,4339200000,3796200000,-43300000,-3300000,362000000,358700000,57006,THG
2019-12-31,,,522100000,,425100000,,1098500000,559600000,559600000,538900000,-37500000,,,,93100000,4890700000,4331100000,3792200000,-37500000,-3900000,429000000,425100000,57006,THG
2018-12-31,,,282500000,,391000000,,877900000,355800000,355800000,522100000,-45100000,,,,43500000,4494300000,4138500000,3616400000,-73300000,152000000,239000000,391000000,57006,THG
2017-12-31,,,292900000,,186200000,,847600000,338100000,338100000,509500000,-45200000,,,,76800000,4267900000,3929800000,3420300000,-45200000,-29900000,216100000,186200000,57006,THG
2019-12-31,87000000,,591000000,40000000,405000000,732000000,1624000000,768000000,768000000,37000000,-131000000,,,,186000000,7160000000,6392000000,5536000000,-177000000,,405000000,405000000,57007,OC
2018-12-31,89000000,,703000000,41000000,545000000,680000000,1651000000,853000000,853000000,29000000,-117000000,,,,156000000,7057000000,6204000000,5406000000,-150000000,,547000000,545000000,57007,OC
2017-12-31,85000000,,559000000,42000000,289000000,674000000,1594000000,780000000,780000000,55000000,-107000000,,,,269000000,6384000000,5604000000,4790000000,-221000000,,290000000,289000000,57007,OC
2016-12-31,82000000,,587000000,40000000,393000000,576000000,1412000000,748000000,748000000,6000000,-108000000,,,,188000000,5677000000,4929000000,4265000000,-161000000,,399000000,393000000,57007,OC
2020-11-01,4968000000,,2443000000,,2960000000,1932000000,17370000000,4250000000,4250000000,,-1777000000,,,,-518000000,23888000000,19638000000,6518000000,-1807000000,-1000000,2961000000,2663000000,57009,AVGOP
2019-11-03,4696000000,,2226000000,,2724000000,1635000000,15874000000,4331000000,4331000000,,-1444000000,,,,-510000000,22597000000,18266000000,6723000000,-2105000000,-12000000,2736000000,2695000000,57009,AVGOP
2018-11-04,3768000000,,4545000000,,12259000000,1027000000,13827000000,5487000000,5487000000,,-628000000,,,,-8084000000,20848000000,15361000000,7021000000,-942000000,-19000000,12629000000,12259000000,57009,AVGOP
2017-10-29,3302000000,,1825000000,2901000000.0,1692000000,777000000,11043000000,2689000000,2689000000,,-454000000,,,,35000000,17636000000,14947000000,6593000000,-864000000,-6000000,1790000000,1692000000,57009,AVGOP
2019-12-31,,,593942,,437904,1376456,1895116,518660,518660,,,,,,156038,5255810,4737150,3360694,75282,,437904,437904,57010,CLEU
2018-12-31,,,1092253,518575.0,842661,1283560,2106696,823136,823136,,,,,,167813,4808993,3985857,2702297,269117,,924440,842661,57010,CLEU
2017-12-31,,,1032915,459667.0,869006,950186,1724564,774378,774378,,,,,,158109,3885886,3111508,2161322,258537,,874806,869006,57010,CLEU
2020-03-31,105981000,,-165537000,,-124511000,297808000,227868000,-176584000,-176584000,663000,,,,,-40276000,380572000,557156000,152704000,11047000,750000,-125261000,-124511000,57012,RAMP
2019-03-31,85697000,,-179356000,,1028547000,255318000,164902000,-176113000,-176113000,663000,,,,,-45409000,285620000,461733000,120718000,-3243000,1162494000,-133947000,1028547000,57012,RAMP
2018-03-31,60713000,,-133022000,,23480000,175993000,123705000,-112978000,-112978000,-23000,,,,,-65723000,220101000,333079000,96396000,-20044000,90779000,-67299000,23480000,57012,RAMP
2017-03-31,49367000,,-130760000,,4108000,152156000,74784000,-126547000,-126547000,-192000,,,,,-45184000,174760000,301307000,99976000,-4213000,89684000,-85576000,4108000,57012,RAMP
2020-06-30,397360,,-463857,,-465597,5749290,5662608,-484042,-484042,,,,,,1740,18311830,18795872,12649222,20185,,-465597,-465597,57013,KOSS
2019-06-30,334789,,279486,,305989,6208777,6819874,276308,276308,,,,,,-26503,21842097,21565789,15022223,3178,,305989,305989,57013,KOSS
2018-06-30,427009,,-369376,,-3411220,6493147,6555998,-364158,-364158,,-5218.0,,,,3041844,23522631,23886789,16966633,-5218,,-3411220,-3411220,57013,KOSS
2017-06-30,213653,,-773090,,-963636,7386229,6895304,-704578,-704578,,-964.0,,,,190546,24054281,24758859,17158977,-68512,,-963636,-963636,57013,KOSS
2019-12-31,,,197600000,,152000000,388600000,695900000,189600000,189600000,,-11100000,,,,45600000,1179000000,989400000,483100000,8000000,,152000000,152000000,57014,MORN
2018-12-31,,,230800000,,183000000,296300000,608800000,215800000,215800000,,-4100000,,,,47800000,1019900000,804100000,411100000,15000000,,183000000,183000000,57014,MORN
2017-12-31,,,179800000,,136900000,264100000,525100000,169800000,169800000,,-3600000,,,,42900000,911700000,741900000,386600000,10000000,,136900000,136900000,57014,MORN
2016-12-31,,,224700000,300000.0,161000000,202800000,454300000,180800000,180800000,,-1500000,,,,63700000,798600000,617800000,344300000,43900000,,161000000,161000000,57014,MORN
2019-12-31,,,28724000,,21865000,405041000,434477000,29436000,29436000,,-152000,,,,6859000,802370000,772934000,367893000,-712000,,21865000,21865000,57016,HVT
2018-12-31,,,40408000,,30307000,404856000,446577000,41721000,41721000,,-2451000,,,,10101000,817836000,776115000,371259000,-1313000,,30307000,30307000,57016,HVT
2017-12-31,,,43223000,,21075000,402884000,444860000,41976000,41976000,,-2512000,,,,22148000,820027000,778051000,375167000,1247000,,21075000,21075000,57016,HVT
2016-12-31,,,45821000,,28356000,399236000,443183000,43947000,43947000,,-2568000,,,,17465000,821800000,777853000,378617000,1874000,,28356000,28356000,57016,HVT
2019-12-31,25040000,,-51373000,,-51373000,14728000,-14641000,-54409000,-54409000,,-21000,,,,0,2224000,56633000,16865000,3036000,,-51373000,-51373000,57020,SYBX
2018-12-31,23137000,,-48435000,,-48435000,15716000,-12377000,-51230000,-51230000,,-43000,,,,0,2520000,53750000,14897000,2795000,,-48435000,-48435000,57020,SYBX
2017-12-31,30341000,,-40377000,,-40377000,12927000,2444000,-40824000,-40824000,,-57000,,,,0,2444000,43268000,0,447000,,-40377000,-40377000,57020,SYBX
2016-12-31,15010000,,-20954000,,-20954000,6398000,444000,-20964000,-20964000,,-7000,,,,0,444000,21408000,0,10000,,-20954000,-20954000,57020,SYBX
2019-12-31,,,37213000,24202000,34705000,9906000,50712000,0,37642000,2325000,,,,,124000,63530000,25888000,12818000,-429000,,37089000,34369000,57021,AJX
2018-12-31,,,31401000,33445000,28340000,8204000,43434000,0,32237000,2113000,,,,,64000,56834000,24597000,13400000,-836000,,31337000,28033000,57021,AJX
2017-12-31,,,30285000,27082000,28927000,7680000,42764000,0,31416000,2921000,,,,,131000,53639000,22223000,10875000,-1131000,,30154000,28606000,57021,AJX
2016-12-31,,,28909000,10431000,27836000,5433000,37585000,0,29474000,2393000,,,,,35000,46221000,16747000,8636000,-565000,,28874000,27696000,57021,AJX
2019-12-31,,,148488000,,113988000,500852000,743465000,184093000,184093000,,-28427000,,,,34500000,2222107000,2038014000,1478642000,-35605000,,113988000,113988000,57022,AMN
2018-12-31,,,186685000,,141741000,442618000,696383000,212528000,212528000,,-23443000,,,,44944000,2136074000,1923546000,1439691000,-25843000,,141741000,141741000,57022,AMN
2017-12-31,,,192763000,,132558000,399516000,644419000,212624000,212624000,,-19677000,,,,60205000,1988454000,1775830000,1344035000,-19861000,,132558000,132558000,57022,AMN
2016-12-31,,,176167000,,105838000,398496000,619724000,191608000,191608000,,-15465000,,,,70329000,1902225000,1710617000,1282501000,-15441000,,105838000,105838000,57022,AMN
2020-12-31,,,10629000,,9005000,26731000,43045000,0,11121000,5193000,,,,,1624000,43045000,31924000,0,-492000,,9005000,9005000,57023,LMST
2019-12-31,,,10998000,,10518000,24451000,41268000,0,12541000,4276000,,,,,480000,41268000,28727000,0,-1543000,,10518000,10412000,57023,LMST
2018-12-31,,,10824000,,8794000,23738000,40342000,0,12886000,3718000,,,,,2030000,40342000,27456000,0,-2062000,,8794000,8650000,57023,LMST
2017-12-31,,,6554000,,38453000,23499000,37321000,0,10118000,3704000,,,,,-31899000,37321000,27203000,0,-3564000,,38453000,37486000,57023,LMST
2020-12-31,,,101894000,,79990000,225463000,337557000,0,112094000,,,,,,21904000,337557000,225463000,0,-10200000,,79990000,79990000,57024,HMST
2019-12-31,,,48708000,,17512000,212232000,264322000,0,52090000,,,,,,7988000,264322000,212232000,0,-3382000,-23208000.0,40720000,16862000,57024,HMST
2018-12-31,,,28255000,,40027000,189947000,223496000,0,33549000,,,,,,2032000,223496000,189947000,0,-11539000,13804000.0,26223000,40027000,57024,HMST
2017-12-31,,,25774000,,68946000,186436000,216388000,0,29952000,,,,,,-16894000,216388000,186436000,0,-8500000,26278000.0,42668000,68946000,57024,HMST
2020-12-31,9467000,,76132000,1512000,75030000,92950000,175258000,72841000,72841000,,,,,,1107000,206107000,133266000,30849000,3291000,,75025000,75030000,57030,INMD
2019-12-31,5699000,,62041000,3737000,61145000,70806000,136123000,59618000,59618000,,,,,,883000,156361000,96743000,20238000,2423000,,61158000,61015000,57030,INMD
2018-12-31,4180000,,23625000,3600000,22371000,49436000,85105000,31489000,31489000,,,,,,1260000,100162000,68673000,15057000,-7864000,,22365000,21836000,57030,INMD
2017-12-31,2575000,,9799000,3066000,8819000,32878000,44403000,8950000,8950000,,,,,,980000,53456000,44506000,9053000,849000,,8819000,7665000,57030,INMD
2019-12-31,14618677000,,13692532000,18768261000,12184155000,27724204000,47453052000,5110171000,5110171000,,-725010000,,,,1802440000,576888484000,571778313000,529435432000,8582361000,,11890092000,12184155000,57031,JD
2018-12-31,12144383000,,-2373678000,17057171000,-2491633000,24396406000,33943975000,-2596814000,-2596814000,,-854538000,,,,426872000,462019759000,464616573000,428075784000,223136000,,-2800550000,-2491633000,57031,JD
2017-12-31,6652374000,,120960000,347889000,-152257000,19132897000,24949795000,-835476000,-835476000,,-963742000,,,,139593000,362331754000,363167230000,337381959000,956436000,-269076000.0,-18633000,-152257000,57031,JD
2016-12-31,4452708000,,-1881901000,7326883000,-3806790000,15383564000,18584619000,-1251653000,-1251653000,,-618567000,,,,166391000,258289947000,259541600000,239705328000,-630248000,-1806346000.0,-2048292000,-3806790000,57031,JD
2020-12-31,,,-271000000,215000000,-344000000,1505000000,3000000000,275000000,275000000,12000000,-624000000,,,,102000000,4171000000,3896000000,1171000000,-546000000,-12000000,-373000000,-344000000,57032,TIGO
2019-12-31,,,217000000,271000000,149000000,1588000000,3135000000,448000000,448000000,-1000000,-505000000,,,,120000000,4336000000,3888000000,1201000000,-231000000,57000000,97000000,149000000,57032,TIGO
2018-12-31,,,119000000,251000000,-10000000,1566000000,2829000000,474000000,474000000,-13000000,-325000000,,,,112000000,3946000000,3472000000,1117000000,-355000000,-33000000,7000000,-10000000,57032,TIGO
2017-12-31,,,172000000,185000000,87000000,1531000000,2767000000,441000000,441000000,-17000000,-311000000,,,,162000000,3936000000,3495000000,1169000000,-269000000,60000000,10000000,87000000,57032,TIGO
2019-12-29,,,262200000,,193200000,137400000,548600000,322800000,322800000,,-55700000,,,,69000000,1436800000,1114000000,888200000,-60600000,,193200000,193200000,57035,IAA
2018-12-30,,,246200000,,183700000,123800000,505600000,284400000,284400000,,-38700000,,,,62500000,1326800000,1042400000,821200000,-40200000,,183700000,183700000,57035,IAA
2017-12-31,,,197000000,,161400000,113300000,441100000,234700000,234700000,,-38600000,,,,35600000,1219200000,984500000,778100000,-37700000,,161400000,161400000,57035,IAA
2017-01-01,,,153300000,,94900000,110500000,389700000,191300000,191300000,,-38600000,,,,58400000,1098000000,906700000,708300000,-38000000,,94900000,94900000,57035,IAA
2020-12-31,,,-187432000,292357000,-156678000,,294840000,-62289000,-62289000,,-164837000,,,,-62105000,2649963000,2712252000,2355123000,-125143000,,-125327000,-156678000,57037,MEOH
2019-12-31,,,120840000,298675000,87767000,84200000.0,567777000,139450000,139450000,,-124426000,,,,4474000,3283514000,3144064000,2715737000,-18610000,,116366000,87767000,57037,MEOH
2018-12-31,,,811475000,296628000,568982000,84200000.0,1074927000,829624000,829624000,,-94416000,,,,153491000,4482702000,3653078000,3407775000,-18149000,,657984000,568982000,57037,MEOH
2017-12-31,,,470885000,244347000,316135000,84200000.0,708693000,476468000,476468000,,-94955000,,,,95788000,3060642000,2584174000,2351949000,-5583000,,375097000,316135000,57037,MEOH
2019-12-31,2522000,,-4183000,,-4183000,3172000,9000,-5685000,-5685000,,,,,,0,9000,5694000,0,1502000,,-4183000,-4183000,57039,AIKI
2018-12-31,2522000,,1727000,,1727000,3324000,28000,-4701000,-4701000,,,,,,0,28000,4729000,0,6428000,,1727000,1727000,57039,AIKI
2017-12-31,2522000,,-3306000,,-3306000,3659000,1236000,-3822000,-3822000,,,,,,0,1236000,5058000,0,516000,,-3306000,-3306000,57039,AIKI
2016-12-31,2522000,,-6476000,,-6476000,4018000,877000,-5838000,-5838000,,,,,,0,877000,6715000,0,-638000,,-6476000,25004000,57039,AIKI
2020-12-31,1548000000,,1267000000,58000000,1106000000,1121000000,3789000000,1322000000,1322000000,-202000000,-20000000,,,,159000000,10219000000,8897000000,6430000000,-55000000,,1108000000,1106000000,57042,STM
2019-12-31,1204000000,,510000000,68000000,387000000,1096000000,3398000000,1194000000,1194000000,-96000000,-59000000,,,,122000000,9556000000,8362000000,6158000000,-684000000,,388000000,387000000,57042,STM
2018-12-31,1125000000,,1760000000,65000000,1629000000,1109000000,3586000000,1402000000,1402000000,-50000000,-52000000,,,,125000000,9664000000,8262000000,6078000000,358000000,,1635000000,1629000000,57042,STM
2017-12-31,1296000000,,953000000,63000000,802000000,993000000,3272000000,1039000000,1039000000,-56000000,-52000000,,,,143000000,8347000000,7308000000,5075000000,-86000000,,810000000,802000000,57042,STM
2020-05-31,6067000000,,12063000000,643000000,10135000000,9275000000,31130000000,14151000000,14151000000,51000000,-1999000000,,,,1928000000,39068000000,24917000000,7938000000,-2088000000,,10135000000,10135000000,57045,ORCL
2019-05-31,6026000000,,12268000000,578000000,11083000000,9774000000,31511000000,14006000000,14006000000,16000000,-2082000000,,,,1185000000,39506000000,25500000000,7995000000,-1738000000,,11083000000,11083000000,57045,ORCL
2018-05-31,6084000000,,12424000000,501000000,3587000000,9715000000,31323000000,13901000000,13901000000,3000000,-2025000000,,,,8837000000,39383000000,25482000000,8060000000,-1477000000,,3587000000,3587000000,57045,ORCL
2017-05-31,6153000000,,11680000000,386000000,9452000000,9299000000,30340000000,13437000000,13437000000,3000000,-1798000000,,,,2228000000,37792000000,24355000000,7452000000,-1757000000,,9452000000,9452000000,57045,ORCL
2020-12-31,,,-1116000000,121000000,-1279000000,8628000000,6123000000,-2505000000,-2505000000,,-1651000000,,,,160000000,127144000000,129649000000,121021000000,1389000000,,-1276000000,-1279000000,57047,F
2019-12-31,,,-640000000,45000000,47000000,10218000000,12876000000,2658000000,2658000000,,-1049000000,,,,-724000000,155900000000,153242000000,143024000000,-3298000000,,84000000,47000000,57047,F
2018-12-31,,,4345000000,134000000,3677000000,9781000000,14835000000,5054000000,5054000000,,-1228000000,,,,650000000,160338000000,155284000000,145503000000,-709000000,,3695000000,3677000000,57047,F
2017-12-31,,,8159000000,126000000,7731000000,9962000000,16558000000,6596000000,6596000000,,-1190000000,,,,402000000,156776000000,150180000000,140218000000,1563000000,,7757000000,7731000000,57047,F
2019-12-31,14902622,,-20546711,,-20546711,5983147,0,-20885769,-20885769,,-7220,,,,0,0,20885769,0,339058,,-20546711,-23206609,57048,NEXI
2018-12-31,7729730,,-12833549,,-12833549,5513043,0,-13242773,-13242773,,-1564,,,,0,0,13242773,0,409224,,-12833549,-14906457,57048,NEXI
2019-12-31,71072000,,-82677000,,-82677000,13145000,0,-84217000,-84217000,,,,,,0,0,84217000,0,1540000,,-82677000,-89805000,57051,FULC
2018-12-31,25184000,,-32588000,,-32588000,8314000,0,-33498000,-33498000,,,,,,0,0,33498000,0,910000,,-32588000,-39147000,57051,FULC
2017-12-31,18494000,,-22964000,,-22964000,4499000,0,-22993000,-22993000,,,,,,0,0,22993000,0,29000,,-22964000,-25371000,57051,FULC
2020-06-30,,,-4508218,-1291912,-4045948,6495505,1976843,-4518662,-4518662,,-184332,,,,179449,2179480,6698142,202637,10444,,-4687667,-4045948,57052,PHCF
2019-06-30,,,-2710797,-641182,-2457186,5432407,2863916,-2568491,-2568491,,-199861,,,,392105,3180634,5749125,316718,-142306,,-3102902,-2457186,57052,PHCF
2018-06-30,,,274147,-2513,475346,3467866,3771633,303767,303767,,-128112,,,,148320,4139181,3835414,367548,-29620,,125827,475346,57052,PHCF
2017-06-30,,,1132657,-2513,957222,5394329,6567460,1173131,1173131,,-128112,,,,175435,6649536,5476405,82076,-40474,,957222,957222,57052,PHCF
2020-09-26,,,235044433,,178601433,906749183,1198251910,291502727,291502727,,-40529096,,,,56443000,4610609025,4319106298,3412357115,-56458294,,178601433,178601433,57053,IMKTA
2019-09-28,,,106598002,,81580002,873859464,1022000212,148140748,148140748,,-47410104,,,,25018000,4202033610,4053892862,3180033398,-41542746,,81580002,81580002,57053,IMKTA
2018-09-29,,,80318628,,97364628,856074106,980169361,124095255,124095255,,-47569703,,,,-17046000,4092804877,3968709622,3112635516,-43776627,,97364628,97364628,57053,IMKTA
2017-09-30,,,84261580,,53873580,837144859,963593003,126448144,126448144,,-47458033,,,,30388000,4002699727,3876251583,3039106724,-42186564,,53873580,53873580,57053,IMKTA
2020-12-31,,,74777000,,57518000,112039000,207575000,0,82111000,13425000,,,,,17259000,207575000,125464000,0,-7334000,,57518000,57518000,57054,LBAI
2019-12-31,,,93944000,,70672000,107397000,220204000,0,98495000,14312000,,,,,23272000,220204000,121709000,0,-4551000,,70672000,70076000,57054,LBAI
2018-12-31,,,80289000,,63401000,95487000,192039000,0,83696000,12856000,,,,,16888000,192039000,108343000,0,-3407000,,63401000,62819000,57054,LBAI
2017-12-31,,,80049000,,52580000,86750000,184583000,0,85289000,12544000,,,,,27469000,184583000,99294000,0,-5240000,,52580000,52100000,57054,LBAI
2020-09-26,222500000,,1001900000,2100000,1115200000,843500000,2513300000,1157300000,1157300000,-2900000,-116500000,,,,-108600000,3776400000,2619100000,1263100000,-155400000,,1110500000,1115200000,57055,HOLX
2019-09-28,232200000,,-257700000,2100000,-203600000,886700000,2075200000,585800000,585800000,-2900000,-140800000,,,,-54100000,3367300000,2781500000,1292100000,-843500000,,-203600000,-203600000,57055,HOLX
2018-09-29,218700000,,-418600000,2100000,-111300000,914700000,2016100000,508000000,508000000,-4000000,-148700000,,,,-307300000,3217900000,2709900000,1201800000,-926600000,,-111300000,-111300000,57055,HOLX
2017-09-30,232800000,,1230500000,2100000,755500000,818700000,1957400000,546300000,546300000,-4000000,-153200000,,,,475000000,3058800000,2512500000,1101400000,684200000,,755500000,755500000,57055,HOLX
2019-12-31,31461000,,-15224000,,2494000,93867000,107910000,-17418000,-17418000,,,,,,-17718000,232594000,250012000,124684000,2194000,,2494000,2494000,57058,BAND
2018-12-31,20897000,,7053000,,17923000,67784000,96126000,7445000,7445000,,,,,,-10870000,204113000,196668000,107987000,-392000,,17923000,17923000,57058,BAND
2017-12-31,10789000,,12889000,,5971000,47893000,73774000,15092000,15092000,,-1728000.0,,,,6918000,162955000,147863000,89181000,-2203000,,5971000,5327000,57058,BAND
2016-12-31,8520000,,14336000,,22358000,42458000,67008000,16030000,16030000,,-908000.0,,,,-11094000,152135000,136105000,85127000,-1694000,-3072000.0,25430000,19408000,57058,BAND
2020-12-31,748749000,,991473000,,780088000,2901060000,4572847000,867443000,867443000,,,,,,211385000,5505788000,4638345000,932941000,124030000,,780088000,780088000,57060,CERN
2019-12-28,737136000,,654512000,,529454000,3109935000,4621557000,686669000,686669000,,-14469000.0,,,,125058000,5692598000,5005929000,1071041000,-32157000,,529454000,529454000,57060,CERN
2018-12-29,683663000,,800851000,,630059000,2883165000,4428977000,774785000,774785000,,-7987000.0,,,,170792000,5366325000,4591540000,937348000,26066000,,630059000,630059000,57060,CERN
2017-12-30,605046000,,967129000,,866978000,2632088000,4288181000,960471000,960471000,,-8012000.0,,,,100151000,5142272000,4181801000,854091000,6658000,,866978000,866978000,57060,CERN
2019-12-31,59207000,,-340003000,,-338996000,166349000,192908000,-62724000,-62724000,,-31526000,,,,-1007000,388645000,451369000,195737000,-277279000,,-338996000,-338996000,57061,SCOR
2018-12-31,76979000,,-155562000,,-159268000,231268000,219262000,-121849000,-121849000,,-16465000,,,,3706000,419482000,541331000,200220000,-33713000,,-159268000,-159268000,57061,SCOR
2017-12-31,89023000,,-284110000,,-281393000,288558000,209944000,-202460000,-202460000,,-661000,,,,-2717000,403549000,606009000,193605000,-81650000,,-281393000,-281393000,57061,SCOR
2016-12-31,86975000,,-121180000,,-117173000,270045000,226380000,-162536000,-162536000,,-478000,,,,-4007000,399460000,561996000,173080000,41356000,,-117173000,-117173000,57061,SCOR
2020-12-31,,,75212000,,56039000,310713000,396224000,80256000,80256000,,-3396000,,,,19173000,1397700000,1317444000,1001476000,-5044000,,56039000,56039000,57063,KFRC
2019-12-31,,,71396000,,130862000,312768000,395038000,76220000,76220000,,-2586000,,,,16830000,1347387000,1271167000,952349000,-4824000,76296000.0,54566000,130862000,57063,KFRC
2018-12-31,,,67880000,,57980000,307718000,386487000,71933000,71933000,,-4468000,,,,17004000,1303937000,1232004000,917450000,-4053000,7104000.0,50876000,57980000,57063,KFRC
2017-12-31,,,54918000,,33285000,308850000,375597000,59481000,59481000,,-5039000,,,,25324000,1253646000,1194165000,878049000,-4563000,3691000.0,29594000,33285000,57063,KFRC
2020-03-28,,,60313000,,47949000,202623000,276491000,73668000,73668000,,-13310000,,,,12364000,845575000,771907000,569084000,-13355000,,47949000,47949000,57064,BOOT
2019-03-30,,,47996000,,39022000,186512000,251434000,64322000,64322000,,-16331000,,,,8974000,776854000,712532000,525420000,-16326000,,39022000,39022000,57064,BOOT
2018-03-31,,,31179000,,28879000,162460000,207915000,44355000,44355000,,-15076000,,,,2300000,677949000,633594000,470034000,-13176000,,28879000,28879000,57064,BOOT
2017-04-01,,,23119000,,14197000,150904000,189886000,38982000,38982000,,-14699000,,,,8922000,629816000,590834000,439930000,-15863000,,14197000,14197000,57064,BOOT
2019-12-31,5574000,,-10802000,1897000,-9603000,63272000,56705000,-12141000,-12141000,,-1915000,,,,47000,199408000,211549000,142703000,1339000,,-10849000,-9603000,57067,ICLK
2018-12-31,8000000,,-31956000,1315000,-32409000,56874000,39120000,-25754000,-25754000,,-773000,,,,655000,160017000,185771000,120897000,-6202000,,-32611000,-32409000,57067,ICLK
2017-12-31,3916000,,-24071000,1315000,-24619000,40780000,29525000,-15171000,-15171000,,-551000,,,,548000,125258000,140429000,95733000,-8900000,,-24619000,-29931000,57067,ICLK
2016-12-31,5560000,,-27108000,1315000,-27330000,58057000,34309000,-29308000,-29308000,,-713000,,,,222000,95357000,124665000,61048000,2200000,,-27330000,-29659000,57067,ICLK
2019-12-31,,,116592000,29591000,81611000,14485000,132630000,0,118145000,,,,,,34644000,569763000,451618000,437133000,-1553000,,81948000,81347000,57068,RILY
2018-12-31,,,21303000,602000,15509000,14479000,34976000,0,20497000,,,,,,4903000,366559000,346062000,331583000,806000,,16400000,15509000,57068,RILY
2017-12-31,,,20445000,-184000,11556000,8911000,35747000,0,26836000,,,,,,8510000,301743000,274907000,265996000,-6391000,,11935000,11556000,57068,RILY
2016-12-31,,,47047000,1045000,21526000,4661000,55277000,0,50616000,,,,,,14321000,188355000,137739000,133078000,-3569000,,32726000,21526000,57068,RILY
2020-09-30,950000,,-4538000,,-4685000,19150000,18237000,-1863000,-1863000,,-1490000,,,,147000,60469000,62332000,42232000,-2675000,,-4685000,-4685000,57069,BASI
2019-09-30,627000,,-786000,,-790000,13561000,14035000,-153000,-153000,,-642000,,,,4000,43616000,43769000,29581000,-633000,,-790000,-790000,57069,BASI
2018-09-30,596000,,-254000,,-194000,7111000,8116000,409000,409000,,-274000,,,,-60000,26346000,25937000,18230000,-663000,,-194000,-194000,57069,BASI
2017-09-30,465000,,908000,,884000,5954000,7697000,1278000,1278000,,-375000,,,,24000,24242000,22964000,16545000,-370000,,884000,884000,57069,BASI
2020-12-31,,,32003000,,26192000,93893000,156962000,0,43187000,19882000,,,,,5811000,156962000,113775000,0,-11184000,,26192000,26192000,57070,PGC
2019-12-31,,,66122000,,47434000,86227000,170970000,0,66399000,18344000,,,,,18688000,170970000,104571000,0,-277000,,47434000,47434000,57070,PGC
2018-12-31,,,57720000,,44170000,77639000,152806000,0,57568000,17599000,,,,,13550000,152806000,95238000,0,152000,,44170000,44170000,57070,PGC
2017-12-31,,,54307000,,36497000,67052000,139918000,0,56673000,16193000,,,,,17810000,139918000,83245000,0,-2366000,,36497000,36497000,57070,PGC
2020-12-31,,,506730000,,386164000,564754000,1402990000,593041000,593041000,245195000,-86312000,,,,120566000,2275014000,1681973000,872024000,-86311000,,386164000,384493000,57072,PRI
2019-12-31,,,477111000,,366391000,536015000,1327406000,554247000,554247000,237144000,-77136000,,,,110720000,2100829000,1546582000,773423000,-77137000,,366391000,364737000,57072,PRI
2018-12-31,,,416084000,,324094000,503540000,1215525000,482378000,482378000,229607000,-66294000,,,,91990000,1937328000,1454950000,721803000,-66294000,,324094000,322201000,57072,PRI
2017-12-31,,,379520000,,350255000,445268000,1069441000,434873000,434873000,189300000,-55353000,,,,29265000,1715967000,1281094000,646526000,-55353000,,350255000,347729000,57072,PRI
2020-12-31,,,23507000,,15832000,325609000,393199000,29098000,29098000,,-5990000,,,,7675000,2511515000,2482417000,2118316000,-5591000,,15832000,15832000,57073,ECHO
2019-12-31,,,21878000,,14846000,312079000,386033000,35567000,35567000,,-12639000,,,,7032000,2184977000,2149410000,1798944000,-13689000,,14846000,14846000,57073,ECHO
2018-12-31,,,38019000,,28723000,329750000,420364000,53976000,53976000,,-15546000,,,,9296000,2439701000,2385725000,2019337000,-15957000,,28723000,28723000,57073,ECHO
2017-12-31,,,4350000,,12623000,286236000,339040000,20076000,20076000,,-14768000,,,,-8273000,1943086000,1923010000,1604046000,-15726000,,12623000,12623000,57073,ECHO
2018-12-31,,,62843000,19244000,59258000,79644000,174504000,0,63291000,31569000,,,,,1386000,212277000,148986000,37773000,-448000,,61457000,59041000,57075,RCB
2017-12-31,,,47653000,19394000,43290000,78176000,156838000,0,49030000,29632000,,,,,1839000,208898000,159868000,52060000,22104000,,45814000,43228000,57075,RCB
2016-12-31,,,65215000,39005000,49169000,50378000,122998000,0,50415000,22205000,,,,,9651000,128206000,77791000,5208000,39039000,-2158000.0,55564000,49169000,57075,RCB
2015-12-31,,,53231000,38892000,40383000,38447000,97102000,0,47318000,11337000,,,,,7810000,101449000,54131000,4347000,5913000,-653000.0,45421000,40383000,57075,RCB
2020-12-31,,,-595097625000,,-70635681000,,-29116375000,-29116375000,-29116375000,,,,,,-524461944000,24230124228000,24259240603000,24259240603000,-565981250000,,-70635681000,-70635681000,57077,LPL
2019-12-31,1221978000000.0,,-3344242000000,1147798000000.0,-2829705000000,2005731000000.0,1868327000000,-1359382000000,-1359382000000,,-172750000000.0,,,,-472164000000,23475567000000,24834949000000,21607240000000,-1984860000000,,-2872078000000,-2829705000000,57077,LPL
2018-12-31,1221198000000.0,,-91366000000,907057000000.0,-207239000000,1771177000000.0,3085266000000,92891000000,92891000000,65621000000.0,-80517000000.0,,,,88077000000,24336571000000,24243680000000,21251305000000,-184257000000,,-179443000000,-207239000000,57077,LPL
2017-12-31,1213432000000.0,,2332632000000,608027000000.0,1802756000000,1505477000000.0,5365555000000,2459820000000,2459820000000,46317000000.0,-90538000000.0,,,,395580000000,27790216000000,25330396000000,22424661000000,-127188000000,,1937052000000,1802756000000,57077,LPL
2020-12-31,,,1494997000,,1278708000,1876564000,3703478000,1826914000,1826914000,,-149374000,,,,219584000,8149719000,6322805000,4446241000,-331917000,,1275413000,1278708000,57078,HSY
2019-12-31,37146000.0,,1380784000,5772000.0,1149692000,1906509000,3622478000,1678823000,1678823000,,-152122000,,,,234032000,7986252000,6307429000,4363774000,-298039000,,1146752000,1149692000,57078,HSY
2018-12-31,38521000.0,,1410061000,8545000.0,1177562000,1816459000,3586648000,1731668000,1731668000,,-146858000,,,,239010000,7791069000,6059401000,4204421000,-321607000,,1171051000,1177562000,57078,HSY
2017-12-31,45850000.0,,1110668000,16227000.0,782981000,1861961000,3460523000,1552712000,1552712000,,-100066000,,,,354131000,7515426000,5962714000,4054903000,-442044000,,756537000,782981000,57078,HSY
2019-12-31,,,282755000,,221809000,1584523000,1976829000,392306000,392306000,,-99351000,,,,60946000,7280431000,6888125000,5303602000,-109551000,,221809000,221809000,57079,BLDR
2018-12-31,,,260755000,,205191000,1553972000,1922940000,368968000,368968000,,-111413000,,,,55564000,7724771000,7355803000,5801831000,-108213000,,205191000,205191000,57079,BLDR
2017-12-31,,,91929000,,38781000,1442288000,1727391000,285103000,285103000,,-134474000,,,,53148000,7034209000,6749106000,5306818000,-193174000,,38781000,38781000,57079,BLDR
2016-12-31,,,21669000,,144341000,1365412000,1596748000,231336000,231336000,,-157667000,,,,-122672000,6367284000,6135948000,4770536000,-209667000,,144341000,144341000,57079,BLDR
2019-12-31,,,45442000,,45442000,16058000,60594000,44536000,44536000,,-1894000,,,,0,111026000,66490000,50432000,906000,,45442000,45442000,57082,ACIU
2018-12-31,,,-50951000,,-50951000,12467000,-37083000,-49550000,-49550000,,-298000,,,,0,7194000,56744000,44277000,-1301000,,-50951000,-50951000,57082,ACIU
2017-12-31,,,-26411000,,-26411000,10131000,-12408000,-22539000,-22539000,,-147000,,,,0,20255000,42794000,32663000,-3872000,,-26411000,-26411000,57082,ACIU
2016-12-31,,,-7096000,,-7096000,7896000,-2560000,-10456000,-10456000,,-7000,,,,0,23214000,33670000,25774000,3360000,,-7096000,-7096000,57082,ACIU
2019-12-31,,,926088,-1198732,1909444,6830354,46937924,18470254,18470254,,-19768193,,,,-249480,185788133,167317879,138850209,-17544166,,1175568,-5911251,57084,SOHO
2018-12-31,,,-138808,441706,109936,6180962,46883665,19818060,19818060,,-19953746,,,,469349,177373121,157555061,130489456,-19956868,,-608157,-5719978,57084,SOHO
2017-12-31,,,1767293,1154775,442503,6335926,40389325,17053780,17053780,,-15727628,,,,1737804,153666693,136612913,113277368,-15286487,,29489,-3339136,57084,SOHO
2016-12-31,,,-467485,2329175,926716,6021065,40012581,18972445,18972445,,-17735107,,,,-1367634,152845752,133873307,112833171,-19439930,,900149,-218173,57084,SOHO
2019-12-31,,,9541000,2903000,9628000,8613000,96621000,35969000,35969000,,-28279000,,,,0,114387000,78418000,17766000,-26428000,,9541000,-4760000,57085,GOOD
2018-12-31,,,12324000,4675000,12320000,7005000,90286000,35661000,35661000,,-26172000,,,,0,106798000,71137000,16512000,-23337000,,12324000,973000,57085,GOOD
2017-12-31,,,5937000,4675000,5937000,6060000,82152000,33297000,33297000,,-24570000,,,,0,94799000,61502000,12647000,-27360000,,5937000,-4939000,57085,GOOD
2016-12-31,,,3958000,4675000,3958000,6243000,76553000,32793000,32793000,,-27404000,,,,0,86372000,53579000,9819000,-28835000,,3958000,-3698000,57085,GOOD
2020-02-01,,,358371000,,272595000,1305044000,1882257000,572605000,572605000,,-154090000,,,,85776000,5072037000,4499432000,3189780000,-214234000,,272595000,272277000,57088,MIK
2019-02-02,,,417054000,,319545000,1362901000,2035168000,667850000,667850000,,-147085000,,,,97509000,5271944000,4604094000,3236776000,-250796000,,319545000,318950000,57088,MIK
2018-02-03,,,605741000,,390498000,1402900000,2141289000,735390000,735390000,,-129116000,,,,215243000,5361960000,4626570000,3220671000,-131031000,,390498000,388979000,57088,MIK
2017-01-28,,,581773000,,378159000,1300662000,2034703000,729557000,729557000,,-126270000,,,,203614000,5197292000,4467735000,3162589000,-147784000,,378159000,375836000,57088,MIK
2019-12-28,287977000,,-383655000,,-386618000,277774000,416890000,-208724000,-208724000,,-31657000,,,,2963000,1298865000,1507589000,881975000,-174931000,,-386618000,-386618000,57089,INFN
2018-12-29,244302000,,-214950000,,-214295000,205195000,347261000,-155007000,-155007000,,-22049000,,,,-655000,943379000,1098386000,596118000,-59943000,,-214295000,-214295000,57089,INFN
2017-12-30,224368000,,-195936000,,-194506000,180131000,283615000,-147518000,-147518000,,-14017000,,,,-1430000,740739000,888257000,457124000,-48418000,,-194506000,-194506000,57089,INFN
2016-12-31,220848000,,-29181000,,-23927000,179290000,413433000,-12609000,-12609000,,-12887000,,,,-4751000,870135000,882744000,456702000,-16572000,,-24430000,-23927000,57089,INFN
2020-06-30,,,83732000,6947000,61562000,56816000,151834000,88887000,88887000,,-3888000,,,,19076000,653163000,564276000,501329000,-5155000,,64656000,61562000,57090,MBUU
2019-06-30,,,91797000,6118000,66066000,53932000,167170000,107282000,107282000,,-6464000,,,,22096000,684016000,576734000,516846000,-15485000,,69701000,66066000,57090,MBUU
2018-06-30,,,89387000,5502000,27613000,38821000,121842000,77823000,77823000,,-5385000,,,,58418000,497002000,419179000,375160000,11564000,,30969000,27613000,57090,MBUU
2017-06-30,,,48668000,4941000,28358000,27912000,75038000,44928000,44928000,,-1559000,,,,17593000,281937000,237009000,206899000,3740000,,31075000,28358000,57090,MBUU
2019-12-31,,,120045000,,62971000,645253000,872539000,208704000,208704000,,-71778000,,,,57074000,4289761000,4081057000,3417222000,-88659000,,62971000,62971000,57092,JELD
2018-12-31,,,131849000,,141907000,638842000,918536000,261995000,261995000,,-70818000,,,,-10058000,4346847000,4084852000,3428311000,-130146000,,141907000,141907000,57092,JELD
2017-12-31,,,145940000,,8122000,567385000,847517000,263697000,263697000,,-79034000,,,,137818000,3763749000,3500052000,2916232000,-117757000,,8122000,-2340000,57092,JELD
2016-12-31,,,134111000,,377181000,556480000,780554000,216235000,216235000,,-77590000,,,,-246394000,3666942000,3450707000,2886388000,-82124000,-3324000.0,380505000,-19466000,57092,JELD
2019-12-31,,,54561000,,54561000,9982000,0,-9982000,-9982000,,-14023000,,,,0,0,9982000,0,64543000,,54561000,54561000,57093,SFE
2018-12-31,,,-15629000,,-15629000,13071000,0,-13071000,-13071000,,-16067000,,,,0,0,13071000,0,-2558000,,-15629000,-15629000,57093,SFE
2017-12-31,,,-88572000,,-88572000,17131000,0,-17131000,-17131000,,-8620000,,,,0,0,17131000,0,-71441000,,-88572000,-88572000,57093,SFE
2016-12-31,,,-22262000,,-22262000,18692000,0,-18692000,-18692000,,-4634000,,,,0,0,18692000,0,-3570000,,-22262000,-22262000,57093,SFE
2019-12-31,43339000,,-251299000,-659000,-250640000,753064000,535366000,-261037000,-261037000,,,,,,0,644773000,905810000,109407000,9738000,,-251299000,-250640000,57094,TC
2018-12-31,19262000,,-75088000,-659000,-78700000,583137000,534362000,-68037000,-68037000,,-3146000.0,,,,0,651013000,719050000,116651000,-7051000,-3612000.0,-75088000,-113766000,57094,TC
2017-12-31,15925000,,-75694000,-659000,-90671000,281699000,225883000,-71741000,-71741000,,-2416000.0,,,,0,280666000,352407000,54783000,-3953000,-14977000.0,-75694000,-111616000,57094,TC
2016-12-31,19576000,,-81508000,-659000,-86568000,161124000,99605000,-81095000,-81095000,,-1376000.0,,,,0,117353000,198448000,17748000,-413000,-5060000.0,-81508000,-103473000,57094,TC
2019-12-31,,,9652475000,9123000,11296689000,1607753000,2516422000,602454000,602454000,3758000,-266773000,,,,59186000,3683527000,3081073000,1167105000,9050021000,1685123000,9593289000,11296689000,57096,IHRT
2018-12-31,,,-24136000,30868000,-201910000,1604439000,2548950000,726527000,726527000,6033000,-334798000,,,,13836000,3611323000,2884796000,1062373000,-750663000,-164667000,-37972000,-201910000,57096,IHRT
2017-12-31,,,-833196000,41191000,-398060000,1554711000,2527524000,691708000,691708000,5801000,-1484435000,,,,-177188000,3586647000,2894939000,1059123000,-1524904000,197297000,-656008000,-398060000,57096,IHRT
2016-12-31,,,-296203000,135778000,-302056000,2067190000,3855963000,1157802000,1157802000,-4256000,-1850119000,,,,-49631000,6251000000,5093198000,2395037000,-1454005000,197297000,-246572000,-302056000,57096,IHRT
2019-12-31,3971000,,-11462000,,-11505000,8915000,6348000,-8375000,-8375000,1837000,-1946000,,,,43000,16475000,24850000,10127000,-3087000,,-11505000,-11505000,57100,SPCB
2018-12-31,4790000,,-10010000,,-15740000,10753000,8139000,-9922000,-9922000,2518000,-844000,,,,5730000,21882000,31804000,13743000,-88000,,-15740000,-15740000,57100,SPCB
2017-12-31,7238000,,-7054000,,-6661000,14212000,12913000,-7109000,-7109000,-1428000,-211000,,,,-393000,33264000,40373000,20351000,55000,,-6661000,-6661000,57100,SPCB
2016-12-31,6718000,,-11902000,,-13993000,17247000,2564000,-22114000,-22114000,713000,-219000,,,,2091000,20025000,42139000,17461000,10212000,,-13993000,-13993000,57100,SPCB
2019-12-31,49399000,,-286290000,,-279659000,149455000,26523000,-208732000,-208732000,,-1400000,,,,-6631000,335001000,543733000,308478000,-77558000,,-279659000,-279659000,57102,AKBA
2018-12-31,49399000,,-171926000,,-143588000,63961000,-84812000,-150290000,-150290000,,-1400000,,,,-28338000,207742000,358032000,292554000,-21636000,,-143588000,-143588000,57102,AKBA
2017-12-31,49399000,,-73671000,,-73671000,27008000,-49666000,-76674000,-76674000,,-1400000,,,,0,181227000,257901000,230893000,3003000,,-73671000,-73671000,57102,AKBA
2016-12-31,49399000,,-135747000,,-135747000,22210000,-114250000,-136460000,-136460000,,-1400000,,,,0,1535000,137995000,115785000,525000,,-135747000,-135747000,57102,AKBA
2020-06-30,,,12050000,,9359000,32941000,46684000,0,12231000,1512000,,,,,2691000,46684000,34453000,0,-181000,,9359000,9359000,57104,PCSB
2019-06-30,,,11004000,,8318000,31235000,44998000,0,11535000,2228000,,,,,2686000,44998000,33463000,0,-531000,,8318000,8318000,57104,PCSB
2018-06-30,,,11626000,,6604000,29329000,43742000,0,12080000,2333000,,,,,5022000,43742000,31662000,0,-454000,,6604000,6604000,57104,PCSB
2017-06-30,,,4495000,,3229000,26396000,38926000,0,10717000,1813000,,,,,1266000,38926000,28209000,0,-6222000,,3229000,3229000,57104,PCSB
2020-08-31,,,386878000,9302000,422439000,697678000,981807000,284129000,284129000,,-116977000,,,,-36731000,28406365000,28122236000,27424558000,102749000,,423609000,253771000,57106,CHSCO
2019-08-31,,,815601000,7390000,829880000,691877000,1384333000,692456000,692456000,,-167065000,,,,-12456000,31900453000,31207997000,30516120000,123145000,,828057000,661212000,57106,CHSCO
2018-08-31,,,671230000,9446000,775907000,635519000,1092120000,456601000,456601000,,-149202000,,,,-104076000,32683347000,32226746000,31591227000,214629000,,775306000,607239000,57106,CHSCO
2017-08-31,,,-110166000,12505000,71592000,609590000,893877000,284287000,284287000,,-171239000,,,,-181124000,32037426000,31753139000,31143549000,-394453000,,70958000,-96051000,57106,CHSCO
2019-12-31,222899000,,-179440000,,-179056000,52364000,91228000,-181518000,-181518000,-2517000,-1718000,,,,-268000,108589000,290107000,17361000,2078000,,-179172000,-179056000,57109,BNTX
2018-12-31,140284000,,-47662000,847000.0,-48019000,32652000,113885000,-53854000,-53854000,-5197000,-1721000,,,,600000,127575000,181429000,13690000,6192000,,-48262000,-48019000,57109,BNTX
2017-12-31,82021000,,-85905000,1090000.0,-85653000,34135000,52280000,-61278000,-61278000,-2598000,-676000,,,,45000,61598000,122876000,9318000,-24627000,,-85950000,-85653000,57109,BNTX
2019-12-31,,,2105000000,2000000,1670000000,1631000000,5975000000,2770000000,2770000000,,-464000000,,,,434000000,15455000000,12685000000,9480000000,-665000000,,1671000000,1670000000,57112,WM
2018-12-31,,,2376000000,1000000,1925000000,1453000000,5665000000,2735000000,2735000000,,-384000000,,,,453000000,14914000000,12179000000,9249000000,-359000000,,1923000000,1925000000,57112,WM
2017-12-31,,,2191000000,23000000,1949000000,1468000000,5464000000,2620000000,2620000000,,-368000000,,,,242000000,14485000000,11865000000,9021000000,-429000000,,1949000000,1949000000,57112,WM
2016-12-31,,,1822000000,23000000,1182000000,1410000000,5123000000,2412000000,2412000000,,-385000000,,,,642000000,13609000000,11197000000,8486000000,-590000000,,1180000000,1182000000,57112,WM
2020-06-30,,,25157000,,18196000,42714000,83841000,41127000,41127000,,-4421000,,,,6961000,1200550000,1159423000,1116709000,-15970000,,18196000,18172000,57113,KE
2019-06-30,,,38485000,,31558000,45681000,88406000,42725000,42725000,,-4069000,,,,6927000,1181844000,1139119000,1093438000,-4240000,,31558000,31526000,57113,KE
2018-06-30,,,44775000,,16752000,43092000,86030000,42938000,42938000,,-527000,,,,28023000,1072061000,1029123000,986031000,1837000,,16752000,16743000,57113,KE
2017-06-30,,,44255000,,34179000,36647000,75435000,38788000,38788000,,-271000,,,,10076000,930914000,892126000,855479000,5467000,,34179000,34164000,57113,KE
2020-12-31,,,169000000,,122986000,833349000,1077877000,0,244528000,,,,,,46014000,1182987000,938459000,105110000,-75528000,,122986000,122986000,57114,OPY
2019-12-31,,,74912000,,52953000,706941000,884127000,0,177186000,,,,,,21959000,987677000,810491000,103550000,-102274000,,52953000,52953000,57114,OPY
2018-12-31,,,44869000,,28892000,655823000,814301000,0,158478000,101078000.0,,,,,15977000,911765000,753287000,97464000,-113609000,,28892000,28892000,57114,OPY
2017-12-31,,,19552000,361000.0,22816000,651511000,796461000,0,144950000,101078000.0,,,,,-2134000,891984000,747034000,95523000,-125398000,1130000.0,21686000,22816000,57114,OPY
2020-09-30,,,-51200000,,-41600000,484700000,595300000,54800000,54800000,,-64600000,,,,-9600000,2346000000,2291200000,1750700000,-106000000,,-41600000,-41600000,57116,BV
2019-09-30,,,57200000,,44400000,444000000,638200000,137900000,137900000,,-72500000,,,,12800000,2404600000,2266700000,1766400000,-80700000,,44400000,44400000,57116,BV
2018-09-30,,,-81300000,,-15100000,479500000,626100000,41700000,41700000,,-97800000,,,,-66200000,2353600000,2311900000,1727500000,-123000000,,-15100000,-15100000,57116,BV
2017-09-30,,,-61428000,,-37494000,435481000,596165000,34893000,34893000,,-98075000,,,,-23934000,2225873000,2190980000,1629708000,-96321000,,-37494000,-37494000,57116,BV
2019-12-31,,,921154,,365954,3328674,0,-3328674,-3328674,,,,,,555200,0,3328674,0,4249828,,365954,-2873869,57118,LACQ
2018-12-31,,,2675949,,2122033,1559245,0,-959240,-959240,-600005.0,,,,,553916,0,959240,0,3635189,,2122033,-1342689,57118,LACQ
2017-12-31,,,-82674,,-93579,440085,0,-440085,-440085,-600005.0,,,,,10905,0,440085,0,-82674,,-93579,-247842,57118,LACQ
2019-12-31,2496165,,-12517577,,-12518377,16205774,6012381,-12689558,-12689558,,-2500,,,,800,15854924,28544482,9842543,171981,,-12518377,-12518377,57121,HYRE
2018-12-31,1414727,,-11243103,,-11243903,12388936,4645000,-9158663,-9158663,,-2040311,,,,800,9777079,18935742,5132079,-2084440,,-11243903,-11243903,57121,HYRE
2017-12-31,687039,,-4270932,,-4271732,3691237,311326,-4066950,-4066950,,-202454,,,,800,3223874,7290824,2912548,-203982,,-4271732,-4271732,57121,HYRE
2016-12-31,117059,,-865876,,-866676,809002,87501,-838560,-838560,,-31153,,,,800,515437,1353997,427936,-27316,,-866676,-866676,57121,HYRE
2020-12-31,374964000,,901015000,,784147000,475053000,1786117000,904053000,904053000,1244000,-14426000,,,,116868000,3121469000,2217416000,1335352000,-3038000,,784147000,784147000,57122,TER
2019-12-31,322824000,,525772000,,467468000,446351000,1339829000,529743000,529743000,764000,-23145000,,,,58304000,2294965000,1765222000,955136000,-3971000,,467468000,467468000,57122,TER
2018-12-31,301505000,,467801000,,451779000,387945000,1220394000,490793000,490793000,960000,-31269000,,,,16022000,2100802000,1610009000,880408000,-22992000,,451779000,451779000,57122,TER
2017-12-31,307305000,,524412000,,257692000,343791000,1221453000,539917000,539917000,-90000,-21663000,,,,266720000,2136606000,1596689000,915153000,-15505000,,257692000,257692000,57122,TER
2019-12-31,175441,,-5827728,,-5827728,5695357,0,-5870798,-5870798,,-1930,,,,0,0,5870798,0,43070,,-5827728,-5827728,57123,ADTX
2018-12-31,525000,,-5689237,,-5689237,5084471,0,-5609471,-5609471,,-79766,,,,0,0,5609471,0,-79766,,-5689237,-5689237,57123,ADTX
2017-12-31,525000,,-851944,,-851944,851944,0,-851944,-851944,,-79766,,,,0,0,851944,0,0,,-851944,-851944,57123,ADTX
2019-12-31,,,311760000,529258000,179065000,232802000,787282000,436250000,436250000,,-114703000,,,,91942000,1487583000,1051333000,700301000,-124490000,,219818000,179065000,57124,SIX
2018-12-31,,,411858000,525271000,275996000,156299000,796480000,524488000,524488000,,-108034000,,,,95855000,1463707000,939219000,667227000,-112630000,,316003000,275996000,57124,SIX
2017-12-31,,,329052000,494431000,273816000,155748000,736827000,469408000,469408000,,-99766000,,,,16026000,1359074000,889666000,622247000,-140356000,,313026000,273816000,57124,SIX
2016-12-31,,,233266000,485876000,118302000,291085000,719703000,321725000,321725000,,-82377000,,,,76539000,1319398000,997673000,599695000,-88459000,,156727000,118302000,57124,SIX
2020-12-31,,,-7018000000,2383000000,-7242000000,,44032000000,4450000000,4450000000,25539000000,-2140000000,,,,318000000,119704000000,115254000000,75672000000,-11468000000,,-7336000000,-7242000000,57125,TOT
2019-12-31,,,17310000000,2527000000,11267000000,,59785000000,16101000000,16101000000,28088000000,-2091000000,,,,5872000000,176249000000,160148000000,116464000000,1209000000,,11438000000,11267000000,57125,TOT
2018-12-31,,,18066000000,2474000000,11446000000,,58972000000,18363000000,18363000000,27594000000,-1347000000,,,,6516000000,184106000000,165743000000,125134000000,-297000000,,11550000000,11446000000,57125,TOT
2017-12-31,,,11328000000,2481000000,8631000000,,49565000000,11900000000,11900000000,25360000000,-907000000,,,,3029000000,149099000000,137199000000,99534000000,-572000000,,8299000000,8631000000,57125,TOT
2019-12-28,,,78224000,17366000,61123000,262926000,695808000,215780000,215780000,,-116509000,,,,17101000,2222140000,2006360000,1526332000,-137556000,,61123000,59066000,57127,SUM
2018-12-29,,,96077000,14404000,36330000,253609000,625223000,166704000,166704000,,-116548000,,,,59747000,2101002000,1934298000,1475779000,-70627000,,36330000,33906000,57127,SUM
2017-12-30,,,-158200000,13178000,125804000,242670000,650798000,228610000,228610000,,-108549000,,,,-283977000,1932575000,1703965000,1281777000,-386810000,,125777000,121830000,57127,SUM
2016-12-31,,,40827000,17995000,46110000,243512000,554271000,161459000,161459000,,-97536000,,,,-5299000,1626063000,1464604000,1071792000,-120632000,,46126000,36783000,57127,SUM
2020-03-31,,,799450000000,671996000000,582191000000,1480640000000,2336461000000,857316000000,857316000000,-1495000000,-11090000000,,,,177190000000,8259885000000,7402569000000,5923424000000,-57866000000,,622260000000,582191000000,57129,SNE
2019-03-31,,,1011648000000,699114000000,916271000000,1554853000000,2401705000000,846852000000,846852000000,-1495000000,-12467000000,,,,45098000000,8665687000000,7818835000000,6263982000000,164796000000,,966550000000,916271000000,57129,SNE
2018-03-31,,,699049000000,689001000000,490794000000,1564198000000,2304181000000,739983000000,739983000000,-1495000000,-13566000000,,,,151770000000,8534664000000,7794681000000,6230483000000,-40934000000,,547279000000,490794000000,57129,SNE
2017-03-31,,,251619000000,650234000000,73289000000,1496102000000,1936495000000,440393000000,440393000000,-1495000000,-14544000000,,,,124058000000,7603250000000,7162857000000,5666755000000,-188774000000,,127561000000,73289000000,57129,SNE
2019-12-29,,,112800000,,112400000,877200000,968400000,90800000,90800000,,-4200000,,,,400000,5355600000,5264800000,4387200000,22000000,,112400000,111300000,57131,KELYB
2018-12-30,,,-4200000,,22900000,884800000,972200000,87400000,87400000,,-3100000,,,,-27100000,5513900000,5426500000,4541700000,-91600000,,22900000,22700000,57131,KELYB
2017-12-31,,,84400000,,71600000,870800000,954100000,83300000,83300000,,-2700000,,,,12800000,5374400000,5291100000,4420300000,1100000,,71600000,70500000,57131,KELYB
2017-01-01,,,150800000,,120800000,839700000,906300000,66600000,66600000,,-3800000,,,,30000000,5276800000,5210200000,4370500000,84200000,,120800000,118200000,57131,KELYB
2019-12-31,,,2223000000,300000000,1765000000,1681000000,5409000000,2383000000,2383000000,,-104000000,,,,591000000,39431000000,37048000000,34022000000,-160000000,,1632000000,1765000000,57134,MGA
2018-12-31,,,2951000000,458000000,2296000000,1994000000,6102000000,2830000000,2830000000,,-113000000,,,,619000000,40827000000,37997000000,34725000000,121000000,,2332000000,2296000000,57134,MGA
2017-12-31,,,2985000000,502000000,2196000000,1668000000,5693000000,2841000000,2841000000,,-90000000,,,,741000000,36588000000,33747000000,30895000000,144000000,,2244000000,2196000000,57134,MGA
2016-12-31,,,2780000000,451000000,2031000000,1601000000,5322000000,2665000000,2665000000,,-100000000,,,,706000000,36445000000,33780000000,31123000000,115000000,,2074000000,2031000000,57134,MGA
2019-12-31,,,46427000,,37024000,3784000,83766000,60665000,60665000,,-13830000,,,,9403000,752627000,691962000,668861000,-14238000,,37024000,37024000,57135,VSEC
2018-12-31,,,45248000,,35080000,3714000,72261000,52530000,52530000,617764000.0,-8982000,,,,10168000,697218000,644688000,624957000,-7282000,,35080000,35080000,57135,VSEC
2017-12-31,,,45085000,,39096000,2429000,72771000,54325000,54325000,617764000.0,-9240000,,,,5989000,760113000,705788000,687342000,-9240000,,39096000,39096000,57135,VSEC
2016-12-31,,,41674000,,26793000,6609000,74205000,51529000,51529000,617764000.0,-9855000,,,,14881000,691790000,640261000,617585000,-9855000,,26793000,26793000,57135,VSEC
2019-12-31,60073000,,189946000,,155210000,354757000,605393000,176754000,176754000,,,,,,34736000,785368000,608614000,179975000,13192000,,155210000,155210000,57137,GMED
2018-12-31,55496000,,188605000,,156474000,311591000,553559000,176884000,176884000,,,,,,32131000,712969000,536085000,159410000,11721000,,156474000,156474000,57137,GMED
2017-12-31,43679000,,169928000,,107348000,267301000,485524000,166635000,166635000,,,,,,62580000,635977000,469342000,150453000,3293000,,107348000,107348000,57137,GMED
2016-12-31,40532000,,157279000,,104341000,222156000,429289000,163123000,163123000,,,,,,52938000,563994000,400871000,134705000,-5844000,,104341000,104341000,57137,GMED
2019-12-31,,,-22437000,163989000,-8650000,1260000,42186000,9861000,9861000,20516000,-10640000,,,,17000,137841000,127980000,95655000,-32298000,,-22454000,-8650000,57139,BRP
2018-12-31,,,2689000,47145000,-624000,915000,28226000,10757000,10757000,13464000,-6625000,,,,0,79880000,69123000,51654000,-8068000,,2689000,-624000,57139,BRP
2017-12-31,,,3850381,24021401,1703293,9558978,17209431,6213551,6213551,13464000,-1906421,,,,0,48014994,41801443,30805563,-2363170,,3850381,1703293,57139,BRP
2020-12-31,,,-5846749,,-6046195,17903876,68691888,18600688,18600688,,-18168155,,,,199446,220057606,201456918,151365718,-24447437,,-6046195,-6046195,57140,ASC
2019-12-31,,,-22802491,,-22861257,18146214,66636174,16167265,16167265,,-26222853,,,,58766,230042240,213874975,163406066,-38969756,,-22861257,-22861257,57140,ASC
2018-12-31,,,-42776078,,-42939001,15860261,41381819,-9616322,-9616322,,-25138153,,,,162923,210179181,219795503,168797362,-33159756,,-42939001,-42939001,57140,ASC
2017-12-31,,,-12430768,,-12490335,14598765,57383058,8513202,8513202,,-20856042,,,,59567,195935392,187422190,138552334,-20943970,,-12490335,-12490335,57140,ASC
2020-06-30,,,-8576675,,-8576675,1901886,2718062,816176,816176,,,,,,0,2718062,1901886,0,-9392851,,-8576675,-8576675,57141,KF
2019-06-30,,,-24361963,,-24361963,2390958,3566545,1175587,1175587,,,,,,0,3566545,2390958,0,-25537550,,-24361963,-24361963,57141,KF
2018-06-30,,,8993090,,8993090,2937088,4059181,1122093,1122093,,,,,,0,4059181,2937088,0,7870997,,8993090,8993090,57141,KF
2017-06-30,,,52088429,,52088429,3157412,4224047,1066635,1066635,,,,,,0,4224047,3157412,0,51021794,,52088429,52088429,57141,KF
2020-12-31,311000000,,256000000,4000000,192000000,1851000000,2626000000,408000000,408000000,,,,,,64000000,7022000000,6614000000,4396000000,-152000000,,192000000,178000000,57145,XRX
2019-12-31,373000000,,830000000,7000000,1353000000,2103000000,3650000000,1129000000,1129000000,,-105000000.0,,,,179000000,9066000000,7937000000,5416000000,-299000000,705000000.0,651000000,1339000000,57145,XRX
2018-12-31,397000000,,557000000,34000000,361000000,2485000000,3869000000,939000000,939000000,,-114000000.0,,,,247000000,9662000000,8723000000,5793000000,-382000000,55000000.0,310000000,347000000,57145,XRX
2017-12-31,424000000,,538000000,37000000,195000000,2702000000,4071000000,892000000,892000000,,-119000000.0,,,,468000000,9991000000,9099000000,5920000000,-354000000,129000000.0,70000000,181000000,57145,XRX
2019-12-31,,,-20578631,,-20520131,8500783,-11284062,-19784845,-19784845,,-2244,,,,-58500,5801401,25586246,17085463,-793786,,-20520131,-20973056,57146,ALT
2018-12-31,,,-45320946,,-39171152,9765581,-8128142,-17893723,-17893723,,-297090,,,,-6149794,10331168,28224891,18459310,-27427223,,-39171152,-42478952,57146,ALT
2017-12-31,,,-52063765,,-46425390,8457557,-7668007,-16125564,-16125564,,-162139,,,,-5638375,10738322,26863886,18406329,-35938201,,-46425390,-51355400,57146,ALT
2016-12-31,,,-11086812,,-11086812,6435130,-3985285,-10420415,-10420415,,-38499,,,,0,3236175,13656590,7221460,-666397,,-11086812,-11455360,57146,ALT
2020-06-30,209606000,,-120492000,,-126845000,344623000,525039000,-37615000,-37615000,,-23750000,,,,6353000,948019000,985634000,422980000,-82877000,,-126845000,-126845000,57149,EXTR
2019-06-30,210132000,,-25874000,,-25853000,340949000,551235000,-6192000,-6192000,,-12597000,,,,-21000,995789000,1001981000,444554000,-19682000,,-25853000,-25853000,57149,EXTR
2018-06-30,183877000,,-46647000,,-46792000,318095000,534517000,23830000,23830000,,-13923000,,,,145000,983142000,959312000,448625000,-70477000,,-46792000,-46792000,57149,EXTR
2017-06-30,93724000,,2596000,,-1744000,200490000,330957000,28041000,28041000,,-4086000,,,,4340000,607084000,579043000,276127000,-25445000,,-1744000,-1744000,57149,EXTR
2019-12-31,,,-245006000,421636000,-216245000,2102968000,2285187000,182219000,182219000,,-339957000,,,,10172000,12926464000,12744245000,10641277000,-427225000,,-255178000,-216245000,57151,ARKOW
2018-12-31,,,52175000,514888000,38772000,2102288000,2197597000,95309000,95309000,,-110464000,,,,-30382000,12983170000,12887861000,10785573000,-43134000,,82557000,38772000,57151,ARKOW
2017-12-31,,,-5416000,465177000,-5595000,1659188000,1758142000,98954000,98954000,,-71300000,,,,-31295000,9613833000,9514879000,7855691000,-104370000,-40000.0,25879000,-5595000,57151,ARKOW
2016-12-31,,,19708000,409401000,-20979000,1413484000,1511575000,98091000,98091000,,-51520000,,,,9667000,7466786000,7368695000,5955211000,-78383000,-59000.0,10041000,-20979000,57151,ARKOW
2020-12-31,,,64940000,,64914000,28341000,110355000,82014000,82014000,,-11647000,,,,26000,676378000,594364000,566023000,-17074000,,64914000,60512000,57152,WTREP
2019-12-31,,,62561000,,62541000,30843000,135142000,104299000,104299000,,-33491000,,,,20000,715065000,610766000,579923000,-41738000,,62541000,44745000,57152,WTREP
2018-12-31,,,-34856000,,-34883000,22311000,19344000,-2967000,-2967000,,-26500000,,,,27000,601735000,604702000,582391000,-31889000,,-34883000,-54516000,57152,WTREP
2017-12-31,,,10762000,,10741000,21174000,46416000,25242000,25242000,,-15900000,,,,21000,623544000,598302000,577128000,-14480000,,10741000,-8892000,57152,WTREP
2019-12-31,8616000,,-825000,,-1151000,27481000,36654000,557000,557000,,-917000,,,,326000,83755000,83198000,47101000,-1382000,,-1151000,-2193000,57153,INVE
2018-12-31,7235000,,-4548000,-170000.0,-4708000,26232000,33332000,-135000,-135000,,-1518000,,,,155000,78142000,78277000,44810000,-4413000,,-4703000,-5541000,57153,INVE
2017-12-31,6146000,,-8366000,-178000.0,-8138000,21481000,22160000,-5467000,-5467000,,-2590000,,,,-214000,60219000,65686000,38059000,-2899000,,-8152000,-8138000,57153,INVE
2016-12-31,6520000,,-13571000,-180000.0,-13695000,25341000,23729000,-8132000,-8132000,,-2378000,,,,132000,56168000,64300000,32439000,-5439000,,-13703000,-13695000,57153,INVE
2020-12-31,8846000,,5640000,,5640000,13989000,28335000,5500000,5500000,,,,,,0,76217000,70717000,47882000,140000,,5640000,5640000,57154,RADA
2019-12-31,6912000,,-2224000,,-2030000,11128000,15937000,-2103000,-2103000,,-85000.0,,,,0,44331000,46434000,28394000,-121000,-115000.0,-2224000,-2030000,57154,RADA
2018-12-31,3189000,,181000,-352000.0,163000,6861000,10215000,165000,165000,,-2000.0,,,,0,28032000,27867000,17817000,16000,-404000.0,181000,163000,57154,RADA
2017-12-31,1653000,,1827000,659000.0,2239000,4705000,8341000,1983000,1983000,,-279000.0,,,,0,26182000,24199000,17841000,-156000,515000.0,1827000,2239000,57154,RADA
2020-02-29,259000000,,-148000000,,-152000000,484000000,768000000,-169000000,-169000000,,-23000000,,,,4000000,1040000000,1209000000,272000000,21000000,,-152000000,-152000000,57155,BB
2019-02-28,217000000,,77000000,,93000000,390000000,700000000,-43000000,-43000000,,-24000000,,,,-16000000,904000000,947000000,204000000,120000000,,93000000,93000000,57155,BB
2018-02-28,234000000,,406000000,,405000000,400000000,681000000,-106000000,-106000000,,-23000000,,,,1000000,932000000,1038000000,251000000,512000000,,405000000,405000000,57155,BB
2017-02-28,302000000,,-1208000000,,-1206000000,318000000,642000000,-164000000,-164000000,,-48000000,,,,-2000000,1309000000,1473000000,667000000,-1044000000,,-1206000000,-1206000000,57155,BB
2019-12-31,19792212,,-176144999,,-176144999,174112612,43312352,-151205258,-151205258,,-17382215,,,,0,49646937,200852195,6334585,-24939741,,-176144999,-176144999,57156,TXMD
2018-12-31,27299138,,-132617160,,-132617160,115988954,13361808,-130220170,-130220170,,-4677834,,,,0,16099460,146319630,2737652,-2396990,,-132617160,-132617160,57156,TXMD
2017-12-31,33852993,,-76925380,,-76925380,57703370,14140770,-77628710,-77628710,,-4677834,,,,0,16777713,94406423,2636943,703330,,-76925380,-76925380,57156,TXMD
2016-12-31,53943477,,-89875459,,-89875459,51348414,15170742,-90253600,-90253600,,-4677834,,,,0,19356450,109610050,4185708,378141,,-89875459,-89875459,57156,TXMD
2020-01-31,,,74318000,,56004000,346108000,424473000,77460000,77460000,,,,,,18314000,1543686000,1466226000,1119213000,-3142000,,56004000,56004000,57157,CONN
2019-01-31,,,96778000,,73849000,328628000,434195000,104558000,104558000,,,,,,22929000,1549813000,1445255000,1115618000,-7780000,,73849000,73849000,57157,CONN
2018-01-31,,,31634000,,6463000,316325000,362119000,44965000,44965000,,,,,,25171000,1516031000,1471066000,1153912000,-13331000,,6463000,6463000,57157,CONN
2017-01-31,,,-34517000,,-25562000,326078000,299029000,-28039000,-28039000,,,,,,-8955000,1596848000,1624887000,1297819000,-6478000,,-25562000,-25562000,57157,CONN
2019-12-31,67090000,,-75305000,,-75305000,16958000,0,-84048000,-84048000,,,,,,0,0,84048000,0,8743000,,-75305000,-75305000,57158,RLAY
2018-12-31,40388000,,-48785000,,-48785000,9501000,0,-49889000,-49889000,,,,,,0,0,49889000,0,1104000,,-48785000,-48785000,57158,RLAY
2019-12-31,27266000,,-41594000,,-41622000,5439000,124000,-32581000,-32581000,,-177000,,,,28000,124000,32705000,0,-9013000,,-41622000,-41622000,57159,TRIL
2018-12-31,34096000,,-32859000,,-32866000,2786000,0,-36882000,-36882000,,-35000,,,,7000,0,36882000,0,4023000,,-32866000,-32866000,57159,TRIL
2017-12-31,38293000,,-45084000,,-45088000,3861000,0,-42154000,-42154000,,-68000,,,,4000,0,42154000,0,-2930000,,-45088000,-45088000,57159,TRIL
2016-12-31,29580000,,-35414000,,-31733000,3826000,0,-33406000,-33406000,,-82000,,,,-3681000,0,33406000,0,-2008000,,-31733000,-31733000,57159,TRIL
2019-12-31,29557000,,-35596000,,-35512000,6232000,0,-35789000,-35789000,,,,,,-84000,0,35789000,0,193000,,-35512000,-40682000,57161,PRAX
2018-12-31,18820000,,-26402000,,-26535000,3899000,0,-22719000,-22719000,,-127000.0,,,,133000,0,22719000,0,-3683000,,-26535000,-29223000,57161,PRAX
2019-12-31,21739000,,-48635000,,-32436000,72823000,103352000,-25486000,-25486000,,-15986000,,,,-16199000,284707000,310193000,181355000,-23149000,,-32436000,-32436000,57162,TRHC
2018-12-31,12222000,,-50645000,,-47269000,35971000,66601000,1606000,1606000,,-906000,,,,-3376000,204270000,202664000,137669000,-101719000,,-47269000,-47269000,57162,TRHC
2017-12-31,5628000,,3452000,,12791000,25708000,39830000,-1018000,-1018000,,-688000,,,,-9339000,133485000,134503000,93655000,4470000,,12791000,12791000,57162,TRHC
2016-12-31,3811000,,-4980000,,-5521000,15746000,29614000,4942000,4942000,,-4488000,,,,541000,94791000,89849000,65177000,-9922000,,-5521000,-3082000,57162,TRHC
2019-12-31,,,14882000,,5832000,9949000,51042000,15127000,15127000,-498000,,,,,9050000,135366000,120239000,84324000,-245000,,5832000,5832000,57168,GORO
2018-12-31,,,16551000,,9288000,9325000,48192000,16712000,16712000,2836000,,,,,7263000,115308000,98596000,67116000,-161000,,9288000,9288000,57168,GORO
2017-12-31,,,28478000,,4150000,8122000,56563000,29478000,29478000,60000,,,,,24328000,110156000,80678000,53593000,-1000000,,4150000,4150000,57168,GORO
2016-12-31,,,9146000,,4387000,9533000,34057000,8228000,8228000,-187000,,,,,4759000,83227000,74999000,49170000,918000,,4387000,4387000,57168,GORO
2019-12-31,,,16465000,,13129000,38544000,60754000,0,17512000,4698000,,,,,3336000,60754000,43242000,0,-1047000,,13129000,13129000,57171,FUNC
2018-12-31,,,13431000,,10667000,37088000,57239000,0,15526000,4625000,,,,,2764000,57239000,41713000,0,-2095000,,10667000,10667000,57171,FUNC
2017-12-31,,,12214000,,5269000,33880000,51384000,0,13038000,4466000,,,,,6945000,51384000,38346000,0,-824000,,5269000,4054000,57171,FUNC
2016-12-31,,,10064000,,7281000,31056000,49171000,0,12106000,6009000,,,,,2783000,49171000,37065000,0,-2042000,,7281000,5256000,57171,FUNC
2020-12-31,,,3242200000,1561700000,2372700000,844600000,3590300000,2745700000,2745700000,,,,,,718900000,6206700000,3461000000,2616400000,496500000,,2523300000,2307400000,57172,TROW
2019-12-31,,,2927300000,1121000000,2131300000,846000000,3233000000,2387000000,2387000000,,,,,,678400000,5617900000,3230900000,2384900000,540300000,,2248900000,2076000000,57172,TROW
2018-12-31,,,2384600000,740300000,1837500000,779500000,3125700000,2346200000,2346200000,,,,,,615900000,5372600000,3026400000,2246900000,38400000,,1768700000,1793900000,57172,TROW
2017-12-31,,,2505100000,992800000,1497800000,722600000,2781400000,2058800000,2058800000,,,,,,923900000,4854900000,2796100000,2073500000,446300000,,1581200000,1463900000,57172,TROW
2019-12-31,,,29122628,,29122628,1676533,13304191,11627658,11627658,,-1914526,,,,0,13304191,1676533,0,17494970,,29122628,29122628,57174,WEA
2018-12-31,,,-8665947,,-8665947,1602849,12143727,10540878,10540878,,-1556186,,,,0,12143727,1602849,0,-19206825,,-8665947,-8665947,57174,WEA
2017-12-31,,,17825113,,17811883,1645236,12361598,10716362,10716362,,-1040282,,,,13230,12361598,1645236,0,7108751,,17811883,17811883,57174,WEA
2016-12-31,,,21765168,,21732512,1519822,13353116,11833294,11833294,,-766919,,,,32656,13353116,1519822,0,9931874,,21732512,21732512,57174,WEA
2019-12-31,,,255000000,,179000000,70000000,768000000,503000000,503000000,,-227000000,,,,76000000,2122000000,1619000000,1354000000,-248000000,,179000000,127000000,57175,GTN
2018-12-31,,,288000000,,211000000,33000000,492000000,384000000,384000000,,-107000000,,,,77000000,1084000000,700000000,592000000,-96000000,,211000000,211000000,57175,GTN
2017-12-31,,,193000000,,262000000,32000000,325000000,216000000,216000000,,-95000000,,,,-69000000,883000000,667000000,558000000,-23000000,,262000000,262000000,57175,GTN
2016-12-31,,,105691000,,62273000,32919000,337471000,242033000,242033000,,-97236000,,,,43418000,812465000,570432000,474994000,-136342000,,62273000,62273000,57175,GTN
2019-12-31,,,-3804494,2654085,-3015718,1351180,3922120,-264465,-264465,,-2472628,,,,0,8268768,8533233,4346648,-3540029,,-3804494,-3015718,57181,MDRR
2018-12-31,,,-2938002,3568601,-2743323,1044330,3004658,-873335,-873335,,-1917183,,,,53151,6589951,7463286,3585293,-2064667,,-2991153,-2743323,57181,MDRR
2017-12-31,,,-968548,3293936,-847919,307241,765260,-285127,-285127,307241.0,-766857,,,,0,1724657,2009784,959397,-683421,,-968548,-847919,57181,MDRR
2016-12-31,,,-46247,3293936,-46247,44429,0,-44429,-44429,307241.0,-1818,,,,0,0,44429,0,-1818,,-46247,-46247,57181,MDRR
2020-05-02,37772000,,-9000,,491000,101095000,138700000,-167000,-167000,,-106000,,,,-500000,608932000,609099000,470232000,158000,,491000,491000,57182,DAKT
2019-04-27,35557000,,-4944000,,-958000,99465000,130294000,-4728000,-4728000,,-160000,,,,-3986000,569704000,574432000,439410000,-216000,,-958000,-958000,57182,DAKT
2018-04-28,35530000,,12429000,,5562000,97679000,145669000,12460000,12460000,,-217000,,,,6867000,610530000,598070000,464861000,-31000,,5562000,5562000,57182,DAKT
2017-04-29,29081000,,15588000,,10342000,95913000,140415000,15421000,15421000,,-230000,,,,5246000,586539000,571118000,446124000,-663000,,10342000,10342000,57182,DAKT
2019-12-31,73375000,,-26135000,,-20910000,280856000,345311000,-8920000,-8920000,,-9780000,,,,-5225000,524876000,533796000,179565000,-17215000,,-20910000,-20910000,57183,DESP
2018-12-31,71154000,,26223000,,19154000,241597000,358504000,45753000,45753000,,-14420000,,,,7069000,530614000,484861000,172110000,-19530000,,19154000,19154000,57183,DESP
2017-12-31,71308000,,54360000,,42366000,238914000,381461000,71239000,71239000,,-10667000,,,,11994000,523940000,452701000,142479000,-16879000,,42366000,42366000,57183,DESP
2016-12-31,63251000,,28335000,,17797000,186149000,284487000,35087000,35087000,,-4563000,,,,10538000,411162000,376075000,126675000,-6752000,,17797000,17797000,57183,DESP
2019-12-31,,,43284205,,29496551,22384847,143769151,61236250,61236250,3943785,-13865556,,,,13787654,186572452,125336202,42803301,-17952045,,29496551,29496551,57184,REI
2018-12-31,,,12445481,,8999760,12844365,86632279,26971154,26971154,7791874,-427898,,,,3445721,114434268,87463114,27801989,-14525673,,8999760,8999760,57184,REI
2017-12-31,,,12170040,,1753869,10515887,47568776,11878957,11878957,4656152,-427898,,,,10416171,63547138,51668181,15978362,291083,,1753869,1753869,57184,REI
2016-12-31,,,-57625272,,-37637687,8027077,19477828,-519745,-519745,487182,-649009,,,,-19987585,29345628,29865373,9867800,-57105527,,-37637687,-37637687,57184,REI
2019-12-31,,,735685000,,587121000,123653000,1314094000,1169696000,1169696000,,-434011000,,,,148564000,2016904000,847208000,702810000,-434011000,,587121000,575163000,57186,AL
2018-12-31,,,640138000,,510835000,97369000,1097717000,982870000,982870000,,-342732000,,,,129303000,1679702000,696832000,581985000,-342732000,,510835000,510835000,57186,AL
2017-12-31,,,609530000,,756152000,91323000,1008028000,896901000,896901000,,-287371000,,,,-146622000,1516380000,619479000,508352000,-287371000,,756152000,756152000,57186,AL
2016-12-31,,,580238000,,374925000,82993000,966373000,866439000,866439000,,-286201000,,,,205313000,1419055000,552616000,452682000,-286201000,,374925000,374925000,57186,AL
2019-12-31,24254000,,-28292000,,-28292000,4635000,0,-28889000,-28889000,,,,,,0,0,28889000,0,597000,,-28292000,-35044000,57187,CMPI
2018-12-31,18174000,,-20814000,,-20814000,2820000,0,-20994000,-20994000,,,,,,0,0,20994000,0,180000,,-20814000,-25125000,57187,CMPI
2020-08-31,,,386878000,9302000,422439000,697678000,981807000,284129000,284129000,,-116977000,,,,-36731000,28406365000,28122236000,27424558000,102749000,,423609000,253771000,57188,CHSCN
2019-08-31,,,815601000,7390000,829880000,691877000,1384333000,692456000,692456000,,-167065000,,,,-12456000,31900453000,31207997000,30516120000,123145000,,828057000,661212000,57188,CHSCN
2018-08-31,,,671230000,9446000,775907000,635519000,1092120000,456601000,456601000,,-149202000,,,,-104076000,32683347000,32226746000,31591227000,214629000,,775306000,607239000,57188,CHSCN
2017-08-31,,,-110166000,12505000,71592000,609590000,893877000,284287000,284287000,,-171239000,,,,-181124000,32037426000,31753139000,31143549000,-394453000,,70958000,-96051000,57188,CHSCN
2019-12-31,6049000,,-20340000,,-20703000,34203000,22414000,-17838000,-17838000,,-2317000,,,,363000,32595000,50433000,10181000,-2502000,,-20703000,-20703000,57189,LUNG
2018-12-31,6991000,,-18467000,,-18479000,20347000,12286000,-15052000,-15052000,,-2520000,,,,12000,20004000,35056000,7718000,-3415000,,-18479000,-18479000,57189,LUNG
2019-12-31,59017000,,-102087000,,-103686000,305812000,268350000,-96479000,-96479000,,-10931000,,,,1599000,390255000,486734000,121905000,-5608000,,-103686000,-103686000,57192,NVRO
2018-12-31,48459000,,-48437000,,-49205000,266608000,273324000,-41743000,-41743000,,-10401000,,,,768000,387289000,429032000,113965000,-6694000,,-49205000,-49205000,57192,NVRO
2017-12-31,37560000,,-35250000,,-36658000,219712000,227693000,-29579000,-29579000,,-9902000,,,,1408000,326674000,356253000,98981000,-5671000,,-36658000,-36658000,57192,NVRO
2016-12-31,33729000,,-30155000,,-31778000,142423000,153071000,-23081000,-23081000,,-6394000,,,,1623000,228504000,251585000,75433000,-7074000,,-31778000,-31778000,57192,NVRO
2019-12-31,,,-401000000,2000000,-311000000,210000000,628000000,-35000000,-35000000,,-195000000,,,,-90000000,2022000000,2057000000,1394000000,-366000000,,-311000000,-311000000,57193,FWONA
2018-12-31,,,-200000000,3000000,-150000000,204000000,554000000,-110000000,-110000000,,-192000000,,,,-50000000,1827000000,1937000000,1273000000,-90000000,,-150000000,-150000000,57193,FWONA
2017-12-31,,,-304000000,2000000,255000000,199000000,564000000,-40000000,-40000000,,-220000000,,,,-561000000,1783000000,1823000000,1219000000,-264000000,,257000000,255000000,57193,FWONA
2016-12-31,,,500000000,2000000,329000000,58000000,0,-68000000,-68000000,,-19000000,,,,171000000,0,68000000,0,568000000,,329000000,329000000,57193,FWONA
2019-12-31,6207747,,-7880986,,-7188727,18313626,25430909,909536,909536,,-4822734,,,,-692259,135741336,134831800,110310427,-8790522,,-7188727,-7188727,57194,KNDI
2018-12-31,10084378,,2076055,,-5694699,11801415,20247445,-1638348,-1638348,,-1871851,,,,7770754,112438828,114077176,92191383,3714403,,-5694699,-5694699,57194,KNDI
2017-12-31,27628085,,-31610504,,-28347474,12798343,14344189,-26082239,-26082239,,-2280286,,,,-3263030,102805621,128887860,88461432,-5528265,,-28347474,-28347474,57194,KNDI
2016-12-31,26504650,,-5829211,,-6510757,22233416,17721816,-31016250,-31016250,,-1831667,,,,681546,129492013,160508263,111770197,25187039,,-6510757,-6510757,57194,KNDI
2020-03-31,148159000,,-90768000,1669000,-88937000,432072000,496273000,-83958000,-83958000,,-23695000,,,,211000,599510000,683468000,103237000,-6810000,,-90979000,-88937000,57196,NEWR
2019-03-31,104859000,,-41059000,2733000,-40893000,329997000,401826000,-33030000,-33030000,,-19679000,,,,697000,479225000,512255000,77399000,-8029000,,-41756000,-40893000,57196,NEWR
2018-03-31,74332000,,-44361000,2733000,-45320000,264809000,292333000,-46808000,-46808000,,-86000,,,,959000,355058000,401866000,62725000,2447000,,-45320000,-45320000,57196,NEWR
2017-03-31,61054000,,-60813000,2733000,-61077000,213778000,213489000,-61343000,-61343000,,-87000,,,,264000,263479000,324822000,49990000,530000,,-61077000,-61077000,57196,NEWR
2020-03-31,10767000,,-39119000,,-38927000,25175000,5873000,-35795000,-35795000,,-3738000,,,,-192000,38659000,74454000,32786000,-3324000,,-38927000,-38927000,57200,LIVX
2019-03-31,7966000,,-37544000,,-37762000,21954000,2530000,-33894000,-33894000,,-3273000,,,,218000,33701000,67595000,31171000,-3650000,,-37762000,-37762000,57200,LIVX
2018-03-31,1578000,,-19014000,,-23336000,11377000,501000,-14877000,-14877000,,-3922000,,,,6000,7195000,22072000,6694000,-4137000,-4316000.0,-19020000,-23336000,57200,LIVX
2017-03-31,1578000,,-14250000,,-14250000,4980000,-505000,-5485000,-5485000,,-512000,,,,0,225000,5710000,730000,-8765000,-4316000.0,-14250000,-14250000,57200,LIVX
2020-12-31,,,-1419000000,65000000,-1061000000,,934000000,-1235000000,-1235000000,2169000000,-184000000,,,,-363000000,8503000000,9738000000,7569000000,-184000000,,-1056000000,-1105000000,57201,BHFAP
2019-12-31,,,-1052000000,65000000,-740000000,,1405000000,-895000000,-895000000,2279000000,-157000000,,,,-317000000,6520000000,7415000000,5115000000,-157000000,,-735000000,-761000000,57201,BHFAP
2018-12-31,,,989000000,65000000,865000000,,3463000000,1046000000,1046000000,2377000000,-57000000,,,,119000000,8864000000,7818000000,5401000000,-57000000,,870000000,865000000,57201,BHFAP
2017-12-31,,,-615000000,65000000,-378000000,,1865000000,-465000000,-465000000,2330000000,-150000000,,,,-237000000,6839000000,7304000000,4974000000,-150000000,,-378000000,-378000000,57201,BHFAP
2019-12-31,,,213504000,,163010000,77868000,581958000,358786000,358786000,,-7141000,,,,50494000,2052314000,1693528000,1470356000,-145282000,,163010000,163010000,57203,PUMP
2018-12-31,,,225117000,,173862000,53753000,433985000,292094000,292094000,,-6889000,,,,51255000,1704562000,1412468000,1270577000,-66977000,,173862000,173862000,57203,PUMP
2017-12-31,,,15741000,,12613000,48493000,168042000,63921000,63921000,,-7347000,,,,3128000,981865000,917944000,813823000,-48180000,,12613000,12613000,57203,PUMP
2016-12-31,,,-81119000,,-53147000,26613000,32780000,-37375000,-37375000,,-20187000,,,,-27972000,436920000,474295000,404140000,-43744000,,-53147000,-53147000,57203,PUMP
2019-12-31,,,89177000,,89177000,10203000,321614000,197831000,197831000,-2801000,-147313000,,,,0,456048000,258217000,134434000,-108654000,,89177000,89177000,57205,SFL
2018-12-31,,,73622000,,73622000,9167000,288291000,176918000,176918000,-1873000,-100710000,,,,0,416839000,239921000,128548000,-103296000,,73622000,73622000,57205,SFL
2017-12-31,,,101209000,,101209000,7432000,247337000,153502000,153502000,-1747000,-87330000,,,,0,379131000,225629000,131794000,-52293000,,101209000,101209000,57205,SFL
2016-12-31,,,146406000,,146406000,9072000,274348000,173570000,173570000,-2587000,-72357000,,,,0,410364000,236794000,136016000,-27164000,,146406000,146406000,57205,SFL
2019-12-31,,,321311000,,216959000,64465000,738870000,276759000,276759000,163830000,-81632000,,,,104352000,1274883000,998124000,536013000,44552000,,216959000,216959000,57207,DEN
2018-12-31,,,409931000,,322698000,71495000,935471000,563944000,563944000,83583000,-69688000,,,,87233000,1473625000,909681000,538154000,-154013000,,322698000,322698000,57207,DEN
2017-12-31,,,46500000,,163152000,95006000,631520000,164018000,164018000,164783000,-99263000,,,,-116652000,1129786000,965768000,498266000,-117518000,,163152000,163152000,57207,DEN
2016-12-31,,,-1520347000,,-976177000,109926000,499831000,-70949000,-70949000,205836000,-125145000,,,,-544170000,975596000,1046545000,475765000,-1449398000,,-976177000,-976177000,57207,DEN
2019-12-31,,,22256000,,22256000,3983000,-12967000,0,-18255000,1305000,,,,,0,-12967000,5288000,0,40511000,,22256000,22256000,57209,EARN
2018-12-31,,,-11295000,,-11295000,4265000,26294000,0,20786000,1243000,,,,,0,26294000,5508000,0,-32081000,,-11295000,-11295000,57209,EARN
2017-12-31,,,10788000,,10788000,4494000,31279000,0,25577000,1208000,,,,,0,31279000,5702000,0,-14789000,,10788000,10788000,57209,EARN
2016-12-31,,,11906000,,11906000,3757000,15462000,0,10453000,1252000,,,,,0,15462000,5009000,0,1453000,,11906000,11906000,57209,EARN
2019-12-31,51222000,,-338918000,,-341017000,497862000,301250000,-247834000,-247834000,,-109728000,,,,252000,4740583000,4988417000,4439333000,-91084000,,-339170000,-341017000,57210,OPEN
2018-12-31,28458000,,-239552000,1491000.0,-241291000,268642000,133428000,-163672000,-163672000,,-60456000,,,,377000,1838066000,2001738000,1704638000,-75880000,,-239929000,-248515000,57210,OPEN
2017-12-31,16123000,,-84767000,1491000.0,-84829000,111866000,66347000,-61642000,-61642000,,-23342000,,,,0,711066000,772708000,644719000,-23125000,,-84767000,-84829000,57210,OPEN
2020-12-31,,,-13612000000,,-9919000000,2710000000,4164000000,-2589000000,-2589000000,668000000,-1365000000,,,,-2337000000,69897000000,72486000000,65733000000,-11023000000,1205000000,-11275000000,-9919000000,57211,MPC
2019-12-31,,,4329000000,9413000000.0,2637000000,3411000000,13869000000,6069000000,6069000000,751000000,-1238000000,,,,1074000000,124112000000,118043000000,110243000000,-1740000000,1205000000,3255000000,2636000000,57211,MPC
2018-12-31,,,4568000000,9878000000.0,2780000000,2424000000,10640000000,5169000000,5169000000,557000000,-946000000,,,,962000000,96706000000,91537000000,86066000000,-601000000,1205000000,3606000000,2779000000,57211,MPC
2017-12-31,,,3344000000,7795000000.0,3432000000,1743000000,7964000000,3653000000,3653000000,454000000,-625000000,,,,-460000000,75053000000,71400000000,67089000000,-309000000,1205000000,3804000000,3430000000,57211,MPC
2019-12-31,30034000,,-105186000,,-105186000,112469000,52168000,-90335000,-90335000,,-15044000,,,,0,54637000,144972000,2469000,-14851000,,-105186000,-105186000,57213,ADMS
2018-12-31,39300000,,-130999000,,-130999000,109136000,33413000,-115023000,-115023000,,-19092000,,,,0,34046000,149069000,633000,-15976000,,-130999000,-130999000,57213,ADMS
2017-12-31,27168000,,-91220000,,-89490000,61345000,554000,-87959000,-87959000,,-4645000,,,,-1730000,571000,88530000,17000,-3261000,,-89490000,-89490000,57213,ADMS
2016-12-31,31230000,,-60173000,,-60058000,30326000,572000,-60984000,-60984000,,-4645000,,,,-115000,572000,61556000,0,811000,,-60058000,-60058000,57213,ADMS
2019-12-31,,,18278000000,6751000000,12101000000,60737000000,87507000000,26311000000,26311000000,459000000,-6704000000,,,,5648000000,194471000000,168160000000,106964000000,-8033000000,,12630000000,12101000000,57214,KOF
2018-12-31,,,16964000000,6806000000,13911000000,58126000000,83938000000,25135000000,25135000000,677000000,-7366000000,,,,5260000000,182342000000,157207000000,98404000000,-8171000000,2975000000.0,11704000000,13911000000,57214,KOF
2017-12-31,,,-11195000000,18141000000,-12802000000,58226000000,83508000000,24870000000,24870000000,412000000,-8595000000,,,,4184000000,183256000000,158386000000,99748000000,-36065000000,3256000000.0,-15379000000,-12802000000,57214,KOF
2016-12-31,,,14455000000,7096000000,10070000000,55581000000,79662000000,23285000000,23285000000,796000000,-7317000000,,,,3928000000,177718000000,154433000000,98056000000,-8830000000,3256000000.0,10527000000,10070000000,57214,KOF
2020-02-29,17800000,,165940000,,152333000,463231000,734466000,220364000,220364000,,-12705000,,,,13607000,1707432000,1487068000,972966000,-54424000,,152333000,152333000,57216,HELE
2019-02-28,13000000,,188000000,,168545000,400637000,641106000,201665000,201665000,,-11719000,,,,13776000,1564151000,1362486000,923045000,-13665000,-5679000.0,174224000,168545000,57216,HELE
2018-02-28,13500000,,155438000,,44446000,374583000,611199000,193062000,193062000,,-13951000,,,,26556000,1478845000,1285783000,867646000,-37624000,-84436000.0,128882000,44446000,57216,HELE
2017-02-28,11800000,,155717000,,140689000,356460000,573416000,173532000,173532000,,-14361000,,,,11407000,1397535000,1224003000,824119000,-17815000,-3621000.0,144310000,140689000,57216,HELE
2020-12-31,,,3810400000,,3513200000,1346000000,4642200000,3576600000,3576600000,-280400000,-56900000,,,,297200000,8497100000,4920500000,3854900000,233800000,,3513200000,3513200000,57218,REGN
2019-12-31,,,2429100000,,2115800000,1306700000,3342500000,2245000000,2245000000,-209200000,-30200000,,,,313300000,6557600000,4312600000,3215100000,184100000,,2115800000,2115800000,57218,REGN
2018-12-31,,,2553500000,,2444400000,1127200000,3259300000,2534400000,2534400000,-402300000,-28200000,,,,109100000,5145600000,2611200000,1886300000,19100000,,2444400000,2444400000,57218,REGN
2017-12-31,,,2078500000,,1198500000,1320400000,3400000000,2079600000,2079600000,-402300000,-25100000,,,,880000000,5872200000,3792600000,2472200000,-31200000,,1198500000,1198500000,57218,REGN
2019-12-31,9859000,,-48044000,29137000,-48425000,140632000,119124000,-31367000,-31367000,,-33137000,,,,3475000,1448666000,1480033000,1329542000,-16677000,,-51519000,-50353000,57219,TWI
2018-12-31,11146000,,19807000,110862000,16087000,136081000,188179000,40952000,40952000,,-30456000,,,,6762000,1602408000,1561456000,1414229000,-21145000,,13045000,3880000,57219,TWI
2017-12-31,10302000,,-52876000,102348000,-60042000,152709000,159744000,-3267000,-3267000,,-30229000,,,,11203000,1468922000,1472189000,1309178000,-49609000,,-64079000,-66435000,57219,TWI
2016-12-31,9971000,,-36474000,100871000,-37605000,147539000,132559000,-24951000,-24951000,,-32539000,,,,3281000,1265497000,1290448000,1132938000,-11523000,,-39755000,-47161000,57219,TWI
2019-12-31,,,4163000,18899000,4147000,21475000,216377000,58572000,58572000,,-77994000,,,,0,299744000,241172000,83367000,-54409000,,4163000,-3101000,57221,AFIN
2018-12-31,,,-37471000,8335000,-37409000,23233000,208339000,40433000,40433000,,-66789000,,,,0,291207000,250774000,82868000,-77904000,,-37471000,-37409000,57221,AFIN
2017-12-31,,,-46577000,4546000,-46494000,19791000,197257000,23411000,23411000,,-60305000,,,,0,270910000,247499000,73653000,-69988000,,-46577000,-46494000,57221,AFIN
2016-12-31,,,-54255000,4546000,-54255000,11168000,138991000,26680000,26680000,,-54253000,,,,0,177668000,150988000,38677000,-80935000,,-54255000,-54255000,57221,AFIN
2020-07-31,,,116433000,214925000,98833000,320295000,820719000,250852000,250852000,,-106721000,,,,7378000,1963704000,1712852000,1142985000,-134419000,,109055000,98833000,57222,MTN
2019-07-31,,,398965000,226213000,301163000,319015000,1027452000,490320000,490320000,,-79496000,,,,75472000,2271575000,1781255000,1244123000,-91355000,,323493000,301163000,57222,MTN
2018-07-31,,,340092000,222229000,379898000,291606000,907136000,411068000,411068000,,-63226000,,,,-61138000,2011553000,1600485000,1104417000,-70976000,,401230000,379898000,57222,MTN
2017-07-31,,,348449000,227803000,210553000,236799000,826376000,400420000,400420000,,-54089000,,,,116731000,1907218000,1506798000,1080842000,-51971000,,231718000,210553000,57222,MTN
2020-12-25,72194000,,374651000,,330456000,355796000,854937000,426947000,426947000,,-11280000,,,,44195000,1650115000,1223168000,795178000,-52296000,,330456000,330456000,57223,GGG
2019-12-27,67557000,,405877000,,343853000,372743000,859756000,419456000,419456000,,-13110000,,,,62024000,1646045000,1226589000,786289000,-13579000,,343853000,343853000,57223,GGG
2018-12-28,63124000,,410766000,,341054000,390988000,882539000,428427000,428427000,,-14385000,,,,69712000,1653292000,1224865000,770753000,-17661000,,341054000,341054000,57223,GGG
2017-12-29,59217000,,347094000,,252412000,363240000,795202000,372745000,372745000,,-16202000,,,,94682000,1474744000,1101999000,679542000,-25651000,,252412000,252412000,57223,GGG
2020-12-25,13361000,,32291000,,33279000,56614000,127250000,43910000,43910000,,-8727000,,,,-988000,914236000,870326000,786986000,-11619000,,33279000,33279000,57224,ICHR
2019-12-27,11102000,,4275000,,10729000,47270000,86364000,14977000,14977000,,-10647000,,,,-6454000,620837000,605860000,534473000,-10702000,,10729000,10729000,57224,ICHR
2018-12-28,9355000,,54219000,,57883000,44748000,140976000,71504000,71504000,,-9987000,,,,-3664000,823611000,752107000,682635000,-17285000,,57883000,57883000,57224,ICHR
2017-12-29,7899000,,43029000,,56454000,33370000,105991000,55842000,55842000,,-3277000,,,,-13886000,655892000,600050000,549901000,-12813000,-461000.0,56915000,56454000,57224,ICHR
2020-12-31,,,-7453000000,,-5543000000,25416000000,43983000000,-6977000000,-6977000000,4499000000,-697000000,,,,-1892000000,94471000000,101448000000,50488000000,-476000000,,-5561000000,-5543000000,57225,CVX
2019-12-31,,,5536000000,995000000.0,2924000000,25945000000,59752000000,10478000000,10478000000,4138000000,-798000000,,,,2691000000,139865000000,129387000000,80113000000,-4942000000,,2845000000,2924000000,57225,CVX
2018-12-31,,,20575000000,1088000000.0,14824000000,24942000000,64324000000,14624000000,14624000000,4864000000,-748000000,,,,5715000000,158902000000,144278000000,94578000000,5951000000,,14860000000,14824000000,57225,CVX
2017-12-31,,,9221000000,1195000000.0,9195000000,23885000000,58909000000,3499000000,3499000000,12333000000,-307000000,,,,-48000000,127485000000,123986000000,68576000000,5722000000,,9269000000,9195000000,57225,CVX
2020-09-30,,,-1766114,,-1775281,7385890,6638507,-747383,-747383,,-174962,,,,9167,34478358,35225741,27839851,-1018731,,-1775281,-1775281,57226,FORD
2019-09-30,,,-3608192,,-3604030,9678265,6580882,-3097383,-3097383,,-201004,,,,-4162,37409030,40506413,30828148,-510809,,-3604030,-3604030,57226,FORD
2018-09-30,,,632320,,1379320,6011424,6568076,556652,556652,,-115447,,,,-747000,34499503,33942851,27931427,75668,,1379320,1379320,57226,FORD
2017-09-30,,,579346,,579346,3593173,4191643,598470,598470,,-115447,,,,0,24764613,24166143,20572970,-19124,,579346,579346,57226,FORD
2020-12-31,,,97666000,1412000,77588000,138107000,283048000,0,99150000,45791000,,,,,19924000,283048000,183898000,0,-1484000,,77742000,77588000,57227,TMP
2019-12-31,,,102861000,1412000,81718000,138768000,284695000,0,104534000,41393000,,,,,21016000,284695000,180161000,0,-1673000,,81845000,80412000,57227,TMP
2018-12-31,,,104240000,1412000,82308000,133870000,285307000,0,108511000,42926000,,,,,21805000,285307000,176796000,0,-4271000,,82435000,80993000,57227,TMP
2017-12-31,,,95242000,1422000,52494000,128661000,263647000,0,97174000,37812000,,,,,42620000,263647000,166473000,0,-1932000,,52622000,51676000,57227,TMP
2020-12-31,341400000,,541700000,,488500000,1191400000,2024400000,491600000,491600000,,,,,,53200000,2594400000,2102800000,570000000,50100000,,488500000,488500000,57229,FTNT
2019-12-31,277100000,,379200000,,326500000,1029000000,1650300000,344200000,344200000,,,,,,52700000,2156200000,1812000000,505900000,35000000,,326500000,326500000,57229,FTNT
2018-12-31,244500000,,250900000,,332200000,875300000,1350800000,231000000,231000000,,,,,,-81300000,1801200000,1570200000,450400000,19900000,,332200000,332200000,57229,FTNT
2017-12-31,210600000,,124000000,,31400000,788900000,1109600000,110100000,110100000,,,,,,92600000,1494900000,1384800000,385300000,13900000,,31400000,31400000,57229,FTNT
2020-12-31,125900000,,472700000,,372700000,538300000,1213000000,548800000,548800000,,-67300000,,,,98000000,4347500000,3798700000,3134500000,-76100000,-2000000,374700000,372700000,57230,BC
2019-12-31,121600000,,110700000,,-131000000,542000000,1158100000,494500000,494500000,,-76000000,,,,80300000,4108400000,3613900000,2950300000,-383800000,-161400000,30400000,-131000000,57230,BC
2018-12-31,121500000,,310700000,,265300000,509500000,1136100000,505100000,505100000,4300000.0,-46000000,,,,57300000,4120900000,3615800000,2984800000,-194400000,11900000,253400000,265300000,57230,BC
2017-12-31,111600000,,212900000,,146400000,467900000,961000000,381500000,381500000,4300000.0,-26400000,,,,111600000,3802200000,3420700000,2841200000,-168600000,45100000,101300000,146400000,57230,BC
2019-12-31,,,34255000,420194000,8917000,139033000,219631000,76927000,76927000,,-44153000,,,,2713000,462310000,385383000,242679000,-42672000,,31542000,8917000,57231,SWCH
2018-12-31,,,31261000,565142000,4052000,124197000,181447000,54679000,54679000,,-26370000,,,,1943000,405860000,351181000,224413000,-23418000,,29318000,4052000,57231,SWCH
2017-12-31,,,-9561000,633239000,-15208000,87400000,180045000,90127000,90127000,649000.0,-25079000,,,,-981000,378275000,288148000,198230000,-99688000,,-8580000,-15208000,57231,SWCH
2016-12-31,,,31368000,633239000,31368000,70891000,149508000,51070000,51070000,27018000.0,-10836000,,,,0,318352000,267282000,168844000,-19702000,,31368000,31368000,57231,SWCH
2020-02-01,,,-214884000,,-164358000,910033000,900706000,-9327000,-9327000,-847000,,,,,-50526000,2019194000,2028521000,1118488000,-205557000,,-164358000,-164358000,57236,EXPR
2019-02-02,,,20290000,,9630000,581912000,615729000,33817000,33817000,-847000,-25000.0,,,,10660000,2116344000,2082527000,1500615000,-13527000,,9630000,9630000,57236,EXPR
2018-02-03,,,28851000,,18873000,573550000,631861000,58311000,58311000,-847000,-2242000.0,,,,9978000,2158502000,2100191000,1526641000,-29460000,,18873000,18873000,57236,EXPR
2017-01-28,,,92097000,,58340000,795114000,905365000,110251000,110251000,-847000,-13468000.0,,,,33757000,2204417000,2094166000,1299052000,-18154000,,58340000,58340000,57236,EXPR
2019-12-31,,,36691000,,36691000,3084000,20576000,17492000,17492000,,-2399000,,,,0,20576000,3084000,0,19199000,,36691000,33658000,57238,PCQ
2018-12-31,,,-281000,,-281000,3167000,22664000,19497000,19497000,,-2221000,,,,0,22664000,3167000,0,-19778000,,-281000,-3548000,57238,PCQ
2017-12-31,,,26174000,,26174000,3207000,22324000,19117000,19117000,,-1041000,,,,0,22324000,3207000,0,7057000,,26174000,24107000,57238,PCQ
2016-12-31,,,3841000,,3841000,3229000,21372000,18143000,18143000,,-330000,,,,0,21372000,3229000,0,-14302000,,3841000,2728000,57238,PCQ
2019-12-31,,,-287900000,200000,-297600000,50400000,26200000,-145800000,-145800000,,-70400000,,,,11200000,334100000,479900000,307900000,-142100000,,-299100000,-297600000,57239,BORR
2018-12-31,,,-188400000,1700000,-190500000,38700000,-15200000,-157600000,-157600000,,-13700000,,,,2500000,164900000,322500000,180100000,-30800000,,-190900000,-190500000,57239,BORR
2017-12-31,,,-88000000,2000000,-88000000,17700000,-36100000,-75000000,-75000000,,-500000,,,,0,100000,75100000,36200000,-13000000,,-88000000,-88000000,57239,BORR
2016-12-31,,,-1920000,2000000,-1920000,1920000,0,-1920000,-1920000,,-500000,,,,0,0,1920000,0,0,,-1920000,-1920000,57239,BORR
2019-12-31,27543000,,-13423000,,-10765000,82672000,112504000,-6960000,-6960000,,,,,,-2658000,160289000,167249000,47785000,-6463000,,-10765000,-10765000,57240,SPOK
2018-12-31,24464000,,-2185000,,-1479000,87598000,119658000,-3173000,-3173000,,,,,,-706000,169474000,172647000,49816000,988000,,-1479000,-1479000,57240,SPOK
2017-12-31,18702000,,11559000,,-15306000,84452000,125484000,10706000,10706000,,,,,,26865000,171175000,160469000,45691000,859000,,-15306000,-15306000,57240,SPOK
2016-12-31,13467000,,22971000,,13979000,82167000,130750000,22153000,22153000,,,,,,8992000,179561000,157408000,48811000,816000,,13979000,13979000,57240,SPOK
2019-12-31,94188000,,92775000,,89833000,137037000,244915000,107878000,107878000,,-17601000,,,,2942000,356071000,248193000,111156000,-15103000,,89833000,89833000,57241,CHRS
2018-12-31,94188000,,-209409000,,-209339000,94177000,-106378000,-200555000,-200555000,,-9684000,,,,0,0,200555000,106378000,-8854000,,-209409000,-209339000,57241,CHRS
2017-12-31,94188000,,-238286000,-1289000.0,-238170000,69003000,-158975000,-227978000,-227978000,,-9552000,,,,0,1556000,229534000,160531000,-10308000,,-238286000,-238170000,57241,CHRS
2016-12-31,94188000,,-127788000,-1173000.0,-127337000,51597000,-64334000,-115931000,-115931000,,-7980000,,,,0,190106000,306037000,254440000,-11857000,,-127788000,-127337000,57241,CHRS
2020-12-31,373788000,,-96537000,,-110861000,559627000,860440000,-112427000,-112427000,,-8659000,,,,14324000,1038756000,1151183000,178316000,15890000,,-110861000,-110861000,57242,ALKS
2019-12-31,500533000,,-197056000,,-196620000,611749000,990562000,-162078000,-162078000,,-13601000,,,,-436000,1170947000,1333025000,180385000,-34978000,,-196620000,-196620000,57242,ALKS
2018-12-31,414606000,,-126967000,,-139311000,537208000,917854000,-99128000,-99128000,,-15437000,,,,12344000,1094274000,1193402000,176420000,-27839000,,-139311000,-139311000,57242,ALKS
2017-12-31,412889000,,-143274000,,-157945000,421578000,748626000,-147900000,-147900000,,-12008000,,,,14671000,903374000,1051274000,154748000,4626000,,-157945000,-157945000,57242,ALKS
2019-12-31,,,-27019000,,-27647000,13871000,44035000,30164000,30164000,,-15902000,,,,628000,44035000,13871000,0,-57183000,,-27647000,-27647000,57243,CPTA
2018-12-31,,,-17942000,,-16026000,13988000,47293000,33305000,33305000,,-15930000,,,,-1916000,47293000,13988000,0,-51247000,,-16026000,-16026000,57243,CPTA
2017-12-31,,,-5695000,,-6984000,14008000,51089000,37081000,37081000,,-17853000,,,,1289000,51089000,14008000,0,-42776000,,-6984000,-6984000,57243,CPTA
2016-12-31,,,9152000,,9152000,19561000,68312000,48751000,48751000,,-19407000,,,,0,68312000,19561000,0,-39599000,,9152000,9152000,57243,CPTA
2019-12-31,,,16950428,-168680,13977625,26352548,43506259,17153711,17153711,,-96646,,,,2955356,129932881,112779170,86426622,-203283,,13995072,13977625,57244,XPEL
2018-12-31,,,11481305,-190029,8712534,21630602,33436605,11806003,11806003,,-168389,,,,2760073,109920614,98114611,76484009,-324698,,8721232,8712534,57244,XPEL
2017-12-31,,,2148550,-188426,1047331,14472327,16683832,2211505,2211505,,-328402,,,,1154220,67297044,65085539,50613212,-62955,,994330,1047331,57244,XPEL
2016-12-31,,,3029575,-55179,2215502,10569731,14098083,3295147,3295147,233205.0,-223045,,,,866075,51759267,48464120,37661184,-265572,,2163500,2215502,57244,XPEL
2019-12-31,,,216653000,,171957000,2200000,241843000,237395000,237395000,2248000,-12085000,,,,44696000,378771000,141376000,136928000,-20742000,,171957000,171957000,57245,NMIH
2018-12-31,,,135961000,,107927000,2200000,152607000,152337000,152337000,270000,-14979000,,,,28034000,275025000,122688000,122418000,-16376000,,107927000,107927000,57245,NMIH
2017-12-31,,,52792000,,22050000,2200000,71042000,70425000,70425000,617000,-13528000,,,,30742000,182743000,112318000,111701000,-17633000,,22050000,22050000,57245,NMIH
2016-12-31,,,11452000,,64001000,2200000,28200000,28200000,28200000,617000,-14848000,,,,-52549000,123815000,95615000,95615000,-16748000,,64001000,64001000,57245,NMIH
2020-12-31,,,159600000,,133300000,237800000,437000000,184800000,184800000,,-15200000,,,,26300000,1310400000,1125600000,873400000,-25200000,,133300000,133300000,57248,HMN
2019-12-31,,,236449000,,184443000,234609000,523450000,280051000,280051000,,-15577000,,,,52006000,1430485000,1150434000,907035000,-43602000,,184443000,184443000,57248,HMN
2018-12-31,,,19537000,,18343000,205413000,237951000,32538000,32538000,,-13001000,,,,1194000,1191599000,1159061000,953648000,-13001000,,18343000,18343000,57248,HMN
2017-12-31,,,88687000,,169459000,187789000,288424000,100635000,100635000,,-11948000,,,,-80772000,1171550000,1070915000,883126000,-11948000,,169459000,169459000,57248,HMN
2020-12-31,24319000,,-5059000,-262000,-4852000,38373000,51597000,-11095000,-11095000,,-20000,,,,55000,68062000,79157000,16465000,6036000,-22000,-5114000,-4852000,57249,RNWK
2019-12-31,34848000,,-20190000,-502000,-20001000,61583000,68986000,-27445000,-27445000,,-636000,,,,1068000,172113000,199558000,103127000,7255000,-22000,-21258000,-20001000,57249,RNWK
2018-12-31,30789000,,-22787000,-502000,-24989000,41846000,51783000,-20852000,-20852000,,-636000,,,,2202000,69510000,90362000,17727000,-1935000,-22000,-24989000,-24989000,57249,RNWK
2017-12-31,29710000,,-20192000,-502000,-16305000,44349000,55554000,-18105000,-18105000,-400000.0,-636000,,,,-2778000,78718000,96823000,23164000,-2087000,1109000,-17414000,-16305000,57249,RNWK
2019-12-31,35415000,,-46389000,,-46389000,10470000,0,-45885000,-45885000,,-1767000,,,,0,0,45885000,0,-504000,,-46389000,-46389000,57251,MBIO
2018-12-31,23964000,,-30662000,,-30662000,7259000,0,-31223000,-31223000,,-8000,,,,0,0,31223000,0,561000,,-30662000,-30662000,57251,MBIO
2017-12-31,20376000,,-31288000,,-31288000,9209000,0,-29585000,-29585000,,-8000,,,,0,0,29585000,0,-1703000,,-31288000,-31288000,57251,MBIO
2016-12-31,8547000,,-12654000,,-12654000,2816000,0,-11363000,-11363000,,-1148000,,,,0,0,11363000,0,-1291000,,-12654000,-12654000,57251,MBIO
2020-12-31,,,151723000,,114887000,665258000,875467000,152753000,152753000,,-9014000,,,,36836000,4735940000,4583187000,3860473000,-1030000,,114887000,114887000,57252,RUSHB
2019-12-31,,,189523000,,141583000,753749000,1025628000,216507000,216507000,,-30487000,,,,47940000,5809847000,5593340000,4784219000,-26984000,,141583000,141583000,57252,RUSHB
2018-12-31,,,183169000,,139062000,705226000,978269000,202554000,202554000,,-21058000,,,,44107000,5506190000,5303636000,4527921000,-19385000,,139062000,139062000,57252,RUSHB
2017-12-31,,,136399000,,172129000,631053000,829936000,148814000,148814000,,-13201000,,,,-35730000,4713882000,4565068000,3883946000,-12415000,,172129000,172129000,57252,RUSHB
2019-12-31,,,3545267000,,2734910000,489397000,9120166000,3666294000,3666294000,619889000,-185129000,,,,810357000,17076085000,13409791000,7955919000,-121027000,,2734910000,2734910000,57253,EOG
2018-12-31,,,4240998000,,3419040000,426969000,9592707000,4343805000,4343805000,938121000,-245052000,,,,821958000,17266477000,12922672000,7673770000,-102807000,,3419040000,3419040000,57253,EOG
2017-12-31,,,661182000,,2582579000,434467000,6023377000,1069738000,1069738000,524834000,-274372000,,,,-1921397000,11287588000,10217850000,5264211000,-408556000,,2582579000,2582579000,57253,EOG
2016-12-31,,,-1557505000,,-1096686000,347815000,3661311000,-1369849000,-1369849000,449318000,-281681000,,,,-460819000,7544405000,8914254000,3883094000,-187656000,,-1096686000,-1096686000,57253,EOG
2020-10-31,,,28407054,,28407054,2980262,13790717,10810455,10810455,,,,,,0,13790717,2980262,0,17596599,,28407054,28407054,57258,MIN
2019-10-31,,,40836344,,40836344,3089318,15301777,12212459,12212459,,,,,,0,15301777,3089318,0,28623885,,40836344,40836344,57258,MIN
2018-10-31,,,-7384607,,-7384607,3176629,14740502,11563873,11563873,,,,,,0,14740502,3176629,0,-18948480,,-7384607,-7384607,57258,MIN
2017-10-31,,,5899433,,5899433,3322692,14547313,11224621,11224621,,,,,,0,14547313,3322692,0,-5325188,,5899433,5899433,57258,MIN
2019-12-31,,,77953000,,61735000,30600000,313270000,112874000,112874000,78300000,-42685000,,,,12642000,746372000,633498000,433102000,-34921000,-3576000,65311000,61735000,57259,NWN
2018-12-31,,,91502000,,64569000,9100000,293926000,123062000,123062000,76608000,-37059000,,,,24191000,706143000,583081000,412217000,-31560000,-2742000,67311000,64569000,57259,NWN
2017-12-31,,,113081000,,-55623000,6100000,277885000,144802000,144802000,45930000,-37526000,,,,41008000,755038000,610236000,477153000,-224199000,-127696000,72073000,-55623000,57259,NWN
2016-12-31,,,105430000,,58895000,7000000,270862000,143717000,143717000,42541000,-38236000,,,,43011000,668173000,524456000,397311000,-38287000,-3524000,62419000,58895000,57259,NWN
2019-12-31,209900000,,446800000,37100000,326700000,1093700000,2501000000,959000000,959000000,,-219100000,,,,120300000,8200000000,7241000000,5699000000,-512200000,,326500000,325300000,57262,WAB
2018-12-31,87500000,,367600000,3900000,294900000,583200000,1251900000,541400000,541400000,,-112200000,,,,75900000,4363500000,3822100000,3111600000,-173800000,,291700000,294200000,57262,WAB
2017-12-31,95200000,,352100000,19664000,262300000,472700000,1077300000,472900000,472900000,,-79900000,,,,89800000,3881700000,3408800000,2804400000,-120800000,,262300000,261600000,57262,WAB
2016-12-31,71375000,,412837000,770848000,304887000,364068000,924239000,466098000,466098000,,-50298000,,,,99433000,2931188000,2465090000,2006949000,-53261000,,313404000,303973000,57262,WAB
2020-03-31,130434000,,5898000,22355000,-212000,523085000,699551000,38421000,38421000,,-38641000,,,,-7915000,2309238000,2270817000,1609687000,-32523000,,13813000,-212000,57263,VSAT
2019-03-31,123044000,,-107483000,8330000,-67623000,465958000,530537000,-68120000,-68120000,,-50010000,,,,-41014000,2068258000,2136378000,1537721000,-39363000,,-66469000,-67623000,57263,VSAT
2018-03-31,168347000,,-103492000,10841000,-67305000,385420000,473811000,-92187000,-92187000,,-4026000,,,,-35217000,1594625000,1686812000,1120814000,-11305000,,-68275000,-67305000,57263,VSAT
2017-03-31,129647000,,25384000,3313000,23767000,333468000,510362000,36459000,36459000,,-12083000,,,,3617000,1559337000,1522878000,1048975000,-11075000,,21767000,23767000,57263,VSAT
2019-12-31,,,-7836000,,-7863000,65397000,72307000,-7201000,-7201000,14111000,-535000,,,,27000,72307000,79508000,0,-635000,,-7863000,-7863000,57264,BMTX
2018-12-31,,,-14575000,,-14603000,57519000,57516000,-10485000,-10485000,10482000,-535000,,,,28000,57516000,68001000,0,-4090000,,-14603000,-14603000,57264,BMTX
2017-12-31,,,-5059000,,-5069000,14955000,12542000,-4649000,-4649000,2236000,-535000,,,,10000,12542000,17191000,0,-410000,,-5069000,-5069000,57264,BMTX
2020-03-31,22998000,,-171027000,,-155079000,302554000,360286000,34734000,34734000,,-38791000,,,,-15948000,1755871000,1721137000,1395585000,-205761000,,-155079000,-155079000,57265,VSTO
2019-03-31,27742000,,-674272000,,-648443000,377049000,415688000,10897000,10897000,,-57191000,,,,-25829000,2058528000,2047631000,1642840000,-685169000,,-648443000,-648443000,57265,VSTO
2018-03-31,29663000,,-133789000,,-60232000,423430000,520962000,67869000,67869000,,-49214000,,,,-73557000,2308463000,2240594000,1787501000,-201658000,,-60232000,-60232000,57265,VSTO
2017-03-31,32769000,,-250694000,,-274454000,424269000,669186000,212148000,212148000,,-43670000,,,,23760000,2546892000,2334744000,1877706000,-462842000,,-274454000,-274454000,57265,VSTO
2019-11-30,,,-12496000,,-12496000,34812000,31183000,-8513000,-8513000,,-4825000,,,,0,63216000,71729000,32033000,-3983000,,-12496000,-12496000,57266,THTX
2018-11-30,,,-5969000,,-4700000,27521000,26402000,-3561000,-3561000,,-2114000,,,,-1269000,45217000,48778000,18815000,-2408000,,-4700000,-4700000,57266,THTX
2017-11-30,,,-18450000,,-18450000,31833000,20735000,-11098000,-11098000,,-2114000,,,,0,42864000,53962000,22129000,-7352000,,-18450000,-18450000,57266,THTX
2016-11-30,,,1049000,,410000,19521000,23459000,3938000,3938000,,-2114000,,,,639000,37072000,33134000,13613000,-2889000,,410000,410000,57266,THTX
2019-12-31,,,-40672821,7591265,-42403369,20084088,-30563733,-50638683,-50638683,-9138,-2041491,,,,400311,109060066,159698749,139623799,9965862,,-41073132,-42403369,57267,EBON
2018-12-31,,,-10914674,6261028,-12308494,55506699,24445792,-3692877,-3692877,-27368030,-921047,,,,899586,319041793,322734670,294596001,-7221797,,-11814260,-12308494,57267,EBON
2016-12-31,,,11079497,30786573,12440428,45498538,58531607,12122572,12122572,910497,-921047,,,,-60494,120775441,108652869,62243834,-1043075,,11139991,12440428,57267,EBON
2015-12-31,,,27499599,30786573,24236120,26768157,51789275,23797928,23797928,1223190,-921047,,,,3263479,92140244,68342316,40350969,3701671,,24236120,24236120,57267,EBON
2019-12-31,3066000,,-727000,,-742000,8006000,3431000,-7641000,-7641000,,-261000,,,,15000,19842000,27483000,16411000,6914000,,-742000,-742000,57268,BDR
2018-12-31,2576000,,-1416000,,-1339000,6697000,8419000,-854000,-854000,,-562000,,,,-77000,21707000,22561000,13288000,-562000,,-1339000,-1339000,57268,BDR
2017-12-31,2452000,,-402000,,-384000,6021000,8936000,463000,463000,,-723000,,,,-18000,23283000,22820000,14347000,-865000,,-384000,-384000,57268,BDR
2016-12-31,2741000,,-1166000,,-1195000,6287000,8357000,-671000,-671000,,-412000,,,,29000,22506000,23177000,14149000,-495000,,-1195000,-1195000,57268,BDR
2019-12-31,63400000,,-148743000,,-148037000,120212000,43493000,-140119000,-140119000,,-9199000,,,,-706000,143985000,284104000,100492000,-8624000,,-148037000,-228827000,57270,PROG
2018-12-31,48712000,,-123856000,,-129106000,101425000,35898000,-114239000,-114239000,,-9091000,,,,5250000,127974000,242213000,92076000,-9617000,,-129106000,-129106000,57270,PROG
2020-03-31,,,3095000000,55000000,2331000000,1351000000,4077000000,2726000000,2726000000,,-24000000,,,,757000000,12780000000,10054000000,8703000000,369000000,,2338000000,2331000000,57271,INFY
2019-03-31,,,3003000000,9000000,2199000000,1281000000,3978000000,2697000000,2697000000,13120000000.0,-24000000,,,,803000000,11799000000,9102000000,7821000000,306000000,,2200000000,2199000000,57271,INFY
2018-03-31,,,3143000000,10000000,2486000000,1151000000,3810000000,2659000000,2659000000,10020000000.0,-24000000,,,,657000000,10939000000,8280000000,7129000000,484000000,,2486000000,2486000000,57271,INFY
2017-03-31,,,2974000000,10000000,2140000000,1242000000,3762000000,2520000000,2520000000,10020000000.0,-24000000,,,,834000000,10208000000,7688000000,6446000000,454000000,,2140000000,2140000000,57271,INFY
2019-12-31,,,256968,,203004,335062,0,-335062,-335062,,,,,,53964,0,335062,0,592030,,203004,203004,57272,MCMJ
2020-09-30,1155127,,11305955,,12602272,41267273,26369007,-17092474,-17092474,1039081,,,,,-1345300,41883734,58976208,15514727,28398429,-48983,12651255,12235422,57273,YCBD
2019-09-30,1155127,,-47788776,,-50428226,28875186,14514874,-14360312,-14360312,1039081,,,,,-2359000,23651551,38011863,9136677,-33428464,-4998450,-45429776,-50428226,57273,YCBD
2018-09-30,1155127,,-1797068,1411972.0,-412075,2152149,355081,-1797068,-1797068,1039081,,,,,0,459091,2256159,104010,0,1384993,-1797068,-412075,57273,YCBD
2019-12-29,98000000,,-180800000,,-156900000,514500000,890800000,98000000,98000000,48600000,-231400000,,,,-23900000,1801500000,1703500000,910700000,-278800000,,-156900000,-156900000,57274,OCDX
2018-12-30,98700000,,-217600000,,-248800000,494900000,889300000,117800000,117800000,49100000,-235600000,,,,31200000,1787300000,1669500000,898000000,-335400000,,-248800000,-248800000,57274,OCDX
2017-12-31,96400000,,-14300000,,-116300000,503000000,897400000,77300000,77300000,58700000,-239800000,,,,102000000,1781700000,1704400000,884300000,-91600000,,-116300000,-116300000,57274,OCDX
2019-12-31,,,6749562000,100793000,5674145000,1546227000,6621168000,5462831000,5462831000,-387890000,,,,,1078295000,22109946000,16647115000,15488778000,1286731000,,5671267000,5674145000,57275,ZTO
2018-12-31,,,5317045000,52311000,4383025000,1210717000,5364883000,4332223000,4332223000,-178057000,-780000.0,,,,929133000,17604451000,13272228000,12239568000,984822000,,4387912000,4383025000,57275,ZTO
2017-12-31,,,3805261000,6004000,3159663000,780517000,4345584000,3748435000,3748435000,-183368000,-15668000.0,,,,646361000,13060073000,9311638000,8714489000,56826000,,3158900000,3159663000,57275,ZTO
2016-12-31,,,2783590000,5714000,2053855000,705995000,3442869000,2768978000,2768978000,-32104000,-12986000.0,,,,731987000,9788768000,7019790000,6345899000,14612000,,2051603000,1848468000,57275,ZTO
2019-12-31,,,1762447,,1762447,386675,0,-386675,-386675,,,,,,0,0,386675,0,2149122,,1762447,-295982,57279,ANDA
2018-12-31,,,-14772,,-14772,14772,0,-14772,-14772,,,,,,0,0,14772,0,0,,-14772,-14772,57279,ANDA
2017-12-31,,,-424,,-424,424,0,-424,-424,,,,,,0,0,424,0,0,,-424,-424,57279,ANDA
2016-12-31,,,-33122,,-33122,424,0,0,-424,,,,,,0,0,0,0,-33122,,-33122,-33122,57279,ANDA
2019-12-31,11625000,,-39612000,,-39612000,25476000,-1984000,-39673000,-39673000,588000,-1490000,,,,0,7296000,46969000,9280000,61000,,-39612000,-39612000,57281,CLXT
2018-12-31,10358000,,-27897000,,-27897000,17993000,236000,-28115000,-28115000,588000,-1257000,,,,0,236000,28351000,0,218000,,-27897000,-27897000,57281,CLXT
2017-12-31,11508000,,-25980000,,-25980000,14789000,508000,-25789000,-25789000,588000,-261000,,,,0,508000,26297000,0,-191000,,-25980000,-25980000,57281,CLXT
2016-12-31,5638000,,-12086000,,-12086000,6670000,199000,-12109000,-12109000,588000,-5000,,,,0,399000,12508000,200000,23000,,-12086000,-12086000,57281,CLXT
2019-12-31,,,287000000,,302000000,1492000000,2666000000,911000000,911000000,,-536000000,,,,-15000000,9172000000,8261000000,6506000000,-624000000,,302000000,302000000,57282,CAR
2018-12-31,,,267000000,,165000000,1473000000,2559000000,830000000,830000000,,-514000000,,,,102000000,9124000000,8294000000,6565000000,-563000000,,165000000,165000000,57282,CAR
2017-12-31,,,211000000,,361000000,1342000000,2363000000,762000000,762000000,,-481000000,,,,-150000000,8848000000,8086000000,6485000000,-551000000,,361000000,361000000,57282,CAR
2016-12-31,,,279000000,,163000000,1314000000,2436000000,869000000,869000000,,-503000000,,,,116000000,8659000000,7790000000,6223000000,-590000000,,163000000,163000000,57282,CAR
2019-12-31,,,186000000,,-667000000,882000000,12056000000,2579000000,2579000000,2083000000,-769000000,,,,693000000,20393000000,17814000000,8337000000,-2393000000,-15000000,-507000000,-985000000,57283,OXY
2018-12-31,,,5608000000,,4131000000,585000000,11256000000,4701000000,4701000000,1467000000,-356000000,,,,1477000000,17824000000,13123000000,6568000000,907000000,-15000000,4131000000,4114000000,57283,OXY
2017-12-31,,,1328000000,,1311000000,546000000,6914000000,694000000,694000000,1189000000,-324000000,,,,17000000,12508000000,11814000000,5594000000,634000000,-15000000,1311000000,1305000000,57283,OXY
2016-12-31,,,-1664000000,,-574000000,1330000000,4901000000,-1577000000,-1577000000,277000000,-275000000,,,,-662000000,10090000000,11667000000,5189000000,-87000000,428000000,-1002000000,-574000000,57283,OXY
2019-12-31,,,25389000,-162076000,20787000,5567000,56592000,36790000,36790000,,-25497000,,,,3783000,59738000,22948000,3146000,-11401000,,21606000,8263000,57284,LMRK
2018-12-31,,,116048000,-166818000,115010000,4731000,62990000,42107000,42107000,,-23263000,,,,227000,64824000,22717000,1834000,73941000,,115821000,104380000,57284,LMRK
2017-12-31,,,16131000,-150318000,18769000,5286000,50944000,32121000,32121000,,-16724000,,,,-3145000,52625000,20504000,1681000,-15990000,,19276000,12096000,57284,LMRK
2016-12-31,,,9921000,-135630000,9811000,3755000,37962000,23016000,23016000,,-11617000,,,,0,41171000,18155000,3209000,-13095000,,9921000,7103000,57284,LMRK
2019-12-31,,,121009000,5868000,79539000,165878000,390522000,180028000,180028000,44616000,-111525000,,,,40699000,1567072000,1387044000,1176550000,-59019000,,80310000,79539000,57285,PQG
2018-12-31,,,88616000,4585000,58300000,164527000,383237000,175187000,175187000,43523000,-113723000,,,,28995000,1608154000,1432967000,1224917000,-86571000,,59621000,58300000,57285,PQG
2017-12-31,,,-60634000,3919000,57603000,144567000,377707000,185713000,185713000,47427000,-179044000,,,,-119197000,1472101000,1286388000,1094394000,-246347000,,58563000,57603000,57285,PQG
2016-12-31,,,-69117000,5064000,-79746000,107139000,283178000,139040000,139040000,36999000,-140315000,,,,10041000,1064177000,925137000,780999000,-208157000,,-79158000,-79746000,57285,PQG
2019-12-31,,,68900000,11400000,66600000,150900000,342800000,136800000,136800000,,-62500000,,,,1400000,1772800000,1636000000,1430000000,-67900000,-100000,67500000,66600000,57286,KOP
2018-12-31,,,54800000,10800000,23400000,155100000,335100000,129200000,129200000,,-56300000,,,,26000000,1710200000,1581000000,1375100000,-74400000,400000,28800000,23400000,57286,KOP
2017-12-31,,,60300000,5900000,29100000,132500000,322100000,139800000,139800000,,-42500000,,,,29000000,1475500000,1335700000,1153400000,-79500000,-800000,31300000,29100000,57286,KOP
2016-12-31,,,38500000,4200000,29300000,125700000,290000000,111400000,111400000,,-50800000,,,,11400000,1416200000,1304800000,1126200000,-72900000,600000,27100000,29300000,57286,KOP
2020-06-30,,,-4639000,,-4684000,3837000,1636000,-2403000,-2403000,,,,,,-175000,4476000,6879000,2840000,-2236000,-220000,-4464000,-4684000,57288,GROW
2019-06-30,,,-4269000,467000.0,-3388000,3118000,575000,-2757000,-2757000,,,,,,-977000,3459000,6216000,2884000,-1512000,-96000,-3292000,-3388000,57288,GROW
2018-06-30,,,886000,518000.0,647000,4038000,1991000,-2288000,-2288000,,,,,,197000,6261000,8549000,4270000,3174000,-96000,689000,647000,57288,GROW
2017-06-30,,,-527000,484000.0,-513000,3629000,3009000,-873000,-873000,,,,,,17000,6763000,7636000,3754000,346000,-96000,-544000,-513000,57288,GROW
2019-12-31,,,-3623000,,-2636000,20036000,15651000,-4385000,-4385000,,,,,,-987000,40100000,44485000,24449000,762000,,-2636000,-2636000,57289,BKTI
2018-12-31,,,-472000,,-195000,17552000,19977000,2425000,2425000,,,,,,-277000,49380000,46955000,29403000,-2897000,,-195000,-195000,57289,BKTI
2017-12-31,,,-4785000,,-3626000,14577000,12750000,-1827000,-1827000,,,,,,-1159000,39395000,41222000,26645000,-2958000,,-3626000,-3626000,57289,BKTI
2016-12-31,,,4272000,,2689000,12792000,17077000,4285000,4285000,,,,,,1583000,50689000,46404000,33612000,-13000,,2689000,2689000,57289,BKTI
2020-11-30,,,11298658,,11298658,1845304,13244565,11399261,11399261,,-1143159,,,,0,13244565,1845304,0,-100603,,11298658,11298658,57290,PFO
2019-11-30,,,26407534,,26407534,1896449,13271620,11375171,11375171,,-2352550,,,,0,13271620,1896449,0,15032363,,26407534,26407534,57290,PFO
2018-11-30,,,-7573866,,-7573866,1831025,13038936,11207911,11207911,,-2039756,,,,0,13038936,1831025,0,-18781777,,-7573866,-7573866,57290,PFO
2017-11-30,,,22642827,,22642827,1924126,13133038,11208912,11208912,,-1464813,,,,0,13133038,1924126,0,11433915,,22642827,22642827,57290,PFO
2019-12-31,46492000,,-51058000,,-51550000,112196000,112140000,-46548000,-46548000,,-5236000,,,,492000,200462000,247010000,88322000,-4510000,,-51550000,-51550000,57291,FSLY
2018-12-31,34618000,,-30750000,,-30935000,73584000,79064000,-29138000,-29138000,,-1810000,,,,185000,144563000,173701000,65499000,-1612000,,-30935000,-30935000,57291,FSLY
2017-12-31,28989000,,-32242000,,-32450000,58269000,56228000,-31030000,-31030000,,-1116000,,,,208000,104900000,135930000,48672000,-1212000,,-32450000,-32450000,57291,FSLY
2019-12-31,,,-44582000,,-44582000,11378000,-33412000,-45488000,-45488000,,,,,,0,5633000,51121000,39045000,906000,,-44582000,-44582000,57296,ATHX
2018-12-31,,,-24283000,,-24283000,10442000,-14365000,-25662000,-25662000,,,,,,0,24291000,49953000,38656000,1379000,,-24283000,-24283000,57296,ATHX
2017-12-31,,,-32241000,,-32241000,8466000,-24133000,-33283000,-33283000,,,,,,0,3708000,36991000,27841000,1042000,,-32241000,-32241000,57296,ATHX
2016-12-31,,,-15374000,,-15337000,7835000,-7491000,-15708000,-15708000,,,,,,-37000,17347000,33055000,24838000,334000,,-15337000,-15337000,57296,ATHX
2019-12-31,,,1906900000,346700000,1921100000,-120000000,6497700000,2868700000,2868700000,1234500000,-1072500000,,,,-12900000,15561400000,12692700000,9063700000,-961800000,,1919800000,1921100000,57297,AEP
2018-12-31,,,2046600000,100400000,1923800000,-124500000,6182600000,2877800000,2877800000,1142700000,-984400000,,,,115300000,16195700000,13317900000,10013100000,-831200000,,1931300000,1923800000,57297,AEP
2017-12-31,,,2898600000,26600000,1912600000,-45500000,6442300000,3431200000,3431200000,1059400000,-895000000,,,,969700000,15424900000,11993700000,8982600000,-532600000,,1928900000,1912600000,57297,AEP
2016-12-31,,,546800000,23100000,610900000,-43200000,6412000000,3474900000,3474900000,1018000000,-877200000,,,,-73700000,16380100000,12905200000,9968100000,-2928100000,-2500000.0,620500000,610900000,57297,AEP
2019-12-31,,,211972000,376303000,94797000,12663000,275863000,220864000,220864000,,-1039000,,,,26253000,447673000,226809000,171810000,-8892000,,185719000,28051000,57300,RTLR
2018-12-31,,,80319000,376303000,62960000,1999000,110029000,82896000,82896000,,-1039000,,,,17359000,184467000,101571000,74438000,-2577000,,62960000,62960000,57300,RTLR
2017-12-31,,,25353000,376303000,20665000,1265000,28738000,23987000,23987000,,-1039000,,,,4688000,39295000,15308000,10557000,1366000,,20665000,20665000,57300,RTLR
2016-12-31,,,7688000,376303000,4928000,208000,8093000,7012000,7012000,,-1039000,,,,2760000,10607000,3595000,2514000,676000,,4928000,4928000,57300,RTLR
2019-12-31,,,-23517000,,-18141000,7881000,1113000,-23367000,-23367000,1361000,-85000,,,,-5376000,15549000,38916000,14436000,-150000,,-18141000,-18141000,57301,DNN
2018-12-31,,,-38371000,,-30077000,7261000,-29000,-30149000,-30149000,1316000,-85000,,,,-8294000,15550000,45699000,15579000,-8222000,,-30077000,-30077000,57301,DNN
2017-12-31,,,-24620000,,-19563000,6220000,2309000,-21519000,-21519000,1296000,-6000,,,,-5166000,16067000,37586000,13758000,-3101000,-109000.0,-19454000,-19563000,57301,DNN
2016-12-31,,,-15654000,,-17343000,4502000,3211000,-15643000,-15643000,903000,-3000,,,,-3955000,13833000,29476000,10622000,-11000,-5644000.0,-11699000,-17343000,57301,DNN
2020-09-30,,,9154950,,7293066,29530198,37914198,8384000,8384000,,,,,,1861884,93074514,84690514,55160316,770950,,7293066,7293066,57302,CLFD
2019-09-30,,,5926593,,4566156,27500989,32689123,5188134,5188134,,,,,,1360437,85034182,79846048,52345059,738459,,4566156,4566156,57302,CLFD
2018-09-30,,,5527952,,4274547,24969933,30996784,6026851,6026851,,,,,,1253405,77651354,71624503,46654570,-498899,,4274547,4274547,57302,CLFD
2017-09-30,,,5585813,,3847839,24308772,30264259,5955487,5955487,,,,,,1737974,73947619,67992132,43683360,-369674,,3847839,3847839,57302,CLFD
2020-03-31,,,-180200000,21564000,-397007000,431014000,965817000,283291000,283291000,-13800000,-181184000,,,,345000,7584000000,7300709000,6618183000,-463491000,-218235000,-180545000,-585263000,57304,NGL
2019-03-31,,,-78222000,8145000,360047000,332296000,706096000,161827000,161827000,-13800000,-164725000,,,,1233000,8689157000,8527330000,7983061000,-240049000,418850000,-79455000,247724000,57304,NGL
2018-03-31,,,-21124000,32684000,-70875000,290792000,690386000,191196000,191196000,-13800000,-199149000,,,,1353000,6953947000,6762751000,6263561000,-212320000,-47128000,-22477000,-130926000,57304,NGL
2017-03-31,,,96735000,-20711000,137042000,294808000,478799000,3752000,3752000,-13800000,-149994000,,,,1933000,12707203000,12703451000,12228404000,92983000,49072000,94802000,106668000,57304,NGL
2020-06-30,,,14661000,,11549000,179485000,194951000,15466000,15466000,,-120000,,,,3112000,232915000,217449000,37964000,-805000,,11549000,11549000,57313,LFVN
2019-06-30,,,9230000,,7429000,178171000,187985000,9814000,9814000,,-323000,,,,1801000,225958000,216144000,37973000,-584000,,7429000,7429000,57313,LFVN
2018-06-30,,,9548000,,5761000,158033000,168356000,10323000,10323000,,-456000,,,,3787000,203204000,192881000,34848000,-775000,,5761000,5761000,57313,LFVN
2017-06-30,,,2910000,,1608000,161584000,166033000,4449000,4449000,,-570000,,,,1302000,199489000,195040000,33456000,-1539000,,1608000,1608000,57313,LFVN
2019-12-31,,,19098912000000,3931792000000,13251483000000,3431485000000,26349861000000,20244740000000,20244740000000,893123000000,-1894490000000,,,,4596413000000,70846769000000,50602029000000,44496908000000,-1145828000000,,14502499000000,13251483000000,57315,EC
2018-12-31,,,19855851000000,2090831000000,11556405000000,2646142000000,26993252000000,22577731000000,22577731000000,796102000000,-2399414000000,,,,7322019000000,67819935000000,45242204000000,40826683000000,-2721880000000,,12533832000000,11556405000000,57315,EC
2017-12-31,,,13036866000000,1780746000000,6620412000000,2539190000000,18537982000000,14017176000000,14017176000000,1016610000000,-2385994000000,,,,5634944000000,55210224000000,41193048000000,36672242000000,-980310000000,,7401922000000,6620412000000,57315,EC
2016-12-31,,,7790526000000,1533643000000,2447881000000,2848948000000,14956305000000,9563345000000,9563345000000,1576271000000,-2765024000000,,,,4543046000000,48485561000000,38922216000000,33529256000000,-1772819000000,,3247480000000,2447881000000,57315,EC
2019-12-28,,,-5229000,,-4894000,44327000,48309000,613000,613000,,-8485000,,,,-335000,278478000,277865000,230169000,-5842000,,-4894000,-7382000,57318,STAF
2018-12-29,,,-6479000,,-6501000,43439000,48304000,1741000,1741000,,-8966000,,,,22000,260926000,259185000,212622000,-8220000,,-6501000,-6987000,57318,STAF
2017-12-30,,,-17559000,,-18491000,32350000,36741000,825000,825000,,-6490000,,,,932000,192650000,191825000,155909000,-18384000,,-18491000,-20700000,57318,STAF
2016-12-31,,,-6591430,,-6618858,31275434,32806291,-1508572,-1508572,,-4784572,,,,27429,187580603,189089174,154774312,-5082858,,-6618858,-9663430,57318,STAF
2019-12-31,,,-32975000,693000,-10249000,173104000,191451000,24465000,24465000,-6118000,-25402000,,,,-9544000,219711000,195246000,28260000,-57440000,13181000,-23431000,-10249000,57320,SFUN
2018-12-31,,,-160407000,694000,-114911000,188288000,193655000,8394000,8394000,-3027000,-21174000,,,,-18989000,240047000,231653000,46392000,-168801000,26509000,-141418000,-114911000,57320,SFUN
2017-12-31,,,19381000,692000,21707000,213298000,231740000,19141000,19141000,-699000,-16153000,,,,18352000,395338000,376197000,163598000,240000,20675000,1029000,21707000,57320,SFUN
2016-12-31,,,-144651000,695000,-169635000,381068000,229207000,-151446000,-151446000,-415000,-20791000,,,,24984000,916391000,1067837000,687184000,6795000,20675000,-169635000,-169635000,57320,SFUN
2019-12-31,69559000,,-149773000,,-149773000,129709000,62997000,-136271000,-136271000,,-17066000,,,,0,72957000,209228000,9960000,-13502000,,-149773000,-149773000,57322,FLXN
2018-12-31,53079000,,-169659000,,-169659000,121311000,15188000,-159202000,-159202000,,-15712000,,,,0,22524000,181726000,7336000,-10457000,,-169659000,-169659000,57322,FLXN
2017-12-31,51231000,,-137481000,,-137481000,78801000,351000,-129681000,-129681000,,-11268000,,,,0,355000,130036000,4000,-7800000,,-137481000,-137481000,57322,FLXN
2016-12-31,41314000,,-71894000,,-71894000,28466000,0,-69780000,-69780000,,-1748000,,,,0,0,69780000,0,-2114000,,-71894000,-71894000,57322,FLXN
2020-12-31,6333000000,,4637000000,129000000,5590000000,23054000000,35575000000,6814000000,6814000000,-626000000,-1288000000,,,,-864000000,73620000000,66806000000,38045000000,-2177000000,89000000,5501000000,5590000000,57323,IBM
2019-12-31,5936000000,,10166000000,144000000,9431000000,20382000000,36489000000,10785000000,10785000000,-614000000,-1344000000,,,,731000000,77147000000,66362000000,40658000000,-619000000,-4000000,9435000000,9431000000,57323,IBM
2018-12-31,5379000000,,11342000000,134000000,8728000000,20325000000,36937000000,12231000000,12231000000,-998000000,-723000000,,,,2619000000,79591000000,67360000000,42654000000,-889000000,5000000,8723000000,8728000000,57323,IBM
2017-12-31,5590000000,,11400000000,131000000,5753000000,21137000000,36943000000,11682000000,11682000000,-1466000000,-615000000,,,,5642000000,79139000000,67457000000,42196000000,-282000000,-5000000,5758000000,5753000000,57323,IBM
2020-12-31,,,242100000,85800000,161600000,789200000,1509900000,671500000,671500000,,-12900000,,,,59500000,2298600000,1627100000,788700000,-429400000,,182600000,156900000,57325,JHG
2019-12-31,,,583500000,697600000,427600000,789600000,1405600000,553400000,553400000,,-15100000,,,,137800000,2192400000,1639000000,786800000,30100000,,445700000,415900000,57325,JHG
2018-12-31,,,661800000,157600000,523800000,773000000,1504800000,669200000,669200000,,-15700000,,,,162200000,2306400000,1637200000,801600000,-7400000,,499600000,511100000,57325,JHG
2017-12-31,,,447400000,228500000,655500000,629100000,1124200000,442300000,442300000,,-11900000,,,,-211000000,1818300000,1376000000,694100000,5100000,,658400000,638200000,57325,JHG
2020-05-02,,,-50228000,,-38250000,404472000,442549000,-29319000,-29319000,5536000,-7445000,,,,-11978000,1851063000,1880382000,1408514000,-20909000,,-38250000,-38250000,57326,BNED
2019-04-27,,,-37434000,,-24374000,423880000,527726000,35701000,35701000,2280000,-9898000,,,,-13060000,2034643000,1998942000,1506917000,-73135000,,-24374000,-24374000,57326,BNED
2018-04-28,,,-273009000,,-252566000,433746000,560506000,61174000,61174000,2280000,-10306000,,,,-20443000,2203617000,2142443000,1643111000,-334183000,,-252566000,-252566000,57326,BNED
2017-04-29,,,10091000,,5361000,380770000,459061000,24973000,24973000,2280000,-3464000,,,,4730000,1874362000,1849389000,1415301000,-14882000,,5361000,5358000,57326,BNED
2019-12-31,,,15571000,83704000,10582000,102900000,853879000,345225000,345225000,,-390112000,,,,4663000,1057611000,712386000,203732000,-329654000,,10908000,8384000,57328,UNIT
2018-12-31,,,11124000,92375000,16187000,85198000,871959000,335011000,335011000,,-319591000,,,,-5421000,1017634000,682623000,145675000,-323887000,,16545000,7989000,57328,UNIT
2017-12-31,,,-47677000,101407000,-9439000,72045000,808051000,301801000,301801000,,-305994000,,,,-38849000,916032000,614231000,107981000,-349478000,,-8828000,-16552000,57328,UNIT
2016-12-31,,,305000,101407000,-212000,35402000,721571000,310199000,310199000,,-275394000,,,,517000,770408000,460209000,48837000,-309894000,,-212000,-5497000,57328,UNIT
2019-12-31,,,47900000,32700000,35800000,491500000,543900000,52400000,52400000,,-19800000,,,,11300000,3291800000,3239400000,2747900000,-4500000,,36600000,35800000,57329,HY
2018-12-31,,,36600000,32100000,34700000,461800000,501000000,39200000,39200000,,-15700000,,,,2300000,3179100000,3139900000,2678100000,-2600000,,34300000,34700000,57329,HY
2017-12-31,,,93800000,6900000,48600000,427800000,502600000,74800000,74800000,,-14400000,,,,44900000,2885200000,2810400000,2382600000,19000000,,48900000,48600000,57329,HY
2016-12-31,,,38300000,6600000,42800000,390700000,427500000,36800000,36800000,,-7300000,,,,-4000000,2569700000,2532900000,2142200000,1500000,,42300000,42800000,57329,HY
2019-12-31,,,130100000,,188500000,662000000,1164800000,314100000,314100000,,-189500000,,,,37700000,2781900000,2467800000,1617100000,-184000000,96100000,92400000,188500000,57330,KAR
2018-12-31,,,151900000,,328000000,608800000,1121300000,340100000,340100000,,-191200000,,,,34300000,2442800000,2102700000,1321500000,-188200000,210400000,117600000,328000000,57330,KAR
2017-12-31,,,158400000,,362000000,531700000,1029700000,326500000,326500000,,-163200000,,,,-15600000,2238800000,1912300000,1209100000,-168100000,188000000,174000000,362000000,57330,KAR
2016-12-31,,,355300000,,222400000,583100000,1322700000,499000000,499000000,,-138800000,,,,132900000,3150100000,2651100000,1827400000,-143700000,188000000,222400000,222400000,57330,KAR
2019-12-31,,,439100000,,439100000,33100000,747400000,460000000,460000000,,-211500000,,,,0,1131500000,671500000,384100000,-20900000,,439100000,368000000,57331,ATCO
2018-12-31,,,278800000,,278800000,31600000,747300000,469900000,469900000,,-212100000,,,,0,1096300000,626400000,349000000,-191100000,,278800000,207500000,57331,ATCO
2017-12-31,,,175200000,,175200000,40100000,530600000,290600000,290600000,,-116400000,,,,0,831300000,540700000,300700000,-115400000,,175200000,110800000,57331,ATCO
2016-12-31,,,-139039000,,-139039000,32118000,592278000,344062000,344062000,,-119882000,,,,0,877905000,533843000,285627000,-483101000,,-139039000,-194736000,57331,ATCO
2019-12-31,,,216516000,166454000,156323000,517876000,1266225000,403641000,403641000,41915000,-170040000,,,,61223000,1723691000,1320050000,457466000,-187125000,,155293000,99006000,57332,WEX
2018-12-31,,,238619000,10227000,168295000,436053000,1129534000,388787000,388787000,38407000,-101251000,,,,68843000,1492639000,1103852000,363105000,-150168000,,169776000,168295000,57332,WEX
2017-12-31,,,174416000,9220000,160062000,346993000,897564000,257636000,257636000,24993000,-105753000,,,,15450000,1248577000,990941000,351013000,-83220000,,158966000,160062000,57332,WEX
2016-12-31,,,48930000,8558000,23499000,281684000,662404000,193936000,193936000,11675000,-70465000,,,,28592000,1012488000,818552000,350084000,-145006000,,20338000,23499000,57332,WEX
2020-12-31,,,1209832000,,910911000,552867000,2180748000,0,1209832000,418049000,,,,,298921000,4418911000,3209079000,2238163000,0,,910911000,910911000,57333,SC
2019-12-31,,,1354268000,,994370000,524580000,2302758000,0,1354268000,423910000,,,,,359898000,4426940000,3072672000,2124182000,0,,994370000,994370000,57333,SC
2018-12-31,,,1192268000,,915926000,492992000,2021163000,0,1192268000,335903000,,,,,276342000,3821696000,2629428000,1800533000,0,,915926000,915926000,57333,SC
2017-12-31,,,804009000,,1172807000,591918000,1839741000,0,804009000,443814000,,,,,-368798000,3413958000,2609949000,1574217000,0,,1172807000,1172807000,57333,SC
2019-12-29,,,4418000,254000,2385000,39457000,42877000,3420000,3420000,,-349000,,,,1106000,140733000,137313000,97856000,998000,,3312000,2385000,57334,VITL
2018-12-30,,,6352000,-673000,5797000,27960000,34819000,6859000,6859000,,-424000,,,,723000,106713000,99854000,71894000,-507000,,5629000,5797000,57334,VITL
2017-12-31,,,-2112000,-673000,-1920000,19867000,18388000,-1479000,-1479000,,-524000,,,,33000,74000000,75479000,55612000,-633000,,-2145000,-1920000,57334,VITL
2019-12-31,10159000,,-34188000,,-34188000,7286000,-7734000,-15020000,-15020000,,,,,,0,2425000,17445000,10159000,-19168000,,-34188000,-34188000,57337,ONCT
2018-12-31,10159000,,-6579000,,-6579000,1820000,-5766000,-7586000,-7586000,,-1000.0,,,,0,2521000,10107000,8287000,1007000,,-6579000,-6579000,57337,ONCT
2017-12-31,10159000,,-10436000,,-10436000,2871000,-7689000,-10560000,-10560000,,-10000.0,,,,0,1674000,12234000,9363000,124000,,-10436000,-10436000,57337,ONCT
2019-12-31,,,148239000,,97740000,489554000,1024371000,223956000,223956000,10136000,-82897000,,,,50499000,3412190000,3188234000,2387819000,-75717000,,97740000,97740000,57338,CLH
2018-12-31,,,94482000,,65636000,502347000,994752000,183974000,183974000,9806000,-84052000,,,,28846000,3300303000,3116329000,2305551000,-89492000,,65636000,65636000,57338,CLH
2017-12-31,,,58689000,,100739000,456648000,882305000,127775000,127775000,9460000,-87705000,,,,-42050000,2944978000,2817203000,2062673000,-69086000,,100739000,100739000,57338,CLH
2016-12-31,,,8716000,,-39873000,420315000,822369000,104875000,104875000,10177000,-84309000,,,,48589000,2755226000,2650351000,1932857000,-96159000,,-39873000,-39873000,57338,CLH
2020-09-30,,,-1267203,,-1267203,10898634,39534044,28635410,28635410,,-12431910,,,,0,39534044,10898634,0,-29902613,,-1267203,-1267203,57340,OCSI
2019-09-30,,,6973982,,6973982,13958901,49627470,35668569,35668569,,-14528318,,,,0,49627470,13958901,0,-28694587,,6973982,6973982,57340,OCSI
2018-09-30,,,20673049,,20673049,13519334,47670547,34151213,34151213,,-14379881,,,,0,47670547,13519334,0,-13478164,,20673049,20673049,57340,OCSI
2017-09-30,,,-8766879,,-8766879,13630321,46571856,32941535,32941535,,-10769842,,,,0,46571856,13630321,0,-41708414,,-8766879,-8766879,57340,OCSI
2020-12-31,,,1000449000,,816030000,,4250478000,1273884000,1273884000,2817279000,-177582000,,,,168682000,9735066000,8461182000,5484588000,-273435000,,831767000,768925000,57341,MKL
2019-12-31,,,2285808000,185111000.0,1790466000,,5534505000,2477346000,2477346000,2908521000,-171687000,,,,486346000,9526191000,7048845000,3991686000,-191538000,,1799462000,1791571000,57341,MKL
2018-12-31,,,-7855000,193711000.0,-128180000,,3011267000,238957000,238957000,2656380000,-154212000,,,,122498000,6841285000,6602328000,3830018000,-246812000,,-130353000,-133008000,57341,MKL
2017-12-31,,,87295000,163702000.0,395269000,,2301545000,216606000,216606000,2004181000,-132451000,,,,-313463000,6061659000,5845053000,3760114000,-129311000,,400758000,361531000,57341,MKL
2019-12-31,,,-1905,,-8511,1905,0,-1905,-1905,,,,,,6606,0,1905,0,0,,-8511,-8511,57344,PTK
2019-12-31,,,138473000,,104346000,162815000,382814000,208297000,208297000,,-60393000,,,,34127000,910178000,701881000,527364000,-69824000,,104346000,100814000,57345,DIN
2018-12-31,,,110608000,,80354000,166683000,353087000,176299000,176299000,,-61686000,,,,30254000,780931000,604632000,427844000,-65691000,,80354000,77643000,57345,DIN
2017-12-31,,,-428309000,,-342750000,165679000,338711000,163023000,163023000,,-61979000,,,,-85559000,731725000,568702000,393014000,-591332000,,-342750000,-335982000,57345,DIN
2016-12-31,,,157851000,,101002000,148935000,384147000,225231000,225231000,,-61479000,,,,56849000,787566000,562335000,403419000,-67380000,,101002000,99572000,57345,DIN
2020-12-31,,,79795000,,79795000,23489000,137788000,68424000,68424000,,-15997000,,,,0,186884000,118460000,49096000,11371000,,79795000,79395000,57347,TRNO
2019-12-31,,,55516000,,55516000,23924000,126821000,58882000,58882000,,-16338000,,,,0,171022000,112140000,44201000,-3366000,,55516000,55165000,57347,TRNO
2018-12-31,,,63289000,,63289000,21503000,111669000,49350000,49350000,,-18211000,,,,0,151657000,102307000,39988000,13939000,,63289000,62888000,57347,TRNO
2017-12-31,,,53095000,,53095000,19681000,96610000,39059000,39059000,,-16777000,,,,0,132484000,93425000,35874000,14036000,,53095000,49015000,57347,TRNO
2019-12-31,,,-7010000000,5550000000,-34071000000,68099000000,108130000000,21873000000,21873000000,11490000000,-48136000000,,,,26369000000,678595000000,656722000000,570465000000,-28883000000,,-33379000000,-34071000000,57348,YPF
2018-12-31,,,90144000000,3157000000,38613000000,36767000000,78330000000,28526000000,28526000000,7675000000,-28717000000,,,,51538000000,435820000000,407294000000,357490000000,61618000000,,38606000000,38613000000,57348,YPF
2017-12-31,,,8703000000,238000000,12340000000,23035000000,42294000000,12075000000,12075000000,4810000000,-18385000000,,,,-3969000000,252813000000,240738000000,210519000000,-3372000000,,12672000000,12340000000,57348,YPF
2016-12-31,,,-29804000000,-94000000,-28237000000,19195000000,33944000000,10422000000,10422000000,1206000000,-18109000000,,,,-1425000000,210100000000,199678000000,176156000000,-40226000000,,-28379000000,-28237000000,57348,YPF
2019-12-31,,,-2138,,-2138,2138,0,-2138,-2138,,,,,,0,0,2138,0,0,,-2138,-2138,57351,FTCV
2020-09-30,,,76543000,-2506000,55541000,348445000,475020000,89197000,89197000,2755000,-10701000,,,,20625000,1467458000,1378261000,992438000,-12654000,,55918000,48729000,57353,SGU
2019-09-30,,,25154000,-1968000,17542000,396247000,487706000,33445000,33445000,25113000,-12196000,,,,7517000,1753872000,1720427000,1266166000,-8291000,,17637000,17542000,57353,SGU
2018-09-30,,,63107000,-1303000,55191000,381807000,463342000,61368000,61368000,-11408000,-10004000,,,,7602000,1677837000,1616469000,1214495000,1739000,,55505000,48851000,57353,SGU
2017-09-30,,,47276000,-929000,26744000,331532000,408499000,51278000,51278000,-2193000,-8056000,,,,20376000,1323555000,1272277000,915056000,-4002000,,26900000,25830000,57353,SGU
2019-12-31,56461000,,-61322000,,-61368000,36425000,3806000,-89080000,-89080000,,-3381000,,,,46000,5095000,94175000,1289000,27758000,,-61368000,-63426000,57354,KDMN
2018-12-31,48966000,,-54776000,,-54252000,37644000,714000,-85896000,-85896000,,-4619000,,,,-524000,1396000,87292000,682000,31120000,,-54252000,-56263000,57354,KDMN
2017-12-31,40777000,,-79895000,,-79774000,37057000,9278000,-68556000,-68556000,,-5962000,,,,-121000,12264000,80820000,2986000,-11339000,,-79774000,-81692000,57354,KDMN
2016-12-31,35840000,,-208413000,,-208755000,100180000,22185000,-113835000,-113835000,,-72634000,,,,342000,26055000,139890000,3870000,-94578000,,-208755000,-230488000,57354,KDMN
2020-12-31,187000000,,285000000,8000000,254000000,1143000000,1830000000,500000000,500000000,,-77000000,,,,31000000,4876000000,4376000000,3046000000,-215000000,,254000000,254000000,57362,XYL
2019-12-31,191000000,,416000000,10000000,401000000,1165000000,2051000000,695000000,695000000,,-67000000,,,,15000000,5249000000,4554000000,3198000000,-279000000,,401000000,401000000,57362,XYL
2018-12-31,189000000,,585000000,14000000,549000000,1150000000,2031000000,692000000,692000000,,-82000000,,,,36000000,5207000000,4515000000,3176000000,-107000000,,549000000,549000000,57362,XYL
2017-12-31,181000000,,466000000,16000000,331000000,1086000000,1847000000,580000000,580000000,,-82000000,,,,136000000,4707000000,4127000000,2860000000,-114000000,,330000000,331000000,57362,XYL
2019-12-31,,,-280600000,870100000,-80100000,801300000,2977800000,591700000,591700000,712900000,-499200000,,,,-98200000,3867000000,3275300000,889200000,-872300000,,-182400000,-80100000,57363,LILAK
2018-12-31,,,-584700000,1010800000,-345200000,758400000,2815900000,556500000,556500000,670600000,-443700000,,,,51100000,3705700000,3149200000,889800000,-1141200000,,-635800000,-345200000,57363,LILAK
2017-12-31,,,-651200000,1361000000,-778100000,696200000,2713800000,549800000,549800000,673600000,-381800000,,,,147500000,3590000000,3040200000,876200000,-1201000000,,-798700000,-778100000,57363,LILAK
2016-12-31,,,-98100000,1480800000,-432300000,517600000,2046600000,472700000,472700000,467600000,-314400000,,,,305900000,2723800000,2251100000,677200000,-570800000,,-404000000,-432300000,57363,LILAK
2019-12-31,,,12272000000,11631000000,2409000000,69680000000,108710000000,34200000000,34200000000,4589000000,-33159000000,,,,7987000000,296567000000,262367000000,187857000000,-21928000000,,4285000000,2409000000,57367,MTL
2018-12-31,,,16217000000,9846000000,12628000000,72303000000,134818000000,58231000000,58231000000,3344000000,-36660000000,,,,2681000000,312574000000,254343000000,177756000000,-42014000000,,13536000000,12628000000,57367,MTL
2017-12-31,,,15720000000,8933000000,11557000000,69595000000,138757000000,63885000000,63885000000,3755000000,-41528000000,,,,3150000000,299113000000,235228000000,160356000000,-48165000000,,12570000000,11557000000,57367,MTL
2016-12-31,,,14151000000,7686000000,7126000000,75333000000,129687000000,48419000000,48419000000,4605000000,-45664000000,,,,4893000000,276009000000,227590000000,146322000000,-34268000000,-426000000.0,9258000000,7126000000,57367,MTL
2020-12-31,,,58009000,,44792000,141113000,224397000,0,60989000,22295000,,,,,13217000,224397000,163408000,0,-2980000,,44792000,44792000,57369,HONE
2019-12-31,,,22676000,,18268000,124204000,165287000,0,23724000,17359000,,,,,4408000,165287000,141563000,0,-1048000,,18268000,18268000,57369,HONE
2018-12-31,,,14207000,,11394000,99228000,134300000,0,21491000,13581000,,,,,2813000,134300000,112809000,0,-7284000,,11394000,11394000,57369,HONE
2017-12-31,,,17052000,,10379000,93311000,125266000,0,17631000,14324000,,,,,6673000,125266000,107635000,0,-579000,,10379000,10379000,57369,HONE
2019-12-31,,,-9053000,,-10075000,4612000,3272000,-10199000,-10199000,26000,-71000,,,,1022000,26469000,36668000,23197000,1146000,,-10075000,-10075000,57372,EXN
2018-12-31,,,-5784000,,-7700000,4394000,4747000,-7820000,-7820000,133000,-57000,,,,1916000,24313000,32133000,19566000,2036000,,-7700000,-7700000,57372,EXN
2017-12-31,,,-6728000,,-5691000,4033000,3662000,-6356000,-6356000,50000,-567000,,,,-1037000,21208000,27564000,17546000,-372000,,-5691000,-5691000,57372,EXN
2016-12-31,,,-16272000,,-14071000,3300000,3088000,-4202000,-4202000,33000,-514000,,,,-2201000,16994000,21196000,13906000,-12070000,,-14071000,-14071000,57372,EXN
2020-12-31,,,-15202000000,,-9940000000,2404000000,3199000000,795000000,795000000,,-264000000,,,,559000000,20705000000,19910000000,17506000000,-15997000000,,-15761000000,-9940000000,57374,BKR
2019-12-31,,,753000000,12570000000.0,128000000,2812000000,4432000000,1620000000,1620000000,,-237000000,,,,482000000,23838000000,22218000000,19406000000,-867000000,,271000000,128000000,57374,BKR
2018-12-31,,,541000000,17548000000.0,195000000,2657000000,3986000000,1318000000,1318000000,11000000.0,-223000000,,,,258000000,22877000000,21559000000,18891000000,-777000000,,283000000,195000000,57374,BKR
2017-12-31,,,-388000000,24133000000.0,-103000000,2518000000,3123000000,590000000,590000000,15000000.0,-131000000,,,,45000000,17179000000,16589000000,14056000000,-978000000,,-433000000,-103000000,57374,BKR
2019-12-31,9514520,,-30847110,,-30742311,9832384,129380,-27314471,-27314471,,,,,,-104799,775821,28090292,646441,-3532639,,-30742311,-30742311,57376,SOLO
2018-12-31,5566036,,-10039812,,-10038145,6877839,202130,-16858405,-16858405,,,,,,-1667,777302,17635707,575172,6818593,,-10038145,-10038145,57376,SOLO
2017-12-31,4430386,,-11366372,,-11366372,3004632,45223,-9489156,-9489156,,-69562.0,,,,0,109173,9598329,63950,-1877216,,-11366372,-11366372,57376,SOLO
2016-12-31,2778295,,-8973347,,-8973347,1415290,0,-8942022,-8942022,,-25908.0,,,,0,0,8942022,0,-31325,,-8973347,-8973347,57376,SOLO
2019-12-31,5724000,,-9384000,,-9384000,2895000,0,-8619000,-8619000,,,,,,0,0,8619000,0,-765000,,-9384000,-9582000,57377,ENLV
2018-12-31,4255000,,-4242000,,-4242000,1044000,0,-5299000,-5299000,,,,,,0,0,5299000,0,1057000,,-4242000,-4901000,57377,ENLV
2017-12-31,1691000,,-2504000,,-2504000,480000,0,-2171000,-2171000,,,,,,0,0,2171000,0,-333000,,-2504000,-3221000,57377,ENLV
2016-12-31,2029000,,-2878000,,-2878000,793000,0,-2822000,-2822000,,,,,,0,0,2822000,0,-56000,,-2878000,-3442000,57377,ENLV
2020-12-31,,,824459000,2677000,827630000,57302000,1467025000,702392000,702392000,,-214151000,,,,-3247000,2302526000,1600134000,835501000,122067000,,827706000,827630000,57380,AVB
2019-12-31,,,799106000,3901000,785974000,67217000,1559289000,830494000,830494000,,-203585000,,,,13003000,2327490000,1496996000,768201000,-31388000,,786103000,783911000,57380,AVB
2018-12-31,,,974015000,3244000,974525000,61413000,1523717000,831108000,831108000,,-220974000,,,,-160000,2289150000,1458042000,765433000,142907000,,974175000,971686000,57380,AVB
2017-12-31,,,876801000,6056000,876921000,53695000,1466597000,828752000,828752000,,-199661000,,,,141000,2189262000,1360510000,722665000,48049000,,876660000,874458000,57380,AVB
2019-12-31,,,1117000000,,912000000,723000000,7690000000,1836000000,1836000000,3911000000,-1007000000,,,,213000000,10844000000,9008000000,3154000000,-719000000,8000000,904000000,908000000,57381,FE
2018-12-31,,,1512000000,,1348000000,192000000,7764000000,2358000000,2358000000,4078000000,-1097000000,,,,490000000,11063000000,8705000000,3299000000,-846000000,326000000,1022000000,981000000,57381,FE
2017-12-31,,,1426000000,,-1724000000,155000000,7197000000,2326000000,2326000000,3689000000,-988000000,,,,1715000000,10740000000,8414000000,3543000000,-900000000,-1435000000,-289000000,-1724000000,57381,FE
2016-12-31,,,1078000000,,-6177000000,108000000,6522000000,1989000000,1989000000,3492000000,-955000000,,,,527000000,10504000000,8515000000,3982000000,-911000000,-6728000000,551000000,-6177000000,57381,FE
2019-12-31,,,1650991000,,1278577000,876427000,3376327000,1904209000,1904209000,119156000,-491773000,,,,372414000,10164367000,8260158000,6788040000,-253218000,,1278577000,1277477000,57382,OKE
2018-12-31,,,1517935000,,1151703000,819882000,3170488000,1818127000,1818127000,103922000,-469620000,,,,362903000,12593196000,10775069000,9422708000,-300192000,,1155032000,1150603000,57382,OKE
2017-12-31,,,1040801000,157485000.0,387841000,737917000,2635862000,1393214000,1393214000,98396000,-485658000,,,,447282000,12173907000,10780693000,9538045000,-352413000,,593519000,387074000,57382,OKE
2016-12-31,,,957956000,3240170000.0,352039000,668335000,2424810000,1276041000,1276041000,88849000,-469651000,,,,212406000,8920934000,7644893000,6496124000,-318085000,-2051000.0,745550000,352039000,57382,OKE
2019-12-31,,,3000000,,10000000,122000000,499000000,94000000,94000000,62000000,-143000000,,,,-7000000,1870000000,1776000000,1371000000,-91000000,,10000000,10000000,57383,CVA
2018-12-31,,,123000000,,152000000,138000000,570000000,112000000,112000000,102000000,-145000000,,,,-29000000,1868000000,1756000000,1298000000,11000000,,152000000,152000000,57383,CVA
2017-12-31,,,-134000000,,57000000,134000000,503000000,65000000,65000000,89000000,-147000000,,,,-191000000,1752000000,1687000000,1249000000,-199000000,,57000000,57000000,57383,CVA
2016-12-31,,,18000000,,-4000000,119000000,541000000,124000000,124000000,91000000,-138000000,,,,22000000,1699000000,1575000000,1158000000,-106000000,,-4000000,-4000000,57383,CVA
2020-12-31,,,91946000,,66289000,494351000,796342000,0,215721000,86270000,,,,,25657000,796342000,580621000,0,-123775000,,66289000,56539000,57384,TCBI
2019-12-31,,,396310000,,312015000,512113000,982160000,0,408576000,61471000,,,,,84295000,982160000,573584000,0,-12266000,,312015000,302265000,57384,TCBI
2018-12-31,,,373351000,,293387000,443622000,905884000,0,397658000,64604000,,,,,79964000,905884000,508226000,0,-24307000,,293387000,283637000,57384,TCBI
2017-12-31,,,325708000,,197063000,377564000,791584000,0,355655000,58365000,,,,,128645000,791584000,435929000,0,-29947000,,197063000,187313000,57384,TCBI
2019-12-31,,,178252000,107141000,161553000,108654000,766674000,296648000,296648000,33305000,-137851000,,,,873000,1251284000,954636000,484610000,-118396000,,177379000,159095000,57385,SUI
2018-12-31,,,120246000,70376000,107229000,97151000,682921000,264770000,264770000,33738000,-134250000,,,,88000,1121410000,856640000,438489000,-144524000,,120158000,104662000,57385,SUI
2017-12-31,,,81683000,75908000,72183000,96430000,599035000,217314000,217314000,23755000,-131585000,,,,-136000,978875000,761561000,379840000,-135631000,,81819000,64566000,57385,SUI
2016-12-31,,,31754000,83333000,26315000,73406000,476466000,160544000,160544000,20746000,-122315000,,,,283000,830741000,670197000,354275000,-128790000,,31471000,17484000,57385,SUI
2020-09-27,5975000000,,5719000000,,5198000000,2074000000,14276000000,6227000000,6227000000,,-602000000,,,,521000000,23531000000,17304000000,9255000000,-508000000,,5198000000,5198000000,57386,QCOM
2019-09-29,5398000000,,7481000000,,4386000000,2195000000,15674000000,8081000000,8081000000,,-627000000,,,,3095000000,24273000000,16192000000,8599000000,-600000000,,4386000000,4386000000,57386,QCOM
2018-09-30,5625000000,,392000000,,-4964000000,2986000000,12367000000,3774000000,3774000000,-18000000.0,-768000000,,,,5356000000,22611000000,18837000000,10244000000,-3382000000,,-4964000000,-4964000000,57386,QCOM
2017-09-24,5455000000,,2987000000,,2445000000,2429000000,12466000000,4582000000,4582000000,-18000000.0,-494000000,,,,543000000,22258000000,17676000000,9792000000,-1595000000,,2444000000,2445000000,57386,QCOM
2019-12-31,13537000,,-106784000,,-106818000,123316000,50687000,-86166000,-86166000,,-4568000,,,,34000,83699000,169865000,33012000,-20618000,,-106818000,-106818000,57387,SIEN
2018-12-31,10945000,,-82631000,,-82627000,107605000,41304000,-77246000,-77246000,,-3428000,,,,-4000,68126000,145372000,26822000,-5385000,,-82627000,-82627000,57387,SIEN
2017-12-31,9813000,,-64045000,,-64028000,61213000,22371000,-48655000,-48655000,,-1232000,,,,-17000,36542000,85197000,14171000,-15390000,,-64028000,-64028000,57387,SIEN
2016-12-31,9704000,,-40105000,,-40166000,42266000,13915000,-38055000,-38055000,,-98000,,,,61000,20734000,58789000,6819000,-2050000,,-40166000,-40166000,57387,SIEN
2019-12-31,,,-1371906,186685,-1344549,4675050,3108035,-1567015,-1567015,,-103396,,,,-22428,4484822,6051837,1376787,195109,,-1349478,-1344549,57388,GRNQ
2018-12-31,,,-8308927,230123,-8549767,4286753,2132176,-2154577,-2154577,,-144356,,,,16236,4213360,6367937,2081184,-6154350,,-8325163,-8549767,57388,GRNQ
2017-12-31,,,-3048537,83283,-2284559,3350896,2428571,-922325,-922325,,-54310,,,,68372,3916372,4838697,1487801,-2126212,,-3116909,-2284559,57388,GRNQ
2016-12-31,,,-32207,319143,-50815,1924293,1956428,32135,32135,,-67398,,,,7459,3091735,3059600,1135307,-64342,,-39666,-50815,57388,GRNQ
2020-10-03,28340000,,-283706000,,-272051000,189281000,329581000,111960000,111960000,,-33970000,,,,-11655000,828586000,716626000,499005000,-395666000,,-272051000,-272051000,57390,MTSC
2019-09-28,30928000,,48613000,,43067000,218839000,328930000,79163000,79163000,,-31558000,,,,5546000,892518000,813355000,563588000,-30550000,,43067000,43067000,57390,MTSC
2018-09-29,34784000,,44223000,,61328000,205573000,305529000,65172000,65172000,,-25882000,,,,-17105000,778032000,712860000,472503000,-20949000,,61328000,61328000,57390,MTSC
2017-09-30,34999000,,23011000,,25084000,212451000,302278000,54828000,54828000,,-30821000,,,,-2073000,787955000,733127000,485677000,-31817000,,25084000,25084000,57390,MTSC
2020-12-31,35347000,,139074000,3799000,98589000,163909000,371072000,171816000,171816000,,-13584000,,,,41831000,900610000,728794000,529538000,-32742000,,97243000,98589000,57392,AIN
2019-12-31,37569000,,178212000,4006000,132398000,165206000,397701000,194926000,194926000,,-19650000,,,,44829000,1054132000,859206000,656431000,-16714000,,133383000,132398000,57392,AIN
2018-12-31,40582000,,115247000,3031000,82891000,159472000,349749000,149695000,149695000,,-20242000,,,,32228000,982479000,832784000,632730000,-34448000,,83019000,82891000,57392,AIN
2017-12-31,41174000,,54708000,3247000,33111000,165467000,299083000,92442000,92442000,,-18602000,,,,22123000,863717000,771275000,564634000,-37734000,,32585000,33111000,57392,AIN
2019-12-31,25670000,,-31863000,23963000,-31863000,6669000,324000,-32015000,-32015000,,,,,,0,523000,32538000,199000,152000,,-31863000,-31863000,57395,VCNX
2018-12-31,22353000,,-29518000,23963000,-29518000,4619000,-309000,-27281000,-27281000,,-392000.0,,,,0,724000,28005000,1033000,-2237000,,-29518000,-29518000,57395,VCNX
2017-12-31,16551000,,-18759000,11963000,-18722000,4483000,-70000,-21104000,-21104000,,-1358000.0,,,,0,90000,21194000,160000,2345000,,-18759000,-21933000,57395,VCNX
2016-12-31,16028000,,-13943000,11963000,-13943000,4432000,201000,-20259000,-20259000,,-2990000.0,,,,0,316000,20575000,115000,6316000,,-13943000,-26233000,57395,VCNX
2020-12-31,,,933000000,295000000,845000000,1374000000,2266000000,0,755000000,137000000,,,,,76000000,2266000000,1511000000,0,178000000,,857000000,822000000,57396,FHN
2019-12-31,,,585664000,295431000,440908000,961998000,1815400000,0,719593000,133809000,,,,,133291000,1815400000,1095807000,0,-133929000,,452373000,434708000,57396,FHN
2018-12-31,,,714109000,295431000,545042000,932355000,1929908000,0,859406000,138147000,,,,,157602000,1929908000,1070502000,0,-145297000,,556507000,538842000,57396,FHN
2017-12-31,,,308872000,295431000,165515000,785172000,1343394000,0,454721000,103501000,,,,,131892000,1343394000,888673000,0,-145849000,,176980000,159315000,57396,FHN
2020-12-31,,,130551000,71682000,123911000,53624000,642657000,221871000,221871000,,-91526000,,,,1972000,1065638000,843767000,422981000,-91320000,,128579000,123911000,57400,CPT
2019-12-31,,,225359000,73039000,219623000,53201000,651434000,261959000,261959000,,-80706000,,,,1089000,1048830000,786871000,397396000,-33812000,,224270000,219084000,57400,CPT
2018-12-31,,,162118000,73681000,156128000,50735000,598062000,246381000,246381000,,-84263000,,,,1424000,971673000,725292000,373611000,-76427000,,160694000,155021000,57400,CPT
2017-12-31,,,202084000,79351000,196422000,50587000,560887000,246326000,246326000,,-86750000,,,,1224000,919305000,672979000,358418000,-44242000,,200860000,195762000,57400,CPT
2020-12-31,,,41628000,,31456000,84645000,134882000,0,43752000,6485000,,,,,10172000,134882000,91130000,0,-2124000,,31456000,31456000,57401,EBTC
2019-12-31,,,44581000,,34200000,78038000,130996000,0,45457000,7248000,,,,,10381000,130996000,85539000,0,-876000,,34200000,34200000,57401,EBTC
2018-12-31,,,37697000,,28881000,72246000,118575000,0,39394000,6685000,,,,,8816000,118575000,79181000,0,-1697000,,28881000,28881000,57401,EBTC
2017-12-31,,,35621000,,19393000,68130000,111766000,0,37156000,6199000,,,,,16228000,111766000,74610000,0,-1535000,,19393000,19393000,57401,EBTC
2020-12-31,642900000,,176600000,19600000,234200000,537400000,1715800000,415200000,415200000,,-168400000,,,,-59800000,5255000000,4839800000,3539200000,-238600000,,236400000,234200000,57402,ON
2019-12-31,640900000,,276600000,22400000,211700000,599600000,1993200000,637500000,637500000,,-148300000,,,,62700000,5517900000,4880400000,3524700000,-360900000,,213900000,211700000,57402,ON
2018-12-31,650700000,,755000000,22500000,627400000,622400000,2239700000,854900000,854900000,,-128200000,,,,125100000,5878300000,5023400000,3638600000,-99900000,,629900000,627400000,57402,ON
2017-12-31,594700000,,547500000,22200000,810700000,602300000,2035600000,714800000,714800000,,-141200000,,,,-265500000,5543100000,4828300000,3507500000,-167300000,,813000000,810700000,57402,ON
2020-12-31,,,-195964000,,-196273000,126417000,-45433000,-171850000,-171850000,,-27140000,,,,309000,108085000,279935000,153518000,-24114000,,-196273000,-196273000,57405,KPTI
2019-12-31,,,-199550000,,-199590000,105421000,-83854000,-189275000,-189275000,,-15647000,,,,40000,40893000,230168000,124747000,-10275000,,-199590000,-199590000,57405,KPTI
2018-12-31,,,-178381000,,-178407000,48847000,-131036000,-179883000,-179883000,,-2493000,,,,26000,30336000,210219000,161372000,1502000,,-178407000,-178407000,57405,KPTI
2017-12-31,,,-128921000,,-128984000,24870000,-105668000,-130538000,-130538000,,-2493000,,,,63000,1605000,132143000,107273000,1617000,,-128984000,-128984000,57405,KPTI
2020-12-31,,,-20954000,,-21211000,25348000,41754000,0,4673000,11733000,,,,,257000,41754000,37081000,0,-25627000,,-21211000,-21211000,57406,RIVE
2019-12-31,,,4987000,,4286000,26102000,47055000,0,8739000,12214000,,,,,701000,47055000,38316000,0,-3752000,,4286000,4286000,57406,RIVE
2018-12-31,,,13229000,,10858000,26864000,52154000,0,14144000,11146000,,,,,2371000,52154000,38010000,0,-1135000,,10858000,10858000,57406,RIVE
2017-12-31,,,-1410000,,-4911000,17144000,27150000,0,1079000,8927000,,,,,3501000,27150000,26071000,0,-2489000,,-4911000,-4807000,57406,RIVE
2020-12-31,,,-15680000,322000,-15680000,23951000,181209000,37228000,37228000,,-37865000,,,,0,294118000,256890000,112909000,-52908000,,-15680000,-15680000,57407,WRE
2019-12-31,,,29132000,336000,383550000,24370000,193600000,31279000,31279000,1698000.0,-53734000,,,,0,309180000,277901000,115580000,-2147000,354418000.0,29132000,381588000,57407,WRE
2018-12-31,,,1153000,351000,25630000,22089000,186138000,52223000,52223000,1698000.0,-50501000,,,,0,291730000,239507000,105592000,-51070000,24477000.0,1153000,25104000,57407,WRE
2017-12-31,,,-3652000,365000,19668000,22580000,174881000,50871000,50871000,1698000.0,-46793000,,,,-84000,280281000,229410000,105400000,-54523000,23180000.0,-3568000,19306000,57407,WRE
2019-12-31,,,66500000,,55400000,98600000,183400000,83200000,83200000,1600000,-11800000,,,,11100000,938500000,855300000,755100000,-16700000,,55400000,55100000,57408,NP
2018-12-31,,,41100000,,36400000,95900000,183400000,85100000,85100000,2400000,-13000000,,,,3900000,1034900000,949800000,851500000,-44000000,-800000.0,37200000,36200000,57408,NP
2017-12-31,,,91700000,,80300000,95300000,200200000,103600000,103600000,1300000,-12700000,,,,11400000,979900000,876300000,779700000,-11900000,-800000.0,80300000,79700000,57408,NP
2016-12-31,,,103000000,,73000000,90000000,217300000,119300000,119300000,8000000,-11200000,,,,29600000,941500000,822200000,724200000,-16300000,-400000.0,73400000,72300000,57408,NP
2020-09-30,57000000,,-30000000,123000000,-238000000,232000000,506000000,217000000,217000000,,-53000000,,,,191000000,2614000000,2397000000,2108000000,-247000000,,-221000000,-238000000,57409,CBT
2019-09-30,60000000,,256000000,136000000,157000000,270000000,694000000,364000000,364000000,,-59000000,,,,70000000,3337000000,2973000000,2643000000,-108000000,,186000000,155000000,57409,CBT
2018-09-30,66000000,,119000000,125000000,-113000000,295000000,741000000,380000000,380000000,,-54000000,,,,193000000,3242000000,2862000000,2501000000,-261000000,,-74000000,-114000000,57409,CBT
2017-09-30,57000000,,306000000,121000000,248000000,258000000,659000000,344000000,344000000,,-53000000,,,,33000000,2717000000,2373000000,2058000000,-38000000,,273000000,246000000,57409,CBT
2019-12-31,17845000,,-12528000,,-12408000,25881000,26289000,-17437000,-17437000,,-64000,,,,-120000,49036000,66473000,22747000,4909000,,-12408000,-12408000,57413,MRIN
2018-12-31,22335000,,-40658000,,-41244000,35553000,31653000,-26235000,-26235000,,-147000,,,,586000,58631000,84866000,26978000,-14423000,,-41244000,-41244000,57413,MRIN
2017-12-31,26564000,,-30484000,,-31491000,43380000,42471000,-27473000,-27473000,,-200000,,,,1007000,74991000,102464000,32520000,-3011000,,-31491000,-31491000,57413,MRIN
2016-12-31,27797000,,-15076000,,-16480000,52411000,64859000,-15349000,-15349000,,-129000,,,,1404000,99878000,115227000,35019000,144000,,-16480000,-16480000,57413,MRIN
2019-12-31,,,2718000000,8332000000,1142000000,1130000000,29458000000,5373000000,5373000000,12373000000,-1903000000,,,,1054000000,49312000000,43939000000,19854000000,-2655000000,,1664000000,860000000,57414,TEF
2018-12-31,,,5571000000,9033000000,3331000000,2100000000,29163000000,5832000000,5832000000,12182000000,-1715000000,,,,1621000000,49508000000,43676000000,20345000000,-261000000,,3950000000,2929000000,57414,TEF
2017-12-31,,,4597000000,9698000000,3132000000,2280000000,30987000000,6656000000,6656000000,12655000000,-2137000000,,,,1219000000,52871000000,46215000000,21884000000,-2059000000,,3378000000,2856000000,57414,TEF
2016-12-31,,,3245000000,10228000000,2369000000,2332000000,30899000000,6733000000,6733000000,12185000000,-2463000000,,,,846000000,52903000000,46170000000,22004000000,-3488000000,,2399000000,2113000000,57414,TEF
2019-12-31,197665000,,-158213000,,-162965000,64569000,-115081000,-179650000,-179650000,,-124000,,,,4752000,82584000,262234000,197665000,21437000,,-162965000,-162965000,57416,ARGX
2018-12-31,83609000,,-65847000,,-66641000,27471000,-54378000,-81849000,-81849000,,-124000,,,,794000,29231000,111080000,83609000,16002000,,-66641000,-66641000,57416,ARGX
2017-12-31,83609000,,-27479000,,-28076000,12448000,-10484000,-22932000,-22932000,,-124000,,,,597000,41256000,64188000,51740000,-4547000,,-28076000,-28076000,57416,ARGX
2016-12-31,83609000,,-21374000,,-21374000,7011000,-14405000,-21416000,-21416000,,-124000,,,,0,17152000,38568000,31557000,42000,,-21374000,-21374000,57416,ARGX
2020-12-31,,,827171000,1718066000,770959000,133341000,1371205000,539760000,539760000,,-171609000,,,,0,1901429000,1361669000,530224000,287411000,,827171000,760791000,57417,ARE
2019-12-31,,,404047000,1300652000,363165000,108823000,1095940000,442505000,442505000,,-173675000,,,,0,1541432000,1098927000,445492000,-38458000,,404047000,350995000,57417,ARE
2018-12-31,,,402793000,552749000,379312000,90405000,953881000,385815000,385815000,,-157495000,,,,0,1335001000,949186000,381120000,16978000,,402793000,363983000,57417,ARE
2017-12-31,,,194204000,533503000,169093000,75009000,803808000,312016000,312016000,,-128645000,,,,0,1129417000,817401000,325609000,-117812000,,194204000,145395000,57417,ARE
2020-01-31,,,-53523000,,-54305000,60164000,33818000,-26346000,-26346000,,-5378000,,,,782000,90065000,116411000,56247000,-27177000,,-54305000,-54305000,57418,NAKD
2019-01-31,,,-50494000,,-49220000,66833000,37440000,-29393000,-29393000,,-4041000,,,,-1274000,111920000,141313000,74480000,-21101000,,-49220000,-49220000,57418,NAKD
2018-01-31,,,-37533000,,-37593000,70635000,43929000,-26706000,-26706000,,-8791000,,,,60000,131388000,158094000,87459000,-10827000,,-37593000,-37593000,57418,NAKD
2017-01-31,,,-25909719,,-27392576,72865726,67097154,-5768572,-5768572,,-10693716,,,,1482857,165058313,170826886,97961159,-20141146,,-27392576,-27392576,57418,NAKD
2019-12-31,2163658,,-11000329,-15,-10786837,9508001,6064711,-11252438,-11252438,,-123278,,,,-213347,20095058,31347496,14030347,252109,,-10786982,-10786837,57419,PBTS
2018-12-31,1992228,,1596816,-15,1546290,4460646,7833606,1012607,1012607,,-19385,,,,43190,23152267,22139660,15318661,584209,,1553626,1546290,57419,PBTS
2017-12-31,1151985,,4413077,-6928,3984866,3049938,8088725,3859602,3859602,,-13111,,,,434882,21628554,17768952,13539829,553475,,3978195,3984866,57419,PBTS
2016-12-31,947506,,3990364,-6928,3453977,2840611,7528232,3740115,3740115,,-18201,,,,536387,21174801,17434686,13646569,250249,,3453977,3453977,57419,PBTS
2020-12-26,13556000000,,25078000000,,20899000000,6180000000,43612000000,23876000000,23876000000,,-629000000,,,,4179000000,77867000000,53991000000,34255000000,1202000000,,20899000000,20899000000,57420,INTC
2019-12-28,13362000000,,24058000000,,21048000000,6350000000,42140000000,22428000000,22428000000,393000000.0,-489000000,,,,3010000000,71965000000,49537000000,29825000000,1630000000,,21048000000,21048000000,57420,INTC
2018-12-29,13543000000,,23317000000,,21053000000,6950000000,43737000000,23244000000,23244000000,-72000000.0,-468000000,,,,2264000000,70848000000,47604000000,27111000000,73000000,,21053000000,21053000000,57420,INTC
2017-12-30,13035000000,,20352000000,,9601000000,7452000000,39098000000,18434000000,18434000000,-72000000.0,-646000000,,,,10751000000,62761000000,44327000000,23663000000,1918000000,,9601000000,9601000000,57420,INTC
2019-12-31,,,3245000,490152000,719000,27611000,150708000,9004000,9004000,44197000,-7808000,,,,1665000,191262000,182258000,40554000,-5759000,,1580000,719000,57421,ESTE
2018-12-31,,,97683000,491852000,42325000,27346000,136774000,117427000,117427000,-60778000,-2898000,,,,2470000,165356000,47929000,28582000,-19744000,,95213000,42325000,57421,ESTE
2017-12-31,,,-61106000,446558000,-12514000,27067000,82360000,-62234000,-62234000,8420000,-3225000,,,,-16373000,102018000,164252000,19658000,1128000,,-44733000,-12514000,57421,ESTE
2016-12-31,,,-54013000,446558000,-54541000,9414000,19945000,-32652000,-32652000,7189000,-1282000,,,,528000,40071000,72723000,20126000,-21361000,,-54541000,-54541000,57421,ESTE
2019-12-31,,,13943935,,10893519,110984045,134026037,21330623,21330623,,-7386688,,,,3050416,283060930,261730307,149034893,-7386688,,10893519,10893519,57424,SNFCA
2018-12-31,,,26180390,,21686079,110591917,145596015,33137097,33137097,,-6956707,,,,4494311,279618727,246481630,134022712,-6956707,,21686079,21686079,57424,SNFCA
2017-12-31,,,7532112,,14112934,114225863,130016000,13569444,13569444,,-6037332,,,,-6580822,276926090,263356646,146910090,-6037332,,14112934,14112934,57424,SNFCA
2016-12-31,,,19703231,,12188627,113311303,140309126,24815099,24815099,,-5111868,,,,7514604,304334901,279519802,164025775,-5111868,,12188627,12188627,57424,SNFCA
2020-02-29,,,91637321,,91637321,7368528,50344550,42976022,42976022,,-11570310,,,,0,50344550,7368528,0,48661299,,91637321,91637321,57425,VGM
2019-02-28,,,19233126,,19233126,7278305,52443931,44974588,44974588,191038.0,-11102615,,,,0,52443931,7469343,0,-25741462,,19233126,19233126,57425,VGM
2018-02-28,,,27016300,,27016300,7583914,57631593,49739065,49739065,308614.0,-8757938,,,,0,57631593,7892528,0,-22722765,,27016300,27016300,57425,VGM
2017-02-28,,,3741975,,3741975,7742498,59003721,50948596,50948596,312627.0,-7626477,,,,0,59003721,8055125,0,-47206621,,3741975,3741975,57425,VGM
2019-12-31,,,-32853000,,-32417000,328412000,327744000,-668000,-668000,,-29713000,,,,-436000,1163314000,1163982000,835570000,-32185000,,-32417000,-32417000,57428,TISI
2018-12-31,,,-94209000,,-63146000,359197000,328256000,-30941000,-30941000,,-30875000,,,,-31063000,1246929000,1277870000,918673000,-63268000,,-63146000,-63146000,57428,TISI
2017-12-31,,,-137533000,,-84455000,347790000,309999000,-37791000,-37791000,,-21487000,,,,-53078000,1200211000,1238002000,890212000,-99742000,,-84455000,-84455000,57428,TISI
2016-12-31,,,-15658000,,-12676000,317200000,328552000,11352000,11352000,,-12667000,,,,-3093000,1196696000,1185344000,868144000,-27010000,-111000.0,-12565000,-12676000,57428,TISI
2020-10-02,280600000,,358300000,9300000,269200000,675000000,1377200000,421600000,421600000,,-14000000,,,,88900000,3168200000,2746600000,1791000000,-63300000,,269400000,269200000,57431,VAR
2019-09-27,247600000,,420800000,9300000,291900000,624600000,1370300000,498100000,498100000,,-8800000,,,,128600000,3225100000,2727000000,1854800000,-77300000,,292200000,291900000,57431,VAR
2018-09-28,233900000,,452100000,4300000,149900000,545200000,1273600000,494500000,494500000,,-6800000,,,,301800000,2919100000,2424600000,1645500000,-42400000,,150300000,149900000,57431,VAR
2017-09-29,210000000,,303100000,4300000,218500000,556200000,1113900000,347700000,347700000,,-10700000,,,,77100000,2619300000,2271600000,1505400000,-44600000,-6800000.0,226000000,218500000,57431,VAR
2020-03-31,,,24069000,,17884000,156159000,181123000,23968000,23968000,,-7171000,,,,6185000,282851000,258883000,101728000,101000,,17884000,17884000,57432,ELF
2019-03-31,,,-4340000,,-3079000,137415000,163024000,25355000,25355000,,-7907000,,,,-1261000,267656000,242301000,104632000,-29695000,,-3079000,-3079000,57432,ELF
2018-12-31,,,17956000,,15525000,136579000,162741000,26162000,26162000,,-7853000,,,,2431000,267435000,241273000,104694000,-8206000,,15525000,15525000,57432,ELF
2017-12-31,,,22469000,,33475000,131446000,164725000,33279000,33279000,,-8775000,,,,-11006000,269888000,236609000,105163000,-10810000,,33475000,33475000,57432,ELF
2020-12-31,,,108116000,,81145000,166348000,291177000,0,108108000,16721000,,,,,26971000,291177000,183069000,0,8000,,81145000,81145000,57433,WSBF
2019-12-31,,,47574000,,35903000,124803000,183847000,0,47428000,11616000,,,,,11671000,183847000,136419000,0,146000,,35903000,35903000,57433,WSBF
2018-12-31,,,40280000,,30754000,119492000,173436000,0,40281000,13663000,,,,,9526000,173436000,133155000,0,-1000,,30754000,30754000,57433,WSBF
2017-12-31,,,44433000,,25964000,117250000,176312000,0,44812000,14250000,,,,,18469000,176312000,131500000,0,-379000,,25964000,25964000,57433,WSBF
2020-12-31,9093000,,-9248000,,-7614000,10830000,10499000,-9424000,-9424000,,,,,,-1634000,11309000,20733000,810000,176000,,-7614000,-7614000,57434,AWRE
2019-12-31,7928000,,-3129000,,-8340000,7193000,10943000,-4129000,-4129000,-49000.0,,,,,5211000,12204000,16333000,1261000,1000000,,-8340000,-8340000,57434,AWRE
2018-12-31,7105000,,1225000,,1233000,7474000,14891000,381000,381000,-69000.0,,,,,-8000,16131000,15750000,1240000,844000,,1233000,1233000,57434,AWRE
2017-12-31,7769000,,1544000,,1001000,7296000,14590000,1107000,1107000,-1582000.0,,,,,543000,15465000,14358000,875000,437000,,1001000,1001000,57434,AWRE
2019-12-31,,,-121692000,,-121692000,39610000,-59257000,-98867000,-98867000,,-27360000,,,,0,26868000,125735000,86125000,-22825000,,-121692000,-121692000,57435,CYTK
2018-12-31,89135000.0,,-106289000,,-106289000,31282000,-57634000,-88916000,-88916000,,-21564000,,,,0,31501000,120417000,89135000,-13182000,,-106289000,-106289000,57435,CYTK
2017-12-31,89135000.0,,-127790000,,-127790000,36468000,-76928000,-113396000,-113396000,,-16996000,,,,0,13368000,126764000,90296000,-14394000,,-127790000,-127790000,57435,CYTK
2016-12-31,89135000.0,,16453000,,16453000,27823000,42010000,14187000,14187000,,-2698000,,,,0,106407000,92220000,64397000,2266000,,16453000,16453000,57435,CYTK
2020-01-31,4992000000,,-4000000,4729000000,4616000000,20700000000,28928000000,3236000000,3236000000,,-2675000000,,,,-5533000000,92154000000,88918000000,63226000000,-3240000000,,5529000000,4616000000,57442,DELL
2019-02-01,4604000000,,-2361000000,4823000000,-2310000000,20450000000,25266000000,212000000,212000000,,-2488000000,,,,-180000000,90621000000,90409000000,65355000000,-2573000000,,-2181000000,-2310000000,57442,DELL
2018-02-02,4384000000,,-4769000000,5766000000,-2849000000,18569000000,20561000000,-2392000000,-2392000000,,-2406000000,,,,-1843000000,79040000000,81432000000,58479000000,-2377000000,,-2926000000,-2849000000,57442,DELL
2017-02-03,2636000000,,-4494000000,5766000000,-1167000000,13403000000,13692000000,-2347000000,-2347000000,,-1751000000,,,,-1420000000,62164000000,64511000000,48472000000,-2147000000,1916000000.0,-3074000000,-1167000000,57442,DELL
2019-12-31,,,34270000,,28099000,729262000,1112016000,169676000,169676000,213078000,-16967000,,,,6171000,1784477000,1614801000,672461000,-135406000,,28099000,28099000,57443,AAN
2018-12-31,,,63568000,,50653000,702921000,1086562000,171159000,171159000,212482000,-16440000,,,,12915000,1794716000,1623557000,708154000,-107591000,,50653000,50653000,57443,AAN
2017-12-31,,,89640000,,142918000,656120000,1022600000,178447000,178447000,188033000,-18151000,,,,-53278000,1781902000,1603455000,759302000,-88807000,,142918000,142918000,57443,AAN
2016-12-31,,,218422000,,139283000,1351785000,1608233000,262894000,262894000,-6446000,-23390000,,,,79139000,3207716000,2944822000,1599483000,-44472000,,139283000,139283000,57443,AAN
2020-06-30,,,-1524000000,807000000,-1269000000,3065000000,4081000000,372000000,372000000,,-25000000,,,,21000000,9008000000,8636000000,4927000000,-1896000000,,-1545000000,-1269000000,57445,NWS
2019-06-30,,,354000000,1167000000,155000000,3177000000,4435000000,599000000,599000000,,-59000000,,,,126000000,10074000000,9475000000,5639000000,-245000000,,228000000,155000000,57445,NWS
2018-06-30,,,-1089000000,1186000000,-1514000000,3081000000,4120000000,567000000,567000000,,-7000000,,,,355000000,9024000000,8457000000,4904000000,-1656000000,,-1444000000,-1516000000,57445,NWS
2017-06-30,,,-615000000,284000000,-738000000,2710000000,3610000000,451000000,451000000,,-7000000,,,,28000000,8139000000,7688000000,4529000000,-1066000000,,-643000000,-740000000,57445,NWS
2019-12-31,,,4232000000,9000000,3539000000,9281000000,12500000000,0,3219000000,,,,,,432000000,12500000000,9281000000,0,1013000000,,3800000000,3133000000,57446,NWG
2018-12-31,,,3359000000,754000000,2159000000,9608000000,12647000000,0,3039000000,,,,,,1208000000,12647000000,9608000000,0,320000000,,2151000000,1622000000,57446,NWG
2017-12-31,,,2239000000,763000000,1473000000,10372000000,12647000000,0,2275000000,,,,,,731000000,12647000000,10372000000,0,-36000000,,1508000000,752000000,57446,NWG
2016-12-31,,,-4082000000,795000000,-5199000000,15393000000,12238000000,0,-3155000000,,,,,,1107000000,12238000000,15393000000,0,-927000000,,-5189000000,-6955000000,57446,NWG
2019-12-31,14048000,,-23763000,-160000,-23603000,9352000,-13626000,-22978000,-22978000,,,,,,0,422000,23400000,14048000,-785000,,-23763000,-23603000,57447,LIFE
2018-12-31,20385000,,-34515000,-160000,-34515000,12435000,-20385000,-32820000,-32820000,,,,,,0,0,32820000,20385000,-1695000,,-34515000,-34515000,57447,LIFE
2017-12-31,30067000,,-48207000,-160000,-48207000,17078000,-30067000,-47145000,-47145000,,,,,,0,0,47145000,30067000,-1062000,,-48207000,-48207000,57447,LIFE
2016-12-31,42846000,,-57904000,-160000,-57855000,15094000,0,-57940000,-57940000,,,,,,-49000,0,57940000,0,36000,,-57855000,-57855000,57447,LIFE
2019-12-31,4647000,,139156000,132240000,88095000,70880000,269323000,193796000,193796000,,-80384000,,,,45613000,746044000,552248000,476721000,-54640000,,93543000,88095000,57449,ORA
2018-12-31,4183000,,144844000,133862000,97966000,72901000,270435000,193225000,193225000,,-70924000,,,,34733000,719267000,526042000,448832000,-48381000,,110111000,97966000,57449,ORA
2017-12-31,3157000,,168773000,90738000,132414000,58429000,268452000,205070000,205070000,,-54142000,,,,21664000,692812000,487742000,424360000,-36297000,,147109000,132414000,57449,ORA
2016-12-31,2762000,,133353000,96354000,88708000,52134000,270795000,212882000,212882000,,-67389000,,,,37059000,662591000,449709000,391796000,-79529000,,96294000,88708000,57449,ORA
2019-12-31,,,375657000,,286235000,372044000,1075911000,593238000,593238000,,-205470000,,,,89422000,2299497000,1706259000,1223586000,-217581000,,286235000,286235000,57452,TGNA
2018-12-31,,,508707000,,405665000,357125000,1142280000,698368000,698368000,,-192065000,,,,107367000,2207282000,1508914000,1065002000,-189661000,4325000.0,401340000,405665000,57452,TGNA
2017-12-31,,,310716000,,273744000,349020000,969308000,543650000,543650000,,-210284000,,,,-137246000,1903026000,1359376000,933718000,-232934000,-174218000.0,447962000,273744000,57452,TGNA
2016-12-31,,,449291000,327852000.0,436697000,397352000,1220034000,744050000,744050000,,-231995000,,,,140171000,2004088000,1260038000,784054000,-294759000,127577000.0,309120000,436697000,57452,TGNA
2020-12-31,,,14630000,,11815000,50394000,72931000,0,16074000,6463000,,,,,2815000,72931000,56857000,0,-1444000,,11815000,11815000,57453,CBAN
2019-12-31,,,12609000,,10211000,31068000,61503000,0,15942000,14493000,,,,,2398000,61503000,45561000,0,-3333000,,10211000,10211000,57453,CBAN
2018-12-31,,,14917000,,11917000,24303000,50217000,0,15189000,10725000,,,,,3000000,50217000,35028000,0,-272000,,11917000,11917000,57453,CBAN
2017-12-31,,,14528431,,7750978,26993912,48388259,0,15278773,6115574,,,,,6777453,48388259,33109486,0,-750342,,7750978,7540378,57453,CBAN
2020-12-31,,,732192000,,528359000,600312000,1346246000,0,745934000,,,,,,203833000,1346246000,600312000,0,-13742000,,528359000,528359000,57455,SBNY
2019-12-31,,,787636000,,588926000,516837000,1316905000,0,800068000,,,,,,198710000,1316905000,516837000,0,-12432000,,588926000,587013000,57455,SBNY
2018-12-31,,,673463000,,505342000,461022000,1159741000,0,698719000,,,,,,168121000,1159741000,461022000,0,-25256000,,505342000,504428000,57455,SBNY
2017-12-31,,,575264000,,387209000,408070000,1010330000,0,602260000,,,,,,188055000,1010330000,408070000,0,-26996000,,387209000,387209000,57455,SBNY
2019-12-31,9502742000,,51256503000,221351000,39875981000,33225903000,95178989000,48803059000,48803059000,2140869000,-277454000,,,,11526299000,360967098000,312164039000,265788109000,2453444000,,39730204000,39875981000,57457,GRVY
2018-12-31,8018311000,,34439498000,-605961000,31442803000,32538854000,76726869000,33889497000,33889497000,1466506000,-12174000,,,,3053167000,286770425000,252880928000,210043556000,550001000,,31386331000,31442803000,57457,GRVY
2017-12-31,5239000000,,14458000000,-562000000,13319000000,28012000000,47389000000,14300000000,14300000000,-162000000,-13000000,,,,1144000000,141623000000,127323000000,94234000000,158000000,,13314000000,13319000000,57457,GRVY
2016-12-31,1973000000,,3827000000,-556615000,657000000,15977000000,21809000000,3837000000,3837000000,22000000,-13000000,,,,3240000000,51396000000,47559000000,29587000000,-10000000,,587000000,657000000,57457,GRVY
2020-02-29,,,102091470,,102091470,7356949,50075366,42718417,42718417,,-11134976,,,,0,50075366,7356949,0,59373053,,102091470,102091470,57463,IIM
2019-02-28,,,28667323,,28667323,7172713,50649756,43374980,43374980,102063.0,-10968749,,,,0,50649756,7274776,0,-14707657,,28667323,28667323,57463,IIM
2018-02-28,,,29046779,,29046779,7256485,51698662,44442177,44442177,102063.0,-8365823,,,,0,51698662,7256485,0,-15395398,,29046779,29046779,57463,IIM
2017-02-28,,,-397806,,-397806,7026164,50032585,43006421,43006421,102063.0,-5910963,,,,0,50032585,7026164,0,-43404227,,-397806,-397806,57463,IIM
2019-12-31,,,81757000,,70015000,18888000,120667000,101779000,101779000,,-20022000,,,,11742000,604472000,502693000,483805000,-20022000,,70015000,70015000,57464,GBLI
2018-12-31,,,-75925000,,-56696000,29766000,-26465000,-56231000,-56231000,,-19694000,,,,-19229000,498938000,555169000,525403000,-19694000,,-56696000,-56696000,57464,GBLI
2017-12-31,,,-10050000,,-9551000,25714000,32570000,6856000,6856000,,-16906000,,,,-499000,485515000,478659000,452945000,-16906000,,-9551000,-9551000,57464,GBLI
2016-12-31,,,47618000,,49868000,17338000,67004000,49666000,49666000,,-8905000,,,,-2250000,527657000,477991000,460653000,-2048000,,49868000,49868000,57464,GBLI
2019-12-31,,,18699000,,13279000,11460000,30380000,18808000,18808000,112000,-735000,,,,5420000,123072000,104264000,92692000,-3762000,,13279000,12987000,57465,SGA
2018-12-31,,,19390000,,13690000,11359000,31102000,19682000,19682000,61000,-946000,,,,5700000,124829000,105147000,93727000,-292000,,13690000,13434000,57465,SGA
2017-12-31,,,16326000,,54717000,11657000,30390000,18678000,18678000,55000,-903000,,,,-5920000,118149000,99471000,87759000,-2352000,32471000.0,22246000,53806000,57465,SGA
2016-12-31,,,21783000,,18186000,10980000,32156000,21112000,21112000,64000,-744000,,,,8873000,118955000,97843000,86799000,671000,5276000.0,12910000,17861000,57465,SGA
2019-12-31,5389357,,-7001300,,-7096696,4405684,-2203357,-6609041,-6609041,,-325,,,,95396,2686000,9295041,4889357,-392259,,-7096696,-7096696,57466,EYEG
2018-12-31,5389357,,-10725378,,-10811423,4441458,-6403243,-10844701,-10844701,,-1040,,,,86045,1652520,12497221,8055763,119323,,-10811423,-10811423,57466,EYEG
2017-12-31,5389357,,-14559890,,-13217917,4545354,-9922831,-14468185,-14468185,,-1215,,,,-1341973,407518,14875703,10330349,-91705,,-13217917,-13217917,57466,EYEG
2016-12-31,5389357,,-13343437,,-13343437,5593563,-7753283,-13346846,-13346846,,-275,,,,0,669259,14016105,8422542,3409,,-13343437,-13343437,57466,EYEG
2020-12-31,,,516225000,130000,369777000,1809337000,2924205000,1114868000,1114868000,,-406466000,,,,146151000,5998545000,4883677000,3074340000,-598643000,,370074000,369777000,57467,EQIX
2019-12-31,,,692597000,-224000,507450000,1586064000,2672992000,1086928000,1086928000,,-479684000,,,,185352000,5483176000,4396248000,2810184000,-394331000,,507245000,507450000,57467,EQIX
2018-12-31,,,433038000,-224000,365359000,1460396000,2496782000,1036386000,1036386000,,-521494000,,,,67679000,5102257000,4065871000,2605475000,-603348000,,365359000,365359000,57467,EQIX
2017-12-31,,,286832000,-224000,232982000,1327630000,2154434000,826804000,826804000,,-478698000,,,,53850000,4347583000,3520779000,2193149000,-539972000,,232982000,232982000,57467,EQIX
2019-12-31,30931000,,-16906000,,48148000,204734000,355173000,76672000,76672000,,-20287000,,,,-65054000,717945000,641273000,362772000,-93578000,,48148000,48148000,57468,BCOR
2018-12-31,19332000,,51880000,24945000.0,50634000,171485000,296836000,67965000,67965000,,-16606000,,,,311000,560456000,492491000,263620000,-16085000,,51569000,44657000,57468,BCOR
2017-12-31,19614000,,3486000,18033000.0,27039000,155466000,263680000,51138000,51138000,,-24247000,,,,-25890000,509557000,458419000,245877000,-47652000,,29376000,27039000,57468,BCOR
2016-12-31,17780000,,-2664000,15696000.0,-65158000,136365000,233547000,41378000,41378000,,-38954000,,,,-1285000,455911000,414533000,222364000,-44042000,-63121000.0,-1379000,-65158000,57468,BCOR
2019-12-31,,,704834000,,472142000,991588000,1803833000,812245000,812245000,,-105043000,,,,232692000,3084662000,2272417000,1280829000,-107411000,,472142000,472142000,57469,BWMX
2018-12-31,,,449446000,,299267000,806500000,1358247000,551747000,551747000,,-94707000,,,,150179000,2316716000,1764969000,958469000,-102301000,,299267000,299267000,57469,BWMX
2017-12-31,,,304625000,,207674000,560738000,891600000,330862000,330862000,,-118205000,,,,96951000,1449705000,1118843000,558105000,-26237000,,207674000,207674000,57469,BWMX
2019-12-31,,,-41246000,,-41246000,7981000,-34224000,-42205000,-42205000,,-46000,,,,0,2934000,45139000,37158000,959000,,-41246000,-41246000,57470,KYMR
2018-12-31,,,-21467000,,-21467000,3772000,-17679000,-21451000,-21451000,,-16000,,,,0,0,21451000,17679000,-16000,,-21467000,-21467000,57470,KYMR
2020-12-31,,,33297000,,27402000,57375000,99819000,0,35467000,6977000,,,,,5895000,99819000,64352000,0,-2170000,,27402000,27402000,57472,GNTY
2019-12-31,,,32057000,,26279000,47396000,94582000,0,32057000,14466000,,,,,5778000,94582000,62525000,0,-1551000,,26279000,26279000,57472,GNTY
2018-12-31,,,25195000,,20596000,41930000,81969000,0,26370000,13077000,,,,,4599000,81969000,55599000,0,-3028000,,20596000,20596000,57472,GNTY
2017-12-31,,,22677000,,14439000,35671000,71059000,0,22677000,12038000,,,,,8238000,71059000,48382000,0,0,,14439000,14439000,57472,GNTY
2020-08-31,,,41851622,,42104984,3707580,6418423,2710843,2710843,,-309105,,,,-253362,6418423,3707580,0,39140779,,42104984,42104984,57474,EMF
2019-08-31,,,-998259,,-1165770,4002242,7843076,3840834,3840834,,-307493,,,,167511,7843076,4002242,0,-4839093,,-1165770,-1165770,57474,EMF
2018-08-31,,,-5714156,,-5831010,4364812,6859158,2494346,2494346,,-307493,,,,116854,6859158,4364812,0,-8208502,,-5831010,-5831010,57474,EMF
2017-08-31,,,79965918,,80188937,3738001,6560154,2822153,2822153,,-307493,,,,-223019,6560154,3738001,0,77143765,,80188937,80188937,57474,EMF
2019-12-31,303561000,,-728433000,38210000,-699199000,1672677000,1080975000,-871188000,-871188000,-24075000,-34052000,,,,949000,2280987000,3152175000,1200012000,142755000,,-729382000,-699199000,57475,TOUR
2018-12-31,315222000,,-199218000,63489000,-187934000,1265498000,1175127000,-354236000,-354236000,-51357000,-7918000,,,,153000,2240149000,2594385000,1065022000,155018000,,-199371000,-187934000,57475,TOUR
2017-12-31,541126000,,-755691000,98917000,-773029000,1531943000,1117027000,-928721000,-928721000,-27321000,-7918000,,,,15625000,2141233000,3069954000,1024206000,173030000,,-771316000,-773029000,57475,TOUR
2016-12-31,601402000,,-2424043000,90870000,-2407300000,2559187000,639205000,-2500286000,-2500286000,-21098000,-7918000,,,,-1711000,10530941000,13031227000,9891736000,76243000,,-2422332000,-2407300000,57475,TOUR
2019-12-31,,,4300000,28000000,38300000,311800000,406900000,95000000,95000000,100000,-19600000,,,,-3500000,1205700000,1110700000,798800000,-90700000,30500000,7800000,38300000,57478,NPO
2018-12-31,,,15100000,28000000,19600000,323600000,421600000,98000000,98000000,100000,-28500000,,,,19800000,1274100000,1176100000,852500000,-82900000,24300000,-4700000,19600000,57478,NPO
2017-12-31,,,546000000,28000000,539800000,298800000,385400000,86600000,86600000,100000,-50900000,,,,28100000,1101400000,1014800000,716000000,459400000,21900000,517900000,539800000,57478,NPO
2016-12-31,,,-68700000,28000000,-40100000,304900000,395800000,90900000,90900000,100000,-55900000,,,,-28600000,1187700000,1096800000,791900000,-159600000,21900000,-40100000,-40100000,57478,NPO
2019-12-29,,,112800000,,112400000,877200000,968400000,90800000,90800000,,-4200000,,,,400000,5355600000,5264800000,4387200000,22000000,,112400000,111300000,57482,KELYA
2018-12-30,,,-4200000,,22900000,884800000,972200000,87400000,87400000,,-3100000,,,,-27100000,5513900000,5426500000,4541700000,-91600000,,22900000,22700000,57482,KELYA
2017-12-31,,,84400000,,71600000,870800000,954100000,83300000,83300000,,-2700000,,,,12800000,5374400000,5291100000,4420300000,1100000,,71600000,70500000,57482,KELYA
2017-01-01,,,150800000,,120800000,839700000,906300000,66600000,66600000,,-3800000,,,,30000000,5276800000,5210200000,4370500000,84200000,,120800000,118200000,57482,KELYA
2019-12-31,13715968,,-27048808,,-27048808,10566813,0,-24282781,-24282781,,-1825148,,,,0,0,24282781,0,-2766027,,-27048808,-27048808,57483,NMTR
2018-12-31,7559077,,-24162279,,-24162279,10664991,0,-18224068,-18224068,,-6152043,,,,0,0,18224068,0,-6092211,,-24162279,-24162279,57483,NMTR
2017-12-31,4007911,,-11605817,,-11605817,7161612,0,-11169523,-11169523,,-436294,,,,0,0,11169523,0,-436294,,-11605817,-11605817,57483,NMTR
2016-12-31,1945806,,-5620046,,-5620046,3470429,0,-5416235,-5416235,,-203905,,,,0,0,5416235,0,-203811,,-5620046,-5620046,57483,NMTR
2019-12-31,,,28869558,347700945,0,,28869557,0,28869557,,,,,,0,33659914,4790357,4790357,1,,,,57486,NREF
2018-12-31,,,19390647,239851851,19390647,3800000.0,23190647,0,19390647,,,,,,0,34265451,14874804,11074804,0,,19390647.0,19390647.0,57486,NREF
2019-12-31,,,22807987000,,12134139000,10214759000,16755371000,3660366000,3660366000,2880246000,-6745059000,,,,10673848000,89943794000,86283428000,73188423000,19147621000,,12134139000,12134139000,57489,EDN
2018-12-31,,,9495085000,,6608214000,10984333000,20244241000,6318367000,6318367000,2941541000,-7639617000,,,,2886871000,86039928000,79721561000,65795687000,3176718000,,6608214000,6608214000,57489,EDN
2017-12-31,,,8596806000,,7812493000,8680425000,14662773000,3706334000,3706334000,2276014000,-3947849000,,,,784313000,60897330000,57190996000,46234557000,4890472000,,7812493000,7812493000,57489,EDN
2016-12-31,,,388041000,,240771000,5447129000,573268000,-2544694000,-2544694000,-2329167000,-2582619000,,,,147270000,25826759000,28371453000,25253491000,2932735000,,240771000,240771000,57489,EDN
2019-12-31,,,-18764000,,-15174000,50193000,45839000,-4055000,-4055000,-299000,-6748000,,,,-3590000,149141000,153196000,103302000,-14709000,,-15174000,-15174000,57491,LOV
2018-12-31,,,-3069000,,-3880000,32975000,33948000,1213000,1213000,-240000,-426000,,,,811000,103438000,102225000,69490000,-4282000,,-3880000,-3880000,57491,LOV
2017-12-31,,,-7766000,,-7046000,25215000,25470000,309000,309000,-54000,-516000,,,,-720000,83529000,83220000,58059000,-8075000,,-7046000,-7046000,57491,LOV
2016-12-31,,,2405000,,691000,18938000,22289000,3477000,3477000,-126000,-129000,,,,1082000,73491000,70014000,51202000,-1072000,-632000.0,1323000,691000,57491,LOV
2019-12-31,7856000,,11707000,,17944000,56914000,78713000,13943000,13943000,,-929000,,,,-6237000,234663000,220720000,155950000,-2236000,,17944000,17944000,57492,HEAR
2018-12-31,5611000,,40927000,,39190000,49047000,108699000,54041000,54041000,,-5335000,,,,1737000,287437000,233396000,178738000,-13114000,,39190000,39190000,57492,HEAR
2017-12-31,5587000,,-2655000,,-3248000,40085000,51003000,5331000,5331000,,-7916000,,,,593000,149135000,143804000,98132000,-7986000,,-3248000,-3248000,57492,HEAR
2016-12-31,8259000,,-87569000,,-87182000,48152000,42610000,-13801000,-13801000,,-7447000,,,,-387000,173978000,187779000,131368000,-73768000,,-87182000,-87182000,57492,HEAR
2019-12-31,,,98302000,19807000,67529000,301475000,359122000,39681000,39681000,,-44113000,,,,36089000,3108400000,3068719000,2749278000,58621000,,62213000,67529000,57493,CPS
2018-12-31,,,69655000,26669000,103601000,311040000,548305000,222421000,222421000,,-41004000,,,,-29400000,3624042000,3401621000,3075737000,-152766000,,99055000,103601000,57493,CPS
2017-12-31,,,212747000,28520000,137971000,343209000,675709000,318444000,318444000,,-42112000,,,,71506000,3617773000,3299329000,2942064000,-105697000,,141241000,137971000,57493,CPS
2016-12-31,,,194760000,24431000,138988000,359716000,664776000,291339000,291339000,155000.0,-41389000,,,,54321000,3472891000,3181552000,2808115000,-96579000,,140439000,138988000,57493,CPS
2019-12-31,,,-25659000,,-25659000,33201000,14687000,-18514000,-18514000,,-4547000,,,,0,35095000,53609000,20408000,-7145000,,-25659000,-25659000,57494,OTRKP
2018-12-31,,,-14212000,,-14212000,17684000,4058000,-13626000,-13626000,,-570000,,,,0,15177000,28803000,11119000,-586000,,-14212000,-14212000,57494,OTRKP
2017-12-31,,,-13599000,,-13605000,11811000,1326000,-10731000,-10731000,,-3409000,,,,6000,7717000,18448000,6391000,-2868000,,-13605000,-13605000,57494,OTRKP
2016-12-31,,,-17927000,,-17936000,8838000,2405000,-6574000,-6574000,,-5354000,,,,9000,7075000,13649000,4670000,-11353000,,-17936000,-17936000,57494,OTRKP
2019-12-31,,,-363485000,-45832000,-292068000,103557000,-87684000,-195182000,-195182000,,-36139000,,,,-473000,31432000,226614000,119116000,-168303000,,-363012000,-292068000,57495,SRNE
2018-12-31,76963000.0,,-218800000,-1972000,-203540000,63638000,-62830000,-129477000,-129477000,,-57631000,,,,-6274000,21193000,150670000,84023000,-89323000,,-212526000,-203540000,57495,SRNE
2017-12-31,76963000.0,,-24929000,7042000,9132000,38332000,92379000,51274000,51274000,,-4980000,,,,-36038000,151856000,100582000,59477000,-76203000,,11109000,9132000,57495,SRNE
2016-12-31,76963000.0,,-64833000,6465000,-60923000,24219000,-34834000,-59898000,-59898000,,-1610000,,,,-896000,8152000,68050000,42986000,-4935000,,-63937000,-60923000,57495,SRNE
2019-12-31,3741174000,,-6967603000,,-6967603000,28600145000,23803108000,-8538211000,-8538211000,,-145858000,,,,0,30141886000,38680097000,6338778000,1570608000,,-6967603000,-6967603000,57497,PDD
2018-12-31,1116057000,,-10217125000,,-10217125000,13944708000,10214741000,-4846024000,-4846024000,,-145858000,,,,0,13119990000,17966014000,2905249000,-5371101000,,-10217125000,-10297621000,57497,PDD
2017-12-31,129181000,,-525115000,,-525115000,1477789000,1021246000,-585724000,-585724000,,-145858000,,,,0,1744076000,2329800000,722830000,60609000,,-525115000,-498702000,57497,PDD
2016-12-31,29421000,,-291977000,,-291977000,183783000,-73006000,-286210000,-286210000,,-145858000,,,,0,504864000,791074000,577870000,-5767000,,-291977000,-322407000,57497,PDD
2020-09-30,,,-69716000,,-67674000,74870000,75152000,282000,282000,,-10528000,,,,-2042000,389149000,388867000,313997000,-69998000,,-67674000,-67674000,57498,ALJJ
2019-09-30,,,-5973000,,-15979000,65774000,71120000,5346000,5346000,,-10611000,,,,10006000,354997000,349651000,283877000,-11319000,,-15979000,-15979000,57498,ALJJ
2018-09-30,,,-3033000,,-7332000,71332000,83904000,12572000,12572000,,-10558000,,,,4299000,369776000,357204000,285872000,-15605000,,-7332000,-7332000,57498,ALJJ
2017-09-30,,,3249000,,15673000,63311000,76014000,12703000,12703000,,-9744000,,,,-12424000,326718000,314015000,250704000,-9454000,,15673000,15673000,57498,ALJJ
2019-12-31,,,-3763075,,-3763075,2837623,0,-3980845,-3980845,-437149,-299223,,,,0,0,3980845,0,217770,,-3763075,-3763075,57499,AAU
2018-12-31,,,-3511667,,-3511667,3185471,0,-4522488,-4522488,-437149,-299223,,,,0,0,4522488,0,1010821,,-3511667,-3511667,57499,AAU
2017-12-31,,,-5231295,,-5231295,2780405,0,-5501749,-5501749,-437149,-299223,,,,0,0,5501749,0,270454,,-5231295,-5231295,57499,AAU
2016-12-31,,,-4023504,,-4023504,2430814,0,-4328330,-4328330,-437149,-299223,,,,0,0,4328330,0,304826,,-4023504,-4023504,57499,AAU
2019-12-31,,,-326409000,,-286821000,236144000,453100000,166181000,166181000,,-76566000,,,,-39588000,1131157000,964976000,678057000,-492590000,,-286821000,-286821000,57502,TVTY
2018-12-31,,,124948000,,98803000,46194000,187966000,137105000,137105000,,-8733000,,,,27046000,606299000,469194000,418333000,-12157000,901000.0,97902000,98803000,57502,TVTY
2017-12-31,,,104783000,,63715000,39705000,166681000,123619000,123619000,,-15613000,,,,43553000,556942000,433323000,390261000,-18836000,2485000.0,61230000,63715000,57502,TVTY
2016-12-31,,,78064000,,-129111000,39478000,143878000,100315000,100315000,,-17318000,,,,21973000,500998000,400683000,357120000,-22251000,-184706000.0,56091000,-129111000,57502,TVTY
2019-12-31,,,-23000000,10000000,-5000000,233000000,303000000,73000000,73000000,-3000000,-19000000,,,,-13000000,2310000000,2237000000,2007000000,-96000000,,-10000000,-5000000,57503,LPX
2018-12-31,,,521000000,10000000,395000000,213000000,744000000,535000000,535000000,-4000000,-16000000,,,,122000000,2828000000,2293000000,2084000000,-14000000,-4000000.0,399000000,395000000,57503,LPX
2017-12-31,,,510000000,10000000,390000000,201000000,736000000,530000000,530000000,5000000,-19000000,,,,119000000,2734000000,2204000000,1998000000,-20000000,-1000000.0,391000000,390000000,57503,LPX
2016-12-31,,,170100000,10000000,149800000,188100000,404300000,195600000,195600000,17400000,-32100000,,,,19800000,2233400000,2037800000,1829100000,-25500000,-500000.0,150300000,149800000,57503,LPX
2019-12-31,162900000,,-2135800000,69900000,-2415200000,1228100000,2458400000,1094000000,1094000000,-26600000,-567800000,,,,276300000,13409100000,12315100000,10950700000,-3229800000,,-2412100000,-2415200000,57504,FTI
2018-12-31,189200000,,-1488100000,69800000,-1921600000,1140600000,2279900000,950100000,950100000,-26600000,-482300000,,,,422700000,12552900000,11602800000,10273000000,-2438200000,,-1910800000,-1921600000,57504,FTI
2017-12-31,212900000,,679700000,21500000,113300000,1060900000,2532300000,1258500000,1258500000,-26600000,-456000000,,,,545500000,15056900000,13798400000,12524600000,-578800000,,134200000,113300000,57504,FTI
2016-12-31,105400000,,551400000,-11700000,393300000,572600000,1569600000,891600000,891600000,-26600000,-114100000,,,,180300000,9199600000,8308000000,7630000000,-340200000,,371100000,393300000,57504,FTI
2019-12-31,32333000,,-215460000,17931000,-219404000,887889000,692543000,-227679000,-227679000,,-2453000,,,,9608000,1447899000,1675578000,755356000,12219000,,-225068000,-219404000,57505,METX
2018-12-31,26178000,,67899000,23741000,57254000,718374000,796238000,51686000,51686000,,-8000,,,,14454000,1424234000,1372548000,627996000,16213000,,53445000,47440000,57505,METX
2017-12-31,21217000,,59881000,1480000,40560000,610574000,681754000,49963000,49963000,,-9000,,,,19539000,1149721000,1099758000,467967000,9918000,,40342000,21560000,57505,METX
2016-12-31,18187000,,-19278000,698000,-24285000,467074000,456735000,-28526000,-28526000,,-769000,,,,7869000,801545000,830071000,344810000,9248000,,-27147000,-34862000,57505,METX
2019-12-31,,,107800000,,82700000,214100000,325100000,111000000,111000000,,-22500000,,,,25100000,2203100000,2092100000,1878000000,-3200000,,82700000,82700000,57506,MATX
2018-12-31,,,147700000,,109000000,216900000,347800000,130900000,130900000,,-18700000,,,,38700000,2222800000,2091900000,1875000000,16800000,,109000000,109000000,57506,MATX
2017-12-31,,,125200000,,231000000,204300000,325900000,121600000,121600000,,-24200000,,,,-105800000,2046900000,1925300000,1721000000,3600000,,231000000,231000000,57506,MATX
2016-12-31,,,130500000,,81400000,182100000,324000000,141900000,141900000,,-24100000,,,,49100000,1941600000,1799700000,1617600000,-11400000,,81400000,81400000,57506,MATX
2019-12-31,,,-16255000,99000,-16706000,25816000,134600000,32611000,32611000,,-49629000,,,,352000,301385000,268774000,166785000,-48866000,,-16607000,-16706000,57507,NVGS
2018-12-31,,,-5406000,99000,-5739000,24073000,141693000,41480000,41480000,,-50062000,,,,333000,310046000,268566000,168353000,-46886000,,-5739000,-5739000,57507,NVGS
2017-12-31,,,5707000,99000,5310000,21315000,142085000,47182000,47182000,,-38477000,,,,397000,298595000,251413000,156510000,-41475000,,5310000,5310000,57507,NVGS
2016-12-31,,,45815000,99000,44638000,20316000,161057000,78461000,78461000,,-32423000,,,,1177000,294112000,215651000,133055000,-32646000,,44638000,44638000,57507,NVGS
2020-12-31,,,1693500000,314000000,1395800000,4646500000,6340000000,1693500000,1693500000,,,,,,265000000,14741700000,13048200000,8401700000,0,,1428500000,1395800000,57508,PFG
2019-12-31,,,1693300000,332700000,1394200000,4503900000,6197200000,1693300000,1693300000,,,,,,249200000,16222100000,14528800000,10024900000,0,,1444100000,1394200000,57508,PFG
2018-12-31,,,1784400000,457200000,1546500000,4136700000,5921100000,1784400000,1784400000,,,,,,230700000,14237200000,12452800000,8316100000,0,,1553700000,1546500000,57508,PFG
2017-12-31,,,2252200000,173900000,2310400000,3893800000,6146000000,2252200000,2252200000,,,,,,-72300000,14093200000,11841000000,7947200000,0,,2324500000,2310400000,57508,PFG
2020-06-30,,,-17742626,-6542361,-16452894,3780307,2857093,-17410472,-17410472,,,,,,186021,6535956,23946428,3678863,-332154,,-17928647,-16452894,57510,SINO
2019-06-30,,,-6091244,-5173622,-6533844,5063189,5764537,-5545378,-5545378,,,,,,920869,41771047,47316425,36006510,-545866,,-7012113,-6533844,57510,SINO
2018-06-30,,,1472766,-4812828,459051,3270623,7478870,818149,818149,,,,,,949659,23064563,22246414,15585693,654617,,523107,459051,57510,SINO
2017-06-30,,,3131460,-4768779,3624892,3363840,6465022,3101182,3101182,,,,,,-472084,11445613,8344431,4980591,30278,,3603544,3624892,57510,SINO
2019-12-31,,,-102700000,,-105900000,377800000,785900000,159300000,159300000,,-226100000,,,,3200000,1727800000,1568500000,941900000,-262000000,,-105900000,-105900000,57511,GTT
2018-12-31,,,-248900000,,-243400000,342700000,671400000,117300000,117300000,,-169300000,,,,-5500000,1490800000,1373500000,819400000,-366200000,,-243400000,-243400000,57511,GTT
2017-12-31,,,-54200000,,-71500000,196300000,395800000,66900000,66900000,,-71200000,,,,17300000,827900000,761000000,432100000,-121100000,,-71500000,-71500000,57511,GTT
2016-12-31,,,9200000,,5300000,138400000,247700000,46500000,46500000,,-29400000,,,,3900000,527300000,480800000,279600000,-37300000,,5300000,5300000,57511,GTT
2019-12-28,,,75307000,,60268000,99665000,212282000,94552000,94552000,,-15259000,,,,15039000,554665000,460113000,342383000,-19245000,,60268000,60268000,57512,HLIO
2018-12-29,,,56395000,,46730000,88417000,197124000,85445000,85445000,,-13346000,,,,9665000,508045000,422600000,310921000,-29050000,,46730000,46730000,57512,HLIO
2017-12-30,,,47544000,,31558000,65580000,136525000,62522000,62522000,,-4082000,,,,15986000,342839000,280317000,206314000,-14978000,,31558000,31558000,57512,HLIO
2016-12-31,,,34901000,,23304000,33808000,71349000,35996000,35996000,,-483000,,,,11597000,196934000,160938000,125585000,-1095000,,23304000,23304000,57512,HLIO
2019-12-31,,,-568871000,,-567057000,251736000,244852000,-6884000,-6884000,,-31618000,,,,-1814000,956533000,963417000,711681000,-561987000,,-567057000,-567057000,57514,FET
2018-12-31,,,-389754000,,-374080000,286980000,256372000,-30608000,-30608000,,-32532000,,,,-15674000,1064219000,1094827000,807847000,-359146000,,-374080000,-374080000,57514,FET
2017-12-31,,,-55279000,,-59400000,253713000,188788000,-64925000,-64925000,,-26808000,,,,4121000,818620000,883545000,629832000,9646000,,-59400000,-59400000,57514,FET
2016-12-31,,,-137999000,559000.0,-81978000,227008000,99735000,-127273000,-127273000,,-30388000,,,,-56051000,587635000,714908000,487900000,-10726000,,-81948000,-81978000,57514,FET
2020-12-31,1101561000,,-926185000,,-944839000,1074632000,1324121000,-852072000,-852072000,,-97228000,,,,18654000,2506626000,3358698000,1182505000,-74113000,,-944839000,-944839000,57516,SNAP
2019-12-31,883509000,,-1033267000,,-1033660000,939515000,819696000,-1003328000,-1003328000,,-24994000,,,,393000,1715534000,2718862000,895838000,-29939000,,-1033660000,-1033660000,57516,SNAP
2018-12-31,772185000,,-1253364000,,-1255911000,846703000,381581000,-1237307000,-1237307000,,-3894000,,,,2547000,1180446000,2417753000,798865000,-16057000,,-1255911000,-1255911000,57516,SNAP
2017-12-31,1534863000,,-3463408000,,-3445066000,2058200000,147354000,-3445709000,-3445709000,,-3456000,,,,-18342000,824949000,4270658000,677595000,-17699000,,-3445066000,-3445066000,57516,SNAP
2020-11-30,476721,,-2959956,,-2103486,5832513,2399600,-3909634,-3909634,,-304611,,,,-856470,22409123,26318757,20009523,949678,,-2103486,-2103486,57517,ARTW
2019-11-30,479345,,-1768820,,-1419586,4945449,3927913,-1496881,-1496881,,-358174,,,,-349234,22889173,24386054,18961260,-271939,,-1419586,-1419586,57517,ARTW
2018-11-30,640430,,-3846465,,-3386902,5375128,3511556,-2504002,-2504002,,-304566,,,,-510416,19726793,22230795,16215237,-1342463,-50853.0,-3336049,-3386902,57517,ARTW
2017-11-30,501182,,-1793157,,-1637081,5232961,4082101,-1652042,-1652042,,-319622,,,,-423798,20715080,22367122,16632979,-141115,-267722.0,-1369359,-1637081,57517,ARTW
2019-12-31,,,-383006000,,-420212000,84304000,403312000,273571000,273571000,106000,-103842000,,,,37206000,1489929000,1216358000,1086617000,-656577000,,-420212000,-420212000,57518,ETM
2018-12-31,,,-366740000,,-361435000,69492000,363289000,250427000,250427000,-918000,-104686000,,,,-4153000,1462567000,1212140000,1099278000,-617167000,1152000.0,-362587000,-361435000,57518,ETM
2017-12-31,,,-24072000,,233849000,47859000,149372000,85837000,85837000,130000,-33599000,,,,-257085000,592884000,507047000,443512000,-109909000,836000.0,233013000,231834000,57518,ETM
2016-12-31,,,52859000,,38065000,33328000,141501000,97963000,97963000,417000,-36696000,,,,14794000,464771000,366808000,323270000,-45104000,836000.0,38065000,36164000,57518,ETM
2020-12-31,,,310043000,,239874000,357082000,684778000,327696000,327696000,,-9684000,,,,70169000,3046145000,2718449000,2361367000,-17653000,,239874000,239874000,57520,MHO
2019-12-31,,,166025000,,127587000,302338000,491417000,189079000,189079000,,-17724000,,,,38438000,2500290000,2311211000,2008873000,-23054000,,127587000,127587000,57520,MHO
2018-12-31,,,141289000,,107663000,280608000,451456000,170848000,170848000,,-17215000,,,,33626000,2286282000,2115434000,1834826000,-29559000,,107663000,107663000,57520,MHO
2017-12-31,,,120324000,,72081000,254609000,398192000,143583000,143583000,,-16117000,,,,48243000,1961971000,1818388000,1563779000,-23259000,,72081000,66168000,57520,MHO
2019-12-31,11083000,,-15380000,-2878000,-15303000,4580000,0,-15663000,-15663000,,,,,,0,0,15663000,0,283000,,-15380000,-16076000,57522,SYN
2018-12-31,11844000,,-13421000,-2909000,-13367000,5727000,0,-17571000,-17571000,,,,,,0,0,17571000,0,4150000,,-13421000,-25291000,57522,SYN
2017-12-31,18585000,,-15492000,-1914000,-15174000,7666000,0,-26251000,-26251000,,,,,,0,0,26251000,0,10759000,,-15492000,-22136000,57522,SYN
2016-12-31,29109000,,-27803000,-1596000,-27255000,10143000,0,-39252000,-39252000,,,,,,0,0,39252000,0,11449000,,-27803000,-27255000,57522,SYN
2020-03-31,10648920,,-20096804,,-19942504,8883119,1390104,-18141935,-18141935,,-30543,,,,-154300,1390104,19532039,0,-1954869,,-19942504,-20464982,57524,XAIR
2019-03-31,3929558,,-6558450,,-6558450,6852988,7724001,-3058545,-3058545,,-1506,,,,0,7724001,10782546,0,-3499905,,-6558450,-6558450,57524,XAIR
2018-03-31,4632983,,-10714895,,-10714895,5309504,0,-9942487,-9942487,,-1506,,,,0,0,9942487,0,-772408,,-10714895,-10714895,57524,XAIR
2017-12-31,4438264,,-18044346,,-18044346,6629344,0,-11067608,-11067608,,-1060511,,,,0,0,11067608,0,-6976738,,-18044346,-18044346,57524,XAIR
2019-12-31,,,26161589,,26161589,1801502,3282308,1480806,1480806,,-291860,,,,0,3282308,1801502,0,24680783,,26161589,24886229,57525,GCV
2018-12-31,,,-3549673,,-3549673,1340567,2494013,1153446,1153446,,-116,,,,0,2494013,1340567,0,-4703119,,-3549673,-4997995,57525,GCV
2017-12-31,,,12100835,,12100835,1533057,2748576,1215519,1215519,,-689,,,,0,2748576,1533057,0,10885316,,12100835,10652513,57525,GCV
2016-12-31,,,7215968,,7215968,1216893,2933982,1717089,1717089,,-762,,,,0,2933982,1216893,0,5498879,,7215968,5763622,57525,GCV
2019-12-31,1005000,,-10160351,,-10160351,7805202,3287215,-8563907,-8563907,,-935314,,,,0,13019792,21583699,9732577,-1596444,,-10160351,-10160351,57526,SYTA
2018-12-31,1005000,,-11527981,,-11527981,8378308,2059498,-8125872,-8125872,,-833930,,,,0,14220542,22346414,12161044,-3402109,,-11527981,-11527981,57526,SYTA
2017-12-31,1005000,,-5092495,,-5058495,6194423,3878745,-3688415,-3688415,,-164099,,,,-34000,17753006,21441421,13874261,-1404080,,-5058495,-5058495,57526,SYTA
2016-12-31,1005000,,-2162708,,-2162708,3528920,2937557,-1446960,-1446960,,-192660,,,,0,12326414,13773374,9388857,-715748,,-2162708,-2162708,57526,SYTA
2020-12-31,,,158328000,2800000,122923000,372901000,586466000,213565000,213565000,,-31555000,,,,34545000,2501898000,2288333000,1915432000,-55237000,,123783000,122923000,57527,VSH
2019-12-31,,,226298000,2540000,163936000,390271000,671200000,272453000,272453000,,-33683000,,,,61508000,2668305000,2395852000,1997105000,-46155000,,164790000,163936000,57527,VSH
2018-12-31,,,416776000,2286000,345758000,406931000,888524000,469786000,469786000,,-36680000,,,,70239000,3034689000,2564903000,2146165000,-53010000,,346537000,345758000,57527,VSH
2017-12-31,,,279364000,2032000,-20344000,366250000,703109000,322596000,322596000,,-27850000,,,,298924000,2599368000,2276772000,1896259000,-43232000,,-19560000,-20344000,57527,VSH
2019-12-31,,,-2746021,,-2746021,2716796,0,-2732925,-2732925,,-27515,,,,0,0,2732925,0,-13096,,-2746021,-2746021,57528,APPH
2018-12-31,,,-1015344,,-1019353,983673,0,-986980,-986980,,-27515,,,,4009,0,986980,0,-28364,,-1019353,-1019353,57528,APPH
2019-12-31,,,772000000,2740000000,493000000,233000000,1174000000,936000000,936000000,5000000,-237000000,,,,126000000,4590000000,3654000000,3416000000,-164000000,,646000000,493000000,57531,CF
2018-12-31,,,547000000,2773000000,290000000,211000000,917000000,724000000,724000000,-18000000,-241000000,,,,119000000,4429000000,3705000000,3512000000,-177000000,,428000000,290000000,57531,CF
2017-12-31,,,-125000000,3105000000,358000000,195000000,434000000,226000000,226000000,13000000,-315000000,,,,-575000000,4130000000,3904000000,3696000000,-351000000,,450000000,358000000,57531,CF
2016-12-31,,,-226000000,3144000000,-277000000,177000000,843000000,561000000,561000000,105000000,-200000000,,,,-68000000,3685000000,3124000000,2842000000,-787000000,,-158000000,-277000000,57531,CF
2019-12-31,8122610,,-9966268,,-9355592,3480912,1062501,-10541021,-10541021,,,,,,-610676,4629916,15170937,3567415,574753,,-9355592,-9355592,57533,SNGX
2018-12-31,6750954,,-8899975,,-8899975,2951760,643733,-9058981,-9058981,,,,,,0,5241448,14300429,4597715,159006,,-8899975,-8899975,57533,SNGX
2017-12-31,5507033,,-7563893,,-7147083,3209155,1122389,-7593799,-7593799,,,,,,-416810,5432472,13026271,4310083,29906,,-7147083,-7147083,57533,SNGX
2016-12-31,4295867,,-3775526,,-3245383,3428838,2015123,-5709582,-5709582,,-7281.0,,,,-530143,10448794,16158376,8433671,1934056,,-3245383,-3245383,57533,SNGX
2019-12-31,75114000,,-234461000,-7255000,-205709000,45283000,-72973000,-118256000,-118256000,,-14056000,,,,-237000,4904000,123160000,77877000,-116205000,27471000,-234224000,-205709000,57534,LMNL
2018-12-31,75114000,,-259465000,-6542000,-195366000,29448000,-85932000,-115380000,-115380000,,-22041000,,,,-19637000,24633000,140013000,110565000,-144085000,1932000,-239828000,-195366000,57534,LMNL
2017-12-31,75114000,,-136252000,21447000,-109731000,29563000,-74899000,-124953000,-124953000,,-7889000,,,,-14302000,22313000,147266000,97212000,-11299000,1914000,-121950000,-109731000,57534,LMNL
2016-12-31,75114000,,-117307000,26976000,-100807000,25458000,-78855000,-105150000,-105150000,,-4890000,,,,-6638000,16392000,121542000,95247000,-12157000,1914000,-110669000,-100807000,57534,LMNL
2020-12-31,,,15314000,,12601000,78354000,115282000,0,28251000,8677000,,,,,2713000,115282000,87031000,0,-12937000,,12601000,12601000,57536,CFB
2019-12-31,,,32611000,,28473000,78477000,120259000,0,35398000,6384000,,,,,4138000,120259000,84861000,0,-2787000,,28473000,28298000,57536,CFB
2018-12-31,,,17196000,,19590000,72023000,102951000,0,25115000,5813000,,,,,-2394000,102951000,77836000,0,-7919000,,19590000,17490000,57536,CFB
2017-12-31,,,4408000,,5849000,55646000,66497000,0,5983000,4868000,,,,,-1441000,66497000,60514000,0,-1575000,,5849000,3749000,57536,CFB
2020-07-31,,,38339752,,38339752,5846063,37010547,31164484,31164484,,-6323321,,,,0,37010547,5846063,0,7175268,,38339752,38339752,57539,MUC
2019-07-31,,,45016328,,45016328,5674195,38775775,33101580,33101580,,-9651003,,,,0,38775775,5674195,0,11914748,,45016328,45016328,57539,MUC
2018-07-31,,,6911656,,6911656,5815833,40688854,34873021,34873021,,-8527627,,,,0,40688854,5815833,0,-27961365,,6911656,6911656,57539,MUC
2017-07-31,,,-10002603,,-10002603,5966638,40966641,35000003,35000003,,-6596709,,,,0,40966641,5966638,0,-45002606,,-10002603,-10002603,57539,MUC
2020-04-30,,,342048000,,263846000,1496866000,2144684000,396644000,396644000,,-54279000,,,,78202000,8112296000,7715652000,5967612000,-54596000,,263846000,263846000,57540,CASY
2019-04-30,,,263402000,,203886000,1390112000,1954724000,320225000,320225000,,-56251000,,,,59516000,8364910000,8044685000,6410186000,-56823000,,203886000,203886000,57540,CASY
2018-04-30,,,214437000,,317903000,1282539000,1769393000,265884000,265884000,,-52523000,,,,-103466000,7472124000,7206240000,5702731000,-51447000,,317903000,317903000,57540,CASY
2017-04-30,,,269668000,,177485000,1171623000,1681161000,311909000,311909000,,-42124000,,,,92183000,6640587000,6328678000,4959426000,-42241000,,177485000,177485000,57540,CASY
2020-11-30,,,71387976,,71387976,7424983,79122485,71697502,71697502,,-6879991,,,,0,79122485,7424983,0,-309526,,71387976,71387976,57543,FFC
2019-11-30,,,165170557,,165170557,7492964,79675700,72182736,72182736,,-14153516,,,,0,79675700,7492964,0,92987821,,165170557,165170557,57543,FFC
2018-11-30,,,-42154731,,-42154731,7421799,77919093,70497294,70497294,,-12276079,,,,0,77919093,7421799,0,-112652025,,-42154731,-42154731,57543,FFC
2017-11-30,,,145844286,,145844286,7567867,78449084,70881217,70881217,,-8836143,,,,0,78449084,7567867,0,74963069,,145844286,145844286,57543,FFC
2019-12-31,,,13688000,,11363000,60515000,82121000,21606000,21606000,,-8892000,,,,2325000,335620000,314014000,253499000,-7918000,,11363000,11363000,57545,FFHL
2018-12-31,,,-18554000,,-22172000,65956000,54688000,-11268000,-11268000,,-9766000,,,,3618000,333522000,344790000,278834000,-7286000,,-22172000,-22172000,57545,FFHL
2017-12-31,,,-45195000,,-46003000,61034000,25760000,-35274000,-35274000,,-9453000,,,,808000,290706000,325980000,264946000,-9921000,,-46003000,-46003000,57545,FFHL
2016-12-31,,,-49166000,,-54483000,59975000,17736000,-42239000,-42239000,,-7865000,,,,5317000,253926000,296165000,236190000,-6927000,,-54483000,-54483000,57545,FFHL
2019-12-31,23086000,,23841000,,17022000,54337000,112584000,29443000,29443000,,-5134000,,,,6819000,371084000,341641000,258500000,-5602000,,17022000,17022000,57546,AMOT
2018-12-31,19913000,,20681000,,15925000,43844000,91403000,23991000,23991000,,-2701000,,,,4756000,310611000,286620000,219208000,-3310000,,15925000,15925000,57546,AMOT
2017-12-31,17542000,,16136000,,8036000,36118000,75679000,18800000,18800000,,-2474000,,,,8100000,252012000,233212000,176333000,-2664000,,8036000,8036000,57546,AMOT
2016-12-31,16170000,,12803000,,9078000,34747000,73004000,18883000,18883000,,-6449000,,,,3725000,245893000,227010000,172889000,-5257000,,9078000,9078000,57546,AMOT
2019-12-31,1571154000,,-1275764000,87203000,-2183546000,11482430000,11268044000,-1785540000,-1785540000,,-181099000,,,,904363000,46014906000,47800446000,34746862000,509776000,,-2180127000,-4050074000,57547,BEKE
2018-12-31,670922000,,-499065000,10467000,-467824000,7417059000,6869976000,-1218005000,-1218005000,,-43517000,,,,-71384000,28646499000,29864504000,21776523000,718940000,,-427681000,-2386005000,57547,BEKE
2017-12-31,251802000,,-138338000,65836000,-574430000,5280146000,4768057000,-763891000,-763891000,,-43791000,,,,399283000,25505698000,26269589000,20737641000,625553000,,-537621000,-1441879000,57547,BEKE
2019-12-29,,,171481000,,136940000,202706000,604404000,274087000,274087000,-4082000,-142304000,,,,34541000,1369549000,1095462000,765145000,-102606000,,136940000,136940000,57549,WEN
2018-12-30,,,574916000,,460115000,189889000,599022000,282718000,282718000,-2464000,-147256000,,,,114801000,1263917000,981199000,664895000,292198000,,460115000,460115000,57549,WEN
2017-12-31,,,101019000,,194029000,202893000,601133000,273632000,273632000,-1079000,-140928000,,,,-93010000,1223408000,949776000,622275000,-172613000,,194029000,194029000,57549,WEN
2017-01-01,,,201690000,,129624000,236786000,608694000,260822000,260822000,-11618000,-129432000,,,,72066000,1435418000,1174596000,826724000,-59132000,,129624000,129624000,57549,WEN
2020-06-30,863864000,,1316711000,15586000,1216785000,735977000,3356863000,1757022000,1757022000,,-160274000,,,,101686000,5806424000,4049402000,2449561000,-440311000,,1215025000,1216785000,57552,KLAC
2019-06-30,711030000,,1296231000,18585000,1175617000,600848000,2699527000,1387649000,1387649000,,-124604000,,,,121214000,4568904000,3181255000,1869377000,-91418000,,1175017000,1175617000,57552,KLAC
2018-06-30,608531000,,1455931000,18585000,802265000,444935000,2590660000,1537194000,1537194000,,-114376000,,,,653666000,4036701000,2499507000,1446041000,-81263000,,802265000,802265000,57552,KLAC
2017-06-30,526688000,,1173246000,18585000,926076000,390849000,2193799000,1276262000,1276262000,,-122476000,,,,247170000,3480014000,2203752000,1286215000,-103016000,,926076000,926076000,57552,KLAC
2020-12-31,,,23869000,,19262000,46681000,79804000,0,25442000,7681000,,,,,4607000,79804000,54362000,0,-1573000,,19262000,19262000,57553,CHMG
2019-12-31,,,19043000,,15609000,47450000,74739000,0,20304000,6985000,,,,,3434000,74739000,54435000,0,-1261000,,15609000,15609000,57553,CHMG
2018-12-31,,,23635000,,19626000,46523000,80001000,0,26922000,6556000,,,,,4009000,80001000,53079000,0,-3287000,,19626000,19626000,57553,CHMG
2017-12-31,,,14692000,,7430000,43950000,68456000,0,17748000,6758000,,,,,7262000,68456000,50708000,0,-3056000,,7430000,7430000,57553,CHMG
2020-12-31,70161000,,29349000,,32194000,307605000,415856000,38090000,38090000,,-360000,,,,-2845000,892208000,854118000,476352000,-8741000,,32194000,32194000,57555,OMCL
2019-12-31,68644000,,73933000,,61338000,289916000,436912000,78352000,78352000,,-5804000,,,,12595000,897027000,818675000,460115000,-4419000,,61338000,61338000,57555,OMCL
2018-12-31,64843000,,35616000,,37729000,263095000,372330000,44392000,44392000,,-9800000,,,,-2113000,787309000,742917000,414979000,-8776000,,37729000,37729000,57555,OMCL
2017-12-31,66022000,,4512000,,30518000,241470000,318637000,11145000,11145000,,-7900000,,,,-26006000,712714000,701569000,394077000,-10556000,,30518000,30518000,57555,OMCL
2019-12-31,,,-92000000,,-77000000,104000000,476000000,-39000000,-39000000,340000000,-27000000,,,,-15000000,476000000,515000000,0,-53000000,,-77000000,-77000000,57556,BATRA
2018-12-31,,,-4000000,-8000000.0,5000000,100000000,442000000,1000000,1000000,265000000,-26000000,,,,-15000000,442000000,441000000,0,-5000000,,11000000,5000000,57556,BATRA
2017-12-31,,,-62000000,14000000.0,-25000000,136000000,386000000,-113000000,-113000000,296000000,-15000000,,,,-36000000,386000000,499000000,0,51000000,,-26000000,-25000000,57556,BATRA
2016-12-31,,,-79000000,15000000.0,-62000000,67000000,262000000,-61000000,-61000000,224000000,-1000000,,,,-17000000,262000000,323000000,0,-18000000,,-62000000,-62000000,57556,BATRA
2019-12-31,,,130809874,,130809874,7419835,28104792,20684957,20684957,,,,,,0,28104792,7419835,0,110124917,,130809874,130809874,57557,BOE
2018-12-31,,,-91292751,,-91292751,7902593,29136735,21234142,21234142,,,,,,0,29136735,7902593,0,-112526893,,-91292751,-91292751,57557,BOE
2017-12-31,,,146488887,,146488887,9957960,21686205,11728245,11728245,,,,,,0,21686205,9957960,0,134760642,,146488887,146488887,57557,BOE
2016-12-31,,,12536495,,12536495,9782866,20476319,10693453,10693453,,,,,,0,20476319,9782866,0,1843042,,12536495,12536495,57557,BOE
2019-12-31,,,190763000,5154000,149039000,382389000,672825000,219935000,219935000,,-41277000,,,,41623000,1318641000,1098706000,645816000,-29172000,,149140000,149039000,57558,RBA
2018-12-31,,,152512000,5067000,121479000,382676000,636629000,187339000,187339000,,-44527000,,,,31006000,1170026000,982687000,533397000,-34827000,,121506000,121479000,57558,RBA
2017-12-31,,,77394000,5069000,75027000,323270000,531504000,155540000,155540000,,-38291000,,,,2088000,971191000,815651000,439687000,-78146000,,75306000,75027000,57558,RBA
2016-12-31,,,130494000,4773000,91832000,283529000,500333000,175943000,175943000,,-5564000,,,,36982000,1126977000,951034000,626644000,-45449000,,93512000,91832000,57558,RBA
2020-10-14,,,-20000,,-20000,,0,0,,,,,,,0,0,0,0,-20000,,-20000,-20000,57560,IPOE
2019-12-31,8797154,,-15585771,,-15585771,6788618,0,-15585771,-15585771,,,,,,0,0,15585771,0,0,,-15585771,-15585771,57562,RIDE
2019-12-31,24070000,,18803000,,13601000,127063000,177354000,26221000,26221000,,-7391000,,,,5202000,468186000,441965000,290832000,-7418000,,13601000,13601000,57566,AVD
2018-12-31,26428000,,33207000,,24195000,117182000,182631000,39021000,39021000,,-4198000,,,,9145000,454272000,415251000,271641000,-5814000,,24062000,24195000,57566,AVD
2017-12-31,26076000,,24804000,254000.0,20274000,94522000,147392000,26794000,26794000,,-1941000,,,,4443000,355047000,328253000,207655000,-1990000,,20361000,20274000,57566,AVD
2016-12-31,21298000,,18564000,167000.0,12788000,86450000,128288000,20540000,20540000,,-1630000,,,,5540000,312113000,291573000,183825000,-1976000,,13024000,12788000,57566,AVD
2019-12-31,33665000,,-10305000,1238000,-10296000,52212000,88081000,-2367000,-2367000,,-8618000,,,,-28000,263790000,266157000,175709000,-7938000,,-10277000,-10296000,57568,WIFI
2018-12-31,31372000,,-4884000,2211000,-1220000,52949000,85034000,-2997000,-2997000,,-2400000,,,,-5153000,250821000,253818000,165787000,-1887000,,269000,-1220000,57568,WIFI
2017-12-31,26754000,,-20854000,1212000,-19366000,56501000,66052000,-20701000,-20701000,,-187000,,,,-2078000,204369000,225070000,138317000,-153000,,-18776000,-19366000,57568,WIFI
2016-12-31,22126000,,-26556000,738000,-27331000,48448000,47979000,-26043000,-26043000,,-467000,,,,427000,159344000,185387000,111365000,-513000,,-26983000,-27331000,57568,WIFI
2020-09-30,1827286,,-6819929,1077645,-9933775,21570666,19364447,-4033505,-4033505,,-4607453,,,,2073835,43518384,47551889,24153937,-2786424,-812895,-8893764,-13105005,57571,CETXP
2019-09-30,1481879,,-12638337,885874,-22364941,21528145,15562674,-7447350,-7447350,,-4785506,,,,-1335584,39265041,46712391,23702367,-5190987,-10559963,-11302753,-24330441,57571,CETXP
2018-09-30,5558682,,-13888818,885874,-9240409,15207580,8215954,-12550308,-12550308,,-800398,,,,-2861672,22641417,35191725,14425463,-1338510,1786737,-11027146,-10155489,57571,CETXP
2017-09-30,5558682,,4505563,885874,4389915,34797874,39913552,5115678,5115678,,-923952,,,,115648,120628200,115512522,80714648,-610115,1786737,4389915,3189044,57571,CETXP
2019-12-31,78041000,,90749000,,59229000,245030000,416634000,93563000,93563000,,-2513000,,,,31520000,571850000,478287000,155216000,-2814000,,59229000,59229000,57573,STMP
2018-12-31,56591000,,190914000,,168642000,206531000,460021000,196899000,196899000,,-2595000,,,,22272000,586930000,390031000,126909000,-5985000,,168642000,168642000,57573,STMP
2017-12-31,46208000,,160248000,,150603000,179772000,389483000,163503000,163503000,,-3669000,,,,9645000,468709000,305206000,79226000,-3255000,,150603000,150603000,57573,STMP
2016-12-31,32158000,,116974000,,75229000,148955000,301333000,120220000,120220000,,-3552000,,,,41745000,364305000,244085000,62972000,-3246000,,75229000,75229000,57573,STMP
2019-12-31,,,1006000000,2193000000,1284000000,2184000000,6741000000,2444000000,2444000000,383000000,-962000000,,,,-278000000,12347000000,9903000000,5606000000,-1438000000,,1284000000,1284000000,57574,EIX
2018-12-31,,,-1210000000,2193000000,-423000000,-79000000,4454000000,2274000000,2274000000,388000000,-855000000,,,,-739000000,12657000000,10383000000,8203000000,-3484000000,34000000.0,-471000000,-423000000,57574,EIX
2017-12-31,,,825000000,2214000000,565000000,-37000000,4603000000,2231000000,2231000000,368000000,-763000000,,,,281000000,12320000000,10089000000,7717000000,-1406000000,34000000.0,544000000,565000000,57574,EIX
2016-12-31,,,1467000000,2196000000,1311000000,1900000000,6344000000,2083000000,2083000000,354000000,-704000000,,,,177000000,11869000000,9786000000,5525000000,-616000000,12000000.0,1290000000,1311000000,57574,EIX
2020-12-31,,,247961000,,117549000,726027000,1030286000,0,263173000,26031000,,,,,35535000,1052300000,789127000,22014000,-15212000,,212426000,117549000,57576,PJT
2019-12-31,,,82190000,543127000.0,29562000,555491000,678559000,0,82190000,26382000,,,,,18403000,717639000,635449000,39080000,0,,63787000,29508000,57576,PJT
2018-12-31,,,41513000,514205000.0,27170000,472215000,544335000,0,41513000,20634000,,,,,-1045000,580248000,538735000,35913000,-2645000,,42558000,26899000,57576,PJT
2017-12-31,,,10054000,579732000.0,-32554000,437679000,474895000,0,10054000,19019000,,,,,38380000,499282000,489228000,24387000,0,,-28326000,-32642000,57576,PJT
2020-09-30,,,241204504,,241204504,10904886,8933171,-1971715,-1971715,,,,,,0,8933171,10904886,0,243176219,,241204504,241204504,57578,HQH
2019-09-30,,,-145294912,,-145294912,10472893,7600976,-2871917,-2871917,,,,,,0,7600976,10472893,0,-142422995,,-145294912,-145294912,57578,HQH
2018-09-30,,,69203602,,69203602,10904605,6783802,-4120803,-4120803,,,,,,0,6783802,10904605,0,73324405,,69203602,69203602,57578,HQH
2017-09-30,,,121282551,,121282551,10783417,5619013,-5164404,-5164404,,,,,,0,5619013,10783417,0,126446955,,121282551,121282551,57578,HQH
2019-12-31,,,570000000,543000000,421000000,458000000,1260000000,693000000,693000000,,-124000000,,,,108000000,8118000000,7425000000,6858000000,-123000000,,462000000,419000000,57580,WLK
2018-12-31,,,1334000000,486000000,996000000,434000000,1987000000,1452000000,1452000000,,-126000000,,,,300000000,8635000000,7183000000,6648000000,-118000000,,1034000000,991000000,57580,WLK
2017-12-31,,,1081000000,495000000,1304000000,401000000,1761000000,1252000000,1252000000,,-159000000,,,,-258000000,8041000000,6789000000,6280000000,-171000000,,1339000000,1297000000,57580,WLK
2016-12-31,,,558000000,368000000,399000000,260000000,983000000,685000000,685000000,,-79000000,,,,138000000,5076000000,4391000000,4093000000,-127000000,,420000000,397000000,57580,WLK
2019-12-31,,,-2515694,,-2515694,1357723,208284,-1587992,-1587992,,-183972,,,,0,997992,2585984,789708,-927702,,-2515694,-2746094,57581,HUSA
2018-12-31,,,-251336,,-251336,1422560,1442391,-337991,-337991,,-183972,,,,0,2356660,2694651,914269,86655,,-251336,-490286,57581,HUSA
2017-12-31,,,-2037614,,-2037614,2128667,413963,-1876193,-1876193,,-171605,,,,0,630392,2506585,216429,-161421,,-2037614,-2177846,57581,HUSA
2016-12-31,,,-2641625,,-2641625,1830669,68707,-2064745,-2064745,,-171605,,,,0,165910,2230655,97203,-576880,,-2641625,-2641625,57581,HUSA
2019-12-31,19636000,,58172000,,48259000,98194000,172084000,50693000,50693000,,-4051000,,,,9913000,972358000,921665000,800274000,7479000,,48259000,48259000,57582,TG
2018-12-31,18707000,,36368000,,24842000,93689000,183088000,66716000,66716000,,-5702000,,,,11526000,1065471000,998755000,882383000,-30348000,,24842000,24842000,57582,TG
2017-12-31,18287000,,-14912000,,38251000,88279000,168197000,55433000,55433000,,-6170000,,,,-53163000,961330000,905897000,793133000,-70345000,,38251000,38251000,57582,TG
2016-12-31,19122000,,27683000,,24466000,82913000,144005000,37992000,37992000,,-3806000,,,,3217000,828341000,790349000,684336000,-10309000,,24466000,24466000,57582,TG
2020-12-31,860000000,,-2897000000,566000000,-2951000000,2203000000,6875000000,1693000000,1693000000,,-767000000,,,,-23000000,20397000000,18704000000,13522000000,-4590000000,-49000000,-2874000000,-2951000000,57584,DD
2019-12-31,955000000,,-474000000,569000000,498000000,2589000000,7709000000,3115000000,3115000000,,-668000000,,,,140000000,21512000000,18397000000,13803000000,-3589000000,1214000000,-614000000,497000000,57584,DD
2018-12-31,1070000000,,600000000,1608000000,3845000000,2932000000,8920000000,3874000000,3874000000,,-55000000,,,,195000000,22594000000,18720000000,13674000000,-3274000000,3595000000,405000000,3828000000,57584,DD
2017-12-31,657000000,,-1525000000,1597000000,1159000000,1580000000,3687000000,945000000,945000000,,-1057000000,,,,-1758000000,11672000000,10727000000,7985000000,-2470000000,1058000000,233000000,1146000000,57584,DD
2019-12-31,,,8978000,,2014000,21672000,141546000,51068000,51068000,,-76364000,,,,210000,345903000,294835000,204357000,-42090000,-6754000,8768000,-393000,57585,SNR
2018-12-31,,,-146678000,,-159355000,13382000,135723000,82302000,82302000,-40090000.0,-85643000,,,,4950000,323024000,240722000,187301000,-228980000,-7727000,-151628000,-159355000,57585,SNR
2017-12-31,,,19999000,,12208000,15300000,170578000,34499000,34499000,-40090000.0,-79628000,,,,2378000,324465000,289966000,153887000,-14500000,-5413000,17621000,12208000,57585,SNR
2016-12-31,,,-71810000,,-72249000,15194000,209468000,9728000,9728000,-40090000.0,-91780000,,,,439000,472438000,462710000,262970000,-81538000,-5413000,-72249000,-72249000,57585,SNR
2020-12-31,,,1797000000,,1427000000,3536000000,6515000000,0,1797000000,1182000000,,,,,370000000,6515000000,4718000000,0,0,,1427000000,1317000000,57586,FITBP
2019-12-31,,,3202000000,,2512000000,3412000000,7893000000,0,3457000000,1024000000,,,,,690000000,7893000000,4436000000,0,-255000000,,2512000000,2398000000,57586,FITBP
2018-12-31,,,2765000000,,2193000000,3031000000,6772000000,0,2841000000,900000000,,,,,572000000,6772000000,3931000000,0,-76000000,,2193000000,2095000000,57586,FITBP
2017-12-31,,,2979000000,20000000.0,2180000000,2847000000,6820000000,0,3052000000,921000000,,,,,799000000,6820000000,3768000000,0,-73000000,,2180000000,2082000000,57586,FITBP
2020-09-30,52311000,,173347000,,142828000,206219000,489684000,231154000,231154000,,-42510000,,,,30519000,1116270000,885116000,626586000,-57807000,,142828000,142828000,57587,CCMP
2019-09-30,51707000,,63106000,,39215000,178369000,467016000,236940000,236940000,,-45681000,,,,23891000,1037696000,800756000,570680000,-173834000,,39215000,39215000,57587,CCMP
2018-09-30,51950000,,161711000,,110043000,98176000,314105000,163979000,163979000,,-2905000,,,,51668000,590123000,426144000,276018000,-2268000,,110043000,109920000,57587,CCMP
2017-09-30,54798000,,109372000,,86952000,86483000,254129000,112848000,112848000,,-4529000,,,,22420000,507179000,394331000,253050000,-3476000,,86952000,86696000,57587,CCMP
2020-12-31,,,23231063,,18850063,33336885,59143467,0,24370152,1436430,,,,,4381000,59143467,34773315,0,-1139089,,18850063,18850063,57589,ATLO
2019-12-31,,,21041769,,17194169,29078142,52563438,0,21844986,1640310,,,,,3847600,52563438,30718452,0,-803217,,17194169,17194169,57589,ATLO
2018-12-31,,,21419978,,17013878,25958323,49385388,0,22255029,1172036,,,,,4406100,49385388,27130359,0,-835051,,17013878,17013878,57589,ATLO
2017-12-31,,,21281990,,13697189,23575473,46686527,0,22079351,1031703,,,,,7584801,46686527,24607176,0,-797361,,13697189,13697189,57589,ATLO
2020-03-28,,,21202000,,14487000,440362000,533465000,42741000,42741000,377000,-21541000,,,,6715000,915953000,873212000,382488000,-21539000,,14487000,14487000,57592,TCS
2019-03-30,,,21961000,,21680000,426133000,523683000,56119000,56119000,177000,-27275000,,,,281000,895093000,838974000,371410000,-34158000,,21680000,21680000,57592,TCS
2018-03-31,,,6705000,,19428000,404805000,497061000,42084000,42084000,4931000,-25013000,,,,-12723000,857228000,815144000,360167000,-35379000,,19428000,19428000,57592,TCS
2017-04-01,,,24355000,,14953000,387948000,476070000,42157000,42157000,4931000,-16687000,,,,9402000,819930000,777773000,343860000,-17802000,,14953000,14953000,57592,TCS
2019-12-31,158015000,,-132957000,,-132957000,254264000,270442000,-141837000,-141837000,,,,,,0,1180597000,1322434000,910155000,8880000,,-132957000,-1073143000,57593,LIZI
2018-12-31,83209000,,-9342000,,-9342000,161716000,232927000,-11998000,-11998000,,,,,,0,798561000,810559000,565634000,2656000,,-9342000,-225527000,57593,LIZI
2017-12-31,43189000,,-153665000,,-153665000,229440000,122707000,-149922000,-149922000,,-2008000.0,,,,0,453529000,603451000,330822000,-3743000,,-153665000,-448945000,57593,LIZI
2020-12-31,,,79269000,,63077000,108419000,252418000,0,116537000,27462000,,,,,16192000,252418000,135881000,0,-37268000,,63077000,63077000,57594,PFC
2019-12-31,,,60637000,,49370000,76519000,157934000,0,62755000,18660000,,,,,11267000,157934000,95179000,0,-2118000,,49370000,49334000,57594,PFC
2018-12-31,,,56875000,,46249000,72169000,146155000,0,57764000,16222000,,,,,10626000,146155000,88391000,0,-889000,,46249000,46233000,57594,PFC
2017-12-31,,,48452000,,32268000,67361000,133713000,0,50712000,15640000,,,,,16184000,133713000,83001000,0,-2260000,,32268000,32263000,57594,PFC
2019-12-31,,,47253000,,46749000,3953000,140266000,61715000,61715000,,-42674000,,,,504000,231420000,169705000,91154000,-14462000,,46749000,46697000,57596,RVI
2018-12-31,,,-160943000,,-165304000,8647000,179752000,78490000,78490000,,-69833000,,,,4361000,283077000,204587000,103325000,-239433000,,-165304000,8852000,57596,RVI
2017-12-31,,,-281187000,,-292453000,13814000,211835000,79282000,79282000,,-90264000,,,,11266000,314379000,235097000,102544000,-360469000,,-292453000,-292453000,57596,RVI
2016-12-31,,,-58258000,,-59208000,13759000,214882000,81100000,81100000,-1737000.0,-96806000,,,,950000,314321000,233221000,99439000,-139358000,,-59208000,-59208000,57596,RVI
2020-12-31,30201000,,-224750000,-13257000,-223226000,169289000,5041000,-190792000,-190792000,-3657000,,,,,-3654000,21815000,212607000,16774000,-33958000,,-221096000,-223226000,57597,WBAI
2019-12-31,48614000,,-661928000,-538000,-651268000,266203000,-19722000,-331242000,-331242000,-3297000,,,,,-7642000,39688000,370930000,59410000,-330686000,,-654286000,-651268000,57597,WBAI
2018-12-31,61909000,,-491339000,18345000,-451673000,343849000,46072000,-344488000,-344488000,-15198000,,,,,-19602000,126089000,470577000,80017000,-146851000,11244000.0,-471737000,-451673000,57597,WBAI
2017-12-31,58592000,,-345494000,121588000,-317099000,268850000,34375000,-319765000,-319765000,26698000,,,,,-14025000,71858000,391623000,37483000,-25729000,7636000.0,-331469000,-317099000,57597,WBAI
2020-11-30,,,178442901,,178442901,3905531,1332332,-2573199,-2573199,,,,,,0,1332332,3905531,0,181016100,,178442901,178442901,57601,ASA
2019-11-30,,,91431019,,91431019,3482419,2371123,-1111296,-1111296,,,,,,0,2371123,3482419,0,92542315,,91431019,91431019,57601,ASA
2018-11-30,,,-48788875,,-48788875,3032459,1623750,-1408709,-1408709,,,,,,0,1623750,3032459,0,-47380166,,-48788875,-48788875,57601,ASA
2017-11-30,,,1743881,,1743881,3069426,1402806,-1669147,-1669147,,,,,,0,1402806,3071953,0,3413028,,1743881,1743881,57601,ASA
2019-12-31,,,4262430,,3367179,,0,0,,,,,,,895251,0,0,0,4262430,,3367179,-544754,57604,THCB
2018-12-31,,,-4752,,-4752,,0,0,,,,,,,0,0,0,0,-4752,,-4752,-4752,57604,THCB
2019-12-31,,,-3769,,-3769,,0,0,,,,,,,0,0,0,0,-3769,,-3769,-3769,57605,CAP
2018-12-31,,,-226,,-226,,0,0,,,,,,,0,0,0,0,-226,,-226,-226,57605,CAP
2020-12-31,,,1195000000,16310000000,141000000,312000000,4042000000,2025000000,2025000000,,-1179000000,,,,291000000,8885000000,6860000000,4843000000,-830000000,,904000000,141000000,57606,BIP
2019-12-31,,,928000000,16194000000,52000000,279000000,3202000000,1709000000,1709000000,,-904000000,,,,278000000,6597000000,4888000000,3395000000,-781000000,,650000000,19000000,57606,BIP
2018-12-31,,,1170000000,9219000000,192000000,223000000,2444000000,1420000000,1420000000,,-555000000,,,,364000000,4652000000,3232000000,2208000000,-250000000,,806000000,163000000,57606,BIP
2017-12-31,,,747000000,7912000000,11000000,239000000,2026000000,1116000000,1116000000,,-428000000,,,,173000000,3535000000,2419000000,1509000000,-369000000,,574000000,-11000000,57606,BIP
2019-12-31,14720000,,-13749000,1306000,-18423000,71653000,141372000,4297000,4297000,,-21149000,,,,4383000,272013000,267716000,130641000,-18046000,,-18132000,-18435000,57607,ORBC
2018-12-31,13405000,,-21281000,1026000,-26244000,75014000,129512000,-8591000,-8591000,,-21055000,,,,4658000,276140000,284731000,146628000,-12690000,,-25939000,-26262000,57607,ORBC
2017-12-31,8941000,,-61604000,733000,-61284000,56548000,104032000,-7138000,-7138000,,-17653000,,,,-409000,254220000,261358000,150188000,-54466000,,-61195000,-61296000,57607,ORBC
2016-12-31,6252000,,-22709000,647000,-23511000,46915000,93794000,-2176000,-2176000,,-9085000,,,,517000,186744000,188920000,92950000,-20533000,,-23226000,-23525000,57607,ORBC
2020-12-31,,,277703000,,214448000,225393000,582077000,0,278414000,78270000,,,,,63255000,582077000,303663000,0,-711000,,214448000,214448000,57608,HOMB
2019-12-31,,,385621000,,289539000,210477000,661408000,0,386518000,64413000,,,,,96082000,661408000,274890000,0,-897000,,289539000,289539000,57608,HOMB
2018-12-31,,,395520000,,300403000,196405000,659523000,0,402003000,61115000,,,,,95117000,659523000,257520000,0,-6483000,,300403000,300403000,57608,HOMB
2017-12-31,,,271083000,,135083000,164625000,540373000,0,326511000,49237000,,,,,136000000,540373000,213862000,0,-55428000,,135083000,135083000,57608,HOMB
2019-12-31,,,4314113,,4079495,10596848,80703326,47524536,47524536,,-10578711,,,,234618,85945570,38421034,5242244,-43210423,,4079495,-5175973,57609,CORR
2018-12-31,,,41293150,,43711876,13042847,82020850,44030550,44030550,,-12759010,,,,-2418726,89231598,45201048,7210748,-2737400,,43711876,34163499,57609,CORR
2017-12-31,,,36681934,,32602790,10786497,82019670,47185463,47185463,,-12378514,,,,2345318,88749377,41563914,6729707,-10840462,,34336616,24648802,57609,CORR
2016-12-31,,,30526988,27441044.0,29663200,12270380,82787238,47993987,47993987,,-14417839,,,,-464420,89250586,41256599,6463348,-17466999,,30991408,25514763,57609,CORR
2019-12-31,,,223783000,,173546000,1399058000,1644071000,190759000,190759000,-6850000,-31031000,,,,50237000,2669852000,2479093000,1025781000,33024000,,173546000,173546000,57610,RCII
2018-12-31,,,13841000,,8492000,1503761000,1688168000,99037000,99037000,16424000,-42968000,,,,5349000,2660465000,2561428000,972297000,-85196000,,8492000,8492000,57610,RCII
2017-12-31,,,-110200000,,6653000,1647743000,1718542000,-10359000,-10359000,6519000,-45996000,,,,-116853000,2702540000,2712899000,983998000,-99841000,,6653000,6653000,57610,RCII
2016-12-31,,,-113274000,,-105195000,1749570000,1935049000,104924000,104924000,99000,-47181000,,,,-8079000,2963252000,2858328000,1028203000,-218198000,,-105195000,-105195000,57610,RCII
2020-02-01,,,-131589000,,-128567000,407547000,428579000,21032000,21032000,,-19571000,,,,-3022000,691345000,670313000,262766000,-152621000,,-128567000,-128567000,57614,JILL
2019-02-02,,,42174000,,30525000,399042000,460280000,61238000,61238000,,-19064000,,,,11649000,706262000,645024000,245982000,-19064000,,30525000,30525000,57614,JILL
2018-02-03,,,49926000,,55365000,392729000,464080000,71351000,71351000,,-19261000,,,,-5439000,698145000,626794000,234065000,-21425000,,55365000,55365000,57614,JILL
2017-01-28,,,40744000,,24075000,368525000,427939000,59414000,59414000,,-18670000,,,,16669000,639056000,579642000,211117000,-18670000,,24075000,24075000,57614,JILL
2020-06-30,3213000,,-16444000,-11000,-16439000,12428000,1638000,-14003000,-14003000,,-2466000,,,,0,1638000,15641000,0,-2441000,,-16444000,-38260000,57615,IBIO
2019-06-30,5474000,,-17597000,-6000,-17593000,12153000,2018000,-15609000,-15609000,,-1900000,,,,0,2018000,17627000,0,-1988000,,-17597000,-17853000,57615,IBIO
2018-06-30,3986000,,-16108000,-2000,-16105000,10685000,444000,-14227000,-14227000,,-1915000,,,,0,444000,14671000,0,-1881000,,-16108000,-16365000,57615,IBIO
2017-06-30,4117000,,-16139000,1000,-14532000,10551000,394000,-14274000,-14274000,,-1929000,,,,0,394000,14668000,0,-1865000,,-16139000,-14622000,57615,IBIO
2020-12-31,,,452341000,6486000,451294000,33216000,37420000,-15125000,-15125000,,-620000,,,,248000,66278000,81403000,28858000,467466000,,452093000,443306000,57616,EQC
2019-12-31,,,494150000,1295000,492680000,37642000,81432000,15668000,15668000,,-8908000,,,,1284000,127850000,112182000,46418000,478482000,,492866000,484692000,57616,EQC
2018-12-31,,,276064000,1197000,272813000,44039000,117106000,24026000,24026000,,-26585000,,,,3156000,197022000,172996000,79916000,252038000,,272908000,264825000,57616,EQC
2017-12-31,,,30166000,1129000,29656000,47760000,199146000,60678000,60678000,,-52183000,,,,500000,340571000,279893000,141425000,-30512000,,29666000,21668000,57616,EQC
2019-12-31,,,-13383000,-327000,-6549000,96289000,85067000,0,-12925000,500000,,,,,-6827000,100539000,113464000,15472000,-458000,,-6556000,-6549000,57617,JMP
2018-12-31,,,-56000,13499000,-2187000,116479000,122379000,0,2782000,1994000,,,,,1167000,139262000,136480000,16883000,-2838000,,-1223000,-2187000,57617,JMP
2017-12-31,,,-11627000,13844000,-15883000,106890000,104942000,0,-5520000,2410000,,,,,1744000,116493000,122013000,11551000,-6107000,,-13371000,-15883000,57617,JMP
2016-12-31,,,2814000,15917000,2926000,116557000,122924000,0,2814000,2273000,,,,,-4648000,134977000,132163000,12053000,0,,7462000,2926000,57617,JMP
2019-12-31,,,-30862000,,-30608000,14560000,-11739000,-26299000,-26299000,,,,,,-254000,13801000,40100000,25540000,-4563000,,-30608000,-30608000,57618,BCYC
2018-12-31,,,-22242000,,-21846000,8121000,-13625000,-21746000,-21746000,,,,,,-396000,7136000,28882000,20761000,-496000,,-21846000,-21846000,57618,BCYC
2017-12-31,,,-16282000,,-16259000,6407000,-9806000,-16213000,-16213000,,,,,,-23000,2060000,18273000,11866000,-69000,,-16259000,-16259000,57618,BCYC
2016-12-31,,,-13567000,,-13546000,3778000,-9797000,-13575000,-13575000,,,,,,-21000,0,13575000,9797000,8000,,-13546000,-13546000,57618,BCYC
2020-12-31,,,3446000000,5471000000,1305000000,10756000000,17067000000,0,5226000000,1085000000,,,,,1385000000,17067000000,11841000000,0,-1780000000,,2061000000,1305000000,57619,BBVA
2019-12-31,,,6398000000,6201000000,3512000000,11501000000,20757000000,0,8574000000,682000000,,,,,2053000000,20757000000,12183000000,0,-2176000000,,4345000000,3093000000,57619,BBVA
2018-12-31,,,8446000000,5764000000,5400000000,11285000000,21035000000,0,9182000000,568000000,,,,,2219000000,21035000000,11853000000,0,-736000000,,6227000000,4953000000,57619,BBVA
2017-12-31,,,6931000000,6979000000,3514000000,12043000000,20573000000,0,7565000000,965000000,,,,,2174000000,20573000000,13008000000,0,-634000000,,4757000000,3084000000,57619,BBVA
2020-12-31,,,1048820000,1252343000,978844000,128394000,1983500000,816669000,816669000,,-514388000,,,,9968000,4605967000,3789298000,2622467000,232151000,,1038852000,978844000,57622,WELL
2019-12-31,,,1333367000,1442060000,1232432000,126549000,2412574000,1258952000,1258952000,,-555559000,,,,2957000,5121306000,3862354000,2708732000,74415000,,1330410000,1232432000,57622,WELL
2018-12-31,,,838424000,1378311000,804954000,126383000,2267482000,1190640000,1190640000,,-526592000,,,,8674000,4700499000,3509859000,2433017000,-352216000,,829750000,758250000,57622,WELL
2017-12-31,,,560741000,877499000,522774000,122008000,2169750000,1126022000,1126022000,,-484622000,,,,20128000,4316641000,3190619000,2146891000,-565281000,,540613000,463595000,57622,WELL
2019-12-31,3191000,,79795000,,88181000,5639000,74139000,65309000,65309000,,-173000,,,,-8386000,205226000,139917000,131087000,14486000,,88181000,88181000,57625,FF
2018-12-31,3524000,,60177000,,53158000,6435000,73398000,63439000,63439000,,-173000,,,,7019000,291018000,227579000,217620000,-3262000,,53158000,53142000,57625,FF
2017-12-31,3659000,,16649000,,23511000,6715000,20261000,9887000,9887000,,-172000,,,,-6862000,275026000,265139000,254765000,6762000,,23511000,23484000,57625,FF
2016-12-31,2715000,,40806000,,56341000,7620000,46858000,36523000,36523000,,-173000,,,,-15535000,253193000,216670000,206335000,4283000,,56341000,56228000,57625,FF
2019-12-31,,,16846000,,18076000,68886000,154637000,35219000,35219000,,-27000000,,,,-1230000,2071425000,2036206000,1916788000,-18373000,,18076000,17543000,57626,CAPL
2018-12-31,,,2513000,,5251000,79115000,172795000,36031000,36031000,,-32872000,,,,-2733000,2347988000,2311957000,2175193000,-33518000,,5246000,3672000,57626,CAPL
2017-12-31,,,4939000,-318000.0,23158000,82084000,160766000,22512000,22512000,,-27919000,,,,-18237000,2014890000,1992378000,1854124000,-17573000,,23176000,18821000,57626,CAPL
2016-12-31,,,10262000,-233000.0,10704000,85230000,155567000,17025000,17025000,,-22757000,,,,-453000,1790269000,1773244000,1634702000,-6763000,,10715000,7312000,57626,CAPL
2020-09-30,,,35039316,,35039316,1926569,4057740,2131171,2131171,,-224,,,,0,4057740,1926569,0,32908145,,35039316,33464316,57628,ECF
2019-09-30,,,12698994,,12698994,1696615,4237846,2541231,2541231,,-260,,,,0,4237846,1696615,0,10157763,,12698994,11123994,57628,ECF
2018-09-30,,,19388454,,19388454,1606004,3841253,2235249,2235249,,-75,,,,0,3841253,1606004,0,17153205,,19388454,17813454,57628,ECF
2017-09-30,,,14296744,,14296744,1365522,3800540,2435018,2435018,,-75,,,,0,3800540,1365522,0,11861726,,14296744,14239869,57628,ECF
2020-09-30,,,15616000,-268000,10927000,54895000,75317000,20422000,20422000,,-5254000,,,,4957000,191720000,171298000,116403000,-4806000,,10659000,10926000,57631,LIVE
2019-09-30,,,-5637000,-268000,-4012000,67617000,70873000,3256000,3256000,,-6315000,,,,-1625000,193288000,190032000,122415000,-8893000,,-4012000,-4013000,57631,LIVE
2018-09-30,,,10330000,-268000,5923000,63398000,74198000,10800000,10800000,,-8643000,,,,4407000,199633000,188833000,125435000,-470000,,5923000,5922000,57631,LIVE
2017-09-30,,,10583599,-268000,6501780,44119648,62566635,18446987,18446987,,-7596985,,,,4081819,152060932,133613945,89494297,-7863388,,6501780,6499863,57631,LIVE
2020-12-31,,,964000000,,793000000,,3102000000,1152200000,1152200000,1949800000,-188200000,,,,171000000,13162100000,12009900000,10060100000,-188200000,,793000000,793000000,57632,UNM
2019-12-31,,,1382100000,,1100300000,898300000.0,3428700000,1586800000,1586800000,943600000,-177400000,,,,281800000,11998900000,10412100000,8570200000,-204700000,,1100300000,1100300000,57632,UNM
2018-12-31,,,627800000,,523400000,885900000.0,2572200000,795100000,795100000,891200000,-167300000,,,,104400000,11598500000,10803400000,9026300000,-167300000,,523400000,523400000,57632,UNM
2017-12-31,,,1404000000,,994200000,852300000.0,3271200000,1563900000,1563900000,855000000,-159900000,,,,409800000,11286800000,9722900000,8015600000,-159900000,,994200000,994200000,57632,UNM
2020-12-31,,,407100000,,308700000,339000000,867400000,528400000,528400000,,-103800000,,,,98400000,4921900000,4393500000,4054500000,-121300000,,308700000,308700000,57634,SLGN
2019-12-31,,,252136000,,193814000,296107000,713744000,417637000,417637000,,-105674000,,,,58322000,4489927000,4072290000,3776183000,-165501000,,193814000,193814000,57634,SLGN
2018-12-31,,,293301000,,223994000,271410000,689763000,418353000,418353000,,-116306000,,,,69307000,4448875000,4030522000,3759112000,-125052000,,223994000,223994000,57634,SLGN
2017-12-31,,,239681000,,269659000,244032000,634548000,390516000,390516000,,-110257000,,,,-29978000,4089854000,3699338000,3455306000,-150835000,,269659000,269659000,57634,SLGN
2019-12-31,75568000,,-101293000,12500000,-104593000,106503000,158342000,-100765000,-100765000,,-1355000,,,,2174000,308749000,409514000,150407000,-528000,,-103467000,-136727000,57635,SNCR
2018-12-31,79172000,,-263174000,12500000,-218155000,122012000,167037000,-131239000,-131239000,,-4911000,,,,-17894000,325839000,457078000,158802000,-131935000,18288000.0,-245280000,-243748000,57635,SNCR
2017-12-31,90850000,,-229087000,25280000,-109438000,141037000,220908000,-104903000,-104903000,,-55771000,,,,-34863000,402361000,507264000,181453000,-124184000,75495000.0,-194224000,-109438000,57635,SNCR
2016-12-31,114493000,,-127089000,25280000,11894000,115328000,231610000,-93122000,-93122000,,-7414000,,,,-33220000,426294000,519416000,194684000,-33967000,90560000.0,-93869000,11894000,57635,SNCR
2019-12-31,,,98250000,,76917000,2361000,321066000,206956000,206956000,11996000,-114477000,,,,21061000,1628626000,1421670000,1307560000,-108706000,-272000,77189000,76917000,57636,SJI
2018-12-31,,,18464000,,17663000,10123000,301006000,184623000,184623000,9537000,-90296000,,,,561000,1641338000,1456715000,1340332000,-166159000,-240000,17903000,17663000,57636,SJI
2017-12-31,,,-28341000,,-3490000,2579000,256947000,147163000,147163000,6487000,-54019000,,,,-24937000,1243068000,1095905000,986121000,-175504000,-86000,-3404000,-3490000,57636,SJI
2016-12-31,,,173212000,,118810000,2932000,290908000,191245000,191245000,6342000,-31449000,,,,54151000,1036500000,845255000,745592000,-15933000,-251000,119061000,118810000,57636,SJI
2020-12-31,,,63068000,,52505000,79009000,160954000,0,63372000,18573000,,,,,10563000,160954000,97582000,0,-304000,,52505000,52505000,57639,FBMS
2019-12-31,,,56446000,,43745000,69138000,145015000,0,57078000,18799000,,,,,12701000,145015000,87937000,0,-632000,,43745000,43745000,57639,FBMS
2018-12-31,,,27017000,,21225000,62375000,103328000,0,28399000,12554000,,,,,5792000,103328000,74929000,0,-15192000,,21225000,21225000,57639,FBMS
2017-12-31,,,17571000,,10616000,46739000,73017000,0,18823000,7455000,,,,,6955000,73017000,54194000,0,-1252000,,10616000,10616000,57639,FBMS
2020-12-31,,,-3140000000,,-2701000000,430000000,6794000000,-1620000000,-1620000000,1006000000,-806000000,,,,-485000000,19216000000,20836000000,12422000000,-1520000000,,-2655000000,-2701000000,57641,COP
2019-12-31,,,9524000000,69000000.0,7189000000,639000000,16182000000,7435000000,7435000000,1275000000,-778000000,,,,2267000000,33346000000,25911000000,17164000000,2089000000,,7257000000,7189000000,57641,COP
2018-12-31,,,9973000000,125000000.0,6257000000,585000000,17984000000,9680000000,9680000000,1394000000,-735000000,,,,3668000000,37491000000,27811000000,19507000000,293000000,,6305000000,6257000000,57641,COP
2017-12-31,,,-2615000000,194000000.0,-855000000,576000000,12241000000,2535000000,2535000000,1171000000,-1098000000,,,,-1822000000,29878000000,27343000000,17637000000,-5150000000,,-793000000,-855000000,57641,COP
2020-12-31,,,94673000,8897000,79309000,67752000,376426000,139759000,139759000,,-45086000,,,,56000,606824000,467065000,230398000,-45086000,,94617000,79309000,57642,COR
2019-12-31,,,99104000,55726000,75840000,66203000,359944000,140816000,140816000,,-41712000,,,,67000,572727000,431911000,212783000,-41712000,,99037000,75840000,57642,COR
2018-12-31,,,106753000,92078000,77922000,61113000,345025000,142279000,142279000,,-35526000,,,,-10000,544392000,402113000,199367000,-35526000,,106763000,77922000,57642,COR
2017-12-31,,,100665000,137624000,74855000,55724000,309787000,124812000,124812000,,-24147000,,,,174000,481821000,357009000,172034000,-24147000,,100491000,62605000,57642,COR
2019-12-31,,,-4446275,,-4450152,11562781,9131691,-2431090,-2431090,,-2104851,,,,3877,87518688,89949778,78386997,-2015185,,-4450152,-4450152,57643,CVU
2018-12-31,,,-7530705,,-7546753,9780027,4210030,-5569997,-5569997,,-1989417,,,,16048,70366016,75936013,66155986,-1960708,,-7546753,-7546753,57643,CVU
2017-12-31,,,8477634,,5767634,8449594,18645916,10196322,10196322,,-1698914,,,,2710000,81283148,71086826,62637232,-1718688,,5767634,5767634,57643,CVU
2016-12-31,,,-5674576,,-3608576,8614190,4318918,-4295272,-4295272,,-1356645,,,,-2066000,81329858,85625130,77010940,-1379304,,-3608576,-3608576,57643,CVU
2020-12-31,,,705478000,3062000,550822000,539178000,1434728000,866551000,866551000,,-94877000,,,,134650000,9601482000,8734931000,8166754000,-161073000,,570828000,550822000,57644,STLD
2019-12-31,,,875337000,-10979000,671103000,514527000,1530984000,986880000,986880000,,-127104000,,,,197437000,10464991000,9478111000,8934007000,-111543000,,677900000,671103000,57644,STLD
2018-12-31,,,1619774000,-47842000,1258379000,572625000,2322814000,1722409000,1722409000,,-126620000,,,,363969000,11821839000,10099430000,9499025000,-102635000,,1255805000,1258379000,57644,STLD
2017-12-31,,,935235000,-45266000,812741000,485940000,1582014000,1066881000,1066881000,,-134399000,,,,129439000,9538797000,8471916000,7956783000,-146246000,,805796000,812741000,57644,STLD
2019-12-31,8822226,,-11870228,,-11870228,3165331,0,-11987557,-11987557,,,,,,0,0,11987557,0,117329,,-11870228,-36675338,57647,TFFP
2018-12-31,848809,,-3842186,,-3842186,3049337,0,-3898146,-3898146,,,,,,0,0,3898146,0,55960,,-3842186,-4570536,57647,TFFP
2017-12-31,848809,,-178605,,-178605,178605,0,-178605,-178605,,,,,,0,0,178605,0,0,,-178605,-178605,57647,TFFP
2016-12-31,229259,,-370370,,-370370,141111,0,-370370,-370370,,,,,,0,0,370370,0,0,,-370370,-370370,57647,TFFP
2020-10-31,,,2292326,,2292326,1203582,7038018,5834436,5834436,,-215,,,,0,7038018,1203582,0,-3542110,,2292326,2292326,57648,MHF
2019-10-31,,,14731299,,14731299,1162886,7747570,6584684,6584684,,-339,,,,0,7747570,1162886,0,8146615,,14731299,14731299,57648,MHF
2018-10-31,,,928956,,928956,1150729,8078909,6928180,6928180,,-27,,,,0,8078909,1150729,0,-5999224,,928956,928956,57648,MHF
2017-10-31,,,3154469,,3154469,1179252,8098823,6919571,6919571,,-205,,,,0,8098823,1179252,0,-3765102,,3154469,3154469,57648,MHF
2019-12-31,9834000,,-19597000,,-19612000,8616000,0,-18450000,-18450000,,,,,,15000,0,18450000,0,-1147000,,-19612000,-19612000,57650,CMPS
2018-12-31,6952000,,-13219000,,-13219000,3586000,0,-10538000,-10538000,,,,,,0,0,10538000,0,-2681000,,-13219000,-13219000,57650,CMPS
2020-01-31,,,23182161,,23182161,3316409,13886441,10570032,10570032,,-1120301,,,,0,13886441,3316409,0,12612129,,23182161,23182161,57651,FINS
2020-06-30,,,10902000,,7689000,25719000,39802000,0,10833000,3250000,,,,,3213000,39802000,28969000,0,69000,,7689000,7689000,57652,PROV
2019-06-30,,,5920000,,4417000,37710000,51156000,0,9305000,4141000,,,,,1503000,51156000,41851000,0,-3385000,,4417000,4417000,57652,PROV
2018-06-30,,,5527000,,2131000,44482000,58731000,0,9676000,4573000,,,,,3396000,58731000,49055000,0,-4149000,,2131000,2131000,57652,PROV
2017-06-30,,,8816000,,5207000,51648000,67601000,0,10789000,5164000,,,,,3609000,67601000,56812000,0,-1973000,,5207000,5207000,57652,PROV
2020-12-31,,,17293000,,14055000,122195000,173346000,42052000,42052000,,-8364000,,,,3238000,2053131000,2011079000,1879785000,-24759000,,14055000,14055000,57653,BHE
2019-12-31,,,27269000,,23425000,131518000,201306000,60327000,60327000,,-6664000,,,,3844000,2268095000,2207768000,2066789000,-33058000,,23425000,23425000,57653,BHE
2018-12-31,,,55541000,,22817000,143205000,220593000,67903000,67903000,,-10473000,,,,32724000,2566465000,2498562000,2345872000,-12362000,,22817000,22817000,57653,BHE
2017-12-31,,,71005000,,-31901000,130401000,225920000,85454000,85454000,,-9405000,,,,102906000,2454479000,2369025000,2228559000,-14449000,,-31901000,-31901000,57653,BHE
2019-12-31,11436000,,-8467000,,-8467000,2422000,0,-13858000,-13858000,,-90000,,,,0,0,13858000,0,5391000,,-8467000,-8467000,57655,LHDX
2018-12-31,8021000,,-6536000,,-6536000,1794000,0,-9815000,-9815000,,-190000,,,,0,0,9815000,0,3279000,,-6536000,-6536000,57655,LHDX
2020-12-31,,,176278000,,138340000,,418503000,177793000,177793000,106055000,-5177000,,,,37938000,1822366000,1644573000,1403863000,-1515000,,138340000,138340000,57657,SAIA
2019-12-31,,,146652000,,113719000,,368788000,152183000,152183000,97470000,-6688000,,,,32933000,1786735000,1634552000,1417947000,-5531000,,113719000,113719000,57657,SAIA
2018-12-31,,,135833000,,104981000,,332223000,141556000,141556000,88514000,-5418000,,,,30852000,1653849000,1512293000,1321626000,-5723000,,104981000,104981000,57657,SAIA
2017-12-31,,,89751000,,91129000,,262121000,94527000,94527000,80492000,-5051000,,,,-1378000,1404703000,1310176000,1142582000,-4776000,,91129000,91129000,57657,SAIA
2020-12-31,,,540831000,,350574000,1527329000,2202352000,0,605840000,42938000,,,,,128151000,2296105000,1690265000,93753000,-65009000,,412680000,350574000,57658,EVR
2019-12-31,,,448707000,256534000.0,297436000,1351113000,1873021000,0,448865000,42020000,,,,,95046000,2008698000,1559833000,135677000,-158000,,353661000,297436000,57658,EVR
2018-12-31,,,551371000,249819000.0,377240000,1338537000,1943162000,0,548595000,28976000,,,,,108520000,2064705000,1516110000,121543000,2776000,,442851000,377240000,57658,EVR
2017-12-31,,,437649000,252404000.0,125454000,1079817000,1514922000,0,386844000,23442000,,,,,258442000,1635272000,1248428000,120350000,50805000,,179207000,125454000,57658,EVR
2020-05-30,,,20059000,,18391000,176237000,182507000,6270000,6270000,,-498000,,,,1731000,1351609000,1345339000,1169102000,13789000,,18328000,18391000,57661,CALM
2019-06-01,,,70805000,3182000.0,54229000,174795000,222859000,48064000,48064000,,-644000,,,,15743000,1361188000,1313124000,1138329000,22741000,,55062000,54229000,57661,CALM
2018-06-02,,,117337000,2349000.0,125932000,179316000,361046000,181730000,181730000,,-265000,,,,-8859000,1502932000,1321202000,1141886000,-64393000,,126196000,125932000,57661,CALM
2017-06-03,,,-114294000,1806000.0,-74278000,176032000,45550000,-130482000,-130482000,,-318000,,,,-39867000,1074513000,1204995000,1028963000,16188000,,-74427000,-74278000,57661,CALM
2019-12-31,,,5736000,,3289000,98210000,126178000,6596000,6596000,19284000,-16000,,,,2447000,157728000,151132000,31550000,-860000,,3289000,3289000,57665,MTEX
2018-12-31,,,489000,,-3886000,107630000,139082000,-46000,-46000,29434000,-16000,,,,4375000,173558000,173604000,34476000,535000,,-3886000,-3886000,57665,MTEX
2017-12-31,,,2460000,,-1787000,109984000,141029000,2556000,2556000,26625000,-16000,,,,4247000,176696000,174140000,35667000,-96000,,-1787000,-1787000,57665,MTEX
2016-12-31,,,-955000,,-586000,111432000,143740000,1487000,1487000,28923000,-16000,,,,-369000,180304000,178817000,36564000,-2442000,,-586000,-586000,57665,MTEX
2020-12-31,232561000,,-35125000,,-19424000,567510000,815747000,-34933000,-34933000,,,,,,-15701000,872933000,907866000,57186000,-192000,,-19424000,-19424000,57666,YELP
2019-12-31,230440000,,49767000,,40881000,636477000,951784000,35511000,35511000,,,,,,8886000,1014194000,978683000,62410000,14256000,,40881000,40881000,57666,YELP
2018-12-31,212319000,,40006000,,55350000,603878000,884901000,25897000,25897000,,,,,,-15344000,942773000,916876000,57872000,14109000,,55350000,55350000,57666,YELP
2017-12-31,175787000,,184486000,,152995000,546731000,780329000,16613000,16613000,,,,,,31491000,850847000,834234000,70518000,167873000,,152995000,152995000,57666,YELP
2019-12-31,,,-10280061,5345582,-7622948,6761537,1257955,-7233060,-7233060,,-3377394,,,,0,4219448,11452508,2961493,-3047001,,-10280061,-8750259,57668,BHTG
2018-12-31,,,-14747220,6602695,-14670330,6741561,2072361,-5137427,-5137427,,-9007866,,,,0,3359324,8496751,1286963,-9609793,,-14747220,-15162969,57668,BHTG
2017-12-31,,,-8350527,6602695,-8350527,7185048,734762,-6564070,-6564070,,-1768692,,,,0,2421205,8985275,1686443,-1786457,,-8350527,-8359250,57668,BHTG
2016-12-31,899400.0,,-6745386,6602695,-6745386,5485335,573542,-5924667,-5924667,,-820719,,,,0,2243466,8168133,1669924,-820719,,-6745386,-6745386,57668,BHTG
2020-03-31,65546000,,498681000,12848000,407605000,708506000,1322393000,548341000,548341000,,-40279000,,,,90876000,3030895000,2482554000,1708502000,-49660000,,407805000,407605000,57671,STE
2019-03-31,63038000,,369470000,7988000,304051000,644787000,1185148000,477323000,477323000,,-45015000,,,,64394000,2782170000,2304847000,1597022000,-107853000,,305076000,304051000,57671,STE
2018-03-31,60782000,,354982000,11340000,290915000,615767000,1092746000,416197000,416197000,,-50629000,,,,63360000,2619996000,2203799000,1527250000,-61215000,,291622000,290915000,57671,STE
2017-03-31,59397000,,184646000,11431000,109965000,651957000,1026213000,314859000,314859000,,-44520000,,,,74015000,2612756000,2297897000,1586543000,-130213000,,110631000,109965000,57671,STE
2019-12-31,47353000,,-631000,,-631000,10930000,57052000,-1231000,-1231000,,,,,,0,57052000,58283000,0,600000,,-631000,-6856000,57672,PLRX
2018-12-31,24415000,,-30276000,,-30276000,6500000,0,-30915000,-30915000,,,,,,0,0,30915000,0,639000,,-30276000,-35152000,57672,PLRX
2017-12-31,14526000,,-18333000,,-18333000,3823000,0,-18349000,-18349000,,,,,,0,0,18349000,0,16000,,-18333000,-20622000,57672,PLRX
2020-10-31,,,43800000,,28800000,56200000,124600000,68400000,68400000,,-10900000,,,,15000000,862300000,793900000,737700000,-24600000,,28800000,28800000,57674,AVO
2019-10-31,,,96000000,,71700000,48200000,154700000,106500000,106500000,,-14000000,,,,24300000,883300000,776800000,728600000,-10500000,,71700000,71700000,57674,AVO
2018-10-31,,,88600000,,72400000,35000000,54000000,19000000,19000000,,-5400000,,,,16200000,859900000,840900000,805900000,69600000,,72400000,72400000,57674,AVO
2020-12-31,,,296541000,,221580000,382330000,746046000,0,334915000,28801000,,,,,74961000,746046000,411131000,0,-38374000,,221580000,221580000,57675,ISBC
2019-12-31,,,286732000,,195484000,371188000,709486000,0,301932000,36366000,,,,,91248000,709486000,407554000,0,-15200000,,195484000,195484000,57675,ISBC
2018-12-31,,,270418000,,202576000,357937000,678098000,0,288178000,31983000,,,,,67842000,678098000,389920000,0,-17760000,,202576000,202576000,57675,ISBC
2017-12-31,,,280589000,,126744000,369344000,699163000,0,297199000,32620000,,,,,153845000,699163000,401964000,0,-20010000,,126744000,126744000,57675,ISBC
2019-12-31,13372000,,-19205000,,-15571000,36414000,39174000,-11831000,-11831000,,-4571000,,,,-3634000,187232000,199063000,148058000,-7374000,,-15571000,-15571000,57677,PAR
2018-12-31,12412000,,-9979000,,-24122000,34983000,40048000,-8313000,-8313000,,-387000,,,,14143000,201246000,209559000,161198000,-1666000,,-24122000,-24122000,57677,PAR
2017-12-31,11995000,,387000,,-3386000,38171000,51011000,-121000,-121000,,-121000,,,,3997000,232605000,232726000,181594000,508000,224000.0,-3610000,-3386000,57677,PAR
2016-12-31,11581000,,3650000,,1783000,31440000,46700000,2713000,2713000,,-121000,,,,1147000,229653000,226940000,182953000,937000,-720000.0,2503000,1783000,57677,PAR
2020-03-31,9200000,,-8301000,,-7290000,92560000,118400000,16640000,16640000,,-25039000,,,,-1011000,535831000,519191000,417431000,-24941000,,-7290000,-7290000,57678,MPAA
2019-03-31,8014000,,-7581000,,-7849000,64259000,89278000,17005000,17005000,,-23227000,,,,268000,472797000,455792000,383519000,-24586000,,-7849000,-7849000,57678,MPAA
2018-03-31,5692000,,35389000,,19264000,50507000,107302000,51103000,51103000,,-15445000,,,,16125000,427548000,376445000,320246000,-15714000,,19264000,19264000,57678,MPAA
2017-03-31,3824000,,56721000,,38735000,43267000,120754000,73663000,73663000,,-13094000,,,,17986000,422058000,348395000,301304000,-16942000,,38735000,38735000,57678,MPAA
2020-12-31,,,8183000,,6748000,,30201000,0,8421000,21780000,,,,,1435000,30201000,21780000,0,-238000,,6748000,6562000,57680,EMCF
2019-12-31,,,9616000,,7954000,16303000.0,31738000,0,10065000,5370000,,,,,1662000,31738000,21673000,0,-449000,,7954000,7772000,57680,EMCF
2018-12-31,,,4844000,,4211000,14746000.0,28504000,0,9235000,4523000,,,,,633000,28504000,19269000,0,-4391000,,4211000,4120000,57680,EMCF
2017-12-31,,,6391000,,4277000,13361000.0,24710000,0,6883000,4466000,,,,,2114000,24710000,17827000,0,-492000,,4277000,4277000,57680,EMCF
2019-12-31,84207000,,-372526000,170226000,-385297000,656437000,459846000,-394389000,-394389000,,-8255000,,,,1162000,1021037000,1415426000,561191000,21863000,,-373688000,-385297000,57681,FTCH
2018-12-31,68224000,,-153417000,170226000,-155575000,380005000,298450000,-173316000,-173316000,,-537000,,,,2158000,602384000,775700000,303934000,19899000,,-155575000,-155575000,57681,FTCH
2017-12-31,31611000,,-112105000,170226000,-112275000,252689000,204766000,-90514000,-90514000,,-1573000,,,,170000,385966000,476480000,181200000,-21591000,,-112275000,-112275000,57681,FTCH
2016-12-31,12269000,,-81260000,-1000,-81414000,177892000,116878000,-80180000,-80180000,,-1502000,,,,199000,242116000,322296000,125238000,-1080000,,-81459000,-81414000,57681,FTCH
2019-12-31,,,-19573000,,-20044000,49094000,27943000,-21151000,-21151000,,,,,,471000,35953000,57104000,8010000,1578000,,-20044000,-20044000,57682,IMMR
2018-12-31,,,54735000,,54343000,47933000,101034000,53101000,53101000,,,,,,392000,110979000,57878000,9945000,1634000,,54343000,54343000,57682,IMMR
2017-12-31,,,-44811000,,-45291000,66859000,23057000,-43802000,-43802000,,,,,,480000,35013000,78815000,11956000,-1009000,,-45291000,-45291000,57682,IMMR
2016-12-31,,,-14509000,,-39381000,58764000,43501000,-15263000,-15263000,,,,,,25521000,57086000,72349000,13585000,754000,649000.0,-40030000,-39381000,57682,IMMR
2020-06-30,,,-176813000,,-171362000,207335000,164006000,-76430000,-76430000,,-7522000,,,,-4619000,669729000,746159000,505723000,-100383000,832000,-172194000,-171362000,57683,RGS
2019-06-30,,,-22267000,,-14226000,308820000,346365000,4284000,4284000,,-4795000,,,,-2145000,1069039000,1064755000,722674000,-26551000,5896000,-20122000,-14226000,57683,RGS
2018-06-30,,,-10191000,,6436000,337531000,411449000,34485000,34485000,,-10492000,,,,-69812000,1235479000,1200994000,824030000,-44676000,-53185000,59621000,6436000,57683,RGS
2017-06-30,,,5929000,,-18539000,329413000,407751000,34193000,34193000,,-8584000,,,,9224000,1292800000,1258607000,885049000,-28264000,-15244000,-3295000,-18539000,57683,RGS
2019-12-31,,,58966000,,58957000,4858000,222432000,127730000,127730000,,-67586000,,,,9000,282561000,154831000,60129000,-68764000,,58957000,51757000,57684,KNOP
2018-12-31,,,82163000,,82165000,5190000,222276000,128330000,128330000,,-44347000,,,,-2000,279006000,150676000,56730000,-46167000,,82165000,74965000,57684,KNOP
2017-12-31,,,68048000,,68064000,5355000,167318000,90380000,90380000,,-28040000,,,,-16000,214027000,123647000,46709000,-22332000,,68064000,62811000,57684,KNOP
2016-12-31,,,61087000,,61102000,4271000,142768000,82267000,82267000,,-20499000,,,,-15000,173671000,91404000,30903000,-21180000,,61102000,61102000,57684,KNOP
2020-12-26,84584000,,26868000,,31025000,113446000,297281000,45505000,45505000,,,,,,-4157000,556496000,510991000,259215000,-18637000,,31025000,31025000,57686,ONTO
2019-12-31,48358000,,-597000,,1910000,65694000,156343000,31846000,31846000,,,,,,-2507000,305896000,274050000,149553000,-32443000,,1910000,1910000,57686,ONTO
2018-12-31,39953000,,53346000,,45096000,55708000,148279000,51084000,51084000,,,,,,8250000,273784000,222700000,125505000,2262000,,45096000,45096000,57686,ONTO
2017-12-31,37694000,,59802000,,32909000,48673000,134595000,46288000,46288000,,,,,,26893000,255098000,208810000,120503000,13514000,,32909000,32909000,57686,ONTO
2020-12-31,,,2722100000,31600000,2105200000,1491200000,4883600000,2637400000,2637400000,290600000,-166200000,,,,615700000,4883600000,2246200000,0,84700000,,2106400000,2105200000,57689,CME
2019-12-31,,,2689600000,30400000,2116500000,1525000000,4857800000,2656100000,2656100000,203400000,-178000000,,,,573800000,4857800000,2201700000,0,33500000,,2115800000,2116500000,57689,CME
2018-12-31,,,2777800000,46800000,1962200000,1126100000,4309400000,2681200000,2681200000,253400000,-157700000,,,,814100000,4309400000,1628200000,0,34300000,,1963700000,1962200000,57689,CME
2017-12-31,,,2526300000,46800000,4063400000,929400000,3644700000,2301200000,2301200000,205600000,-117000000,,,,-1537100000,3644700000,1343500000,0,225100000,,4063400000,4063400000,57689,CME
2019-12-28,,,-15161000,,-11964000,20217000,7786000,-12431000,-12431000,,-1480000,,,,-3197000,35097000,47528000,27311000,-2730000,,-11964000,-11964000,57690,JAN
2018-12-29,,,-6335000,,-5608000,17150000,11053000,-6097000,-6097000,,-668000,,,,-727000,36794000,42891000,25741000,-238000,,-5608000,-5608000,57690,JAN
2017-12-30,,,4067000,,118000,13376000,13145000,-231000,-231000,,-894000,,,,-1330000,41544000,41775000,28399000,4298000,-5775000.0,5397000,118000,57690,JAN
2016-12-31,,,-40000,406000.0,-1451000,11240000,12359000,1119000,1119000,,-1168000,,,,426000,40459000,39340000,28100000,-1159000,-1299000.0,-466000,-1451000,57690,JAN
2019-12-31,16835000,,-26277000,,-26277000,10022000,0,-26857000,-26857000,,,,,,0,0,26857000,0,580000,,-26277000,-26277000,57693,APTO
2018-12-31,18733000,,-28868000,,-28868000,10374000,0,-29107000,-29107000,,,,,,0,0,29107000,0,239000,,-28868000,-28868000,57693,APTO
2017-12-31,6274000,,-11643000,,-11643000,5552000,0,-11826000,-11826000,,,,,,0,0,11826000,0,183000,,-11643000,-11643000,57693,APTO
2016-12-31,7834000,,-14240000,,-14240000,6439000,0,-14273000,-14273000,,,,,,0,0,14273000,0,33000,,-14240000,-14240000,57693,APTO
2020-03-28,,,-215000000,1000000,-223000000,2439000000,3363000000,675000000,675000000,,-18000000,,,,10000000,5551000000,4876000000,2188000000,-890000000,,-225000000,-223000000,57694,CPRI
2019-03-30,,,621000000,7000000,543000000,2075000000,3180000000,880000000,880000000,,-38000000,,,,79000000,5238000000,4358000000,2058000000,-259000000,,542000000,543000000,57694,CPRI
2018-03-31,,,742000000,4000000,592000000,1767000000,2859000000,884000000,884000000,,-22000000,,,,150000000,4719000000,3835000000,1860000000,-142000000,,592000000,592000000,57694,CPRI
2017-04-01,,,689000000,2400000,553000000,1541000000,2661000000,900000000,900000000,,-4000000,,,,137000000,4494000000,3594000000,1833000000,-211000000,,552000000,553000000,57694,CPRI
2020-12-31,,,297437000,,216363000,860531000,1025377000,0,143217000,-1048000,,,,,90373000,1434531000,1291314000,409154000,154220000,,207064000,209571000,57695,COWN
2019-12-31,,,70723000,485595000.0,24631000,648816000,628615000,0,-62749000,22088000,,,,,14853000,875187000,937936000,246572000,133472000,,55870000,17839000,57695,COWN
2018-12-31,,,95598000,281803000.0,42819000,616322000,621590000,0,-28144000,20976000,,,,,15719000,855228000,883372000,233638000,123742000,,79879000,36027000,57695,COWN
2017-12-31,,,6962000,440604000.0,-60882000,487357000,425717000,0,-90054000,15336000,,,,,44053000,585136000,675190000,159419000,97016000,,-37091000,-67674000,57695,COWN
2020-12-31,,,1288200000,19400000,854900000,2233700000,3827500000,1593800000,1593800000,,-248700000,,,,296800000,12454700000,10860900000,8627200000,-305600000,-122300000,991400000,854900000,57697,TT
2019-12-31,,,1398900000,44800000,1410900000,2339900000,4027700000,1687800000,1687800000,,-242800000,,,,238600000,13075900000,11388100000,9048200000,-288900000,265800000,1160300000,1410900000,57697,TT
2018-12-31,,,1257800000,42100000,1337600000,2252000000,3786500000,1534500000,1534500000,,-221000000,,,,234900000,12343800000,10809300000,8557300000,-276700000,329800000,1022900000,1337600000,57697,TT
2017-12-31,,,1417900000,66600000,1302600000,2736800000,4432800000,1696000000,1696000000,,-215800000,,,,80200000,14197600000,12501600000,9764800000,-278100000,-25400000,1337700000,1302600000,57697,TT
2020-10-31,,,-134398576,,-134398576,6170655,17596373,11425718,11425718,,-424826,,,,0,17596373,6170655,0,-145824294,,-134398576,-134398576,57698,AWP
2019-10-31,,,145879050,,145879050,6703834,21525459,14821625,14821625,,-1035412,,,,0,21525459,6703834,0,131057425,,145879050,145879050,57698,AWP
2018-10-31,,,-37153107,,-37153107,6993026,13913669,6920643,6920643,,-119844,,,,0,13913669,6993026,0,-44073750,,-37153107,-37153107,57698,AWP
2017-10-31,,,119583102,,119583102,6959765,16347324,9387559,9387559,,-453947,,,,0,16347324,6959765,0,110195543,,119583102,119583102,57698,AWP
2019-12-31,,,124978000,,81001000,672120000,1342100000,448455000,448455000,,-286248000,,,,43977000,2528249000,2079794000,1186149000,-323477000,,81001000,81001000,57700,CZR
2018-12-31,,,135622000,,95235000,502391000,1000415000,340595000,340595000,,-171732000,,,,40387000,2056007000,1715412000,1055592000,-204973000,,95235000,95235000,57700,CZR
2017-12-31,,,-43389000,,73380000,354950000,667130000,206289000,206289000,,-99769000,,,,-116769000,1480798000,1274509000,813668000,-249678000,,73380000,73380000,57700,CZR
2016-12-31,,,37628000,,24527000,191490000,353659000,98720000,98720000,,-50917000,,,,13101000,900465000,801745000,546806000,-61092000,,24527000,24527000,57700,CZR
2019-12-31,,,1916400000,1531500000,1887800000,730400000,5363500000,2864400000,2864400000,-9700000,-814200000,,,,-200000,7580300000,4715900000,2216800000,-948000000,,1916600000,1887800000,57706,AMT
2018-12-31,,,1154600000,1568300000,1236400000,733200000,5262300000,2742300000,2742300000,3500000,-825600000,,,,-110100000,7440100000,4697800000,2177800000,-1587700000,,1264700000,1227000000,57706,AMT
2017-12-31,,,1256100000,1712800000,1238900000,637000000,4607300000,2248200000,2248200000,6200000,-749600000,,,,30700000,6663900000,4415700000,2056600000,-992100000,,1225400000,1151500000,57706,AMT
2016-12-31,,,1125900000,1303600000,956400000,543400000,3995300000,1932400000,1932400000,-6100000,-718300000,,,,155500000,5785700000,3853300000,1790400000,-806500000,,970400000,849300000,57706,AMT
2020-06-30,,,-2000,,-2000,,0,0,,,,,,,0,0,0,0,-2000,,-2000,-2000,57707,LSAQ
2019-12-31,284444000,,602397000,-1448000,494675000,556060000,1438088000,597584000,597584000,,-29896000,,,,109564000,1766914000,1169330000,328826000,4813000,,492833000,494675000,57708,WB
2018-12-31,249873000,,668842000,2679000,571823000,571179000,1440870000,619818000,619818000,,-15390000,,,,96222000,1718518000,1098700000,277648000,49024000,,572620000,571823000,57708,WB
2017-12-31,193393000,,417111000,2207000,352590000,317852000,918799000,407554000,407554000,,-4196000,,,,66746000,1150054000,742500000,231255000,9557000,,350365000,352590000,57708,WB
2016-12-31,154088000,,109980000,4133000,108027000,189501000,484569000,140980000,140980000,,-4196000,,,,4316000,655800000,514820000,171231000,-31000000,,105664000,108027000,57708,WB
2019-12-31,,,7346185000,1041271000,5360152000,,11123693000,8011561000,8011561000,1335995000,-1154560000,,,,1891443000,14319220000,6307659000,3195527000,-665376000,,5454742000,5360152000,57709,PAC
2018-12-31,,,7007672000,1063165000,5037368000,,9826870000,7191574000,7191574000,1065659000,-896225000,,,,1869041000,12682686000,5491112000,2855816000,-183902000,,5138631000,5037368000,57709,PAC
2017-12-31,,,6171722000,1048554000,4649120000,,8593401000,6192565000,6192565000,957274000,-600813000,,,,1440641000,11053427000,4860862000,2460026000,-20843000,,4731081000,4649120000,57709,PAC
2016-12-31,,,4620132000,1071554000,3281884000,,7353816000,5233062000,5233062000,772367000,-381708000,,,,1266573000,9431524000,4198462000,2077708000,-612930000,,3353559000,3281884000,57709,PAC
2019-12-31,,,71756000,,70699000,14341000,92700000,0,72840000,5519000,,,,,1057000,92700000,19860000,0,-1084000,,70699000,70396000,57713,WMC
2018-12-31,,,27118000,,26409000,15788000,49794000,0,27930000,6076000,,,,,709000,49794000,21864000,0,-812000,,26409000,26271000,57713,WMC
2017-12-31,,,88584000,,85097000,15213000,106362000,0,88730000,2419000,,,,,3487000,106362000,17632000,0,-147000,,85097000,84785000,57713,WMC
2016-12-31,,,-21859000,,-25015000,20201000,145000,0,-21101000,1045000,,,,,3156000,145000,21246000,0,-758000,,-25015000,-25392000,57713,WMC
2019-12-31,6478592,,-3625827,-37620,-3537759,31791473,38781617,-3623005,-3623005,,-246186,,,,-79316,47533637,51156642,8752020,-2822,,-3546511,-3537759,57715,CPIX
2018-12-31,7575892,,-7022136,-274266,-6963068,30409084,33363670,-7390772,-7390772,,-195848,,,,16636,40741765,48132537,7378095,368636,,-7038772,-6963068,57715,CPIX
2017-12-31,4280385,,-3874926,-198562,-7978633,31144287,33779546,-4081348,-4081348,,-92904,,,,4174889,41150131,45231479,7370585,206422,,-8049815,-7978633,57715,CPIX
2016-12-31,3190700,,-1334862,-127380,-944683,23115292,27066900,-1433131,-1433131,,-106392,,,,-330924,33025560,34458691,5958660,98269,,-1003938,-944683,57715,CPIX
2019-12-31,,,90544000,,89965000,30929000,121473000,0,90544000,,,,,,579000,121473000,30929000,0,0,,89965000,90492000,57716,KREF
2018-12-31,,,89737000,,89744000,28914000,118651000,0,89737000,,,,,,-70000,118651000,28914000,0,0,,89807000,87293000,57716,KREF
2017-12-31,,,61181000,3090000.0,59062000,18428000,79609000,0,61181000,,,,,,1102000,79609000,18428000,0,0,,60079000,58818000,57716,KREF
2016-12-31,,,32626000,10369000.0,31157000,8569000,41195000,0,32626000,,,,,,354000,41195000,8569000,0,0,,32272000,31141000,57716,KREF
2020-12-31,,,389781000,,292990000,896362000,1429244000,0,424250000,108632000,,,,,96791000,1429244000,1004994000,0,-34469000,,292990000,271613000,57718,WTFC
2019-12-31,,,480101000,,355697000,802683000,1408192000,0,504737000,100772000,,,,,124404000,1408192000,903455000,0,-24636000,,355697000,347497000,57718,WTFC
2018-12-31,,,460133000,,343166000,718618000,1285620000,0,487432000,79570000,,,,,116967000,1285620000,798188000,0,-27299000,,343166000,334966000,57718,WTFC
2017-12-31,,,389997000,,257682000,635623000,1120586000,0,412994000,71969000,,,,,132315000,1120586000,707592000,0,-22997000,,257682000,247904000,57718,WTFC
2019-12-31,39953000,,30981000,,17828000,851927000,1038224000,80105000,80105000,,-20271000,,,,-8479000,1106603000,1026498000,68379000,-49124000,-21632000,39460000,17828000,57721,TREE
2018-12-31,26958000,,43744000,,96499000,594210000,728466000,76445000,76445000,,-12437000,,,,-65575000,764865000,688420000,36399000,-32701000,-12820000,109319000,96499000,57721,TREE
2017-12-31,17925000,,25709000,589000.0,15578000,503325000,600513000,59186000,59186000,,-7028000,,,,6291000,617736000,558550000,17223000,-33477000,-3840000,19418000,15578000,57721,TREE
2016-12-31,13761000,,51574000,589000.0,27494000,297827000,370638000,52863000,52863000,,-561000,,,,20366000,384402000,331539000,13764000,-1289000,-3714000,31208000,27494000,57721,TREE
2019-12-31,3573000,,-23004000,,-25614000,17177000,1506000,-20232000,-20232000,6000,-1876000,,,,0,5020000,25252000,3514000,-2772000,-2610000,-23004000,-25614000,57724,MARK
2018-12-31,4393000,,-18705000,,-21558000,32829000,-2850000,-42291000,-42291000,129000,-3237000,,,,-140000,10053000,52344000,12903000,23586000,-2993000,-18565000,-21558000,57724,MARK
2017-12-31,11642000,,-106457000,,-106735000,52643000,53692000,-22733000,-22733000,1070000,-4645000,,,,278000,70601000,93334000,16909000,-83724000,-2993000,-106735000,-106735000,57724,MARK
2016-12-31,2796000,,-30933000,,-31679000,56001000,48173000,-21438000,-21438000,515000,-4685000,,,,746000,59328000,80766000,11155000,-9495000,-2993000,-31679000,-31679000,57724,MARK
2019-12-31,189923,,-7562114,-67274,-7524368,9527429,5718359,-3998993,-3998993,,,,,,18126,8374501,12373494,2656142,-3563121,,-7580240,-7524368,57728,MLSS
2018-12-31,245636,,-7667785,-11402,-7431645,10645206,4431301,-6459541,-6459541,,,,,,23986,9622076,16081617,5190775,-1208244,,-7691771,-7431645,57728,MLSS
2017-12-31,272746,,-5350460,256744,-5186793,11930951,6969379,-5234318,-5234318,,,,,,19093,11281886,16516204,4312507,-116142,,-5369553,-5186793,57728,MLSS
2016-12-31,1270471,,-7313590,36106,-5946507,11549961,6306472,-6513960,-6513960,,,,,,-19101,10482005,16995965,4175533,-799630,,-7294489,-5946507,57728,MLSS
2019-12-31,,,85404000,-205000,64920000,115019000,197016000,81997000,81997000,,-220000,,,,20565000,527113000,445116000,330097000,3407000,,64839000,64920000,57729,TR
2018-12-31,,,73206000,-125000,56893000,116305000,188173000,71868000,71868000,,-181000,,,,16401000,518920000,447052000,330747000,1338000,,56805000,56893000,57729,TR
2017-12-31,,,84561000,-36000,80864000,119113000,191906000,72793000,72793000,,-144000,,,,3907000,519289000,446496000,327383000,11768000,,80654000,80864000,57729,TR
2016-12-31,,,97912000,174000,67510000,107979000,199212000,91233000,91233000,,-105000,,,,30593000,521100000,429867000,321888000,6679000,,67319000,67510000,57729,TR
2019-12-31,,,20610905,,20610905,1120352,7025334,5845678,5845678,59304,,,,,0,7025334,1179656,0,14765227,,20610905,20610905,57731,PAI
2018-12-31,,,-6657904,,-6657904,1059146,7313001,6202375,6202375,51480,,,,,0,7313001,1110626,0,-12860279,,-6657904,-6657904,57731,PAI
2017-12-31,,,13947458,,13943871,1008416,7516315,6460913,6460913,46986,-7.0,,,,3587,7516315,1055402,0,7486545,,13943871,13943871,57731,PAI
2016-12-31,,,13821644,,13813644,968946,7655797,6637713,6637713,49138,-7.0,,,,8000,7655797,1018084,0,7183931,,13813644,13813644,57731,PAI
2020-12-31,,,103491000,,83651000,377153000,575479000,0,131195000,67131000,,,,,19840000,575479000,444284000,0,-27704000,,83651000,83651000,57732,RNST
2019-12-31,,,215687000,,167596000,350647000,589861000,0,226138000,13076000,,,,,48091000,589861000,363723000,0,-10451000,,167596000,167596000,57732,RNST
2018-12-31,,,188647000,,146920000,301567000,533676000,0,211964000,20145000,,,,,41727000,533676000,321712000,0,-23317000,,146920000,146920000,57732,RNST
2017-12-31,,,159869000,,92188000,261746000,461487000,0,179452000,20289000,,,,,67681000,461487000,282035000,0,-19583000,,92188000,92188000,57732,RNST
2020-12-31,,,86998000,,65051000,94174000,183543000,0,89369000,,,,,,21947000,183543000,94174000,0,-2371000,,65051000,65051000,57733,EBSB
2019-12-31,,,88789000,,66996000,97817000,188760000,0,90943000,,,,,,21793000,188760000,97817000,0,-2154000,,66996000,66996000,57733,EBSB
2018-12-31,,,70792000,,55771000,91678000,165480000,0,73802000,,,,,,15021000,165480000,91678000,0,-3010000,,55771000,55771000,57733,EBSB
2017-12-31,,,76432000,,42945000,82922000,162740000,0,79818000,,,,,,33487000,162740000,82922000,0,-3386000,,42945000,42945000,57733,EBSB
2019-12-31,,,66873000000,3326000000,54241000000,88306000000,297222000000,113434000000,113434000000,-797000000,-43573000000,,,,15750000000,476106000000,362672000000,178884000000,-46561000000,3976000000,51123000000,54241000000,57736,MBT
2018-12-31,,,77119000000,12291000000,6848000000,79661000000,283284000000,107728000000,107728000000,509000000,-38547000000,,,,15395000000,451466000000,343738000000,168182000000,-30609000000,-53892000000,61724000000,6848000000,57736,MBT
2017-12-31,,,68987000000,4079000000,56042000000,86673000000,256787000000,92478000000,92478000000,3696000000,-23428000000,,,,17780000000,417918000000,325440000000,161131000000,-23491000000,5383000000,51207000000,56042000000,57736,MBT
2016-12-31,,,67609000000,4713000000,48474000000,90240000000,259960000000,85667000000,85667000000,2471000000,-24226000000,,,,15138000000,435692000000,350025000000,175732000000,-18058000000,-4021000000,52471000000,48474000000,57736,MBT
2019-12-31,,,45145000,,34716000,77316000,129931000,52615000,52615000,,-6652000,,,,10429000,1382642000,1330027000,1252711000,-7470000,,34716000,34716000,57738,VEC
2018-12-31,,,43252000,,35296000,66372000,114695000,48323000,48323000,,-5153000,,,,7956000,1279304000,1230981000,1164609000,-5071000,,35296000,35296000,57738,VEC
2017-12-31,,,36580000,,59497000,60728000,101948000,41220000,41220000,,-4640000,,,,-22917000,1114788000,1073568000,1012840000,-4640000,,59497000,59497000,57738,VEC
2016-12-31,,,37187000,,23655000,64086000,106912000,42826000,42826000,,-5680000,,,,13532000,1190519000,1147693000,1083607000,-5639000,,23655000,23655000,57738,VEC
2019-12-31,,,18964000,,18964000,480000,74985000,27546000,27546000,21089000,-10533000,,,,0,78959000,51413000,3974000,-8582000,,18964000,18964000,57740,UHT
2018-12-31,,,24196000,,24196000,480000,74175000,28876000,28876000,20323000,-9977000,,,,0,77981000,49105000,3806000,-2909000,,24196000,24196000,57740,UHT
2017-12-31,,,45619000,,45619000,480000,71080000,26453000,26453000,19511000,-10063000,,,,0,74764000,48311000,3684000,26549000,,45619000,45619000,57740,UHT
2016-12-31,,,17215000,,17215000,480000,67746000,26570000,26570000,18220000,-9355000,,,,0,71537000,44967000,3791000,-9355000,,17215000,17215000,57740,UHT
2019-12-31,50024000,,-51825000,,-52250000,134801000,137347000,-47478000,-47478000,,-7478000,,,,425000,200882000,248360000,63535000,-4347000,,-52250000,-52250000,57741,EVBG
2018-12-31,41305000,,-46719000,,-47515000,100470000,100284000,-41491000,-41491000,,-6346000,,,,796000,147094000,188585000,46810000,-5228000,,-47515000,-47515000,57741,EVBG
2017-12-31,22241000,,-19587000,,-19634000,69893000,72849000,-19285000,-19285000,,-691000,,,,47000,104352000,123637000,31503000,618000,,-19634000,-19634000,57741,EVBG
2016-12-31,14765000,,-11310000,,-11286000,49140000,53079000,-10826000,-10826000,,-506000,,,,-24000,76846000,87672000,23767000,-484000,,-11286000,-11286000,57741,EVBG
2020-08-31,,,243166000,386451000,161005000,871154000,1221717000,360975000,360975000,-10412000,-159352000,,,,78992000,3366503000,3005528000,2144786000,-117809000,,164174000,161005000,57742,BEDU
2019-08-31,,,333338000,361832000,241099000,691900000,976991000,300526000,300526000,-15435000,24254000,,,,80580000,2563005000,2262479000,1586014000,32812000,,252758000,241099000,57742,BEDU
2018-08-31,,,316285000,170024000,246969000,368141000,628276000,272162000,272162000,-12027000,24254000,,,,67382000,1718871000,1446709000,1090595000,44123000,,248903000,246969000,57742,BEDU
2017-08-31,,,232779000,3325000,172050000,261972000,468037000,214939000,214939000,-8874000,24254000,,,,40970000,1328367000,1113428000,860330000,17840000,,191809000,172050000,57742,BEDU
2020-12-31,140777000,,610914000,,521571000,518737000,1358676000,688575000,688575000,,-32800000,,,,89343000,2365365000,1676790000,1006689000,-77661000,,521571000,521571000,57744,WAT
2019-12-31,142955000,,678239000,,592198000,526451000,1395896000,716797000,716797000,,-48690000,,,,86041000,2406596000,1689799000,1010700000,-38558000,,592198000,592198000,57744,WAT
2018-12-31,143403000,,682146000,,593794000,585015000,1427365000,691235000,691235000,,-48641000,,,,88352000,2419929000,1728694000,992564000,-9089000,,593794000,593794000,57744,WAT
2017-12-31,132593000,,641097000,,20311000,544703000,1362011000,677972000,677972000,,-56839000,,,,620786000,2309078000,1631106000,947067000,-36875000,,20311000,20311000,57744,WAT
2020-03-31,12018000,,3905000,,13900000,28443000,53673000,13212000,13212000,,,,,,-10375000,138715000,125503000,85042000,-9307000,-380000,14280000,13900000,57746,APPS
2019-03-31,10876000,,-3833000,,-6010000,21244000,35565000,3445000,3445000,,-1120000.0,,,,469000,103569000,100124000,68004000,-7278000,-1708000,-4302000,-6010000,57746,APPS
2018-03-31,9653000,,-20648000,,-52857000,21211000,25055000,-5809000,-5809000,,-2067000.0,,,,-951000,74751000,80560000,49696000,-14839000,-33160000,-19697000,-52857000,57746,APPS
2017-03-31,9283000,,-19282000,,-24264000,18946000,12015000,-16214000,-16214000,,-2625000.0,,,,-144000,40207000,56421000,28192000,-3068000,-5126000,-19138000,-24264000,57746,APPS
2020-05-31,,,3415976,,3029976,5934410,9237090,3302680,3302680,,,,,,386000,28381541,25078861,19144451,113296,,3029976,3029976,57747,TAYD
2019-05-31,,,3059525,,2544525,6045984,9047776,3001792,3001792,,,,,,515000,33619031,30617239,24571255,57733,,2544525,2544525,57747,TAYD
2018-05-31,,,676370,,443370,5276574,5924207,647633,647633,,,,,,233000,24363967,23716334,18439760,28737,,443370,443370,57747,TAYD
2017-05-31,,,2987577,,2330577,5065101,7985833,2920732,2920732,,,,,,657000,25536996,22616264,17551163,66845,,2330577,2330577,57747,TAYD
2019-12-31,20127000,,-5763000,,-4042000,30167000,49595000,-6962000,-6962000,,,,,,-1721000,106132000,113094000,56537000,1199000,,-4042000,-4042000,57750,MCHX
2018-12-31,15423000,,-2834000,,-2678000,24669000,37447000,-3426000,-3426000,,,,,,-156000,85251000,88677000,47804000,592000,,-2678000,-2678000,57750,MCHX
2017-12-31,17736000,,-6045000,,-6087000,28912000,40952000,-5696000,-5696000,,,,,,42000,90291000,95987000,49339000,-335000,,-6087000,-6442000,57750,MCHX
2016-12-31,28446000,,-84012000,,-84066000,44061000,52577000,-19930000,-19930000,,-42000.0,,,,54000,129547000,149477000,76970000,-64082000,,-84066000,-84066000,57750,MCHX
2020-12-31,,,-16819000,43973000,-16223000,27587000,189766000,33531000,33531000,,-50399000,,,,-696000,266645000,233114000,76879000,-50350000,,-16123000,-16223000,57752,KRG
2019-12-31,,,-284000,53272000,-534000,28214000,230821000,70509000,70509000,,-59268000,,,,-282000,315173000,244664000,84352000,-70793000,,-2000,-534000,57752,KRG
2018-12-31,,,-46678000,46441000,-46567000,21320000,258650000,85167000,85167000,,-66785000,,,,-227000,351384000,266217000,92734000,-131845000,,-46451000,-46567000,57752,KRG
2017-12-31,,,13788000,72802000,11874000,21749000,265996000,72156000,72156000,,-65702000,,,,-100000,358819000,286663000,92823000,-58368000,,13888000,11874000,57752,KRG
2019-12-31,,,-123738000,,-151942000,153226000,145237000,-34020000,-34020000,15249000,-48519000,,,,28204000,289522000,323542000,144285000,-89718000,,-151942000,-151942000,57755,STON
2018-12-31,,,-74496000,,-72699000,158900000,157433000,-28994000,-28994000,15791000,-30602000,,,,-1797000,316126000,345120000,158693000,-45502000,,-72699000,-72699000,57755,STON
2017-12-31,,,-84779000,-2959000.0,-74376000,157158000,179411000,-11318000,-11318000,20388000,-27345000,,,,-9621000,338227000,349545000,158816000,-73461000,,-75158000,-74376000,57755,STON
2016-12-31,,,-28894000,-1914000.0,-32499000,144634000,174952000,-2886000,-2886000,20305000,-24488000,,,,1589000,326230000,329116000,151278000,-26008000,,-30483000,-32499000,57755,STON
2020-02-01,,,906150000,,705945000,2078777000,2999125000,901094000,901094000,,,,,,200205000,7398068000,6496974000,4398943000,5056000,,705945000,705945000,57756,ULTA
2019-02-02,,,859141000,,658559000,1535464000,2409311000,854080000,854080000,,,,,,200582000,6716615000,5862535000,4307304000,5061000,,658559000,658559000,57756,ULTA
2018-02-03,,,786859000,,555234000,1287232000,2096809000,785291000,785291000,,,,,,231625000,5884506000,5099215000,3787697000,1568000,,555234000,555234000,57756,ULTA
2017-01-28,,,655714000,,409760000,1073834000,1747229000,654824000,654824000,,,,,,245954000,4854737000,4199913000,3107508000,890000,,409760000,409760000,57756,ULTA
2020-09-30,274000000,,903000000,1086000000,631000000,5031000000,7411000000,2106000000,2106000000,,-240000000,,,,108000000,22317000000,20211000000,14906000000,-1203000000,,795000000,631000000,57757,JCI
2019-09-30,319000000,,1056000000,1063000000,5674000000,5223000000,7693000000,2151000000,2151000000,,-335000000,,,,-233000000,23968000000,21817000000,16275000000,-1095000000,4574000000.0,1289000000,5674000000,57757,JCI
2018-09-30,310000000,,1546000000,1294000000,2162000000,5440000000,7667000000,1917000000,1917000000,,-409000000,,,,197000000,23400000000,21483000000,15733000000,-371000000,987000000.0,1349000000,2162000000,57757,JCI
2017-09-30,307000000,,1151000000,1131000000,1611000000,5707000000,7530000000,1516000000,1516000000,,-446000000,,,,322000000,22835000000,21319000000,15305000000,-365000000,939000000.0,829000000,1611000000,57757,JCI
2020-02-29,,,-764853000,,-613816000,3594307000,3541660000,-55238000,-55238000,,-64789000,,,,-151037000,11158580000,11213818000,7616920000,-709615000,,-613816000,-613816000,57758,BBBY
2019-03-02,,,-156609000,,-137224000,3681210000,4103980000,422770000,422770000,,-69474000,,,,-19385000,12028797000,11606027000,7924817000,-579379000,,-137224000,-137224000,57758,BBBY
2018-03-03,,,695660000,,424858000,3664794000,4443015000,778221000,778221000,,-62961000,,,,270802000,12349301000,11571080000,7906286000,-82561000,,424858000,424858000,57758,BBBY
2017-02-25,,,1065655000,,685108000,3441140000,4576350000,1135210000,1135210000,,-82855000,,,,380547000,12215757000,11080547000,7639407000,-69555000,,685108000,685108000,57758,BBBY
2020-12-31,,,-3220000000,9000000,-2945000000,182000000,1545000000,577000000,577000000,786000000,-543000000,,,,-278000000,14445000000,13868000000,12900000000,-3797000000,,-2942000000,-2945000000,57761,HAL
2019-12-31,,,-1122000000,13000000,-1131000000,227000000,2285000000,1481000000,1481000000,577000000,-592000000,,,,7000000,22408000000,20927000000,20123000000,-2603000000,,-1129000000,-1131000000,57761,HAL
2018-12-31,,,1814000000,22000000,1656000000,254000000,2986000000,2732000000,2732000000,577000000,-598000000,,,,157000000,23995000000,21263000000,21009000000,-918000000,,1657000000,1656000000,57761,HAL
2017-12-31,,,682000000,27000000,-463000000,256000000,2277000000,2021000000,2021000000,577000000,-705000000,,,,1131000000,20620000000,18599000000,18343000000,-1339000000,-19000000.0,-449000000,-463000000,57761,HAL
2019-12-28,93295000,,234166000,,196216000,314661000,629172000,221216000,221216000,,-328000,,,,37950000,937837000,716621000,308665000,12950000,,196216000,196216000,57762,MASI
2018-12-29,81006000,,213776000,,193543000,285417000,574892000,208469000,208469000,,-706000,,,,20233000,858289000,649820000,283397000,5307000,,193543000,193543000,57762,MASI
2017-12-30,65234000,,185800000,,124789000,273011000,522032000,183787000,183787000,,-678000,,,,61011000,790248000,606461000,268216000,2013000,,124789000,124789000,57762,MASI
2016-12-31,57686000,,433516000,,311097000,254707000,478338000,165945000,165945000,,-3260000,,,,122419000,712898000,546953000,234560000,267571000,,311097000,311097000,57762,MASI
2019-12-31,,,12943005000,1277980000,11779965000,15432767000,30921550000,16336142000,16336142000,-847359000,-1555873000,,,,754673000,52599709000,36263567000,21678159000,-3393137000,,12188332000,11779965000,57763,ABEV
2018-12-31,,,13121603000,1206801000,10994961000,14794989000,30981913000,17164064000,17164064000,-977140000,-1495677000,,,,1773893000,50231336000,33067272000,19249423000,-4042461000,,11347710000,10994961000,57763,ABEV
2017-12-31,,,12929802000,1974041000,7331968000,14616853000,29857498000,16366879000,16366879000,-1126234000,-1586158000,,,,5079298000,47899276000,31532397000,18041778000,-3437077000,,7850504000,7331968000,57763,ABEV
2016-12-31,,,13398400000,1826300000,12546600000,14282200000,28924600000,15794600000,15794600000,-1152200000,-1543400000,,,,315000000,45602600000,29808000000,16678000000,-2396200000,,13083400000,12546600000,57763,ABEV
2020-12-31,,,19326000,,15548000,27511000,52994000,0,20053000,5430000,,,,,3778000,52994000,32941000,0,-727000,,15548000,15548000,57764,ESXB
2019-12-31,,,19257000,,15705000,29215000,54866000,0,20151000,5285000,,,,,3552000,54866000,34715000,0,-894000,,15705000,15705000,57764,ESXB
2018-12-31,,,16773000,,13688000,28798000,51650000,0,17662000,5024000,,,,,3085000,51650000,33988000,0,-889000,,13688000,13688000,57764,ESXB
2017-12-31,,,14106000,,7203000,26276000,48082000,0,15892000,5755000,,,,,6903000,48082000,32190000,0,-1786000,,7203000,7203000,57764,ESXB
2020-02-01,,,4406183000,,3272193000,10433826000,14850035000,4416209000,4416209000,,-59086000,,,,1133990000,41716977000,37300768000,26866942000,-10026000,,3272193000,3272193000,57765,TJX
2019-02-02,,,4173211000,,3059798000,6923564000,11141757000,4218193000,4218193000,,-64839000,,,,1113413000,38972934000,34754741000,27831177000,-44982000,,3059798000,3059798000,57765,TJX
2018-02-03,,,3856588000,,2607948000,6375071000,10362497000,3987426000,3987426000,,-64295000,,,,1248640000,35864664000,31877238000,25502167000,-130838000,,2607948000,2607948000,57765,TJX
2017-01-28,,,3723043000,,2298234000,5768467000,9617990000,3849523000,3849523000,,-61671000,,,,1424809000,33183744000,29334221000,23565754000,-126480000,,2298234000,2298234000,57765,TJX
2019-12-31,,,33296000,,17335000,871862000,950758000,78896000,78896000,,-13591000,,,,15961000,3908264000,3829368000,2957506000,-45600000,,17335000,17335000,57767,MRM
2018-12-31,,,91562000,,66310000,842822000,956868000,114046000,114046000,,-15485000,,,,25252000,3433135000,3319089000,2476267000,-22484000,,66310000,66310000,57767,MRM
2020-04-30,,,-10466000,,-10466000,14517000,3932000,-10585000,-10585000,,,,,,0,59702000,70287000,55770000,119000,,-10466000,-15152000,57768,CDMO
2019-04-30,,,-5340000,,-4215000,12846000,7224000,-5622000,-5622000,,,,,,-284000,53603000,59225000,46379000,282000,841000.0,-5056000,-8901000,57768,CDMO
2018-04-30,,,-20563000,,-21813000,16456000,-2924000,-19380000,-19380000,,-27000.0,,,,0,53621000,73001000,56545000,-1183000,-1250000.0,-20563000,-26499000,57768,CDMO
2017-04-30,,,1393000,,-28159000,18079000,19371000,1292000,1292000,,-7000.0,,,,0,57630000,56338000,38259000,101000,-29552000.0,1393000,-32799000,57768,CDMO
2019-12-31,,,-1476596000,264364000,-1387412000,96545000,685801000,-1399178000,-1399178000,37107000,-79232000,,,,-109176000,838453000,2237631000,152652000,-77418000,,-1367420000,-1406848000,57773,XOG
2018-12-31,,,188705000,147872000,114568000,134604000,851574000,224864000,224864000,8554000,-123330000,,,,66850000,970398000,745534000,118824000,-36159000,,121855000,97699000,57773,XOG
2017-12-31,,,-108108000,147872000,-44408000,110167000,441623000,-56131000,-56131000,36332000,-51889000,,,,-63700000,552929000,609060000,111306000,-51977000,,-44408000,-60687000,57773,XOG
2016-12-31,,,-485281000,147872000,-456001000,232388000,195316000,-412289000,-412289000,110947000,-68843000,,,,-29280000,257359000,669648000,62043000,-72992000,,-456001000,-230106000,57773,XOG
2019-12-31,,,-71974000,,-72064000,119019000,44605000,-74414000,-74414000,,-369000,,,,90000,82558000,156972000,37953000,2440000,,-72064000,-72064000,57776,HIMS
2018-12-31,,,-75206000,,-75243000,83572000,7803000,-75769000,-75769000,,-154000,,,,37000,26679000,102448000,18876000,563000,,-75243000,-75243000,57776,HIMS
2019-12-31,,,55303000,,51665000,6692000,0,-19336000,-19336000,,-2928000,,,,1445000,0,19336000,0,74639000,-2193000,53858000,51665000,57777,LAC
2018-12-31,578000.0,,-13822000,,-28267000,8750000,-838000,-23357000,-23357000,,-343000,,,,0,4843000,23357000,5681000,-2045000,-14445000,-13822000,-28267000,57777,LAC
2017-12-31,423000.0,,-33250000,,-33250000,7296000,-1049000,-25283000,-25283000,,-343000,,,,0,4290000,29573000,5339000,-7967000,-14445000,-33250000,-33250000,57777,LAC
2016-12-31,428800.0,,-22179200,,-22179200,5158400,-792800,-12073600,-12073600,,-644800,,,,0,923200,12996800,1716000,-10105600,-14445000,-22179200,-22179200,57777,LAC
2019-12-31,,,-44698000,,-40448000,25336000,-17260000,-42596000,-42596000,,,,,,0,32424000,75020000,49684000,-2102000,4250000,-44698000,-40448000,57778,APVO
2018-12-31,,,-53689000,,-53689000,28133000,-23532000,-51665000,-51665000,,,,,,0,23067000,74732000,46599000,-2024000,4250000,-53689000,-53689000,57778,APVO
2017-12-31,,,-55893000,,6973000,34576000,-19373000,-53949000,-53949000,,,,,,-23301000,14658000,68607000,34031000,-1944000,39565000,-32592000,6973000,57778,APVO
2016-12-31,,,-139583000,,-112415000,36158000,-31602000,-67760000,-67760000,,-810000.0,,,,-19692000,9985000,77745000,41587000,-71823000,7476000,-119891000,-112415000,57778,APVO
2019-12-31,,,67364000,532471000,3983000,50781000,276462000,120562000,120562000,,-56464000,,,,1351000,382926000,262364000,106464000,-53198000,,66013000,-8442000,57779,NSA
2018-12-31,,,57144000,485460000,14109000,40320000,229035000,99568000,99568000,,-42724000,,,,818000,329473000,229905000,100438000,-42424000,,56326000,3732000,57779,NSA
2017-12-31,,,47157000,430464000,2961000,33760000,184443000,75568000,75568000,,-34068000,,,,1159000,265791000,190223000,81348000,-28411000,,45998000,633000,57779,NSA
2016-12-31,,,25234000,401966000,17965000,24628000,129318000,49626000,49626000,,-24109000,,,,368000,197562000,147936000,68244000,-24392000,,24866000,17947000,57779,NSA
2020-09-30,,,46742000,293000,33354000,114967000,172434000,0,47030000,10437000,,,,,12661000,172434000,125404000,0,-288000,,34081000,33354000,57780,FSFG
2019-09-30,,,20090000,204000,16177000,55910000,82593000,0,20458000,6225000,,,,,3095000,82593000,62135000,0,-368000,,16995000,16177000,57780,FSFG
2018-09-30,,,14758000,1432000,10902000,28378000,47941000,0,15355000,4208000,,,,,2422000,47941000,32586000,0,-597000,,12336000,10902000,57780,FSFG
2017-09-30,,,11833000,1432000,9313000,21299000,36784000,0,12210000,3275000,,,,,2520000,36784000,24574000,0,-377000,,9313000,9313000,57780,FSFG
2020-10-03,123459000,,64298000,,52300000,120507000,297975000,54009000,54009000,,-1716000,,,,11998000,623176000,569167000,325201000,10289000,,52300000,52300000,57781,KLIC
2019-09-28,116169000,,34563000,,11653000,116811000,254590000,21610000,21610000,,-2055000,,,,22910000,540052000,518442000,285462000,11339000,,11653000,11653000,57781,KLIC
2018-09-29,119621000,,177420000,,56676000,123188000,409441000,166632000,166632000,,-1054000,,,,120744000,889121000,722489000,479680000,11109000,,56676000,56676000,57781,KLIC
2017-09-30,100203000,,118705000,,126099000,133601000,382094000,148290000,148290000,,-1059000,,,,-7394000,809041000,660751000,426947000,-29585000,,126099000,126099000,57781,KLIC
2019-12-31,,,3386000,,2224000,11242000,28756000,6961000,6961000,2200000,-5388000,,,,1162000,35471000,28510000,6715000,-3575000,,2224000,2224000,57783,GWRS
2018-12-31,,,4885000,,3103000,10548000,29386000,9269000,9269000,2100000,-5255000,,,,1782000,35515000,26246000,6129000,-4384000,,3103000,3103000,57783,GWRS
2017-12-31,,,3950000,,4551000,9207000,25659000,7344000,7344000,2200000,-5125000,,,,-601000,31208000,23864000,5549000,-3394000,,4551000,4551000,57783,GWRS
2016-12-31,,,-3799000,,-2512000,9549000,23558000,5812000,5812000,1918000,-11866000,,,,-1287000,29799000,23987000,6241000,-9611000,,-2512000,-2512000,57783,GWRS
2020-12-31,,,209300000,,161200000,267100000,596800000,0,219700000,110000000,,,,,48100000,596800000,377100000,0,-10400000,,161200000,161200000,57785,FIBK
2019-12-31,,,235100000,,181000000,296400000,631000000,0,272600000,62000000,,,,,54100000,631000000,358400000,0,-37500000,,181000000,181000000,57785,FIBK
2018-12-31,,,206300000,,160200000,274800000,567200000,0,235600000,56800000,,,,,46100000,567200000,331600000,0,-29300000,,160200000,160200000,57785,FIBK
2017-12-31,,,156700000,,106500000,233200000,480600000,0,197400000,50000000,,,,,50200000,480600000,283200000,0,-40700000,,106500000,106500000,57785,FIBK
2019-12-31,10210000,,-15439000,,-15439000,4819000,0,-15029000,-15029000,,,,,,0,0,15029000,0,-410000,,-15439000,-15439000,57786,FRSX
2018-12-31,8638000,,-14657000,,-14657000,4683000,0,-13321000,-13321000,,,,,,0,0,13321000,0,-1336000,,-14657000,-14657000,57786,FRSX
2017-12-31,4089000,,-15942000,,-15942000,4768000,0,-8857000,-8857000,,,,,,0,0,8857000,0,-7085000,,-15942000,-15942000,57786,FRSX
2016-12-31,904000,,-1913000,,-1913000,2851000,0,-3755000,-3755000,,-6000.0,,,,0,0,3755000,0,1836000,,-1913000,-1913000,57786,FRSX
2019-12-31,9362000,,1160000,,774000,16004000,26302000,936000,936000,,,,,,386000,59263000,58327000,32961000,224000,,774000,774000,57788,CYBE
2018-12-31,8819000,,3579000,,2827000,16433000,28611000,3359000,3359000,,,,,,752000,64720000,61361000,36109000,220000,,2827000,2827000,57788,CYBE
2017-12-31,8022000,,908000,,1312000,15657000,24760000,1015000,1015000,,,,,,-404000,53333000,52318000,28573000,-107000,,1312000,1312000,57788,CYBE
2016-12-31,8040000,,6391000,,11562000,14796000,29055000,6153000,6153000,,,,,,-5171000,66240000,60087000,37185000,238000,,11562000,11562000,57788,CYBE
2020-12-31,,,267180000,19000,266266000,17890000,468287000,326152000,326152000,,-38408000,,,,900000,691039000,364887000,222752000,-58972000,,266280000,266266000,57789,DHT
2019-12-31,,,73812000,5000,73679000,14789000,269241000,138868000,138868000,,-65267000,,,,131000,535068000,396200000,265827000,-65056000,,73681000,73679000,57789,DHT
2018-12-31,,,-46844000,5000,-46927000,15052000,138250000,19722000,19722000,,-59402000,,,,83000,375941000,356219000,237691000,-66566000,,-46927000,-46927000,57789,DHT
2017-12-31,,,6733000,5000,6602000,17180000,169320000,55382000,55382000,,-37955000,,,,131000,355052000,299670000,185732000,-48649000,,6602000,6602000,57789,DHT
2019-12-31,,,721012178,,534643942,310531719,1170531908,0,748719815,95394307,,,,,186368236,1344573962,595854147,174042054,-27707637,,534643942,534643942,57791,CNF
2018-12-31,,,1157737186,,860908711,527571341,1920261103,0,1179314869,173659725,,,,,296828475,1920261103,740946234,0,-21577683,,860908711,860908711,57791,CNF
2017-12-31,,,808667625,,532672757,608881229,1702716500,0,808992305,102153200,,,,,275994868,1702716500,893724195,0,-324680,,532672757,532672757,57791,CNF
2016-12-31,,,288045262,,235441839,340013799,753313465,0,305667553,107632113,,,,,52603423,753313465,447645912,0,-17622291,,235441839,235441839,57791,CNF
2019-12-31,,,-3439379000,-5670000,-3434832000,1759395000,729106000,-3150802000,-3150802000,758333000,-352408000,,,,-2167000,7129088000,10279890000,6399982000,-288577000,,-3437212000,-3783588000,57792,DNK
2018-12-31,,,-1369637000,-4134000,-1365615000,785827000,503276000,-1221322000,-1221322000,295141000,-163357000,,,,112000,2675031000,3896353000,2171755000,-148315000,,-1369749000,-1476747000,57792,DNK
2017-12-31,,,-271636000,-4134000,-271524000,156145000,145085000,-218619000,-218619000,46456000,-55013000,,,,-112000,656782000,875401000,511697000,-53017000,,-271524000,-285647000,57792,DNK
2020-09-30,,,53057000,,40297000,66674000,122212000,55538000,55538000,,-3113000,,,,12760000,785679000,730141000,663467000,-2481000,,40297000,40297000,57794,ROAD
2019-09-30,,,57030000,,43121000,60952000,117953000,57001000,57001000,,-1861000,,,,13909000,783238000,726237000,665285000,29000,,43121000,43121000,57794,ROAD
2018-09-30,,,61316000,,50791000,55303000,99536000,44233000,44233000,,-1270000,,,,10525000,680096000,635863000,580560000,17083000,,50791000,50791000,57794,ROAD
2017-09-30,,,40782000,,26040000,47867000,90971000,43104000,43104000,,-3960000,,,,14742000,568212000,525108000,477241000,-2322000,,26040000,26040000,57794,ROAD
2020-10-02,,,-647719000,9988000,-461529000,881015000,1393591000,-82619000,-82619000,,-368534000,,,,-186284000,12829559000,12912178000,11435968000,-565100000,,-461435000,-461529000,57795,ARMK
2019-09-27,,,556172000,9915000,448549000,358256000,1706679000,755850000,755850000,,-352812000,,,,107706000,16227341000,15471491000,14520662000,-199678000,,448466000,448549000,57795,ARMK
2018-09-28,,,471876000,10093000,567885000,352929000,1791722000,842611000,842611000,,-335448000,,,,-96564000,15789633000,14947022000,13997911000,-370735000,,568440000,567885000,57795,ARMK
2017-09-29,,,520642000,9798000,373923000,305570000,1609009000,795227000,795227000,,-257495000,,,,146455000,14604412000,13809185000,12995403000,-274585000,,374187000,373923000,57795,ARMK
2019-12-31,,,362000000,1657000000,240000000,104000000,3098000000,1377000000,1377000000,170000000,-173000000,,,,47000000,3767000000,2390000000,669000000,-1015000000,,315000000,240000000,57796,FANG
2018-12-31,,,1113000000,467000000,846000000,65000000,1757000000,1148000000,1148000000,-79000000,-88000000,,,,168000000,2060000000,912000000,303000000,-35000000,,945000000,846000000,57796,FANG
2017-12-31,,,497000000,326877000,482000000,48000000,969000000,527000000,527000000,67000000,-41000000,,,,-20000000,1193000000,666000000,224000000,-30000000,,517000000,482000000,57796,FANG
2016-12-31,,,-164716000,320830000,-165034000,42619000,398617000,151574000,151574000,26409000,-41068000,,,,192000,527107000,375533000,128490000,-316290000,,-164908000,-165034000,57796,FANG
2019-12-31,,,1674720000,217426000,1203736000,1430456000,4203284000,3200984000,3200984000,-449200000,-938120000,,,,457833000,39644010000,36443026000,35440726000,-1526264000,,1216887000,1203736000,57798,GGB
2018-12-31,,,2157431000,207967000,2303868000,1652880000,6149378000,4451592000,4451592000,34992000,-1177686000,,,,-168951000,46159478000,41707886000,40010100000,-2294161000,,2326382000,2303868000,57798,GGB
2017-12-31,,,-43276000,248740000,-359360000,1654908000,3604624000,2041447000,2041447000,-91731000,-1323448000,,,,295391000,36917619000,34876172000,33312995000,-2084723000,,-338667000,-359360000,57798,GGB
2016-12-31,,,-2581615000,246517000,-2890811000,2239028000,3463726000,1352545000,1352545000,-127847000,-1540797000,,,,304314000,37651667000,36299122000,34187941000,-3934160000,,-2885929000,-2890811000,57798,GGB
2019-12-31,173924415,,3890521771,,3264287925,597531247,5610776233,4992182734,4992182734,-152862163,,,,,626233846,8795689542,3803506808,3184913309,-1101660963,,3264287925,3264287925,57800,QD
2018-12-31,132959649,,2649046731,,2491316213,863018095,3750178172,2805960812,2805960812,-51760384,,,,,157730518,7664329674,4858368862,3914151502,-156914081,,2491316213,2491316213,57800,QD
2017-12-31,137326488,,2420004823,,2164458820,631354457,3281434092,2571377886,2571377886,-58624739,,,,,255546003,4767443665,2196065779,1486009573,-151373063,,2164458820,2164458820,57800,QD
2016-12-31,41021236,,703493068,,576652618,302497604,1019864622,713935199,713935199,-37589417,,,,,126840450,1419903173,705967974,400038551,-10442131,,576652618,576652618,57800,QD
2019-12-31,18014000,,-26293000,,-26293000,9074000,0,-27088000,-27088000,,,,,,0,0,27088000,0,795000,,-26293000,-26293000,57802,CATB
2018-12-31,15632000,,-25870000,,-25870000,9839000,0,-25471000,-25471000,,-100000.0,,,,0,0,25471000,0,-399000,,-25870000,-25870000,57802,CATB
2017-12-31,17413000,,-27364000,,-27364000,10181000,500000,-27094000,-27094000,,-462000.0,,,,0,500000,27594000,0,-270000,,-27364000,-27364000,57802,CATB
2016-12-31,24431000,,-36060000,,-36060000,11127000,0,-35558000,-35558000,,-837000.0,,,,0,0,35558000,0,-502000,,-36060000,-36060000,57802,CATB
2019-12-31,20020959,,-35102222,,-35131015,11552496,1633596,-29939859,-29939859,,-133082,,,,28793,2092032,32031891,458436,-5162363,,-35131015,-35131015,57803,NVCN
2018-12-31,16001464,,-107876382,,-107983475,16490622,1382875,-31109211,-31109211,,-4261598,,,,107093,1749133,32858344,366258,-76767171,,-107983475,-107983475,57803,NVCN
2017-12-31,16214439,,-21149640,,-21634068,14160659,1911193,-28463905,-28463905,,-4261598,,,,484428,5389014,33852919,3477821,7314265,,-21634068,-21634068,57803,NVCN
2016-12-31,19364503,,-86294370,,-86494893,6709287,2421035,-23652755,-23652755,,-4261598,,,,200523,9512796,33165551,7091761,-62641615,,-86494893,-86494893,57803,NVCN
2020-12-31,,,278540000,,212522000,51218000,402506000,334907000,334907000,,,,,,66018000,775351000,440444000,372845000,-56367000,,212522000,212522000,57804,VCTR
2019-12-31,,,120688000,,92491000,42319000,287563000,221371000,221371000,,-40315000.0,,,,28197000,612373000,391002000,324810000,-100683000,,92491000,92491000,57804,VCTR
2018-12-31,,,84911000,,63704000,29702000,172852000,119873000,119873000,1505000.0,-20164000.0,,,,21207000,413412000,293539000,240560000,-34962000,,63704000,63704000,57804,VCTR
2017-12-31,,,38458000,,25826000,33263000,163659000,100486000,100486000,1887000.0,-47408000.0,,,,12632000,409629000,309143000,245970000,-62028000,,25826000,25826000,57804,VCTR
2020-12-31,101053000,,686225000,,601822000,332158000,1403686000,883350000,883350000,,-156324000,,,,84403000,1695390000,812040000,291704000,-197125000,,601822000,601822000,57806,MSCI
2019-12-31,98334000,,603318000,,563648000,322131000,1269835000,754961000,754961000,15000000.0,-148041000,,,,39670000,1557796000,802835000,287961000,-151643000,,563648000,563648000,57806,MSCI
2018-12-31,81411000,,629896000,,507885000,292859000,1146649000,694744000,694744000,15000000.0,-133114000,,,,122011000,1433984000,739240000,287335000,-64848000,,507885000,507885000,57806,MSCI
2017-12-31,75849000,,466899000,,303972000,264885000,1000491000,579770000,579770000,15000000.0,-116098000,,,,162927000,1274172000,694402000,273681000,-112071000,,303972000,303972000,57806,MSCI
2020-12-31,75614000,,-76308000,,-76984000,138257000,147791000,-66080000,-66080000,,-11125000,,,,676000,252424000,318504000,104633000,-10228000,,-76984000,-76984000,57807,PRO
2019-12-31,67246000,,-68457000,,-69081000,136807000,151217000,-52836000,-52836000,,-14765000,,,,624000,250334000,303170000,99117000,-15621000,,-69081000,-69081000,57807,PRO
2018-12-31,55657000,,-64046000,,-64246000,113308000,119845000,-49120000,-49120000,,-16986000,,,,200000,197024000,246144000,77179000,-14926000,,-64246000,-64246000,57807,PRO
2017-12-31,56021000,,-77777000,,-77926000,108452000,100250000,-64223000,-64223000,,-13218000,,,,149000,168816000,233039000,68566000,-13554000,,-77926000,-77926000,57807,PRO
2019-12-31,,,-5268000,,-4627000,21575000,22115000,-1254000,-1254000,,-1156000,,,,-375000,114185000,115439000,92070000,-4014000,266000,-4893000,-5223000,57809,STRR
2018-12-31,,,-5400000,,736000,20456000,18271000,-3562000,-3562000,,-751000,,,,-1561000,104180000,107742000,85909000,-1838000,4575000,-3839000,736000,57809,STRR
2017-12-31,,,-7049000,,-35730000,23496000,21196000,-3794000,-3794000,,-730000,,,,27987000,104632000,108426000,83436000,-3255000,-694000,-35036000,-35730000,57809,STRR
2016-12-31,,,1885000,,14302000,28180000,35773000,5280000,5280000,,-1412000,,,,-12417000,125467000,120187000,89694000,-3395000,-694000,14302000,14302000,57809,STRR
2019-12-31,,,-3503000,,-3986000,29822000,37360000,7538000,7538000,,-11061000,,,,483000,542931000,535393000,505571000,-11041000,,-3986000,-3986000,57810,GLRE
2018-12-31,,,-353997000,2177000.0,-350054000,25173000,-309270000,-334443000,-334443000,,-20492000,,,,332000,200078000,534521000,509348000,-19554000,,-354329000,-350054000,57810,GLRE
2017-12-31,,,-44825000,20102000.0,-44952000,26356000,13121000,-13235000,-13235000,,-23937000,,,,-451000,677265000,690500000,664144000,-31590000,,-44374000,-44952000,57810,GLRE
2016-12-31,,,47209000,17445000.0,44881000,25808000,92363000,66555000,66555000,,-22334000,,,,509000,607712000,541157000,515349000,-19346000,,46700000,44881000,57810,GLRE
2020-12-31,,,90203000,,73447000,171109000,305349000,0,106559000,27681000,,,,,16756000,305349000,198790000,0,-16356000,,73447000,73447000,57813,FCF
2019-12-31,,,130849000,,105333000,165893000,339090000,0,142839000,30358000,,,,,25516000,339090000,196251000,0,-11990000,,105333000,105333000,57813,FCF
2018-12-31,,,132772000,,107498000,155480000,326348000,0,142657000,28211000,,,,,25274000,326348000,183691000,0,-9885000,,107498000,107498000,57813,FCF
2017-12-31,,,103726000,,55165000,150507000,302190000,0,124185000,27498000,,,,,48561000,302190000,178005000,0,-20459000,,55165000,55165000,57813,FCF
2019-12-31,,,12840000,,12840000,1108000,7167000,6059000,6059000,,-727000,,,,0,7167000,1108000,0,6781000,,12840000,11805000,57814,PNF
2018-12-31,,,-542000,,-542000,1142000,7099000,5957000,5957000,,-484000,,,,0,7099000,1142000,0,-6499000,,-542000,-1587000,57814,PNF
2017-12-31,,,9346000,,9346000,1207000,6757000,5550000,5550000,,-229000,,,,0,6757000,1207000,0,3796000,,9346000,8695000,57814,PNF
2016-12-31,,,1927000,,1927000,1192000,6712000,5520000,5520000,,-100000,,,,0,6712000,1192000,0,-3593000,,1927000,1577000,57814,PNF
2020-06-30,,,21756000,,18727000,24882000,49578000,0,22077000,2619000,,,,,3029000,49578000,27501000,0,-321000,,18727000,18727000,57817,GCBC
2019-06-30,,,21026000,,17484000,22472000,46702000,0,21487000,2743000,,,,,3542000,46702000,25215000,0,-461000,,17484000,17484000,57817,GCBC
2018-06-30,,,18503000,,14408000,19573000,40865000,0,18943000,2349000,,,,,4095000,40865000,21922000,0,-440000,,14408000,14408000,57817,GCBC
2017-06-30,,,14928000,,11187000,17549000,34895000,0,15308000,2038000,,,,,3741000,34895000,19587000,0,-380000,,11187000,11187000,57817,GCBC
2019-12-31,30184000,,22955000,,36538000,40121000,95877000,25572000,25572000,,-395000,,,,-13583000,263492000,237920000,167615000,-2646000,,36538000,36538000,57818,GILT
2018-12-31,33023000,,16986000,,18409000,39730000,94037000,21284000,21284000,,-614000,,,,-1423000,266391000,245107000,172354000,-4298000,,18409000,18409000,57818,GILT
2017-12-31,28014000,,6554000,,6801000,43620000,82495000,10861000,10861000,,-844000,,,,-247000,282756000,271895000,200261000,-4307000,,6801000,6801000,57818,GILT
2016-12-31,24853000,,-4088000,,-5340000,49882000,75490000,755000,755000,,-1098000,,,,1252000,279551000,278796000,204061000,-9243000,,-5340000,-5340000,57818,GILT
2019-12-31,,,82233000,,65153000,5242000,174158000,103492000,103492000,20001000,-22224000,,,,21091000,479604000,376112000,305446000,-21259000,4011000,61142000,65153000,57820,CPK
2018-12-31,,,78094000,,56580000,3360000,156575000,94692000,94692000,18303000,-16146000,,,,21232000,490316000,395624000,333741000,-16598000,-282000,56862000,56580000,57820,CPK
2017-12-31,,,74996000,,58124000,698000,142807000,88902000,88902000,16821000,-12530000,,,,14670000,449646000,360744000,306839000,-13906000,-2202000,60326000,58124000,57820,CPK
2016-12-31,,,73016000,,44675000,698000,132742000,85853000,85853000,14730000,-10639000,,,,28341000,498860000,413007000,366118000,-12837000,-2202000,44675000,44675000,57820,CPK
2019-12-29,18000000,,15700000,15000000,12500000,130800000,190000000,41200000,41200000,,-23500000,,,,4800000,717500000,676300000,527500000,-25500000,1700000,10900000,12500000,57821,KTOS
2018-12-30,15600000,,8700000,15000000,-3500000,119800000,169700000,34300000,34300000,,-21600000,,,,4600000,618000000,583700000,448300000,-25600000,-7600000,4100000,-3500000,57821,KTOS
2017-12-31,17800000,,-57100000,15000000,-42700000,127300000,157600000,12500000,12500000,500000.0,-29100000,,,,-10200000,603300000,590800000,445700000,-69600000,4200000,-46900000,-42700000,57821,KTOS
2016-12-25,13900000,,-51800000,15000000,-60500000,114600000,120500000,-8000000,-8000000,500000.0,-34700000,,,,5800000,541900000,549900000,421400000,-43800000,-2900000,-57600000,-60500000,57821,KTOS
2020-12-31,,,41381000,,32712000,29566000,80435000,0,42591000,8278000,,,,,8669000,80435000,37844000,0,-1210000,,32712000,32712000,57823,WTBA
2019-12-31,,,35742000,,28690000,32824000,74148000,0,36146000,5178000,,,,,7052000,74148000,38002000,0,-404000,,28690000,28690000,57823,WTBA
2018-12-31,,,35068000,,28508000,29342000,70060000,0,36086000,4632000,,,,,6560000,70060000,33974000,0,-1018000,,28508000,28508000,57823,WTBA
2017-12-31,,,36438000,,23070000,26741000,68705000,0,37115000,4849000,,,,,13368000,68705000,31590000,0,-677000,,23070000,23070000,57823,WTBA
2019-12-31,,,-25284000,,-25940000,30018000,17165000,-15784000,-15784000,,-18911000,,,,656000,162059000,177843000,144894000,-9500000,,-25940000,-25940000,57824,HDSN
2018-12-31,,,-57363000,,-55659000,32270000,-7365000,-42608000,-42608000,,-14755000,,,,-1704000,166525000,209133000,173890000,-42155000,,-55659000,-55659000,57824,HDSN
2017-12-31,,,12004000,,11157000,15445000,38817000,22265000,22265000,,-3156000,,,,847000,140380000,118115000,101563000,-10261000,,11157000,11157000,57824,HDSN
2016-12-31,,,17265000,,10637000,11651000,31086000,18947000,18947000,,-1118000,,,,6628000,105481000,86534000,74395000,-1682000,,10637000,10637000,57824,HDSN
2020-10-31,,,57302629,,57302629,7371270,21172654,13801384,13801384,,-5044662,,,,0,21172654,7371270,0,43501245,,57302629,57302629,57826,CHW
2019-10-31,,,45044709,,45044709,7725217,25946097,18220880,18220880,,-8271411,,,,0,25946097,7725217,0,26823829,,45044709,45044709,57826,CHW
2018-10-31,,,-22988582,,-22988582,8529450,26130767,17601317,17601317,,-7250989,,,,0,26130767,8529450,0,-40589899,,-22988582,-22988582,57826,CHW
2017-10-31,,,111328198,,111328198,7756646,24472804,16716158,16716158,,-3587281,,,,0,24472804,7756646,0,94612040,,111328198,111328198,57826,CHW
2019-12-31,,,3802000000,2349000000,2936000000,-13000000,10273000000,4531000000,4531000000,1732000000,-1616000000,,,,774000000,34438000000,29907000000,24165000000,-729000000,,3028000000,2936000000,57827,EXC
2018-12-31,,,2197000000,2306000000,2005000000,47000000,10003000000,4416000000,4416000000,1783000000,-1554000000,,,,118000000,35978000000,31562000000,25975000000,-2219000000,,2079000000,2005000000,57827,EXC
2017-12-31,,,3743000000,2291000000,3779000000,109000000,10117000000,4711000000,4711000000,1731000000,-1560000000,,,,-126000000,33558000000,28847000000,23441000000,-968000000,,3869000000,3779000000,57827,EXC
2016-12-31,,,1949000000,1775000000,1121000000,116000000,9134000000,4278000000,4278000000,1576000000,-1536000000,,,,753000000,31366000000,27088000000,22232000000,-2329000000,,1196000000,1121000000,57827,EXC
2019-12-31,247730000,,-4802969000,-940592000,-2797570000,4007635000,6644022000,-2180775000,-2180775000,4562363000,-2794668000,,,,-1905996000,52323525000,54504300000,45679503000,-2622194000,,-2896973000,-2797570000,57830,BAK
2018-12-31,219256000,,3652501000,-876400000,2866675000,3482364000,11446934000,7405309000,7405309000,427013000,-2174762000,,,,745291000,57999866000,50594557000,46552932000,-3752808000,,2907210000,2866675000,57830,BAK
2017-12-31,167456000,,5264577000,-827501000,3865440000,2893880000,13083186000,9385549000,9385549000,636301000,-2284274000,,,,1357682000,49260594000,39875045000,36177408000,-4120972000,8876000.0,3906895000,3865440000,57830,BAK
2016-12-31,162010000,,-140010000,-1017880000,-411472000,2689286000,12678419000,8951544000,8951544000,875579000,-2503501000,,,,616046000,47663988000,38712444000,34985569000,-9091554000,26859000.0,-756056000,-411472000,57830,BAK
2020-12-31,,,47389000,,59543000,164549000,240065000,0,54862000,20654000,,,,,-12154000,240065000,185203000,0,-7473000,,59543000,59543000,57833,LOB
2019-12-31,,,23465000,,18034000,142629000,187787000,0,28341000,16817000,,,,,5431000,187787000,159446000,0,-4876000,,18034000,18034000,57833,LOB
2018-12-31,,,46046000,,51448000,128830000,198409000,0,53048000,16531000,,,,,-5402000,198409000,145361000,0,-7002000,,51448000,51448000,57833,LOB
2017-12-31,,,98254000,,100499000,113246000,240523000,0,110952000,16325000,,,,,-2245000,240523000,129571000,0,-12698000,,100499000,100499000,57833,LOB
2020-12-31,100800000,,-30100000,400000,33300000,1024000000,1203000000,78200000,78200000,,-62500000,,,,-63400000,2282000000,2203800000,1079000000,-108300000,,33300000,33300000,57834,NVST
2019-12-31,154700000,,275500000,2600000,217600000,1069400000,1516100000,292000000,292000000,,-3500000,,,,57900000,2751600000,2459600000,1235500000,-16500000,,217600000,217600000,57834,NVST
2018-12-31,172000000,,301100000,3300000,230700000,1076800000,1609600000,360800000,360800000,,-3500000,,,,70400000,2844500000,2483700000,1234900000,-59700000,,230700000,230700000,57834,NVST
2017-12-31,172400000,,386700000,4100000,301100000,1032600000,1627500000,422500000,422500000,,-3500000,,,,85600000,2810900000,2388400000,1183400000,-35800000,,301100000,301100000,57834,NVST
2020-12-31,,,282900000,,211700000,192900000,771100000,287700000,287700000,,-13600000,,,,71200000,4552800000,4265100000,3781700000,-4800000,,211700000,211700000,57835,SNDR
2019-12-31,,,198100000,,147000000,225700000,864300000,345700000,345700000,,-16600000,,,,51100000,4747000000,4401300000,3882700000,-147600000,,147000000,147000000,57835,SNDR
2018-12-31,,,364600000,,268900000,240700000,915900000,383900000,383900000,,-17100000,,,,95700000,4977000000,4593100000,4061100000,-19300000,,268900000,268900000,57835,SNDR
2017-12-31,,,263400000,,389900000,196100000,756800000,281700000,281700000,,-19400000,,,,-126500000,4383600000,4101900000,3626800000,-18300000,,389900000,389900000,57835,SNDR
2020-12-31,27573000000,,48082000000,,40269000000,28998000000,97795000000,41224000000,41224000000,,-135000000,,,,7813000000,182527000000,141303000000,84732000000,6858000000,,40269000000,40269000000,57836,GOOGL
2019-12-31,26018000000,,39625000000,,34343000000,27461000000,89961000000,36482000000,36482000000,,-100000000,,,,5282000000,161857000000,125375000000,71896000000,3143000000,,34343000000,34343000000,57836,GOOGL
2018-12-31,21419000000,,34913000000,,30736000000,23256000000,77270000000,32595000000,32595000000,,-114000000,,,,4177000000,136819000000,104224000000,59549000000,2318000000,,30736000000,30736000000,57836,GOOGL
2017-12-31,16625000000,,27193000000,,12662000000,19733000000,65272000000,28914000000,28914000000,,-109000000,,,,14531000000,110855000000,81941000000,45583000000,-1721000000,,12662000000,12662000000,57836,GOOGL
2019-12-31,,,4610000,,6231000,120186000,157017000,36831000,36831000,,-51260000,,,,-1621000,1459763000,1422932000,1302746000,-32221000,,6231000,-19726000,57838,IEA
2018-12-31,,,-8698000,,4244000,49562000,31526000,-18036000,-18036000,,-12080000,,,,-12942000,779343000,797379000,747817000,9338000,,4244000,-43644000,57838,IEA
2017-12-31,,,30388000,,16525000,33543000,66021000,32478000,32478000,,-2201000,,,,13863000,454949000,422471000,388928000,-2090000,,16525000,16525000,57838,IEA
2016-12-31,,,54238000,,65538000,30705000,85246000,54541000,54541000,,-516000,,,,-10213000,602665000,548124000,517419000,-303000,1087000.0,64451000,65538000,57838,IEA
2020-12-31,,,62300000,,116600000,1373700000,2080500000,706800000,706800000,,-307600000,,,,-54300000,6393600000,5686800000,4313100000,-644500000,,116600000,52000000,57839,AVTR
2019-12-31,,,40600000,,37800000,1339500000,1920700000,581200000,581200000,,-440000000,,,,2800000,6040300000,5459100000,4119600000,-540600000,,37800000,-335100000,57839,AVTR
2018-12-31,,,-113800000,,-86900000,1319200000,1840000000,519800000,519800000,1000000.0,-523800000,,,,-26900000,5864300000,5344500000,4024300000,-633600000,,-86900000,-356400000,57839,AVTR
2017-12-31,,,-460200000,,-112700000,376000000,474600000,97600000,97600000,1000000.0,-200900000,,,,-314900000,1247400000,1149800000,772800000,-557800000,,-145300000,-414900000,57839,AVTR
2019-12-31,,,191900000,,141000000,79700000,367900000,213300000,213300000,1300000,-35700000,,,,50900000,1981500000,1768200000,1613600000,-21400000,,141000000,138400000,57840,AJRD
2018-12-31,,,188600000,,137300000,101400000,346500000,171500000,171500000,2600000,-34400000,,,,51300000,1895900000,1724400000,1549400000,17100000,,137300000,134400000,57840,AJRD
2017-12-31,,,86900000,,-9200000,120200000,315000000,117200000,117200000,8900000,-30900000,,,,96100000,1877200000,1760000000,1562200000,-30300000,,-9200000,-9200000,57840,AJRD
2016-12-31,,,29200000,,18000000,103600000,283900000,96400000,96400000,19700000,-32500000,,,,11200000,1761300000,1664900000,1477400000,-67200000,,18000000,17600000,57840,AJRD
2019-12-28,3682000,,-8765000,,-8813000,23231000,17939000,-8974000,-8974000,,,,,,48000,43447000,52421000,25508000,418000,,-8813000,-8813000,57841,IRIX
2018-12-29,4006000,,-12776000,,-12813000,26333000,17471000,-12868000,-12868000,,,,,,37000,42600000,55468000,25129000,92000,,-12813000,-12813000,57841,IRIX
2017-12-30,5208000,,-12995000,,-12867000,23323000,15503000,-13028000,-13028000,,,,,,-128000,41593000,54621000,26090000,33000,,-12867000,-12867000,57841,IRIX
2016-12-31,5365000,,-2656000,,-11713000,17919000,20839000,-2445000,-2445000,,,,,,9057000,46158000,48603000,25319000,-211000,,-11713000,-11713000,57841,IRIX
2020-06-30,16638000,,7986000,,7208000,27604000,51648000,7406000,7406000,,,,,,778000,72729000,65323000,21081000,580000,,7208000,7208000,57844,EGAN
2019-06-30,14369000,,5001000,,4168000,25500000,45391000,5522000,5522000,,-319000.0,,,,833000,67232000,61710000,21841000,-521000,,4168000,4168000,57844,EGAN
2018-06-30,14711000,,-2177000,,-1991000,25248000,38971000,-988000,-988000,,-983000.0,,,,-186000,61307000,62295000,22336000,-1189000,,-1991000,-1991000,57844,EGAN
2017-06-30,13753000,,-5487000,,-6020000,26988000,37016000,-3725000,-3725000,,-1730000.0,,,,533000,58215000,61940000,21199000,-1762000,,-6020000,-6020000,57844,EGAN
2019-12-31,,,-9305224,3084122,-6589431,55345141,45548128,0,-9797013,,,,,,-3355366,54561372,64358385,9013244,491789,,-5949858,-6589431,57845,TIGR
2018-12-31,,,-46166668,733206,-43207732,44236718,29744604,0,-14492114,,,,,,-1873113,33560265,48052379,3815661,-31674554,,-44293555,-43207732,57845,TIGR
2017-12-31,,,-9111192,-464878,-7510049,22983052,13967842,0,-9015210,,,,,,-1183698,16949184,25964394,2981342,-95982,,-7927494,-7510049,57845,TIGR
2016-12-31,,,-13372997,110816,-10758453,15894076,3555796,0,-12338280,,,,,,-2561709,5475837,17814117,1920041,-1034717,,-10811288,-10758453,57845,TIGR
2020-12-31,,,145079000,,122044000,253227000,499924000,0,175949000,70748000,,,,,23035000,499924000,323975000,0,-30870000,,122044000,119400000,57846,WSBCP
2019-12-31,,,193214000,,158873000,220859000,505422000,0,221907000,62656000,,,,,34341000,505422000,283515000,0,-28693000,,158873000,158873000,57846,WSBCP
2018-12-31,,,174524000,,143112000,186421000,439748000,0,202606000,50721000,,,,,31412000,439748000,237142000,0,-28082000,,143112000,143112000,57846,WSBCP
2017-12-31,,,148289000,,94482000,166141000,369149000,0,157678000,45330000,,,,,53807000,369149000,211471000,0,-9389000,,94482000,94482000,57846,WSBCP
2020-12-31,,,-44372000,,-44372000,38600000,17707000,-20893000,-20893000,,-23202000,,,,0,132299000,153192000,114592000,-23479000,,-44372000,-44372000,57847,IMGN
2019-12-31,,,-104133000,,-104133000,38489000,-32251000,-70740000,-70740000,,-16974000,,,,0,82271000,153011000,114522000,-33393000,,-104133000,-104133000,57847,IMGN
2018-12-31,,,-168843000,,-168843000,36746000,-121010000,-157756000,-157756000,,-10726000,,,,0,53446000,211202000,174456000,-11087000,,-168843000,-168843000,57847,IMGN
2017-12-31,,,-96012000,,-96012000,33911000,-24292000,-58203000,-58203000,,-16722000,,,,0,115447000,173650000,139739000,-37809000,,-96012000,-96012000,57847,IMGN
2019-12-31,,,1351000,18197000,-2434000,26583000,26749000,166000,166000,,,,,,3541000,182283000,182117000,155534000,1185000,,-2190000,-2434000,57848,RYB
2018-12-31,,,746000,6239000,-1789000,28661000,25634000,-3027000,-3027000,,,,,,2459000,156498000,159525000,130864000,3773000,,-1713000,-1789000,57848,RYB
2017-12-31,,,10353000,1549000,7115000,20192000,29526000,9334000,9334000,,,,,,3812000,140803000,131469000,111277000,1019000,,6541000,7115000,57848,RYB
2016-12-31,,,8042000,453000,6505000,9346000,16897000,7551000,7551000,,,,,,2155000,108513000,100962000,91616000,491000,,5887000,6505000,57848,RYB
2020-03-31,2358968,,15532122,,12688035,12661619,30419304,15398717,15398717,,-98086,,,,2844087,65061953,49663236,34642649,133405,,12688035,12688035,57849,HAPP
2019-03-31,2161708,,21905133,,18721979,8242487,32247068,21842873,21842873,,-83549,,,,3183154,63936185,42093312,31689117,62260,,18721979,18721979,57849,HAPP
2018-03-31,1857818,,20361633,,17489940,7253597,29352200,20240785,20240785,,-133284,,,,2871693,61495527,41254742,32143327,120848,,17489940,17489940,57849,HAPP
2017-03-31,1655007,,17020865,,14516030,6956270,25816807,17205530,17205530,,-493725,,,,2504835,52995670,35790140,27178863,-184665,,14516030,14516030,57849,HAPP
2020-12-31,,,45723000,,38332000,95192000,154977000,0,50945000,8840000,,,,,7391000,154977000,104032000,0,-5222000,,38332000,36871000,57852,FISI
2019-12-31,,,59421000,,48862000,90902000,162249000,0,61676000,9440000,,,,,10559000,162249000,100573000,0,-2255000,,48862000,47401000,57852,FISI
2018-12-31,,,49532000,,39526000,86629000,150408000,0,55114000,8409000,,,,,10006000,150408000,95294000,0,-5582000,,39526000,38065000,57852,FISI
2017-12-31,,,43471000,,33526000,78160000,132784000,0,46833000,7544000,,,,,9945000,132784000,85951000,0,-3362000,,33526000,32064000,57852,FISI
2019-12-31,30391000,,-9665000,,-9665000,61139000,80279000,-11251000,-11251000,,-8000,,,,0,117850000,129101000,37571000,1586000,,-9665000,-9665000,57856,VCEL
2018-12-31,13599000,,-8137000,,-8137000,49007000,58697000,-3909000,-3909000,,-1732000,,,,0,90857000,94766000,32160000,-4228000,,-8137000,-8137000,57856,VCEL
2017-12-31,12944000,,-17286000,,-17286000,35610000,33570000,-14984000,-14984000,,-1107000,,,,0,63924000,78908000,30354000,-2302000,,-17286000,-17286000,57856,VCEL
2016-12-31,15295000,,-19566000,,-19566000,27388000,26076000,-16607000,-16607000,,-314000,,,,0,54383000,70990000,28307000,-2959000,,-19566000,-27145000,57856,VCEL
2020-12-31,,,1154006000,,880690000,304453000,1718309000,0,1180221000,233635000,,,,,273316000,1718309000,538088000,0,-26215000,,880690000,870956000,57860,SLMBP
2019-12-31,,,743740000,,578276000,311081000,1317993000,0,743740000,263172000,,,,,165464000,1317993000,574253000,0,0,,578276000,561439000,57860,SLMBP
2018-12-31,,,559329000,,487476000,285132000,1116305000,0,559329000,271844000,,,,,71853000,1116305000,556976000,0,0,,487476000,471836000,57860,SLMBP
2017-12-31,,,491465000,,288934000,242269000,940554000,0,491465000,206820000,,,,,202531000,940554000,449089000,0,0,,288934000,273220000,57860,SLMBP
2020-12-31,24207000,,-17174000,,-16682000,141136000,167784000,2441000,2441000,,-16698000,,,,-492000,253227000,250786000,85443000,-19615000,,-16682000,-16682000,57862,CRY
2019-12-31,22960000,,1644000,,1720000,143011000,183013000,17042000,17042000,,-14886000,,,,-76000,276222000,259180000,93209000,-15398000,,1720000,1708000,57862,CRY
2018-12-31,23098000,,-6391000,,-2840000,140574000,175784000,12112000,12112000,,-15788000,,,,-3551000,262841000,250729000,87057000,-18503000,,-2840000,-2813000,57862,CRY
2017-12-31,19461000,,3561000,,3704000,101211000,131342000,10670000,10670000,,-4881000,,,,-143000,189702000,179032000,58360000,-7109000,,3704000,3641000,57862,CRY
2019-12-31,,,9497000,937000,12060000,3827000,8137000,-2106000,-2106000,,-7632000,,,,-287000,18988000,21094000,10851000,11603000,,9784000,12060000,57863,ELLO
2018-12-31,,,819000,-1558000,1057000,3600000,8897000,-446000,-446000,-73000.0,-5140000,,,,215000,18117000,18563000,9220000,1265000,,604000,1057000,57863,ELLO
2017-12-31,,,-6269000,-1141000,-6115000,2420000,8348000,1428000,1428000,-18000.0,-3639000,,,,372000,13636000,12208000,5288000,-7697000,,-6641000,-6115000,57863,ELLO
2016-12-31,,,-63000,-701000,-209000,2032000,7349000,996000,996000,-90000.0,-3101000,,,,569000,11632000,10636000,4283000,-1059000,,-632000,-209000,57863,ELLO
2020-09-30,136500000,,271200000,,223000000,833500000,1475100000,396100000,396100000,,-74000000,,,,48200000,2881000000,2484900000,1405900000,-124900000,,223000000,223000000,57864,HRC
2019-09-30,139500000,,208600000,,152200000,798300000,1425000000,364800000,364800000,,-89600000,,,,56400000,2907300000,2542500000,1482300000,-156200000,,152200000,152200000,57864,HRC
2018-09-30,135600000,,197200000,,252400000,770700000,1394200000,381000000,381000000,,-95000000,,,,-55200000,2848000000,2467000000,1453800000,-183800000,,252400000,252400000,57864,HRC
2017-09-30,133700000,,183000000,7400000.0,133600000,851700000,1325400000,340000000,340000000,,-88900000,,,,50700000,2743700000,2403700000,1418300000,-157000000,,132300000,133600000,57864,HRC
2019-12-31,,,-3062000,12983000,-2464000,11344000,12468000,-4467000,-4467000,,-4436000,,,,-275000,30003000,34470000,17535000,1405000,320000,-2787000,-2464000,57865,STRS
2018-12-31,,,-6042000,22665000,-3982000,10314000,5901000,-7237000,-7237000,,-11000,,,,-695000,24989000,32226000,19088000,1195000,1361000,-5347000,-3982000,57865,STRS
2017-12-31,,,17788000,80000,3879000,11401000,19566000,312000,312000,,-6449000,,,,13904000,80340000,80028000,60774000,17476000,1361000,3884000,3879000,57865,STRS
2016-12-31,,,-8778000,75000,-5999000,12164000,21423000,1177000,1177000,,-9190000,,,,-2779000,80341000,79164000,58918000,-9955000,1361000,-5999000,-5999000,57865,STRS
2020-01-31,54726000,,-3604000,,-15949000,121557000,170863000,-5688000,-5688000,,-998000,,,,12345000,310772000,316460000,139909000,2084000,,-15949000,-15949000,57866,QADA
2019-01-31,53993000,,11917000,,10428000,113455000,177132000,9573000,9573000,,-694000,,,,1489000,333016000,323443000,155884000,2344000,,10428000,10428000,57866,QADA
2018-01-31,47661000,,-4208000,,-9065000,110590000,155593000,-3074000,-3074000,,-292000,,,,4857000,305018000,308092000,149425000,-1134000,,-9065000,-9065000,57866,QADA
2017-01-31,43587000,,3826000,,-15450000,99512000,147122000,3364000,3364000,,-185000,,,,19276000,277973000,274609000,130851000,462000,,-15450000,-15450000,57866,QADA
2020-01-31,200000,,5753000,,3281000,31821000,37897000,5876000,5876000,,-116000,,,,2472000,107809000,101933000,69912000,-123000,,3281000,3281000,57867,LAKE
2019-01-31,200000,,3481000,,1459000,30141000,33906000,3565000,3565000,,-125000,,,,2022000,99011000,95446000,65105000,-84000,,1459000,1459000,57867,LAKE
2018-01-31,280000,,8343000,,440000,27446000,36203000,8477000,8477000,,-163000,,,,7903000,95987000,87510000,59784000,-134000,,440000,440000,57867,LAKE
2017-01-31,463000,,6273000,,3893000,24327000,31837000,7047000,7047000,,-620000,,,,2380000,86183000,79136000,54346000,-774000,,3893000,3893000,57867,LAKE
2019-12-31,3520000000,,-19579000000,,-19363000000,26351000000,11259000000,-18612000000,-18612000000,,-980000000,,,,-216000000,60104000000,78716000000,48845000000,-967000000,,-19363000000,-19348000000,57869,OZON
2018-12-31,2123000000,,-5588000000,,-5661000000,13309000000,9558000000,-5874000000,-5874000000,,-66000000,,,,73000000,37220000000,43094000000,27662000000,286000000,,-5661000000,-5632000000,57869,OZON
2020-12-31,,,1078033000,,901248000,431008000,1548499000,1117491000,1117491000,,-39458000,,,,176785000,7562791000,6445300000,6014292000,-39458000,,901248000,901248000,57871,NVR
2019-12-31,,,1025795000,,878539000,447547000,1497677000,1050130000,1050130000,,-24335000,,,,147256000,7425585000,6375455000,5927908000,-24335000,,878539000,878539000,57871,NVR
2018-12-31,,,959732000,,797197000,428874000,1412642000,983768000,983768000,,-24036000,,,,162535000,7187106000,6203338000,5774464000,-24036000,,797197000,797197000,57871,NVR
2017-12-31,,,846911000,,537521000,392272000,1262220000,869948000,869948000,,-23037000,,,,309390000,6320226000,5450278000,5058006000,-23037000,,537521000,537521000,57871,NVR
2020-01-31,,,57503000,3872000,42699000,329301000,375089000,42871000,42871000,,-930000,,,,15124000,700966000,658095000,325877000,14632000,,42379000,42699000,57873,MOV
2019-01-31,,,61733000,3721000,61624000,290742000,369958000,76316000,76316000,,-771000,,,,162000,679567000,603251000,309609000,-14583000,,61571000,61624000,57873,MOV
2018-01-31,,,42142000,3721000,-15225000,236591000,300178000,63587000,63587000,,-1510000,,,,57367000,567953000,504366000,267775000,-21445000,,-15225000,-15225000,57873,MOV
2017-01-31,,,51454000,3721000,35061000,239036000,294817000,55781000,55781000,,-1464000,,,,16315000,552752000,496971000,257935000,-4327000,,35139000,35061000,57873,MOV
2019-12-31,,,71572000,,61202000,98335000,592811000,167966000,167966000,68978000,-76644000,,,,11589000,1452183000,1284217000,859372000,-96394000,1219000,59983000,61202000,57874,ATSG
2018-12-31,,,87478000,,69285000,40555000,377519000,124462000,124462000,33607000,-28807000,,,,19595000,892345000,767883000,514826000,-36984000,1402000,67883000,69285000,57874,ATSG
2017-12-31,,,-6536000,,18495000,32210000,311843000,93295000,93295000,31782000,-15623000,,,,-28276000,1068200000,974905000,756357000,-99831000,-3245000,21740000,18495000,57874,ATSG
2016-12-31,,,34454000,,23488000,24504000,248375000,64948000,64948000,23427000,-10318000,,,,13394000,768870000,703922000,520495000,-30494000,2428000,21060000,23488000,57874,ATSG
2019-12-31,,,-32759000,5654000,-33589000,74006000,119285000,6187000,6187000,,-40653000,,,,830000,371854000,365667000,252569000,-38946000,,-33589000,-33589000,57875,PRTH
2018-12-31,,,-20326000,5654000,-17836000,65190000,106538000,21608000,21608000,,-29935000,,,,-2490000,375822000,354214000,269284000,-41934000,,-17836000,-17881000,57875,PRTH
2017-12-31,,,3839000,5654000,3839000,52163000,103660000,36823000,36823000,,-25058000,,,,0,382167000,345344000,278507000,-32984000,,3839000,3603000,57875,PRTH
2016-12-31,,,20186000,5654000,20186000,49186000,87094000,23175000,23175000,,-4777000,,,,0,344114000,320939000,257020000,-2989000,,20186000,20085000,57875,PRTH
2020-08-31,,,-7056000,16126000,-7128000,3726000,0,-5295000,-5295000,,-5493000,,,,72000,0,5295000,0,-1761000,,-7128000,-7128000,57877,PLG
2019-08-31,,,-16670000,15451000,-16776000,3824000,0,-4611000,-4611000,,-8355000,,,,106000,0,4611000,0,-12059000,,-16776000,-16776000,57877,PLG
2018-08-31,,,-41024000,11152000,-38682000,20521000,0,-20598000,-20598000,,-18414000,,,,0,0,20598000,0,-20426000,,-41024000,-38682000,57877,PLG
2017-08-31,,,-588716000,-11908000,-542415000,5749000,0,-6893000,-6893000,,-367000,,,,1655000,0,6893000,0,-581823000,,-590371000,-542415000,57877,PLG
2020-12-31,,,224694000,,169078000,109816000,709707000,227438000,227438000,109167000,-4215000,,,,55616000,2372178000,2144740000,1662471000,-2744000,,169078000,169078000,57878,WERN
2019-12-31,,,221906000,,166944000,88913000,661636000,203915000,203915000,119281000,-6854000,,,,54962000,2463701000,2259786000,1802065000,17991000,,166944000,166944000,57878,WERN
2018-12-31,,,223881000,,168148000,82933000,632147000,214517000,214517000,104546000,-2695000,,,,55733000,2457914000,2243397000,1825767000,9364000,,168148000,168148000,57878,WERN
2017-12-31,,,144557000,,202889000,79927000,546442000,137022000,137022000,111854000,-2243000,,,,-58332000,2116737000,1979715000,1570295000,7535000,,202889000,202889000,57878,WERN
2020-12-31,,,50272000,,41876000,52231000,124246000,0,55572000,16443000,,,,,8396000,124246000,68674000,0,-5300000,,41876000,41876000,57879,FMNB
2019-12-31,,,43075000,,35760000,49627000,108530000,0,44909000,13994000,,,,,7315000,108530000,63621000,0,-1834000,,35760000,35760000,57879,FMNB
2018-12-31,,,38283000,,32569000,47930000,101000000,0,40445000,12625000,,,,,5714000,101000000,60555000,0,-2162000,,32569000,32569000,57879,FMNB
2017-12-31,,,33161000,,22711000,46442000,94347000,0,36412000,11493000,,,,,10450000,94347000,57935000,0,-3251000,,22711000,22711000,57879,FMNB
2019-12-31,,,-11967000,8769000,-19155000,77614000,105090000,16633000,16633000,,-8250000,,,,4174000,218227000,201594000,113137000,-28600000,,-16141000,-19155000,57880,CNTY
2018-12-31,,,5923000,7062000,3394000,60194000,79029000,9436000,9436000,,-4217000,,,,1917000,168938000,159502000,89909000,-3513000,,4006000,3394000,57880,CNTY
2017-12-31,,,12451000,7421000,6259000,50526000,74086000,14615000,14615000,,-3661000,,,,4560000,154069000,139454000,79983000,-2264000,,7891000,6259000,57880,CNTY
2016-12-31,,,15600000,6388000,9215000,44147000,68820000,16324000,16324000,,-3160000,,,,1787000,139234000,122910000,70414000,-724000,,13813000,9215000,57880,CNTY
2020-11-30,88599000,,96635000,,79722000,154117000,387933000,117271000,117271000,,-10170000,,,,16913000,442150000,324879000,54217000,-20636000,,79722000,79722000,57881,PRGS
2019-11-30,88572000,,28495000,,26400000,155061000,363941000,72169000,72169000,,-9913000,,,,2095000,413298000,341129000,49357000,-43674000,,26400000,26400000,57881,PRGS
2018-11-30,79739000,,60796000,,49670000,142086000,334742000,76942000,76942000,,-5149000,,,,11126000,378981000,302039000,44239000,-16146000,,49670000,49670000,57881,PRGS
2017-11-30,76988000,,52463000,,29021000,145290000,340103000,84678000,84678000,,-4631000,,,,23442000,389154000,304476000,49051000,-32215000,,29021000,29021000,57881,PRGS
2020-12-31,10307000000,,8791000000,,7067000000,9486000000,34562000000,14769000000,14769000000,,,,,,1709000000,47994000000,33225000000,13432000000,-5978000000,,7082000000,7067000000,57882,MRK
2019-12-31,8742000000,,11464000000,94000000.0,9843000000,9863000000,33684000000,15079000000,15079000000,,-893000000.0,,,,1687000000,46840000000,31761000000,13156000000,-3615000000,,9777000000,9843000000,57882,MRK
2018-12-31,9308000000,,8701000000,181000000.0,6220000000,9555000000,28806000000,9943000000,9943000000,,-772000000.0,,,,2508000000,42294000000,32351000000,13488000000,-1242000000,,6193000000,6220000000,57882,MRK
2017-12-31,9845000000,,6521000000,233000000.0,2394000000,9560000000,27406000000,8001000000,8001000000,,-754000000.0,,,,4103000000,40122000000,32121000000,12716000000,-1480000000,,2418000000,2394000000,57882,MRK
2020-12-31,,,91946000,,66289000,494351000,796342000,0,215721000,86270000,,,,,25657000,796342000,580621000,0,-123775000,,66289000,56539000,57883,TCBIP
2019-12-31,,,396310000,,312015000,512113000,982160000,0,408576000,61471000,,,,,84295000,982160000,573584000,0,-12266000,,312015000,302265000,57883,TCBIP
2018-12-31,,,373351000,,293387000,443622000,905884000,0,397658000,64604000,,,,,79964000,905884000,508226000,0,-24307000,,293387000,283637000,57883,TCBIP
2017-12-31,,,325708000,,197063000,377564000,791584000,0,355655000,58365000,,,,,128645000,791584000,435929000,0,-29947000,,197063000,187313000,57883,TCBIP
2020-06-30,,,14189000,-1000,8900000,310911000,328558000,17051000,17051000,,-500000,,,,5289000,589837000,572786000,261279000,-2862000,,8900000,8900000,57884,ETH
2019-06-30,,,33860000,63000,25698000,356880000,411485000,54605000,54605000,,-87000,,,,8162000,746684000,692079000,335199000,-20745000,,25698000,25698000,57884,ETH
2018-06-30,,,49067000,139000,36371000,367097000,415964000,48867000,48867000,,-325000,,,,12696000,766784000,717917000,350820000,200000,,36371000,36371000,57884,ETH
2017-06-30,,,56995000,190000,36194000,361773000,419723000,57950000,57950000,,-955000,,,,20801000,763385000,705435000,343662000,-955000,,36194000,36194000,57884,ETH
2020-03-31,41463000,,-33866000,,-34067000,44238000,80952000,-9864000,-9864000,,-9000,,,,201000,160757000,170621000,79805000,-24002000,,-34067000,-34067000,57885,AGYS
2019-03-31,37817000,,-12943000,,-13164000,42764000,73880000,-11772000,-11772000,,-10000,,,,221000,140842000,152614000,66962000,-1171000,,-13164000,-13164000,57885,AGYS
2018-03-31,27936000,,-11601000,,-8350000,42103000,64417000,-10132000,-10132000,,-10000,,,,-3251000,127360000,137492000,62943000,-1469000,,-8350000,-8350000,57885,AGYS
2017-03-31,29048000,,-11485000,,-11721000,40698000,63785000,-9762000,-9762000,261000.0,-15000,,,,236000,127678000,137440000,63893000,-1723000,,-11721000,-11721000,57885,AGYS
2019-12-31,,,791893000,135346000,662325000,114591000,1660708000,1001510000,1001510000,61352000,-428586000,,,,13472000,2746174000,1744664000,1085466000,-209617000,,778421000,662325000,57888,WES
2018-12-31,,,507446000,2552777000,369429000,67195000,1403292000,895797000,895797000,51136000,-191831000,,,,58934000,2299658000,1403861000,896366000,-388351000,,448512000,369429000,57888,WES
2017-12-31,,,513279000,2883754000,376607000,53949000,1130205000,700426000,700426000,57059000,-142520000,,,,-59923000,2429614000,1729188000,1299409000,-187147000,,573202000,376607000,57888,WES
2016-12-31,,,594026000,3062623000,334446000,49248000,1002066000,637083000,637083000,42802000,-116628000,,,,8372000,1804270000,1167187000,802204000,-43057000,,585654000,334446000,57888,WES
2019-12-31,,,-105385000,,-105385000,33937000,-79309000,-113246000,-113246000,,,,,,0,21219000,134465000,100528000,7861000,,-105385000,-105385000,57891,ALEC
2018-12-31,,,-52248000,,-52248000,11934000,-45354000,-57288000,-57288000,,,,,,0,27677000,84965000,73031000,5040000,,-52248000,-52248000,57891,ALEC
2017-12-31,,,-32480000,,-32480000,6503000,-26176000,-32679000,-32679000,,,,,,0,3735000,36414000,29911000,199000,,-32480000,-32480000,57891,ALEC
2016-12-31,,,-15110000,,-15110000,1874000,-13258000,-15132000,-15132000,,,,,,0,416000,15548000,13674000,22000,,-15110000,-15110000,57891,ALEC
2019-12-31,,,78500613,,78500613,5279302,19695258,14415956,14415956,,-1515715,,,,0,19695258,5279302,0,64084657,,78500613,78500613,57892,AEF
2018-12-31,,,-97006720,,-97006720,5557812,16864056,10863302,10863302,442942.0,-876764,,,,0,16864056,6000754,0,-107870022,,-97006720,-97006720,57892,AEF
2017-12-31,,,26707639,,26707639,1471432,2038508,293370,293370,273706.0,-876764,,,,0,2038508,1745138,0,26414269,,26707639,26707639,57892,AEF
2016-12-31,,,10953562,,10953562,1236111,2015607,433464,433464,346032.0,-876764,,,,0,2015607,1582143,0,10520098,,10953562,10953562,57892,AEF
2020-06-30,,,1960000,38903000,-5661000,372836000,544471000,157824000,157824000,,-35154000,,,,7007000,1885305000,1727481000,1340834000,-155864000,,-5047000,-5661000,57893,KMT
2019-06-30,,,311235000,39532000,241925000,459551000,833996000,360034000,360034000,,-32994000,,,,63359000,2375234000,2015200000,1541238000,-48799000,,247876000,241925000,57893,KMT
2018-06-30,,,275041000,36002000,200180000,485449000,823623000,323506000,323506000,,-30081000,,,,69981000,2367853000,2044347000,1544230000,-48465000,,205060000,200180000,57893,KMT
2017-06-30,,,81875000,35359000,49138000,483268000,652616000,152770000,152770000,,-28842000,,,,29895000,2058368000,1905598000,1405752000,-70895000,,51980000,49138000,57893,KMT
2020-05-30,,,-1214000,,-1838000,51327000,49673000,-1654000,-1654000,,,,,,624000,155898000,157552000,106225000,440000,,-1838000,-1838000,57895,RELL
2019-06-01,,,-6311000,,-7328000,52156000,51735000,-421000,-421000,,,,,,1017000,166652000,167073000,114917000,-5890000,,-7328000,-7328000,57895,RELL
2018-06-02,,,3860000,,3822000,51729000,55082000,3353000,3353000,,,,,,1534000,163212000,159859000,108130000,507000,1496000.0,2326000,3822000,57895,RELL
2017-05-27,,,-6116000,,-6928000,48554000,43883000,-4671000,-4671000,,,,,,812000,136872000,141543000,92989000,-1445000,1496000.0,-6928000,-6928000,57895,RELL
2020-12-31,,,14022000000,758000000,11370000000,33147000000,58369000000,0,14022000000,11200000000,,,,,2592000000,58369000000,44347000000,0,0,-20000000,11430000000,10201000000,57898,C
2019-12-31,,,23901000000,704000000,19401000000,32354000000,66068000000,0,23901000000,9813000000,,,,,4430000000,66068000000,42167000000,0,0,-4000000,19471000000,18171000000,57898,C
2018-12-31,,,23445000000,854000000,18045000000,32216000000,65500000000,0,23445000000,9839000000,,,,,5357000000,65500000000,42055000000,0,0,-8000000,18088000000,16671000000,57898,C
2017-12-31,,,22761000000,932000000,-6798000000,32151000000,65272000000,0,23092000000,10029000000,,,,,29388000000,65272000000,42180000000,0,-331000000,-111000000,-6627000000,-8048000000,57898,C
2020-09-30,43765000,,7463000,,8411000,86129000,148459000,14078000,14078000,,-3592000,,,,-948000,279271000,265193000,130812000,-6615000,,8411000,8411000,57899,DGII
2019-09-30,37564000,,11145000,,9958000,68906000,121998000,12565000,12565000,,-102000,,,,1187000,254203000,241638000,132205000,-1420000,,9958000,9958000,57899,DGII
2018-09-30,33178000,,3250000,,1631000,71416000,111925000,4460000,4460000,,-25000,,,,1619000,226893000,222433000,114968000,-1210000,,1631000,1631000,57899,DGII
2017-09-30,28566000,,9550000,,9403000,51250000,88677000,7417000,7417000,,-48000,,,,147000,181340000,173923000,92663000,2133000,,9403000,9403000,57899,DGII
2020-02-01,,,221569000,,175056000,401682000,673966000,217284000,217284000,,,,,,46513000,1846730000,1629446000,1172764000,4285000,,175056000,175056000,57901,FIVE
2019-02-02,,,191807000,,149645000,336401000,565085000,187184000,187184000,,,,,,42162000,1559563000,1372379000,994478000,4623000,,149645000,149645000,57901,FIVE
2018-02-03,,,158849000,,102451000,272822000,463413000,157391000,157391000,,,,,,56398000,1278208000,1120817000,814795000,1458000,,102451000,102451000,57901,FIVE
2017-01-28,,,114261000,,71840000,216475000,357037000,113962000,113962000,,,,,,42421000,1000410000,886448000,643373000,299000,,71840000,71840000,57901,FIVE
2019-12-31,,,88015000,476000,68211000,40518000,403552000,52173000,52173000,268442000,-3135000,,,,20039000,996383000,944210000,592831000,35842000,,67976000,68211000,57903,NHC
2018-12-31,,,74884000,1179000,58964000,40923000,395960000,59105000,59105000,254038000,-4697000,,,,16185000,978681000,919576000,582721000,15779000,,58699000,58964000,57903,NHC
2017-12-31,,,74549000,694000,56205000,40367000,391852000,59000000,59000000,249833000,-4890000,,,,18867000,963895000,904895000,572043000,15549000,,55682000,56205000,57903,NHC
2016-12-31,,,80207000,694000,50538000,41292000,375573000,64483000,64483000,230775000,-3941000,,,,29669000,923580000,859097000,548007000,15724000,,50538000,50538000,57903,NHC
2019-12-31,,,22103000,,-3995000,17898000,89470000,25627000,25627000,3060000,-4256000,,,,26098000,140096000,114469000,50626000,-3524000,,-3995000,-3995000,57907,TGA
2018-12-31,,,42017000,,15677000,20791000,122929000,46026000,46026000,7321000,-5075000,,,,26340000,176227000,130201000,53298000,-4009000,,15677000,15677000,57907,TGA
2017-12-31,,,-56917000,,-78736000,17748000,97459000,-50598000,-50598000,11248000,-6233000,,,,21819000,148464000,199062000,51005000,-6319000,,-78736000,-78736000,57907,TGA
2016-12-31,,,-75219000,,-87665000,18430000,22799000,-66217000,-66217000,7983000,-6068000,,,,12446000,63134000,129351000,40335000,-9002000,,-87665000,-87665000,57907,TGA
2020-02-01,,,-56285000,,-56296000,195951000,163637000,-40371000,-40371000,,-3777000,,,,11000,501822000,542193000,338185000,-15914000,,-56296000,-56296000,57908,IMBI
2019-02-02,,,-22092000,,-22157000,217800000,206847000,-17196000,-17196000,,-3502000,,,,65000,596637000,613833000,389790000,-4896000,,-22157000,-22157000,57908,IMBI
2018-02-03,,,-3302000,,143000,224490000,235112000,4252000,4252000,,-5084000,,,,-3445000,648220000,643968000,413108000,-7554000,,143000,143000,57908,IMBI
2017-01-28,,,-7944000,,-8745000,230394000,241527000,3092000,3092000,,-5937000,,,,801000,666213000,663121000,424686000,-11036000,,-8745000,-8745000,57908,IMBI
2019-12-31,283859000,,-342997000,,-337497000,52095000,0,-335954000,-335954000,,-6481000,,,,-5500000,0,335954000,0,-7043000,,-337497000,-337497000,57909,ORPH
2018-12-31,194393000,,-235100000,,-229600000,37259000,0,-231652000,-231652000,,-2824000,,,,-5500000,0,231652000,0,-3448000,,-229600000,-229600000,57909,ORPH
2017-12-31,97556000,,-131704000,,-126204000,33486000,0,-131042000,-131042000,,-688000,,,,-5500000,0,131042000,0,-677000,,-126204000,-126204000,57909,ORPH
2016-12-31,55817000,,-63435000,,-57935000,7703000,0,-63520000,-63520000,,-71000,,,,-5500000,0,63520000,0,85000,,-57935000,-57935000,57909,ORPH
2019-11-30,,,13009724,,13009724,3834477,26577952,22743475,22743475,,-4749000,,,,0,26577952,3834477,0,-9733751,,13009724,13009724,57912,PHD
2018-11-30,,,8519438,,8519438,3679495,26103512,22424017,22424017,,-4134125,,,,0,26103512,3679495,0,-13904579,,8519438,8519438,57912,PHD
2017-11-30,,,15896069,,15896069,3905320,24290995,20385675,20385675,,-2938605,,,,0,24290995,3905320,0,-4489606,,15896069,15896069,57912,PHD
2016-11-30,,,22763469,,22763469,4021805,25100443,21078638,21078638,,-1924262,,,,0,25100443,4021805,0,1684831,,22763469,22763469,57912,PHD
2019-12-31,,,31628000,106634000,31291000,80385000,305065000,56375000,56375000,,-26593000,,,,-37000,479345000,422970000,174280000,-24747000,,31665000,-4717000,57913,QTS
2018-12-31,,,-10543000,102701000,-4460000,80857000,287352000,56604000,56604000,,-28749000,,,,-3368000,450524000,393920000,163172000,-67147000,,-7175000,-22073000,57913,QTS
2017-12-31,,,-8321000,113242000,1282000,87231000,271882000,43727000,43727000,,-30523000,,,,-9778000,446510000,402783000,174628000,-52048000,,1457000,689000,57913,QTS
2016-12-31,,,14709000,118342000,21525000,83286000,257035000,48963000,48963000,,-23159000,,,,-9976000,402363000,353400000,145328000,-34254000,,24685000,21525000,57913,QTS
2020-12-31,,,35666000,,27194000,29614000,80315000,0,35666000,15035000,,,,,8472000,80315000,44649000,0,0,,27194000,27194000,57914,BWB
2019-12-31,,,38326000,,31403000,26668000,72033000,0,38326000,7039000,,,,,6923000,72033000,33707000,0,0,,31403000,31403000,57914,BWB
2018-12-31,,,32144000,,26920000,22313000,60413000,0,32144000,5956000,,,,,5224000,60413000,28269000,0,0,,26920000,26920000,57914,BWB
2017-12-31,,,27038000,,16889000,17226000,50618000,0,27038000,6354000,,,,,10149000,50618000,23580000,0,0,,16889000,16889000,57914,BWB
2019-12-31,7385000,,5349000,,5277000,29842000,44555000,7328000,7328000,,-4571000,,,,72000,51865000,44537000,7310000,-1979000,,5277000,2991000,57915,CSTL
2018-12-31,4854000,,-6358000,,-6367000,16471000,17489000,-3836000,-3836000,,-2274000,,,,9000,22786000,26622000,5297000,-2522000,,-6367000,-10163000,57915,CSTL
2017-12-31,13419408,,-37079394,,-37108587,45775794,26496174,-32699028,-32699028,,-4948782,,,,29193,41261736,73960764,14765562,-4380366,,-37108587,-45922281,57915,CSTL
2020-02-02,,,897393000,,645596000,1332768000,2223386000,890618000,890618000,,,,,,251797000,3979296000,3088678000,1755910000,6775000,,645596000,645596000,57916,LULU
2019-02-03,,,715250000,,483801000,1111844000,1816287000,704443000,704443000,,,,,,231449000,3288319000,2583876000,1472032000,10807000,,483801000,483801000,57916,LULU
2018-01-28,,,459998000,,258662000,911581000,1407488000,495907000,495907000,,,,,,201336000,2649181000,2153274000,1241693000,-35909000,,258662000,258662000,57916,LULU
2017-01-29,,,422729000,,303381000,770151000,1199617000,429466000,429466000,,-1700000.0,,,,119348000,2344392000,1914926000,1144775000,-6737000,,303381000,303381000,57916,LULU
2020-11-30,,,12140329,,12140329,1935779,14155237,12219458,12219458,,-1225797,,,,0,14155237,1935779,0,-79129,,12140329,12140329,57921,PFD
2019-11-30,,,28383584,,28383584,1981735,14147135,12165400,12165400,,-2522057,,,,0,14147135,1981735,0,16218184,,28383584,28383584,57921,PFD
2018-11-30,,,-7826063,,-7826063,1924529,13937998,12013469,12013469,,-2187209,,,,0,13937998,1924529,0,-19839532,,-7826063,-7826063,57921,PFD
2017-11-30,,,24298756,,24298756,2013822,13991289,11977467,11977467,,-1574476,,,,0,13991289,2013822,0,12321289,,24298756,24298756,57921,PFD
2020-12-31,272312000000,,130280000000,209010000000,83318000000,993009000000,1375868000000,110547000000,110547000000,,-854000000,,,,34337000000,3160243000000,3049696000000,1784375000000,19733000000,,95943000000,83318000000,57922,CAJ
2019-12-31,298503000000,,195740000000,199323000000,125105000000,1124457000000,1610033000000,187073000000,187073000000,,-1038000000,,,,56223000000,3593299000000,3406226000000,1983266000000,8667000000,,139517000000,125105000000,57922,CAJ
2018-12-31,315842000000,,362892000000,190311000000,252755000000,1160076000000,1835554000000,359636000000,359636000000,,-797000000,,,,96150000000,3951937000000,3592301000000,2116383000000,3256000000,,266742000000,252755000000,57922,CAJ
2017-12-31,333371000000,,353884000000,225545000000,241923000000,1291792000000,1990554000000,365391000000,365391000000,,-818000000,,,,98024000000,4080015000000,3714624000000,2089461000000,-11507000000,,255860000000,241923000000,57922,CAJ
2019-12-31,516095,,3156109,,3148234,10650021,14137956,2971840,2971840,,-166897,,,,7875,41797179,38825339,27659223,184269,,3148234,2445616,57924,RVP
2018-12-31,621365,,-1353261,,-1339943,11190482,10221802,-1590045,-1590045,,-177190,,,,-13318,33274702,34864747,23052900,236784,,-1339943,-2044939,57924,RVP
2017-12-31,740567,,-3923646,,-3736038,13009601,9971588,-3778580,-3778580,,-210761,,,,-187608,34493838,38272418,24522250,-145066,,-3736038,-4441034,57924,RVP
2016-12-31,571842,,-3693775,,-3694907,12821096,10342055,-3050883,-3050883,,-213295,,,,1132,29826636,32877519,19484581,-642892,,-3694907,-4399903,57924,RVP
2020-09-26,,,153738000,871000,120676000,584581000,796558000,197977000,197977000,,-44016000,,,,32218000,2695509000,2497532000,1898951000,-44239000,,121520000,120676000,57925,CENTA
2019-09-28,,,119251000,170000,92786000,534933000,704041000,154608000,154608000,,-42614000,,,,26604000,2383010000,2228402000,1678969000,-35357000,,92647000,92786000,57925,CENTA
2018-09-29,,,127425000,385000,123594000,495340000,675376000,167336000,167336000,,-39196000,,,,3305000,2215362000,2048026000,1539986000,-39911000,,124120000,123594000,57925,CENTA
2017-09-30,,,126429000,1456000,78828000,467896000,632808000,156112000,156112000,,-28209000,,,,46699000,2054478000,1898366000,1421670000,-29683000,,79730000,78828000,57925,CENTA
2020-03-31,,,9350000,8376000,-3532000,136457000,304381000,57066000,57066000,-2723000,-27033000,,,,7681000,420400000,363334000,116019000,-47716000,,1669000,-3532000,57926,GB
2019-03-31,,,29843000,8426000,2350000,123937000,299999000,67654000,67654000,3275000,-27600000,,,,22956000,412956000,345302000,112957000,-37811000,,6887000,2350000,57926,GB
2018-03-31,,,27732000,8905000,15683000,142955000,328273000,84269000,84269000,14330000,-31520000,,,,8254000,421444000,337175000,93171000,-56537000,,19478000,15683000,57926,GB
2017-03-31,,,44243000,7305000,25682000,143819000,307816000,79045000,79045000,1516000,-38709000,,,,15642000,417851000,338806000,110035000,-34802000,,28601000,25682000,57926,GB
2019-12-31,4864000,,47145000,-518000,-12566000,62782000,117033000,49387000,49387000,,-1839000,,,,10355000,756542000,707155000,639509000,-2242000,-49216000,36790000,-12566000,57927,SHYF
2018-12-31,3771000,,21450000,-658000,15012000,46206000,73157000,23180000,23180000,,-1080000,,,,3334000,570527000,547347000,497370000,510000,-3104000,18116000,15012000,57927,SHYF
2017-12-31,3596000,,19853000,-658000,15935000,39329000,63072000,20147000,20147000,,-98000,,,,2382000,404248000,384101000,341176000,-294000,-1537000,17471000,15935000,57927,SHYF
2016-12-31,6772000,,8703000,-657000,8610000,56172000,73070000,10126000,10126000,,-410000,,,,100000,590777000,580651000,517707000,-1423000,-1537000,8603000,8610000,57927,SHYF
2019-12-31,1882434,,-3464492,,-3464492,1271987,0,-3154421,-3154421,,-197026,,,,0,0,3154421,0,-310071,,-3464492,-3464492,57928,VLON
2018-12-31,1813019,,-4312646,,-4312646,800688,0,-2613707,-2613707,,-197026,,,,0,0,2613707,0,-1698939,,-4312646,-4312646,57928,VLON
2019-12-31,,,23475000,,23475000,9818000,43352000,24935000,24935000,,-6306000,,,,0,44667000,19732000,1315000,-1460000,,23475000,21727000,57930,IIPR
2018-12-31,,,6985000,,6985000,6375000,14342000,5338000,5338000,,-6306000,,,,0,14787000,9449000,445000,3294000,,6985000,5455000,57930,IIPR
2017-12-31,,,-72000,,-72000,5497000,6302000,-110000,-110000,,-6306000,,,,0,6420000,6530000,118000,38000,,-72000,-454000,57930,IIPR
2016-12-31,,,-7529144,,-7529144,1529143,308571,-1266857,-1266857,,-6306000,,,,0,457714,1724572,149143,-6262287,,-7529144,-7529144,57930,IIPR
2020-12-31,,,-2850000000,969000000,-3093000000,1575000000,3607000000,-343000000,-343000000,-50000000,-468000000,,,,-11000000,4543000000,4886000000,936000000,-2507000000,,-2839000000,-3093000000,57932,HES
2019-12-31,,,221000000,974000000,-408000000,1634000000,4575000000,576000000,576000000,10000000,-380000000,,,,461000000,6311000000,5735000000,1736000000,-355000000,,-240000000,-412000000,57932,HES
2018-12-31,,,220000000,1259000000,-282000000,1516000000,4381000000,755000000,755000000,-116000000,-399000000,,,,335000000,6152000000,5397000000,1771000000,-535000000,,-115000000,-328000000,57932,HES
2017-12-31,,,-5778000000,1303000000,-4074000000,1854000000,4080000000,-2849000000,-2849000000,4000000,-325000000,,,,-1837000000,5347000000,8196000000,1267000000,-2929000000,,-3941000000,-4120000000,57932,HES
2020-01-31,54726000,,-3604000,,-15949000,121557000,170863000,-5688000,-5688000,,-998000,,,,12345000,310772000,316460000,139909000,2084000,,-15949000,-15949000,57933,QADB
2019-01-31,53993000,,11917000,,10428000,113455000,177132000,9573000,9573000,,-694000,,,,1489000,333016000,323443000,155884000,2344000,,10428000,10428000,57933,QADB
2018-01-31,47661000,,-4208000,,-9065000,110590000,155593000,-3074000,-3074000,,-292000,,,,4857000,305018000,308092000,149425000,-1134000,,-9065000,-9065000,57933,QADB
2017-01-31,43587000,,3826000,,-15450000,99512000,147122000,3364000,3364000,,-185000,,,,19276000,277973000,274609000,130851000,462000,,-15450000,-15450000,57933,QADB
2020-09-30,4554000,,6168000,,11874000,12044000,22639000,6041000,6041000,,,,,,-5706000,43010000,36969000,20371000,127000,,11874000,11874000,57935,GNSS
2019-09-30,4528000,,3357000,,2785000,10792000,18456000,3136000,3136000,,,,,,572000,36979000,33843000,18523000,221000,,2785000,2785000,57935,GNSS
2018-09-30,3523498,,-1369442,,-3745042,10692681,12739714,-1476465,-1476465,,-20949.0,,,,2375600,26306790,27783255,13567076,107023,,-3745042,-3745042,57935,GNSS
2017-09-30,2500053,,-679154,,-876754,8586288,10278601,-807740,-807740,,-20949.0,,,,197600,20314178,21121918,10035577,128586,,-876754,-876754,57935,GNSS
2019-12-31,,,14117000,9621000,20421000,73444000,131958000,8889000,8889000,,-7574000,,,,858000,344065000,335176000,212107000,5228000,,13259000,20421000,57937,CLNE
2018-12-31,,,-8842000,17011000,-3790000,77207000,133495000,4438000,4438000,,-15924000,,,,341000,346419000,341981000,212924000,-13280000,,-9183000,-3790000,57937,CLNE
2017-12-31,,,-83305000,22668000,-79237000,95715000,85770000,-73605000,-73605000,7046000.0,-17751000,,,,-1914000,341599000,415204000,255829000,-9700000,,-81391000,-79237000,57937,CLNE
2016-12-31,,,-12385000,24822000,-12153000,105503000,147106000,-17659000,-17659000,7046000.0,-29595000,,,,1339000,402656000,420315000,255550000,5274000,,-13724000,-12153000,57937,CLNE
2020-12-31,,,-185359000,,-186566000,182933000,-147183000,-330116000,-330116000,,-33291000,,,,1207000,271030000,601146000,418213000,144757000,,-186566000,-186566000,57938,RARE
2019-12-31,,,-399444000,,-402727000,161524000,-262649000,-424173000,-424173000,,-1135000,,,,3283000,103714000,527887000,366363000,24729000,,-402727000,-402727000,57938,RARE
2018-12-31,293998000.0,,-197097000,,-197611000,127724000,-243649000,-371373000,-371373000,,-1135000,,,,514000,51495000,422868000,295144000,174276000,,-197611000,-197611000,57938,RARE
2017-12-31,293998000.0,,-318338000,,-302139000,93909000,-229033000,-322942000,-322942000,,-1135000,,,,-16199000,2612000,325554000,231645000,4604000,,-302139000,-302139000,57938,RARE
2020-03-31,31812000,,-56641000,,-53531000,79874000,77438000,-47715000,-47715000,,-852000,,,,-3110000,120637000,168352000,43199000,-8926000,,-53531000,-53531000,57939,LSPD
2019-03-31,18283000,,-214254000,,-183525000,52833000,53878000,-21775000,-21775000,,-852000,,,,-30729000,77451000,99226000,23573000,-192479000,,-183525000,-183525000,57939,LSPD
2018-03-31,13295000,,-81933000,,-96179000,42453000,39600000,-21267000,-21267000,,-26000,,,,14246000,57079000,78346000,17479000,-60666000,,-96179000,-96179000,57939,LSPD
2017-03-31,13677000,,-54210000,,-58404000,38769000,27610000,-30643000,-30643000,,-26000,,,,4194000,42612000,73255000,15002000,-23567000,,-58404000,-58404000,57939,LSPD
2019-12-31,870279,,-985558,,-813558,5483586,5397189,-956676,-956676,,-90058,,,,-172000,17618559,18575235,12221370,-28882,,-813558,-813558,57940,IKNX
2018-12-31,677242,,185465,,139465,5350966,6254027,225819,225819,,-90583,,,,46000,18213653,17987834,11959626,-40354,,139465,139465,57940,IKNX
2017-12-31,688688,,-524147,,-226147,5506466,5730545,-464609,-464609,,-83080,,,,-298000,17243244,17707853,11512699,-59538,,-226147,-226147,57940,IKNX
2016-12-31,647065,,-69061,,-65061,5611849,6236910,-22004,-22004,,-58222,,,,-4000,17569901,17591905,11332991,-47057,,-65061,-65061,57940,IKNX
2020-12-31,,,38886000,1672000,28428000,15920000,59182000,0,39962000,3300000,,,,,10011000,59182000,19220000,0,-1076000,,28875000,28399000,57941,PKBK
2019-12-31,,,40072000,1819000,29841000,13973000,58024000,0,40543000,3508000,,,,,9785000,58024000,17481000,0,-471000,,30287000,29817000,57941,PKBK
2018-12-31,,,33415000,1439000,24824000,12180000,49710000,0,34446000,3084000,,,,,8377000,49710000,15264000,0,-1031000,,25038000,24378000,57941,PKBK
2017-12-31,,,24227000,1439000,11870000,11114000,39520000,0,25148000,3258000,,,,,12389000,39520000,14372000,0,-921000,,11838000,10751000,57941,PKBK
2019-12-31,1808422,,2184537,565555,2296555,65659037,72048842,4616144,4616144,-34761,-2605167,,,,249639,329479916,324863772,257431074,-2431607,,1934898,962337,57943,MOHO
2018-12-31,1669323,,6566991,6704434,6123990,49627408,58861574,7564843,7564843,-34761,-978477,,,,417124,199015036,191450193,140153462,-997852,,6149867,-21807558,57943,MOHO
2017-12-31,484089,,2804214,288503,2825457,25750263,29113522,2879170,2879170,-34761,-216576,,,,80576,98237569,95358399,69124047,-74956,,2723638,-1146824,57943,MOHO
2019-12-31,2298000,,-10099000,530000,-9497000,6731000,5696000,-3333000,-3333000,,-4479000,,,,0,13047000,16380000,7351000,-6766000,,-10099000,-9497000,57944,THMO
2018-12-31,3012000,,-45670000,-1711000,-39716000,8970000,2193000,-9789000,-9789000,,-2697000,,,,-4730000,9672000,19461000,7479000,-35881000,,-40940000,-39716000,57944,THMO
2017-12-31,3379000,,-8932000,-487000,-5534000,9609000,5060000,-7928000,-7928000,,-672000,,,,-2911000,12766000,20694000,7706000,-1004000,,-6021000,-5534000,57944,THMO
2017-06-30,2497000,,-29768000,-487000,-29095000,12401000,5839000,-9059000,-9059000,,-20519000,,,,-673000,14525000,23584000,8686000,-20709000,,-29095000,-29095000,57944,THMO
2020-04-30,,,-20068498,,-20068498,1988128,13687993,11699865,11699865,,-1758200,,,,0,13687993,1988128,0,-31768363,,-20068498,-20068498,57945,HNW
2019-04-30,,,1980850,,1980850,2010090,14101367,12091277,12091277,,-2017593,,,,0,14101367,2010090,0,-10110427,,1980850,1980850,57945,HNW
2018-04-30,,,5561725,,5561725,2152895,13976569,11823674,11823674,,-1545576,,,,0,13976569,2152895,0,-6261949,,5561725,5561725,57945,HNW
2017-04-30,,,20763847,,20763847,2146845,13817744,11670899,11670899,,-892656,,,,0,13817744,2146845,0,9092948,,20763847,20763847,57945,HNW
2019-12-31,188000000,,-108000000,104000000,-130000000,707000000,2116000000,583000000,583000000,,-589000000,,,,10000000,3400000000,2817000000,1284000000,-691000000,,-118000000,-130000000,57948,SGMS
2018-12-31,202000000,,-339000000,104000000,-352000000,697000000,2108000000,538000000,538000000,,-597000000,,,,13000000,3363000000,2825000000,1255000000,-877000000,,-352000000,-352000000,57948,SGMS
2017-12-31,184000000,,-227000000,104000000,-242000000,613000000,1920000000,440000000,440000000,,-610000000,,,,15000000,3084000000,2644000000,1164000000,-667000000,,-242000000,-242000000,57948,SGMS
2016-12-31,204800000,,-478700000,104000000,-353700000,584500000,1777100000,249100000,249100000,,-661400000,,,,-125000000,2883400000,2634300000,1106300000,-727800000,,-353700000,-353700000,57948,SGMS
2020-12-31,,,-461351000,,-272546000,258272000,660590000,140397000,140397000,42000000,-48739000,,,,-189759000,2171408000,2031011000,1510818000,-601748000,,-271592000,-272546000,57949,KEX
2019-12-31,,,189820000,2969000.0,142347000,304260000,808353000,242528000,242528000,41933000,-55994000,,,,46801000,2838399000,2595871000,2030046000,-52708000,,143019000,141978000,57949,KEX
2018-12-31,,,114159000,3114000.0,78452000,293857000,809751000,251671000,251671000,39251000,-46856000,,,,35081000,2970697000,2719026000,2160946000,-137512000,,79078000,78128000,57949,KEX
2017-12-31,,,73014000,3403000.0,313187000,219831000,656320000,204445000,204445000,29163000,-21472000,,,,-240889000,2214418000,2009973000,1558098000,-131431000,,313903000,310974000,57949,KEX
2020-12-31,,,27261000,,20347000,41342000,73778000,0,27279000,5157000,,,,,6914000,73778000,46499000,0,-18000,,20347000,20347000,57951,CVCY
2019-12-31,,,29952000,,21443000,39032000,76052000,0,30898000,6122000,,,,,8509000,76052000,45154000,0,-946000,,21443000,21443000,57951,CVCY
2018-12-31,,,27909000,,21289000,37670000,72513000,0,28738000,6105000,,,,,6620000,72513000,43775000,0,-829000,,21289000,21289000,57951,CVCY
2017-12-31,,,23819000,,14026000,35226000,68038000,0,26533000,6279000,,,,,9793000,68038000,41505000,0,-2714000,,14026000,14026000,57951,CVCY
2019-12-31,,,54900000,14000000,38600000,167300000,263800000,96500000,96500000,,-33800000,,,,15200000,1618300000,1521800000,1354500000,-41600000,,39700000,38600000,57952,PKOH
2018-12-31,,,71800000,13600000,53600000,167300000,271500000,104200000,104200000,,-34300000,,,,16600000,1658100000,1553900000,1386600000,-32400000,,55200000,53600000,57952,PKOH
2017-12-31,,,47700000,12000000,28600000,145900000,232800000,86900000,86900000,,-31500000,,,,18200000,1412900000,1326000000,1180100000,-39200000,,29500000,28600000,57952,PKOH
2016-12-31,,,41000000,10000000,31700000,128000000,201200000,73200000,73200000,,-28200000,,,,8800000,1276900000,1203700000,1075700000,-32200000,,32200000,31700000,57952,PKOH
2019-12-31,,,-9126000,,-7830000,5024000,-4658000,-9682000,-9682000,,,,,,-1296000,0,9682000,4658000,556000,,-7830000,-8031000,57954,CYCCP
2018-12-31,,,-8625000,,-7288000,5371000,-4177000,-9548000,-9548000,,,,,,-1337000,150000,9698000,4327000,923000,,-7288000,-7489000,57954,CYCCP
2017-12-31,,,-8463000,,-7470000,5254000,-4237000,-9491000,-9491000,,,,,,-993000,0,9491000,4237000,1028000,,-7470000,-14846000,57954,CYCCP
2016-12-31,,,-13774000,,-11791000,5516000,-8634000,-14150000,-14150000,,,,,,-1983000,843000,14993000,9477000,376000,,-11791000,-11991000,57954,CYCCP
2019-12-31,,,-109000000,118000000,-355000000,475000000,2232000000,177000000,177000000,25000000,-260000000,,,,-30000000,5969000000,5792000000,3737000000,-286000000,-274000000,-79000000,-357000000,57956,DVN
2018-12-31,,,944000000,118000000,3064000000,576000000,3440000000,1390000000,1390000000,9000000,-287000000,,,,230000000,8648000000,7258000000,5208000000,-446000000,2510000000,714000000,3056000000,57956,DVN
2017-12-31,,,40000000,4850000000,898000000,651000000,2165000000,142000000,142000000,18000000,-337000000,,,,7000000,6340000000,6198000000,4175000000,-102000000,1045000000,33000000,897000000,57956,DVN
2016-12-31,,,-433000000,4448000000,-1056000000,733000000,2201000000,-910000000,-910000000,136000000,-427000000,,,,141000000,6604000000,7514000000,4403000000,477000000,-884000000,-574000000,-1058000000,57956,DVN
2019-12-31,,,52491000,,41743000,200391000,301155000,67135000,67135000,-111000,-15648000,,,,10512000,876757000,809622000,575602000,-14644000,-236000,41979000,41743000,57957,HURN
2018-12-31,,,25221000,,13646000,180983000,273588000,53634000,53634000,149000,-19013000,,,,11277000,795125000,741491000,521537000,-28413000,-298000,13944000,13646000,57957,HURN
2017-12-31,,,-222504000,,-170117000,173664000,277764000,54694000,54694000,261000,-18613000,,,,-51999000,732570000,677876000,454806000,-277198000,388000,-170505000,-170117000,57957,HURN
2016-12-31,,,59157000,,37617000,160204000,288716000,81836000,81836000,37000,-16274000,,,,19677000,726272000,644436000,437556000,-22679000,-1863000,39480000,37617000,57957,HURN
2019-12-31,,,188445,,106901,404717,0,-404717,-404717,,,,,,81543,0,404717,0,593162,,106901,106901,57958,SRAC
2019-09-30,1777110,,6451677,178597,5392022,4614421,14622672,8231141,8231141,,-2149077,,,,1005190,65518316,57287175,50895644,-1779464,,5446487,5392022,57959,HUDI
2018-09-30,1447196,,6585624,132711,5196047,3447381,13243254,8091820,8091820,,-2082680,,,,1337092,60386004,52294184,47142750,-1506196,,5248532,5196047,57959,HUDI
2017-09-30,1447849,,11356731,86507,9235508,2754851,9673536,5096295,5096295,,-2039140,,,,2027935,49401482,44305187,39727946,6260436,,9328796,9235508,57959,HUDI
2020-12-31,,,244900000,416000000,167300000,664100000,1100800000,434700000,434700000,2000000,-128800000,,,,41600000,6559900000,6125200000,5459100000,-189800000,,203300000,167300000,57960,GPK
2019-12-31,,,354400000,792100000,206800000,551300000,1097300000,534900000,534900000,11100000,-140600000,,,,76300000,6160100000,5625200000,5062800000,-180500000,,278100000,206800000,57960,GPK
2018-12-31,,,348700000,714800000,221100000,457200000,952400000,489600000,489600000,5600000,-123700000,,,,54700000,6029400000,5539800000,5077000000,-140900000,,294000000,221100000,57960,GPK
2017-12-31,,,254700000,714800000,300200000,332700000,709500000,376900000,376900000,-100000,-89700000,,,,-45500000,4405600000,4028700000,3696100000,-122200000,,300200000,300200000,57960,GPK
2020-05-31,2568000,,-80717000,25807000,-84634000,163983000,190975000,2677000,2677000,,-34376000,,,,3917000,542339000,539662000,351364000,-83394000,,-84634000,-84634000,57961,APHA
2019-05-31,1391000,,-15645000,28409000,-16499000,123803000,75421000,-63857000,-63857000,,-7775000,,,,854000,237110000,300967000,161689000,48212000,,-16499000,-16499000,57961,APHA
2018-05-31,490000,,35856000,9580000,29448000,43648000,40887000,-7236000,-7236000,,-1350000,,,,6408000,36917000,44153000,-3970000,43092000,,29448000,29448000,57961,APHA
2017-05-31,492000,,4332000,9580000,4198000,13741000,17297000,2108000,2108000,,-387000,,,,134000,20438000,18330000,3141000,2224000,,4198000,4198000,57961,APHA
2020-12-31,,,100582000,,77764000,160144000,286134000,0,109970000,16020000,,,,,22818000,286134000,176164000,0,-9388000,,77764000,77764000,57966,SBCF
2019-12-31,,,128612000,,98739000,130461000,288395000,0,135514000,15177000,,,,,29873000,288395000,152881000,0,-6902000,,98739000,98739000,57966,SBCF
2018-12-31,,,87534000,,67275000,128172000,249527000,0,96310000,17222000,,,,,20259000,249527000,153217000,0,-8776000,,67275000,67275000,57966,SBCF
2017-12-31,,,79201000,,42865000,123727000,229117000,0,84588000,15535000,,,,,36336000,229117000,144529000,0,-7887000,,42865000,42865000,57966,SBCF
2019-12-31,,,-28880000,,40809000,359042000,597927000,152764000,152764000,,-68939000,,,,-69689000,5401516000,5248752000,4803589000,-181644000,,40809000,40371000,57968,PARR
2018-12-31,,,39760000,,39427000,262559000,407612000,96511000,96511000,,-35268000,,,,333000,3410728000,3314217000,3003116000,-56751000,,39427000,38871000,57968,PARR
2017-12-31,,,71302000,,72621000,248097000,388439000,94353000,94353000,,-29332000,,,,-1319000,2443066000,2348713000,2054627000,-23051000,,72621000,71743000,57968,PARR
2016-12-31,,,-53747000,,-45835000,211356000,228706000,-14267000,-14267000,,-22306000,,,,-7912000,1865045000,1879312000,1636339000,-39480000,,-45835000,-45835000,57968,PARR
2020-06-30,89000000,,-68300000,,-71600000,768200000,836700000,-20500000,-20500000,,,,,,3300000,1825900000,1846400000,989200000,-47800000,,-71600000,-71600000,57972,PTON
2019-06-30,54800000,,-195500000,,-195600000,518900000,383500000,-190200000,-190200000,,,,,,100000,915000000,1105200000,531500000,-5300000,,-195600000,-245700000,57972,PTON
2018-06-30,23400000,,-47800000,,-47900000,212300000,189600000,-46100000,-46100000,,-300000.0,,,,100000,435000000,481100000,245400000,-1700000,,-47900000,-47900000,57972,PTON
2017-06-30,13000000,,-71100000,,-71100000,131600000,73900000,-70700000,-70700000,,-300000.0,,,,0,218600000,289300000,144700000,-400000,,-71100000,-163400000,57972,PTON
2019-12-28,,,25765000,,20476000,56695000,105680000,43501000,43501000,,-17136000,,,,5289000,199676000,156175000,93996000,-17736000,,20476000,20476000,57976,WING
2018-12-29,,,26927000,,21719000,42179000,87419000,40927000,40927000,,-10123000,,,,5208000,153181000,112254000,65762000,-14000000,,21719000,21719000,57976,WING
2017-12-30,,,28742000,,23940000,34898000,72147000,33873000,33873000,,-5131000,,,,4802000,133319000,99446000,61172000,-5131000,,23940000,23940000,57976,WING
2016-12-31,,,21957000,,13769000,34552000,64167000,26607000,26607000,,-4396000,,,,8188000,103324000,76717000,39157000,-4650000,,13769000,13769000,57976,WING
2019-12-31,,,188323000,188929000,85612000,51657000,234807000,183150000,183150000,,-1524000,,,,32020000,628414000,445264000,393607000,10509000,,156303000,85612000,57977,WHD
2018-12-31,,,169801000,184670000,65331000,40529000,218230000,177701000,177701000,,-3723000,,,,19520000,544135000,366434000,325905000,-7900000,,150281000,51683000,57977,WHD
2017-12-31,,,68096000,184670000,66547000,27177000,116040000,88863000,88863000,,-20772000,,,,1549000,341191000,252328000,225151000,-20767000,,66547000,66547000,57977,WHD
2016-12-31,,,-7367000,184670000,-8176000,19207000,29822000,10615000,10615000,,-20235000,,,,809000,155048000,144433000,125226000,-17982000,,-8176000,-8176000,57977,WHD
2019-12-31,383886857,,33348128,21454870,39753232,1044837964,1196156917,-131669848,-131669848,-100898056,,,,,0,7283230253,7414900101,6087073336,165017976,,33348128,25469469,57978,DOYU
2018-12-31,329334413,,-876279828,21454870,-876279828,735722552,151026898,-859119990,-859119990,-54910077,,,,,0,3654383126,4513503116,3503356228,-17159838,,-876279828,-882941495,57978,DOYU
2017-12-31,212114009,,-612897944,21454870,-612897944,410924312,-4651776,-618387515,-618387515,-9302582,,,,,0,1885717001,2504104516,1890368777,5489571,,-612897944,-612897944,57978,DOYU
2016-12-31,93454164,,-782891758,21454870,-782891758,318490807,-368239762,-777561834,-777561834,-2622899,-8904370.0,,,,0,786841976,1564403810,1155081738,-5329924,,-782891758,-1067834816,57978,DOYU
2019-12-31,,,-401000000,2000000,-311000000,210000000,628000000,-35000000,-35000000,,-195000000,,,,-90000000,2022000000,2057000000,1394000000,-366000000,,-311000000,-311000000,57979,FWONK
2018-12-31,,,-200000000,3000000,-150000000,204000000,554000000,-110000000,-110000000,,-192000000,,,,-50000000,1827000000,1937000000,1273000000,-90000000,,-150000000,-150000000,57979,FWONK
2017-12-31,,,-304000000,2000000,255000000,199000000,564000000,-40000000,-40000000,,-220000000,,,,-561000000,1783000000,1823000000,1219000000,-264000000,,257000000,255000000,57979,FWONK
2016-12-31,,,500000000,2000000,329000000,58000000,0,-68000000,-68000000,,-19000000,,,,171000000,0,68000000,0,568000000,,329000000,329000000,57979,FWONK
2020-06-27,440166000,,678096000,,654694000,296722000,1432652000,691757000,691757000,929000,-35797000,,,,23402000,2191395000,1499638000,758743000,-13661000,,654694000,654694000,57984,MXIM
2019-06-29,435222000,,754421000,,827486000,308617000,1500506000,753483000,753483000,143000,-43543000,,,,-73065000,2314329000,1560846000,813823000,938000,,827486000,827486000,57984,MXIM
2018-06-30,450943000,,824885000,,467318000,322918000,1626121000,849400000,849400000,-1607000,-50215000,,,,357567000,2480066000,1630666000,853945000,-24515000,,467318000,467318000,57984,MXIM
2017-06-24,453977000,,679589000,,571613000,291511000,1449980000,718247000,718247000,-22944000,-34274000,,,,107976000,2295615000,1577368000,845635000,-38658000,,571613000,571613000,57984,MXIM
2019-12-31,,,-80483000,,-80483000,71860000,-1762000,-76843000,-76843000,,-5461000,,,,0,166235000,243078000,167997000,-3640000,,-80483000,-80483000,57986,SFT
2018-12-31,,,-44866000,,-44866000,44697000,5389000,-41838000,-41838000,,-3171000,,,,0,131812000,173650000,126423000,-3028000,,-44866000,-44866000,57986,SFT
2017-12-31,,,-25646000,,-25646000,28570000,4539000,-25598000,-25598000,,-261000,,,,0,94538000,120136000,89999000,-48000,,-25646000,-25646000,57986,SFT
2019-12-31,,,4495082,,4494510,1202739,5704571,0,4498082,3750,,,,,572,5704571,1206489,0,-3000,,4494510,4494510,57989,LOAN
2018-12-31,,,4205066,,4204424,1321724,5525498,0,4202066,1708,,,,,642,5525498,1323432,0,3000,,4204424,4204424,57989,LOAN
2017-12-31,,,3441505,,3438534,1227003,4692209,0,3461505,3701,,,,,2971,4692209,1230704,0,-20000,,3438534,3438534,57989,LOAN
2016-12-31,,,2839106,,2836960,1005653,3868441,0,2854106,8682,,,,,2146,3868441,1014335,0,-15000,,2836960,2836960,57989,LOAN
2019-12-31,,,5730253000,2230737000,3839189000,2890817000,10796409000,7575889000,7575889000,329703000,-1444246000,,,,1686453000,38952001000,31376112000,28155592000,-1845636000,,4043800000,3839189000,57990,LOMA
2018-12-31,,,4741942000,2114549000,2768786000,2961734000,10484227000,7290202000,7290202000,232291000,-781356000,,,,1741314000,41237747000,33947545000,30753520000,-2548260000,,3000628000,2768786000,57990,LOMA
2017-12-31,,,3899742146,992738468,3509779198,1958000257,6317600130,4192921358,4192921358,166678515,-417026586,,,,221946197,24838612883,20645691525,18521012753,-293179212,,3677795949,3509779198,57990,LOMA
2016-12-31,,,759751371,390144836,491173013,925181997,2605771836,1636564616,1636564616,44025223,-593592292,,,,257734325,9874443208,8237878592,7268671372,-876813245,,502017046,491173013,57990,LOMA
2019-12-31,390585000,,2856480000,63524000,2372850000,1156149000,4455043000,2646427000,2646427000,,-235620000,,,,481962000,5962757000,3316330000,1507714000,27296000,,2374518000,2372850000,57993,FINV
2018-12-31,317965000,,2620657000,61856000,2469074000,1412107000,3618187000,1906679000,1906679000,192749000.0,-60085000,,,,151206000,4603758000,2697079000,985571000,713978000,,2469451000,2469074000,57993,FINV
2017-12-31,164869000,,1357618000,60021000,1082983000,1376955000,2968299000,1544758000,1544758000,46586000.0,-15598000,,,,274711000,3942821000,2398063000,974522000,-187140000,,1082907000,-1990488000,57993,FINV
2016-12-31,164869000,,549757000,60021000,501490000,590760000,880505000,255040000,255040000,34705000.0,-18191000,,,,48267000,1268654000,1013614000,388149000,294717000,,501490000,-60532000,57993,FINV
2019-12-31,,,6600000,89800000,1800000,26700000,73900000,12400000,12400000,,-5800000,,,,2200000,336900000,324500000,263000000,-5800000,,4400000,1800000,57994,RNGR
2018-12-31,,,-5800000,90100000,-3300000,29000000,66200000,6900000,6900000,,-3700000,,,,0,303100000,296200000,236900000,-12700000,,-5800000,-3300000,57994,RNGR
2017-12-31,,,-26900000,92000000,-21800000,30400000,27600000,-20600000,-20600000,,-6300000,,,,400000,154000000,174600000,126400000,-6300000,,-27300000,-6600000,57994,RNGR
2016-12-31,,,-5000000,92000000,-5000000,11400000,13500000,-4500000,-4500000,,-500000,,,,0,52800000,57300000,39300000,-500000,,-5000000,-5000000,57994,RNGR
2019-12-31,19874000,,120136000,,86920000,206886000,389709000,154285000,154285000,8664000,-17300000,,,,33216000,1476353000,1322068000,1086644000,-34149000,,86920000,86920000,57996,OEC
2018-12-31,20320000,,168254000,,121310000,231918000,429971000,176276000,176276000,1457000,-22800000,,,,46944000,1578203000,1401927000,1148232000,-8022000,,121310000,121310000,57996,OEC
2017-12-31,18159000,,84596000,,64860000,217180000,377596000,134576000,134576000,7681000,-44135000,,,,19736000,1328297000,1193721000,950701000,-49980000,,64860000,64860000,57996,OEC
2016-12-31,16069000,,73872000,,49509000,204157000,374435000,149991000,149991000,4218000,-39100000,,,,24363000,1139291000,989300000,764856000,-76119000,,49509000,49509000,57996,OEC
2019-12-31,,,-32202000,,-32202000,18272000,-15993000,-34265000,-34265000,,,,,,0,20109000,54374000,36102000,2063000,,-32202000,-32202000,57997,SQZ
2018-12-31,,,-20234000,,-20234000,8694000,-11710000,-20404000,-20404000,,-59000.0,,,,0,12669000,33073000,24379000,170000,,-20234000,-20234000,57997,SQZ
2019-12-31,,,-89200000,,-80800000,47400000,-23900000,-72100000,-72100000,800000,-25100000,,,,-8400000,1836600000,1908700000,1860500000,-17100000,,-80800000,-80800000,57998,CENX
2018-12-31,,,-66400000,,-66200000,40200000,-22900000,-63500000,-63500000,400000,-22400000,,,,-200000,1893200000,1956700000,1916100000,-2900000,,-66200000,-66200000,57998,CENX
2017-12-31,,,56200000,,48600000,44800000,131300000,84400000,84400000,2100000,-22200000,,,,7600000,1589100000,1504700000,1457800000,-28200000,,48600000,44700000,57998,CENX
2016-12-31,,,-249600000,,-252400000,45200000,-6100000,-207400000,-207400000,156100000,-22200000,,,,2800000,1319100000,1526500000,1325200000,-42200000,,-252400000,-252400000,57998,CENX
2019-12-31,30100000,,-84500000,,-78000000,125300000,249700000,51700000,51700000,,-102400000,,,,-6500000,293300000,241600000,43600000,-136200000,,-78000000,-78000000,58000,ZI
2018-12-31,6100000,,-31500000,,-28600000,63100000,114200000,30300000,30300000,,-58200000,,,,-2900000,144300000,114000000,30100000,-61800000,,-28600000,-28600000,58000,ZI
2020-03-31,,,-5423000,,-5423000,19681000,19716000,0,-5290000,5325000,,,,,0,19716000,25006000,0,-133000,,-5423000,-5423000,58001,CARV
2019-03-31,,,-5936000,,-5936000,20224000,22008000,0,-5298000,7082000,,,,,0,22008000,27306000,0,-638000,,-5936000,-5936000,58001,CARV
2018-03-31,,,5321000,,5354000,19801000,33303000,0,6153000,7349000,,,,,-33000,33303000,27150000,0,-832000,,5354000,2148000,58001,CARV
2017-03-31,,,-2734000,,-2853000,19348000,25797000,0,-2071000,8520000,,,,,119000,25797000,27868000,0,-663000,,-2853000,-2853000,58001,CARV
2020-03-31,,,-89069000,-6558000,-92491000,604809000,489709000,-114473000,-114473000,-627000,-58000,,,,8724000,1295850000,1410323000,806141000,25404000,,-97793000,-92491000,58003,RUHN
2019-03-31,,,-74510000,-1256000,-73246000,424514000,342045000,-81542000,-81542000,-927000,-107000,,,,10413000,1093438000,1174980000,751393000,7032000,,-84923000,-73246000,58003,RUHN
2018-03-31,,,-74111000,18477210,-104005000,377255000,304195000,-72351000,-72351000,-709000,-107000,,,,15843000,947580000,1019931000,643385000,-1760000,,-89954000,-104005000,58003,RUHN
2017-03-31,,,-24894763,18477210,-55383671,234331735,212674331,-21825771,-21825771,168367,-1573958,,,,15242611,577902804,599728575,365228473,-3068992,,-40137374,-55383671,58003,RUHN
2020-12-31,,,-73100000,,-53500000,,392000000,17500000,17500000,239600000,-135900000,,,,-19600000,4513700000,4496200000,4121700000,-90600000,,-53500000,-53500000,58004,YELL
2019-12-31,,,-108300000,,-104000000,,401200000,7600000,7600000,241200000,-111200000,,,,-4300000,4871200000,4863600000,4470000000,-115900000,,-104000000,-104000000,58004,YELL
2018-12-31,,,31300000,,20200000,,509200000,112700000,112700000,248800000,-105800000,,,,11100000,5092000000,4979300000,4582800000,-81400000,,20200000,20200000,58004,YELL
2017-12-31,,,-18100000,,-10800000,,491200000,97800000,97800000,245700000,-102800000,,,,-7300000,4891000000,4793200000,4399800000,-115900000,,-10800000,-10800000,58004,YELL
2019-12-31,,,-2275000,,-2613000,7758000,-2730000,-9025000,-9025000,-1463000,,,,,338000,14299000,23324000,17029000,6750000,,-2613000,-2819000,58005,AAMC
2018-12-31,,,-10501000,,-10876000,5214000,-2577000,-6608000,-6608000,-1183000,,,,,375000,14743000,21351000,17320000,-3893000,,-10876000,-11082000,58005,AAMC
2017-12-31,,,-6261000,,-6969000,6114000,-2092000,-7347000,-7347000,-859000,,,,,708000,17301000,24648000,19393000,1086000,,-6969000,-7175000,58005,AAMC
2016-12-31,,,-3229000,,-4935000,6945000,1806000,-4323000,-4323000,-816000,,,,,1706000,19175000,23498000,17369000,1094000,,-4935000,-5142000,58005,AAMC
2019-12-31,,,2313000000,1876000000,2197000000,132000000,4196000000,2495000000,2495000000,,-1078000000,,,,315000000,10829000000,8334000000,6633000000,-182000000,363000000,1998000000,2055000000,58008,SRE
2018-12-31,,,888000000,2110000000,1049000000,157000000,3679000000,2031000000,2031000000,,-887000000,,,,-49000000,10102000000,8071000000,6423000000,-1143000000,188000000,937000000,924000000,58008,SRE
2017-12-31,,,1319000000,2470000000,256000000,127000000,3599000000,2036000000,2036000000,,-623000000,,,,938000000,9640000000,7604000000,6041000000,-717000000,-31000000,381000000,256000000,58008,SRE
2016-12-31,,,1907000000,2290000000,1370000000,71000000,3009000000,1626000000,1626000000,,-556000000,,,,389000000,10183000000,8557000000,7174000000,281000000,-31000000,1518000000,1370000000,58008,SRE
2020-12-31,,,-1762275000,,-2067245000,720849000,352642000,-1232045000,-1232045000,67455000,-556474000,,,,564671000,2095861000,3327906000,1743219000,-530230000,,-2326946000,-2067245000,58009,WYNN
2019-12-31,,,488218000,-201573000.0,122985000,896670000,4784046000,898591000,898591000,2240000000,-414030000,,,,176840000,6611099000,5712508000,1827053000,-410373000,,311378000,122985000,58009,WYNN
2018-12-31,,,305740000,-219334000.0,572430000,761415000,5071385000,1257201000,1257201000,2442156000,-381849000,,,,-497344000,6717660000,5460459000,1646275000,-951461000,,803084000,572430000,58009,WYNN
2017-12-31,,,560269000,130504000.0,747181000,685485000,4512975000,1055565000,1055565000,2199576000,-388664000,,,,-328985000,6070160000,5014595000,1557185000,-495296000,,889254000,747181000,58009,WYNN
2019-12-31,,,-29522000,,-29528000,12165000,441000,-11989000,-11989000,,-17072000,,,,6000,441000,12430000,0,-17533000,,-29528000,-29528000,58014,CDZI
2018-12-31,,,-26267000,,-26273000,11402000,440000,-11220000,-11220000,,-16792000,,,,6000,440000,11660000,0,-15047000,,-26273000,-26273000,58014,CDZI
2017-12-31,,,-33860000,,-33864000,12803000,437000,-12640000,-12640000,,-15162000,,,,4000,437000,13077000,0,-21220000,,-33864000,-33864000,58014,CDZI
2016-12-31,,,-26335000,,-26339000,9330000,412000,-9210000,-9210000,,-14875000,,,,4000,412000,9622000,0,-17125000,,-26339000,-26339000,58014,CDZI
2020-12-31,1024327000,,149185000,,118503000,2309181000,3532371000,198863000,198863000,,-32746000,,,,30682000,4519484000,4320621000,987113000,-49678000,,118503000,118503000,58015,NOW
2019-12-31,748369000,,67185000,,626698000,1873300000,2663792000,42123000,42123000,,-33283000,,,,-559513000,3460437000,3418314000,796645000,25062000,,626698000,626698000,58015,NOW
2018-12-31,529501000,,-39024000,,-26704000,1499083000,1986158000,-42426000,-42426000,,-52733000,,,,-12320000,2608816000,2651242000,622658000,3402000,,-26704000,-26704000,58015,NOW
2017-12-31,377518000,,-113406000,,-116846000,1105510000,1418632000,-64396000,-64396000,,-53394000,,,,3440000,1918494000,1982890000,499862000,-49010000,,-116846000,-116846000,58015,NOW
2019-12-31,,,75236000,,75236000,21326000,101486000,0,80160000,,,,,,0,127642000,47482000,26156000,-4924000,,75236000,5313000,58016,BRMK
2018-12-31,,,81840000,,81750000,12223000,94063000,29170048,81840000,234873.0,,,,,90000,94063000,12223000,167142,-41133,,81750000,81750000,58016,BRMK
2017-12-31,,,45388000,,45388000,6501000,51889000,12607708,45388000,234873.0,,,,,0,51889000,6501000,0,-17012,,45388000,45388000,58016,BRMK
2016-12-31,,,5593382,,5593382,51370,5654773,5603403,5603403,234873.0,,,,,0,5654773,51370,0,-10021,,5593382,5593382,58016,BRMK
2020-12-31,,,-1851800000,51700000,-1870300000,97700000,356200000,-133200000,-133200000,45700000,-139800000,,,,8000000,2881100000,3014300000,2524900000,-1718600000,-14000000,-1859800000,-1870300000,58017,BTU
2019-12-31,,,-142300000,58700000,-211300000,164400000,1086800000,1800000,1800000,58400000,-144000000,,,,46000000,4623400000,4621600000,3536600000,-144100000,3200000,-188300000,-211300000,58017,BTU
2018-12-31,,,664100000,56000000,646900000,176200000,1510400000,602200000,602200000,53000000,-149300000,,,,18400000,5581800000,4979600000,4071400000,61900000,18100000,645700000,536200000,58017,BTU
2017-12-31,,,92800000,49400000,461600000,178900000,1583500000,707300000,707300000,55800000,-152600000,,,,-424800000,5578800000,4871500000,3995300000,-614500000,-36000000,517600000,158000000,58017,BTU
2019-12-31,,,833000000,,621000000,-16000000,2066000000,1220000000,1220000000,280000000,-386000000,,,,212000000,3610000000,2390000000,1544000000,-387000000,,621000000,621000000,58018,AWK
2018-12-31,,,787000000,,567000000,-20000000,1941000000,1139000000,1139000000,277000000,-361000000,,,,222000000,3440000000,2301000000,1499000000,-352000000,,565000000,567000000,58018,AWK
2017-12-31,,,912000000,,426000000,9000000,1988000000,1228000000,1228000000,259000000,-356000000,,,,486000000,3357000000,2129000000,1369000000,-316000000,,426000000,426000000,58018,AWK
2016-12-31,,,770000000,,468000000,5000000,1880000000,1147000000,1147000000,258000000,-339000000,,,,302000000,3302000000,2155000000,1422000000,-377000000,,468000000,468000000,58018,AWK
2019-12-31,,,463400000,,433600000,-1500000,952900000,505800000,505800000,93600000,-150700000,,,,29800000,2231600000,1725800000,1278700000,-42400000,,433600000,433600000,58020,OGE
2018-12-31,,,497700000,,425500000,4500000,903200000,485100000,485100000,92000000,-167700000,,,,72200000,2270300000,1785200000,1367100000,12600000,,425500000,425500000,58020,OGE
2017-12-31,,,569700000,,619000000,21600000,904800000,510300000,510300000,89400000,-161800000,,,,-49300000,2261100000,1750800000,1356300000,59400000,,619000000,619000000,58020,OGE
2016-12-31,,,486300000,,338200000,27500000,941000000,503300000,503300000,87600000,-149600000,,,,148100000,2259200000,1755900000,1318200000,-17000000,,338200000,338200000,58020,OGE
2019-12-31,,,681373349,1246482,774276129,330639385,1392153660,820327452,820327452,,,,,,-93102643,3088049995,2267722543,1695896335,-138954103,,774475992,774276129,58021,XYF
2018-12-31,,,1092978024,1046619,883111893,425749584,2314315041,1491569047,1491569047,,,,,,209921188,3540600044,2049030997,1226285003,-398591023,,883056836,883111893,58021,XYF
2017-12-31,,,477742879,3213041,340275002,174820053,1026791845,684271297,684271297,,,,,,138248227,1786935193,1102663896,760143348,-206528418,,339494652,340275002,58021,XYF
2016-12-31,,,-147199063,3993391,-119574250,99922119,-28748644,-136769915,-136769915,,,,,,-27018204,230305685,367075600,259054329,-10429148,,-120180859,-119574250,58021,XYF
2019-12-31,,,194453000,,165138000,124555000,648582000,324505000,324505000,2122000,-125126000,,,,29315000,1201503000,876998000,552921000,-130052000,,165138000,165138000,58024,STAY
2018-12-31,,,253832000,,211756000,116994000,705363000,379059000,379059000,-19000,-124353000,,,,42076000,1262492000,883433000,557129000,-125227000,,211756000,211756000,58024,STAY
2017-12-31,,,231702000,,172188000,117652000,720180000,376271000,376271000,-2959000,-126921000,,,,59514000,1282725000,906454000,562545000,-144569000,,172188000,172188000,58024,STAY
2016-12-31,,,197703000,,163352000,119645000,711421000,370492000,370492000,-25000,-137515000,,,,34351000,1270593000,900101000,559172000,-172789000,,163352000,163352000,58024,STAY
2020-12-31,,,11039000,,8554000,,31992000,0,11039000,20953000,,,,,2485000,31992000,20953000,0,0,,8554000,8554000,58026,VBFC
2019-12-31,,,5641000,,4477000,17961000.0,25908000,0,5816000,2131000,,,,,1164000,25908000,20092000,0,-175000,,4477000,4477000,58026,VBFC
2018-12-31,,,3730000,,3037000,17283000.0,23295000,0,4005000,2007000,,,,,693000,23295000,19290000,0,-275000,,3037000,2924000,58026,VBFC
2017-12-31,,,1471000,,-3096000,17549000.0,20926000,0,1351000,2026000,,,,,4567000,20926000,19575000,0,120000,,-3096000,-3594000,58026,VBFC
2019-12-31,,,-1258397,,-1258397,1258397,0,-1258397,-1258397,,,,,,0,0,1258397,0,0,,-1258397,-1258397,58032,TRIN
2020-12-31,130982000,,186911000,,176186000,267593000,604599000,206024000,206024000,,,,,,10725000,811020000,604996000,206421000,-19113000,,176186000,176186000,58033,CGNX
2019-12-31,119427000,,162994000,,203865000,273842000,535871000,142602000,142602000,,,,,,-40871000,725625000,583023000,189754000,20392000,,203865000,203865000,58033,CGNX
2018-12-31,116445000,,234574000,,219267000,262699000,600286000,221142000,221142000,,,,,,15307000,806338000,585196000,206052000,13432000,,219267000,219267000,58033,CGNX
2017-12-31,99205000,,266464000,,176712000,220728000,578794000,258861000,258861000,,,,,,89752000,766083000,507222000,187289000,7603000,,176712000,176712000,58033,CGNX
2019-12-31,16190000,,-40983000,,-40796000,50346000,27447000,-39089000,-39089000,,,,,,-187000,56734000,95823000,29287000,-1894000,,-40796000,-40796000,58034,QTRX
2018-12-31,15805000,,-31511000,,-31536000,33593000,17948000,-31450000,-31450000,,,,,,25000,37632000,69082000,19684000,-61000,,-31536000,-31536000,58034,QTRX
2017-12-31,16304000,,-27019000,,-27019000,19688000,9987000,-26005000,-26005000,,-951000.0,,,,0,22874000,48879000,12887000,-1014000,,-27019000,-31188000,58034,QTRX
2016-12-31,16993000,,-23173000,,-23173000,12466000,7748000,-21711000,-21711000,,-1298000.0,,,,0,17585000,39296000,9837000,-1462000,,-23173000,-27618000,58034,QTRX
2019-12-31,,,246404000,,225877000,35304000,418467000,383163000,383163000,,-137133000,,,,20527000,562340000,179177000,143873000,-136759000,,225877000,225877000,58035,FLY
2018-12-31,,,95649000,,85723000,31185000,266956000,235771000,235771000,,-144742000,,,,9926000,413587000,177816000,146631000,-140122000,,85723000,85723000,58035,FLY
2017-12-31,,,13930000,,2598000,30671000,215800000,185129000,185129000,,-127782000,,,,11332000,351551000,166422000,135751000,-171199000,,2598000,2598000,58035,FLY
2016-12-31,,,-36389000,,-29112000,30077000,220112000,190035000,190035000,,-123161000,,,,-7277000,342843000,152808000,122731000,-226424000,,-29112000,-29112000,58035,FLY
2020-04-30,,,-9502688,,-9502688,5838307,35562925,29724618,29724618,,-1320312,,,,0,35562925,5838307,0,-39227306,,-9502688,-9502688,58036,MUI
2019-04-30,,,39868970,,39868970,5785622,36537366,30751744,30751744,,-1431604,,,,0,36537366,5785622,0,9117226,,39868970,39868970,58036,MUI
2018-04-30,,,13764082,,13764082,5697475,35457653,29760178,29760178,,-7035872,,,,0,35457653,5697475,0,-15996096,,13764082,13764082,58036,MUI
2017-04-30,,,-6786306,,-6786306,5758837,36186848,30428011,30428011,,-5637124,,,,0,36186848,5758837,0,-37214317,,-6786306,-6786306,58036,MUI
2019-12-31,74000,,1395000,,806000,13510000,15562000,1978000,1978000,,-1299000,,,,589000,102032000,100054000,86470000,-583000,,806000,806000,58038,TATT
2018-12-31,553000,,-5872000,,-4408000,13472000,8391000,-5634000,-5634000,,-1569000,,,,-1464000,93178000,98812000,84787000,-238000,,-4408000,-4408000,58038,TATT
2017-12-31,731000,,4729000,,2396000,14383000,20444000,5330000,5330000,,-1132000,,,,2333000,106527000,101197000,86083000,-601000,,2396000,2396000,58038,TATT
2016-12-31,1140000,,3927000,,62000,13899000,19037000,3998000,3998000,,-1139000,,,,3865000,95794000,91796000,76757000,-71000,,62000,62000,58038,TATT
2019-12-31,13500000,,101000000,,85800000,140900000,290000000,135600000,135600000,,-36100000,,,,15200000,1022800000,887200000,732800000,-34600000,,85800000,85200000,58039,SWM
2018-12-31,15200000,,105500000,,94500000,129900000,278500000,133400000,133400000,,-28200000,,,,10700000,1041300000,907900000,762800000,-27900000,-300000.0,94800000,93900000,58039,SWM
2017-12-31,17800000,,104000000,,34500000,132500000,283400000,133100000,133100000,,-26900000,,,,69600000,982100000,849000000,698700000,-29100000,100000.0,34400000,34100000,58039,SWM
2016-12-31,17500000,,98200000,,82800000,107300000,257900000,133100000,133100000,,-16600000,,,,15400000,839900000,706800000,582000000,-34900000,100000.0,82800000,82300000,58039,SWM
2020-09-30,,,667000000,9000000,532000000,1842000000,3410000000,1093000000,1093000000,-9000000,-322000000,,,,135000000,6559000000,5466000000,3149000000,-426000000,,532000000,532000000,58040,UGI
2019-09-30,,,401000000,10000000,256000000,1911000000,2997000000,655000000,655000000,-17000000,-258000000,,,,93000000,7320000000,6665000000,4323000000,-254000000,,308000000,256000000,58040,UGI
2018-09-30,,,855000000,418600000,719000000,1982000000,3576000000,1163000000,1163000000,-24000000,-230000000,,,,33000000,7651000000,6488000000,4075000000,-308000000,,822000000,719000000,58040,UGI
2017-09-30,,,701400000,577600000,436600000,1828800000,3283400000,1051500000,1051500000,-13200000,-223500000,,,,177600000,6120700000,5069200000,2837300000,-350100000,,523800000,436600000,58040,UGI
2019-12-31,,,200000,,-8400000,416700000,495300000,39800000,39800000,38800000,-33600000,,,,8600000,1969700000,1929900000,1474400000,-39600000,,-8400000,-8400000,58041,ARGO
2018-12-31,,,67700000,,63600000,351700000,490500000,99200000,99200000,39600000,-31600000,,,,4100000,1801800000,1702600000,1311300000,-31500000,,63600000,63600000,58041,ARGO
2017-12-31,,,39900000,,50300000,359100000,479900000,73900000,73900000,46900000,-27700000,,,,-10400000,1774100000,1700200000,1294200000,-34000000,,50300000,50300000,58041,ARGO
2016-12-31,,,181900000,,146700000,292100000,536700000,197000000,197000000,47600000,-19600000,,,,35200000,1576500000,1379500000,1039800000,-15100000,,146700000,146700000,58041,ARGO
2020-06-30,,,10025000000,96994000000,3929000000,27362000000,38629000000,10440000000,10440000000,827000000,-24244000000,,,,8107000000,121256000000,110816000000,82627000000,-415000000,18085000000,1918000000,3929000000,58043,CRESY
2019-06-30,,,-47089000000,103159000000,-26796000000,23781000000,35063000000,9015000000,9015000000,2267000000,-21600000000,,,,780000000,110741000000,101726000000,75678000000,-56104000000,7140000000,-47869000000,-26796000000,58043,CRESY
2018-06-30,,,-18985000000,86213000000,6106000000,24002000000,31760000000,6120000000,6120000000,1638000000,-19391000000,,,,-9964000000,93266000000,87146000000,61506000000,-25105000000,36441000000,-9021000000,6106000000,58043,CRESY
2017-06-30,,,-3380000000,32768000000,-624000000,18081000000,24776000000,5762000000,5762000000,933000000,-13736000000,,,,1833000000,67907000000,62145000000,43131000000,-9142000000,1705000000,-5213000000,-624000000,58043,CRESY
2019-12-31,3864000,,-11979000,-2378000,-4027000,168893000,188971000,16214000,16214000,,-5180000,,,,400000,428358000,412144000,239387000,-28193000,,-12379000,-4027000,58044,PRPL
2018-12-31,2095000,,-19614000,-1349000,-4322000,127401000,112602000,-16894000,-16894000,,-3733000,,,,0,285791000,302685000,173189000,-2720000,,-19614000,-4322000,58044,PRPL
2017-12-31,1387000,,-8819000,-1349000,-8819000,92378000,85018000,-8747000,-8747000,,-81000,,,,0,196859000,205606000,111841000,-82000,,-8819000,-8819000,58044,PRPL
2016-12-31,792000,,-1901000,-1349000,-1901000,22544000,21477000,-1859000,-1859000,,-27000,,,,0,65473000,67332000,43996000,-42000,,-1901000,-1901000,58044,PRPL
2019-12-31,13560000,,-57141000,,-57002000,101714000,77594000,-38378000,-38378000,,,,,,-239000,113427000,151805000,35833000,-18763000,-100000,-56902000,-57002000,58047,ATEC
2018-12-31,9853000,,-30169000,,-28975000,72640000,63237000,-19994000,-19994000,,,,,,-1361000,91694000,111688000,28457000,-10175000,-167000,-28808000,-42463000,58047,ATEC
2017-12-31,4920000,,-4574000,,-2294000,69959000,68222000,-7345000,-7345000,,-7615000.0,,,,-34000,101739000,109084000,33517000,2771000,2246000,-4540000,-2294000,58047,ATEC
2016-12-31,9248000,,-30935000,,-29925000,77301000,76634000,-10849000,-10849000,,-5365000.0,,,,-4634000,120248000,131097000,43614000,-20086000,-3624000,-26301000,-29925000,58047,ATEC
2020-08-31,,,784000000,498000000,456000000,25026000000,28017000000,2991000000,2991000000,,-584000000,,,,360000000,139537000000,136546000000,111520000000,-2207000000,,424000000,456000000,58048,WBA
2019-08-31,,,4550000000,641000000,3982000000,24998000000,30076000000,5078000000,5078000000,,-676000000,,,,588000000,136866000000,131788000000,106790000000,-528000000,,3962000000,3982000000,58048,WBA
2018-08-31,,,6029000000,682000000,5024000000,24638000000,30792000000,6154000000,6154000000,,-577000000,,,,998000000,131537000000,125383000000,100745000000,-125000000,,5031000000,5024000000,58048,WBA
2017-08-31,,,4861000000,808000000,4078000000,23618000000,29162000000,5544000000,5544000000,,-643000000,,,,760000000,118214000000,112670000000,89052000000,-683000000,,4101000000,4078000000,58048,WBA
2019-12-31,,,-33700000,2400000,-47300000,109800000,145200000,-4100000,-4100000,23700000,-31000000,,,,11900000,1718700000,1722800000,1573500000,-29600000,,-45600000,-38100000,58050,SG
2018-12-31,,,23700000,1700000,-18100000,77900000,151300000,30200000,30200000,27400000,-30800000,,,,40400000,1425500000,1395300000,1274200000,-6500000,,-16700000,-43300000,58050,SG
2017-12-31,,,-109900000,200000,-150000000,91900000,-15000000,-140500000,-140500000,23400000,-22400000,,,,26400000,1076100000,1216600000,1091100000,30600000,,-136300000,-156100000,58050,SG
2016-12-31,,,44500000,251300000,32500000,85100000,187900000,79500000,79500000,23300000,-34600000,,,,-7300000,1001500000,922000000,813600000,-35000000,,51800000,32500000,58050,SG
2019-12-31,,,-32487000,1020000,-31571000,11756000,-21642000,-33013000,-33013000,-385000,-170000,,,,0,18449000,51462000,40091000,526000,,-32487000,-31571000,58051,IMTX
2018-12-31,,,-32355000,1236000,-31444000,7666000,-30201000,-34409000,-34409000,-3458000,-16000,,,,0,3770000,38179000,33971000,2054000,,-32355000,-31444000,58051,IMTX
2019-12-31,7098000,,-28871000,621000,-28805000,13567000,-6814000,-20381000,-20381000,,-5000,,,,2000,1169000,21550000,7983000,-8490000,,-28873000,-28805000,58052,RKDA
2018-12-31,7098000,,-13470000,621000,-13480000,11604000,-5266000,-16870000,-16870000,,-5000,,,,10000,1464000,18334000,6730000,3400000,,-13480000,-13480000,58052,RKDA
2017-12-31,7098000,,-15681000,621000,-15707000,10651000,-3664000,-14315000,-14315000,,-747000,,,,26000,4026000,18341000,7690000,-1366000,,-15707000,-15707000,58052,RKDA
2016-12-31,7098000,,-19599000,621000,-19624000,11050000,-6370000,-17420000,-17420000,,-1319000,,,,25000,3188000,20608000,9558000,-2179000,,-19624000,-19624000,58052,RKDA
2019-12-31,,,48328000,7663000,41844000,19297000,136287000,74245000,74245000,,-27037000,,,,303000,139357000,65112000,3070000,-25917000,,48025000,41351000,58053,EPRT
2018-12-31,,,20809000,248862000,15613000,13762000,94243000,49129000,49129000,-623000.0,-30192000,,,,195000,96223000,47094000,1980000,-28320000,,20614000,11028000,58053,EPRT
2017-12-31,,,6457000,248862000,6296000,8775000,52902000,24611000,24611000,-623000.0,-22574000,,,,161000,54449000,29838000,1547000,-18154000,,6296000,6296000,58053,EPRT
2016-12-31,,,5102665,248862000,4999999,5761332,19982662,6983998,6983998,-623000.0,-1316000,,,,102667,20693328,13709330,710666,-1881333,,4999999,4999999,58053,EPRT
2019-12-31,109339000,,-120459000,,-120459000,42751000,-85435000,-128186000,-128186000,,-3000,,,,0,23904000,152090000,109339000,7727000,,-120459000,-120459000,58055,DRNA
2018-12-31,109339000,,-88853000,,-88853000,21685000,-39535000,-61220000,-61220000,,-603000,,,,0,6176000,67396000,45711000,-27633000,,-88853000,-88853000,58055,DRNA
2017-12-31,109339000,,-60200000,,-60200000,16838000,-34858000,-51696000,-51696000,,-603000,,,,0,1030000,52726000,35888000,-8504000,,-60200000,-80292000,58055,DRNA
2016-12-31,109339000,,-59513000,,-59513000,15433000,-41399000,-56832000,-56832000,,-603000,,,,0,295000,56832000,41399000,-2681000,,-59513000,-59513000,58055,DRNA
2019-12-31,,,12952000,,9663000,380926000,404829000,23903000,23903000,,-600000,,,,3289000,1092602000,1068699000,687773000,-10951000,,9663000,9663000,58058,LL
2018-12-31,,,-53400000,,-54379000,366055000,392940000,26885000,26885000,,-600000,,,,979000,1084636000,1057751000,691696000,-80285000,,-54379000,-54379000,58058,LL
2017-12-31,,,-38557000,,-37823000,368527000,369061000,534000,534000,,-600000,,,,-734000,1028933000,1028399000,659872000,-39091000,,-37823000,-37823000,58058,LL
2016-12-31,,,-94273000,,-68563000,375830000,309319000,-66511000,-66511000,,-600000,,,,-25710000,960588000,1027099000,651269000,-27762000,,-68563000,-68563000,58058,LL
2020-03-31,,,-290840000,-414000,-309586000,374830000,636353000,127575000,127575000,121698000,-86631000,,,,7393000,2772809000,2645234000,2136456000,-418415000,-11426000,-298233000,-320229000,58059,JE
2019-03-31,,,-126440000,-399000,-266339000,377066000,678571000,145106000,145106000,150483000,-71393000,,,,11832000,3038438000,2893332000,2359867000,-271546000,-128259000,-138272000,-275298000,58059,JE
2018-03-31,,,545190000,-422000,509276000,419478000,640511000,125729000,125729000,76951000,-51079000,,,,20671000,3623558000,3497829000,2983047000,419461000,-5945000,524519000,500912000,58059,JE
2017-03-31,,,514114000,-422000,446412000,394741000,695971000,216593000,216593000,78561000,-72602000,,,,43231000,3757054000,3540461000,3061083000,297521000,-5945000,470883000,445194000,58059,JE
2019-12-31,224463000000,,-3265838000000,1393331000000,-2345517000000,1992008000000,1291827000000,-1279648000000,-1279648000000,58666000000,-2099928000000,,,,-1002303000000,59172890000000,60452538000000,57881063000000,-1986190000000,,-2263535000000,-2345517000000,58061,KEP
2018-12-31,215494000000,,-2000819000000,1348837000000,-1314567000000,1984808000000,2345208000000,-209954000000,-209954000000,46424000000,-1871771000000,,,,-826321000000,60627610000000,60837564000000,58282402000000,-1790865000000,,-1174498000000,-1314567000000,58061,KEP
2017-12-31,215494000000,,3614218000000,1283196000000,1298720000000,2640985000000,7159684000000,5308615000000,5308615000000,-789916000000,-1786005000000,,,,2172824000000,59335889000000,54027274000000,52176205000000,-1694397000000,,1441394000000,1298720000000,58061,KEP
2016-12-31,215494000000,,10513468000000,1326852000000,7048581000000,2507189000000,14125341000000,12275479000000,12275479000000,-657327000000,-1736789000000,,,,3365141000000,59763087000000,47487608000000,45637746000000,-1762011000000,,7148327000000,7048581000000,58061,KEP
2019-12-31,26659000,,-46961000,,-47599000,8287000,0,-33446000,-33446000,-1500000,,,,,638000,0,33446000,0,-13515000,,-47599000,-47599000,58062,NTEC
2018-12-31,35402000,,-43440000,,-43543000,7926000,0,-43328000,-43328000,-1500000,-112000.0,,,,103000,0,43328000,0,-112000,,-43543000,-43543000,58062,NTEC
2017-12-31,24295000,,-28880000,,-28909000,5144000,0,-29439000,-29439000,2000,-112000.0,,,,29000,0,29439000,0,559000,,-28909000,-28909000,58062,NTEC
2016-12-31,10749000,,-13362000,,-13362000,3097000,0,-13846000,-13846000,2000,-112000.0,,,,0,0,13846000,0,484000,,-13362000,-13362000,58062,NTEC
2019-12-31,,,1577863,,1161764,840321,0,-840321,-840321,,,,,,416099,0,840321,0,2418184,,1161764,-513319,58063,BFI
2018-12-31,,,1298461,,1021711,553546,0,-553546,-553546,,,,,,276750,0,553546,0,1852007,,1021711,-585767,58063,BFI
2017-12-31,,,-2822,,-2822,2822,0,-2822,-2822,,,,,,0,0,2822,0,0,,-2822,-2822,58063,BFI
2019-12-31,,,107512000,,76930000,202908000,307550000,96625000,96625000,,-1388000,,,,30582000,806428000,709803000,498878000,10887000,,76930000,76930000,58065,MMI
2018-12-31,,,117220000,,87257000,193148000,311933000,112488000,112488000,,-1400000,,,,29963000,814816000,702328000,502883000,4732000,,87257000,87257000,58065,MMI
2017-12-31,,,99226000,,51524000,171648000,273143000,96132000,96132000,,-1496000,,,,47702000,719700000,623568000,446557000,3094000,,51524000,51524000,58065,MMI
2016-12-31,,,107102000,,64657000,161794000,272682000,106501000,106501000,,-1533000,,,,42445000,717450000,610949000,444768000,601000,,64657000,64657000,58065,MMI
2019-12-31,,,-11056000000,252000000,-7656000000,-36000000,4575000000,1377000000,1377000000,,-948000000,,,,-3400000000,17129000000,15752000000,12554000000,-12433000000,,-7656000000,-7656000000,58068,PCGU
2018-12-31,,,-10143000000,252000000,-6851000000,-52000000,5352000000,2368000000,2368000000,,-943000000,,,,-3292000000,16759000000,14391000000,11407000000,-12511000000,,-6851000000,-6851000000,58068,PCGU
2017-12-31,,,2157000000,252000000,1646000000,-1000000,5837000000,2984000000,2984000000,,-902000000,,,,511000000,17135000000,14151000000,11298000000,-827000000,,1646000000,1646000000,58068,PCGU
2016-12-31,,,1448000000,252000000,1393000000,-12000000,4987000000,2244000000,2244000000,,-843000000,,,,55000000,17666000000,15422000000,12679000000,-796000000,,1393000000,1393000000,58068,PCGU
2019-12-31,20275000,,-27021000,,-27216000,6102000,0,-26377000,-26377000,,,,,,195000,0,26377000,0,-644000,,-27216000,-27216000,58069,RPTX
2018-12-31,9507000,,-14248000,,-14283000,3313000,0,-12820000,-12820000,,,,,,35000,0,12820000,0,-1428000,,-14283000,-14283000,58069,RPTX
2017-12-31,4337000,,-7796000,,-7796000,1838000,0,-6175000,-6175000,,,,,,0,0,6175000,0,-1621000,,-7796000,-7796000,58069,RPTX
2020-01-03,,,866000000,4000000,667000000,689000000,1548000000,899000000,899000000,,-147000000,,,,196000000,11094000000,10195000000,9546000000,-33000000,,670000000,667000000,58070,LDOS
2018-12-28,,,610000000,3000000,581000000,729000000,1504000000,775000000,775000000,,-145000000,,,,28000000,10194000000,9419000000,8690000000,-165000000,,582000000,581000000,58070,LDOS
2017-12-29,,,393000000,13000000,366000000,737000000,1432000000,685000000,685000000,,-148000000,,,,29000000,10170000000,9485000000,8738000000,-292000000,,364000000,366000000,58070,LDOS
2016-12-30,,,318000000,12000000,244000000,422000000,940000000,515000000,515000000,,-96000000,,,,72000000,7043000000,6528000000,6103000000,-197000000,,246000000,244000000,58070,LDOS
2019-12-31,,,9541000,2903000,9628000,8613000,96621000,35969000,35969000,,-28279000,,,,0,114387000,78418000,17766000,-26428000,,9541000,-4760000,58071,GOODN
2018-12-31,,,12324000,4675000,12320000,7005000,90286000,35661000,35661000,,-26172000,,,,0,106798000,71137000,16512000,-23337000,,12324000,973000,58071,GOODN
2017-12-31,,,5937000,4675000,5937000,6060000,82152000,33297000,33297000,,-24570000,,,,0,94799000,61502000,12647000,-27360000,,5937000,-4939000,58071,GOODN
2016-12-31,,,3958000,4675000,3958000,6243000,76553000,32793000,32793000,,-27404000,,,,0,86372000,53579000,9819000,-28835000,,3958000,-3698000,58071,GOODN
2020-12-31,55921000,,119410000,,133995000,103621000,345981000,186439000,186439000,,-21001000,,,,-14585000,774425000,587986000,428444000,-67029000,,133995000,133995000,58073,ENPH
2019-12-31,40381000,,90114000,,161148000,75536000,221245000,105328000,105328000,,-9691000,,,,-71034000,624333000,519005000,403088000,-15214000,,161148000,161148000,58073,ENPH
2018-12-31,32587000,,-10229000,,-11627000,53533000,94445000,8325000,8325000,,-10693000,,,,1398000,316159000,307834000,221714000,-18554000,,-11627000,-11627000,58073,ENPH
2017-12-31,33157000,,-45341000,,-45192000,45347000,56043000,-22461000,-22461000,1468000.0,-8212000,,,,-149000,286166000,308627000,230123000,-22880000,,-45192000,-45192000,58073,ENPH
2020-09-30,,,510600000,5700000,387400000,757800000,1363000000,605700000,605700000,-500000,-79600000,,,,123700000,4131600000,3525900000,2768600000,-95100000,1700000,386900000,387400000,58077,SMG
2019-09-30,,,581600000,4500000,460700000,601300000,1025500000,425600000,425600000,-1400000,-101800000,,,,144900000,3156000000,2730400000,2130500000,156000000,23500000,436700000,460700000,58077,SMG
2018-09-30,,,115700000,5000000,63700000,540100000,885100000,352000000,352000000,-7000000,-86400000,,,,-11900000,2663400000,2311400000,1778300000,-236300000,-63900000,127600000,63700000,58077,SMG
2017-09-30,,,314900000,12900000,218300000,550900000,972600000,425800000,425800000,-4100000,-76100000,,,,116600000,2642100000,2216300000,1669500000,-110900000,20500000,198300000,218300000,58077,SMG
2020-09-30,13175000,,121766000,1919000,113649000,319506000,461308000,133382000,133382000,-4755000,-46682000,,,,7371000,1429456000,1296074000,968148000,-11616000,,114395000,113649000,58078,AQUA
2019-09-30,15177000,,1116000,3063000,-9523000,331536000,448119000,105433000,105433000,-4027000,-58556000,,,,9587000,1444441000,1339008000,996322000,-104317000,,-8471000,-9523000,58078,AQUA
2018-09-30,15271000,,9266000,3161000,6135000,298942000,422330000,109718000,109718000,-1601000,-57580000,,,,1382000,1339541000,1229823000,917211000,-100452000,,7884000,6135000,58078,AQUA
2017-09-30,19503000,,13827000,5137000,2163000,273754000,418225000,127699000,127699000,-2731000,-55377000,,,,7417000,1247424000,1119725000,829199000,-113872000,,6410000,2163000,58078,AQUA
2020-12-31,16954000,,-36869000,,-36869000,9318000,0,-26272000,-26272000,,-10597000,,,,0,0,26272000,0,-10597000,,-36869000,-38983000,58079,PYPD
2019-12-31,14083000,,-6905000,,-6905000,4477000,0,-18560000,-18560000,,-15000,,,,0,0,18560000,0,11655000,,-6905000,-13327000,58079,PYPD
2018-12-31,12550000,,5917000,,5917000,5814000,0,-18364000,-18364000,,-42000,,,,0,0,18364000,0,24281000,,5917000,89000,58079,PYPD
2017-12-31,9736000,,-54488000,,-54488000,4064000,0,-13800000,-13800000,,-42000,,,,0,0,13800000,0,-40688000,,-54488000,-59142000,58079,PYPD
2019-12-31,,,21470000,16067000,8450000,134862000,206900000,22651000,22651000,8400000,-8621000,,,,7257000,813725000,791074000,606825000,-1181000,,14213000,359000,58080,SPKE
2018-12-31,,,-12315000,44488000,-1186000,113146000,170335000,-5369000,-5369000,9900000,-9410000,,,,2077000,1005928000,1011297000,835593000,-6946000,,-14392000,-9295000,58080,SPKE
2017-12-31,,,113809000,101559000,19245000,109025000,254888000,94522000,94522000,9000000,-11134000,,,,38765000,798055000,703533000,543167000,19287000,,75044000,16207000,58080,SPKE
2016-12-31,,,76099000,93406000,14444000,85104000,207053000,83861000,83861000,5300000,-8859000,,,,10426000,546697000,462836000,339644000,-7762000,,65673000,14444000,58080,SPKE
2019-12-31,4186000,,5523000,,5065000,3312000,12538000,5040000,5040000,,,,,,458000,22664000,17624000,10126000,966000,,5065000,5065000,58081,MNDO
2018-12-31,3412000,,5572000,,5134000,3227000,11989000,5350000,5350000,,,,,,438000,18135000,12785000,6146000,222000,,5134000,5134000,58081,MNDO
2017-12-31,3137000,,6209000,,5612000,3206000,11029000,4686000,4686000,,,,,,597000,18062000,13376000,7033000,1523000,,5612000,5612000,58081,MNDO
2016-12-31,3187000,,5372000,,4203000,2828000,11221000,5206000,5206000,,,,,,1169000,18052000,12846000,6831000,166000,,4203000,4203000,58081,MNDO
2020-12-31,92900000,,11300000,,6600000,130900000,273700000,49900000,49900000,,-17100000,,,,8400000,764300000,714400000,490600000,-38600000,3700000,2900000,6600000,58082,KN
2019-12-31,96800000,,66300000,,49100000,145400000,332000000,89800000,89800000,,-15300000,,,,16600000,854800000,765000000,522800000,-23500000,-600000,49700000,49100000,58082,KN
2018-12-31,100600000,,61100000,,67700000,142800000,325400000,82000000,82000000,,-16600000,,,,-4500000,826900000,744900000,501500000,-20900000,2100000,65600000,67700000,58082,KN
2017-12-31,93400000,,19400000,,68300000,125900000,298100000,78800000,78800000,,-20800000,,,,12900000,744200000,665400000,446100000,-59400000,61800000,6500000,68300000,58082,KN
2019-12-31,795540,,10969869,203013,9746385,4247973,15815827,10772314,10772314,,,,,,1589101,17925476,7153162,2109649,197555,,9380768,9746385,58084,SDH
2018-12-31,665378,,8810938,331277,7477066,3031886,12396403,8699139,8699139,,,,,,1158465,13538999,4839860,1142596,111799,,7652473,7477066,58084,SDH
2017-12-31,255424,,-819177,43734,-674679,2077583,1506819,-826188,-826188,,,,,,-149447,2287160,3113348,780341,7011,,-669730,-674679,58084,SDH
2019-12-27,14600000,,2300000,15800000,-9400000,134900000,196800000,47300000,47300000,,-25600000,,,,10000000,1066200000,1018900000,869400000,-45000000,,-7700000,-9400000,58085,UCTT
2018-12-28,13300000,,52300000,14700000,36600000,91800000,175800000,70700000,70700000,,-10000000,,,,15300000,1096500000,1025800000,920700000,-18400000,,37000000,36600000,58085,UCTT
2017-12-29,11700000,,87000000,14700000,75100000,66500000,167700000,89500000,89500000,,-2200000,,,,11900000,924400000,834900000,756700000,-2500000,,75100000,75100000,58085,UCTT
2016-12-30,9900000,,18947000,14700000,10051000,54492000,86783000,22391000,22391000,,-3744000,,,,8896000,562759000,540368000,475976000,-3444000,,10051000,10051000,58085,UCTT
2019-12-31,,,-6564643,-231999,-6458382,9341784,10277901,-5585165,-5585165,,-1112527,,,,0,64999611,70584776,54721710,-979478,,-6564643,-6458382,58087,NETE
2018-12-31,,,-5022733,-125737,-4936182,9758688,10169646,-4331121,-4331121,,-847179,,,,0,65786817,70117938,55617171,-691612,,-5022733,-4936182,58087,NETE
2017-12-31,,,-10023049,-39186,-9913485,10629773,8827612,-8597418,-8597418,,-1189622,,,,0,60064824,68662242,51237212,-1425631,,-10023049,-9913485,58087,NETE
2016-12-31,,,-13616076,70378,-13487537,8797883,8578618,-8637448,-8637448,,-1463833,,,,0,54286859,62924307,45708241,-4978628,,-13616076,-13487537,58087,NETE
2020-11-30,,,799428,,799428,2011806,11290721,9278915,9278915,,-1777472,,,,0,11290721,2011806,0,-8479487,,799428,799428,58089,CXE
2019-11-30,,,16159975,,16159975,2084521,12995548,10911027,10911027,,-2677604,,,,0,12995548,2084521,0,5248948,,16159975,16159975,58089,CXE
2018-11-30,,,4470606,,4470606,2088869,13808777,11719908,11719908,,-2530529,,,,0,13808777,2088869,0,-7249302,,4470606,4470606,58089,CXE
2017-11-30,,,13353683,,13353683,2258843,13767442,11508599,11508599,,-1950450,,,,0,13767442,2258843,0,1845084,,13353683,13353683,58089,CXE
2019-12-31,9563000,,-16155000,,-16155000,6769000,0,-16332000,-16332000,,-88000,,,,0,0,16332000,0,177000,,-16155000,-16155000,58090,CLNN
2018-12-31,6645000,,-11654000,,-11654000,2515000,0,-9160000,-9160000,,-368000,,,,0,0,9160000,0,-2494000,,-11654000,-11654000,58090,CLNN
2019-12-31,11800000,,119322000,,119497000,454735000,617056000,131417000,131417000,,-8636000,,,,-175000,1230593000,1099176000,613537000,-12095000,,119497000,119497000,58091,CROX
2018-12-31,14100000,,65157000,,50437000,426677000,560154000,95438000,95438000,,-955000,,,,14720000,1088205000,992767000,528051000,-30281000,,50437000,-69216000,58091,CROX
2017-12-31,13400000,,18180000,,10238000,455699000,517221000,21820000,21820000,,-869000,,,,7942000,1023513000,1001693000,506292000,-3640000,,10238000,-5294000,58091,CROX
2016-12-31,11900000,,-7213000,,-16494000,463613000,500164000,-2510000,-2510000,,-836000,,,,9281000,1036273000,1038783000,536109000,-4703000,,-16494000,-31738000,58091,CROX
2020-07-31,,,51545865,,51545865,11195469,58957774,47762305,47762305,,-8329453,,,,0,58957774,11195469,0,3783560,,51545865,51545865,58093,MYI
2019-07-31,,,97467206,,97467206,9887635,62740104,52852469,52852469,,-13054598,,,,0,62740104,9887635,0,44614737,,97467206,97467206,58093,MYI
2018-07-31,,,16492250,,16492250,8588879,66925383,58336504,58336504,,-11871250,,,,0,66925383,8588879,0,-41844254,,16492250,16492250,58093,MYI
2017-07-31,,,-13518346,,-13518346,8837377,70738748,61901371,61901371,,-9415458,,,,0,70738748,8837377,0,-75419717,,-13518346,-13518346,58093,MYI
2019-12-31,,,-55489000,,-55489000,24155000,-34148000,-58303000,-58303000,,-2149000,,,,0,36128000,94431000,70276000,2814000,,-55489000,-55489000,58094,CCXI
2018-12-31,,,-37966000,,-37966000,20409000,-19861000,-40270000,-40270000,,-1224000,,,,0,42875000,83145000,62736000,2304000,,-37966000,-37966000,58094,CCXI
2017-12-31,,,17859000,,17859000,16509000,33002000,16493000,16493000,,-4000,,,,0,82497000,66004000,49495000,1366000,,17859000,17859000,58094,CCXI
2016-12-31,,,-39963000,,-39963000,14710000,-26010000,-40720000,-40720000,,-4000,,,,0,11935000,52655000,37945000,757000,,-39963000,-39963000,58094,CCXI
2019-12-31,,,199638000,8588000,158592000,560110000,939985000,379875000,379875000,,-156391000,,,,35326000,3974988000,3595113000,3035003000,-180237000,-1766000,164312000,158592000,58095,SABRP
2018-12-31,,,398413000,7205000,337531000,501937000,1075542000,573605000,573605000,,-157017000,,,,57492000,3866956000,3293351000,2791414000,-175192000,1739000,340921000,337531000,58095,SABRP
2017-12-31,,,377613000,5198000,242531000,534211000,1097231000,563020000,563020000,,-153925000,,,,128037000,3598484000,3035464000,2501253000,-185407000,-1932000,249576000,242531000,58095,SABRP
2016-12-31,,,328035000,2579000,242562000,578753000,1098385000,519632000,519632000,,-158251000,,,,86645000,3373387000,2853755000,2275002000,-191597000,5549000,241390000,242562000,58095,SABRP
2020-09-30,,,54837000,50433000,17425000,143396000,235524000,88879000,88879000,,-17689000,,,,6329000,1022970000,934091000,787446000,-34042000,,48508000,17425000,58096,ONEW
2019-09-30,,,37263000,92217000,35657000,116503000,172126000,52941000,52941000,,-15963000,,,,0,767624000,714683000,595498000,-15678000,,37263000,35657000,58096,ONEW
2018-09-30,,,1946000,85058000,1116000,91297000,137654000,44672000,44672000,,-9370000,,,,0,602805000,558133000,465151000,-42726000,,1946000,1116000,58096,ONEW
2017-09-30,,,-4259000,73458589,-4272000,65352000,85701000,19294000,19294000,,-4952000,,,,0,391483000,372189000,305782000,-23553000,,-4259000,-11133000,58096,ONEW
2019-12-31,2275736,,-4044751,,-4044751,6625140,4919399,-3981477,-3981477,,-103335,,,,0,24801141,28782618,19881742,-63274,,-4044751,-4044751,58099,POLA
2018-12-31,1907810,,-1063252,,-848252,6622758,7431780,-1098788,-1098788,,-20170,,,,-215000,24046354,25145142,16614574,35536,,-848252,-848252,58099,POLA
2017-12-31,1334637,,-757416,,-757416,4228491,4761168,-801960,-801960,,-17822,,,,0,14418726,15220686,9657558,44544,,-757416,-757416,58099,POLA
2016-12-31,213931,,7263857,,4402810,2536915,10181657,7403923,7403923,,-112550,,,,2861047,22801494,15397571,12619837,-140066,,4402810,4402810,58099,POLA
2019-12-31,117510000,,3388000,,-7542000,188229000,326316000,8207000,8207000,-2072000,-6371000,,,,10930000,458915000,450708000,132599000,-4819000,,-7542000,-7542000,58100,ALTR
2018-12-31,97592000,,27024000,,15535000,160028000,280406000,18852000,18852000,-3805000,-200000,,,,11489000,396379000,377527000,115973000,8172000,,15535000,15535000,58100,ALTR
2017-12-31,93234000,,-36411000,,-101941000,167937000,226742000,-35257000,-35257000,-4620000,-2160000,,,,65530000,333333000,368590000,106591000,-1154000,,-101941000,-101941000,58100,ALTR
2016-12-31,71325000,,13702000,10000.0,10163000,123288000,210640000,15447000,15447000,-2742000,-2265000,,,,3539000,313240000,297793000,102600000,-1745000,,10163000,10163000,58100,ALTR
2020-12-31,18990000,,19268000,,18825000,76156000,114718000,19572000,19572000,,-35000,,,,443000,145072000,125500000,30354000,-304000,,18825000,18825000,58101,ECOM
2019-12-31,19058000,,4171000,,3482000,77020000,101189000,5111000,5111000,,-140000,,,,689000,129959000,124848000,28770000,-940000,,3482000,3482000,58101,ECOM
2018-12-31,22359000,,-6987000,,-7601000,86277000,101717000,-6919000,-6919000,,-140000,,,,614000,131218000,138137000,29501000,-68000,,-7601000,-7601000,58101,ECOM
2017-12-31,21868000,,-16273000,,-16557000,85604000,93433000,-14039000,-14039000,,-140000,,,,284000,122535000,136574000,29102000,-2234000,,-16557000,-16557000,58101,ECOM
2020-12-31,,,-643900000,256300000,-949000000,2406700000,3768300000,1361600000,1361600000,,-274600000,,,,301800000,9654000000,8292400000,5885700000,-2005500000,,-945700000,-949000000,58102,TAP
2019-12-31,,,479900000,253700000,241700000,2700100000,4201200000,1501100000,1501100000,,-280900000,,,,233700000,10579400000,9078300000,6378200000,-1021200000,,246200000,241700000,58102,TAP
2018-12-31,,,1359800000,228400000,1116500000,2725700000,4184800000,1459100000,1459100000,,-306200000,,,,225200000,10769600000,9310500000,6584800000,-99300000,,1134600000,1116500000,58102,TAP
2017-12-31,,,1383200000,208900000,1565600000,2934000000,4766100000,1832100000,1832100000,,-349300000,,,,-204600000,11002800000,9170700000,6236700000,-448900000,1500000.0,1587800000,1565600000,58102,TAP
2019-12-31,15594000,,-55350000,,-55350000,16389000,-20472000,-52455000,-52455000,,-1519000,,,,0,6677000,59132000,27149000,-2895000,,-55350000,-55350000,58103,SELB
2018-12-31,20692000,,-65336000,,-65336000,18238000,-26092000,-65022000,-65022000,,-1494000,,,,0,903000,65925000,26995000,-314000,,-65336000,-65336000,58103,SELB
2017-12-31,17412000,,-65321000,,-65321000,18826000,-27546000,-63784000,-63784000,,-1206000,,,,0,207000,63991000,27753000,-1537000,,-65321000,-65321000,58103,SELB
2016-12-31,14402000,,-36210000,,-36210000,13051000,-7217000,-34670000,-34670000,,-1253000,,,,0,8083000,42753000,15300000,-1540000,,-36210000,-40776000,58103,SELB
2020-03-31,,,-6838202,,-5249210,5124572,2610335,-2514237,-2514237,,-4806,,,,-1588992,142102324,144616561,139491989,-4323965,,-5249210,-5249210,58106,FRD
2019-03-31,,,6823945,,5099924,4782510,12907037,8124527,8124527,,-17546,,,,1724021,187154493,179029966,174247456,-1300582,,5099924,5099924,58106,FRD
2018-03-31,,,5764588,,3934101,4181657,9949191,5767534,5767534,,-27846,,,,1830487,121157278,115389744,111208087,-2946,,3934101,3934101,58106,FRD
2017-03-31,,,-4150816,,-2678684,4018199,-191622,-4209821,-4209821,,-27846,,,,-1472132,77756055,81965876,77947677,59005,,-2678684,-2678684,58106,FRD
2019-12-31,2485000,,-12975000,,-12998000,7540000,1665000,-8360000,-8360000,,,,,,23000,3284000,11644000,1619000,-4615000,,-12998000,-12998000,58114,SFET
2018-12-31,2414000,,-11747000,,-11753000,7467000,675000,-9206000,-9206000,,,,,,6000,1466000,10672000,791000,-2541000,,-11753000,-11753000,58114,SFET
2017-12-31,1608000,,-5312000,,-5313000,6201000,513000,-7296000,-7296000,,,,,,1000,1096000,8392000,583000,1984000,,-5313000,-5313000,58114,SFET
2016-12-31,1085000,,-8920000,,-8922000,5015000,331000,-5769000,-5769000,,,,,,2000,843000,6612000,512000,-3151000,,-8922000,-8922000,58114,SFET
2020-12-31,,,1877100000000,652300000000,1504400000000,5936900000000,13102700000000,1349300000000,1349300000000,1647000000000,,,,,376500000000,18624700000000,17275400000000,5522000000000,527800000000,,1500600000000,1504400000000,58116,SKM
2019-12-31,391327000000.0,,1162655000000,-133293000000,889907000000,11286215000000,17384944000000,1104178000000,1104178000000,797095000000,-397890000000.0,,,,300713000000,17743702000000,16639524000000,358758000000,58477000000,,861942000000,875141000000,58116,SKM
2018-12-31,387675000000.0,,3975966000000,-121572000000,3127887000000,10921182000000,16520639000000,1194042000000,1194042000000,845693000000,-307319000000.0,,,,843978000000,16873960000000,15679918000000,353321000000,2781924000000,,3131988000000,3112084000000,58116,SKM
2017-12-31,395276000000.0,,3403249000000,187056000000,2599829000000,11220096000000,17186912000000,1530833000000,1530833000000,902864000000,-299100000000.0,,,,745654000000,17520013000000,15989180000000,333101000000,1872416000000,,2657595000000,2599829000000,58116,SKM
2020-12-31,,,269942000,18484000,222759000,985596000,1813518000,0,497122000,330800000,,,,,39901000,1813518000,1316396000,0,-227180000,,230041000,212784000,58118,TCFCP
2019-12-31,,,357167000,20226000,295468000,871128000,1693164000,0,555924000,266112000,,,,,50241000,1693164000,1137240000,0,-198757000,,306926000,285473000,58118,TCFCP
2018-12-31,,,401724000,18459000,304358000,769984000,1416124000,0,450774000,195366000,,,,,86096000,1416124000,965350000,0,-49050000,,315628000,289247000,58118,TCFCP
2017-12-31,,,245160000,17827000,268637000,743359000,1305094000,0,336325000,225410000,,,,,-33624000,1305094000,968769000,0,-91165000,,278784000,242912000,58118,TCFCP
2020-05-31,,,110786000,145612000,78796000,328110000,443337000,115227000,115227000,,-31616000,,,,26342000,3059119000,2943892000,2615782000,-4441000,,84444000,78796000,58119,WOR
2019-05-31,,,206456000,117148000,153455000,338392000,479955000,141563000,141563000,,-38063000,,,,43183000,3759556000,3617993000,3279601000,64893000,,163273000,153455000,58119,WOR
2018-05-31,,,209070000,117606000,194794000,367460000,562857000,195397000,195397000,,-38675000,,,,8220000,3581620000,3386223000,3018763000,13673000,,200850000,194794000,58119,WOR
2017-05-31,,,297127000,122294000,204515000,316373000,535905000,219532000,219532000,,-29796000,,,,79190000,3014108000,2794576000,2478203000,77595000,,217937000,204515000,58119,WOR
2019-12-31,,,72842000,612959000,65571000,88984000,324765000,44201000,44201000,,-52695000,,,,-1302000,646375000,602174000,321610000,28641000,,74144000,63082000,58120,JBGS
2018-12-31,,,45875000,558344000,39924000,69758000,338530000,57336000,57336000,,-74447000,,,,-738000,647491000,590155000,308961000,-11461000,,46613000,37325000,58120,JBGS
2017-12-31,,,-88996000,613335000,-71753000,68601000,301681000,71421000,71421000,,-58141000,,,,-9912000,538870000,467449000,237189000,-160417000,,-79084000,-73408000,58120,JBGS
2016-12-31,,,63057000,295000,61974000,48753000,300418000,118322000,118322000,,-51781000,,,,1083000,477572000,359250000,177154000,-55265000,,61974000,61974000,58120,JBGS
2019-12-31,,,3733894000,,2639063000,1447637000,11589842000,4152567000,4152567000,1061524000,-2210136000,,,,1094831000,34825621000,30673054000,23235779000,-418673000,,2639063000,2639063000,58123,VLRS
2018-12-31,,,-1292702000,,-942882000,1501203000,6703993000,-72015000,-72015000,1043937000,-1812894000,,,,-349820000,27305150000,27377165000,20601157000,-1220687000,,-942882000,-942882000,58123,VLRS
2017-12-31,,,516257000,,278671000,1691524000,7475566000,1177726000,1177726000,1002471000,-1466489000,,,,237586000,24788186000,23610460000,17312620000,-661469000,,278671000,278671000,58123,VLRS
2017-01-01,,,4935780000,,3478598000,1446865000,4699742000,2215671000,2215671000,905322000,-1245000,,,,1457182000,23471560000,21255889000,18771818000,2720109000,,3478598000,3478598000,58123,VLRS
2019-12-31,255000,,-4753000,,-4217000,3225000,-369000,-3869000,-3869000,,-294000,,,,17000,477000,4346000,846000,-884000,,-4770000,-4217000,58124,MICT
2018-12-31,1906000,,-10354000,1964000.0,-2610000,7927000,3510000,-7621000,-7621000,,-1267000,,,,606000,14162000,21783000,10652000,-2733000,4894000.0,-10960000,-2610000,58124,MICT
2017-12-31,1964000,,-5070000,5595000.0,-8157000,5999000,4272000,-4669000,-4669000,,-401000,,,,-10000,18366000,23035000,14094000,-401000,-4901000.0,-5060000,-8157000,58124,MICT
2016-12-31,1802000,,-6307000,4183000.0,-5807000,5887000,2627000,-5988000,-5988000,,-319000,,,,-45000,13284000,19272000,10657000,-319000,-1251000.0,-6262000,-5807000,58124,MICT
2019-12-31,75677000,,60104000,,50201000,620212000,978142000,260989000,260989000,,-53957000,,,,9903000,1517557000,1256568000,539415000,-200885000,,50201000,50201000,58126,IART
2018-12-31,78041000,,57403000,,60801000,600402000,935508000,235905000,235905000,,-64683000,,,,-3398000,1472441000,1236536000,536933000,-178502000,,60801000,60801000,58126,IART
2017-12-31,63455000,,11385000,,64743000,516735000,781138000,180578000,180578000,,-35019000,,,,-53358000,1188236000,1007658000,407098000,-169193000,,64743000,64743000,58126,IART
2016-12-31,57955000,,90406000,,74564000,430975000,661855000,159063000,159063000,,-25803000,,,,15842000,992075000,833012000,330220000,-68657000,,74564000,74564000,58126,IART
2020-06-30,53405000,,-31038000,,-31091000,99249000,118456000,-34198000,-34198000,,-229000,,,,53000,157600000,191798000,39144000,3160000,,-31091000,-31091000,58127,BILL
2019-06-30,28924000,,-7470000,,-7314000,59312000,78433000,-9803000,-9803000,,-825000,,,,-156000,108351000,118154000,29918000,2333000,,-7314000,-7314000,58127,BILL
2018-06-30,17986000,,-7185000,,-7195000,35324000,45493000,-7817000,-7817000,,-427000,,,,10000,64865000,72682000,19372000,632000,,-7195000,-7195000,58127,BILL
2019-12-31,,,120897000,10728000,115442000,34047000,513032000,241102000,241102000,3003000,-108474000,,,,5172000,1612213000,1371111000,1099181000,-120205000,,115725000,82592000,58128,PEB
2018-12-31,,,15127000,10095000,13393000,20945000,262653000,131068000,131068000,2165000,-53923000,,,,1742000,828678000,697610000,566025000,-115941000,,13385000,-4405000,58128,PEB
2017-12-31,,,100443000,4625000,99888000,20062000,252844000,120574000,120574000,9918000,-37299000,,,,181000,769317000,648743000,516473000,-20131000,,100262000,83379000,58128,PEB
2016-12-31,,,73828000,3432000,73704000,27912000,279596000,149245000,149245000,9918000,-43615000,,,,-134000,814201000,664956000,534605000,-75417000,,73962000,46469000,58128,PEB
2020-12-31,,,19560000,,15717000,23971000,49860000,0,19560000,6329000,,,,,3843000,49860000,30300000,0,0,,15717000,15082000,58129,MNSBP
2019-12-31,,,17304000,,13950000,21863000,42680000,0,17984000,2833000,,,,,3354000,42680000,24696000,0,-680000,,13950000,13950000,58129,MNSBP
2018-12-31,,,11303000,,9209000,17279000,31282000,0,12036000,1967000,,,,,2094000,31282000,19246000,0,-733000,,9209000,9209000,58129,MNSBP
2017-12-31,,,6216765,,3882210,13199253,21874915,0,6699196,1976466,,,,,2334555,21874915,15175719,0,-482431,,3882210,3882210,58129,MNSBP
2019-12-31,100721000,,2070000,,882000,210959000,307286000,-4394000,-4394000,,-46000,,,,1188000,530860000,535254000,223574000,6464000,,882000,882000,58130,AXON
2018-12-31,76856000,,28104000,,29205000,154886000,258583000,26841000,26841000,,-86000,,,,-1101000,420068000,393227000,161485000,1263000,,29205000,29205000,58130,AXON
2017-12-31,54373000,,15761000,,5207000,138692000,207088000,14023000,14023000,,-186000,,,,10554000,343798000,329775000,136710000,3062000,,5207000,5207000,58130,AXON
2016-12-31,30609000,,31497000,,17297000,108076000,170536000,31851000,31851000,,-186000,,,,14200000,268245000,236394000,97709000,-2354000,,17297000,17297000,58130,AXON
2019-12-31,,,2508000,,1959000,7423000,9969000,2546000,2546000,,-179000,,,,549000,46691000,44145000,36722000,-38000,,1959000,1959000,58131,SMID
2018-12-31,,,2259000,,1687000,8274000,10490000,2216000,2216000,,-176000,,,,572000,40220000,38004000,29730000,43000,,1687000,1687000,58131,SMID
2017-12-31,,,3741000,,2684000,7749000,11464000,3715000,3715000,,-184000,,,,1057000,41717000,38002000,30253000,26000,,2684000,2684000,58131,SMID
2016-12-31,,,4297000,,2835000,6013000,10349000,4336000,4336000,,-162000,,,,1462000,40050000,35714000,29701000,-39000,,2835000,2835000,58131,SMID
2020-11-30,,,35578684,,35578684,5745431,32367712,26622281,26622281,,-3857123,,,,0,32367712,5745431,0,8956403,,35578684,35578684,58133,EVN
2019-11-30,,,61532942,,61532942,5968429,32461015,26492586,26492586,,-6358062,,,,0,32461015,5968429,0,35040356,,61532942,61532942,58133,EVN
2018-11-30,,,1987553,,1987553,3980731,23481106,19500375,19500375,,-4976170,,,,0,23481106,3980731,0,-17512822,,1987553,1894065,58133,EVN
2017-11-30,,,24082160,,24082160,4197825,24486754,20288929,20288929,,-3927427,,,,0,24486754,4197825,0,3793231,,24082160,23883814,58133,EVN
2019-12-31,,,-104300000,,-140800000,1100800000,1453000000,225300000,225300000,126900000,-310400000,,,,36500000,4431200000,4205900000,2978200000,-329600000,,-140800000,-140800000,58135,VRT
2018-12-31,,,-271000000,,-314000000,1223800000,1420400000,48600000,48600000,148000000,-288800000,,,,49900000,4285600000,4237000000,2865200000,-319600000,6900000.0,-320900000,-314000000,58135,VRT
2017-12-31,,,-407100000,,-369600000,1086000000,1312600000,7100000,7100000,219500000,-379300000,,,,-19700000,3879400000,3872300000,2566800000,-414200000,17800000.0,-387400000,-369600000,58135,VRT
2016-12-31,,,-230400000,,-256050000,489900000,387450000,-192600000,-192600000,90150000,-42150000,,,,30000000,1301850000,1494450000,914400000,-37800000,4350000.0,-260400000,-256800000,58135,VRT
2019-12-31,22844000,,-26883000,,-26883000,5725000,0,-28569000,-28569000,,,,,,0,0,28569000,0,1686000,,-26883000,-26883000,58136,ORIC
2018-12-31,19026000,,-21363000,,-21363000,3345000,0,-22371000,-22371000,,,,,,0,0,22371000,0,1008000,,-21363000,-21363000,58136,ORIC
2017-12-31,19126000,,-22029000,,-22029000,3415000,0,-22541000,-22541000,,,,,,0,0,22541000,0,512000,,-22029000,-22029000,58136,ORIC
2019-12-31,,,39055527,,39055527,2275682,10203899,7928217,7928217,,-4181234,,,,0,10203899,2275682,0,29060563,,39055527,39055527,58137,JTA
2018-12-31,,,-32767629,,-32767629,2602725,10970017,8367292,8367292,,-1846054,,,,0,10970017,2602725,0,-40603993,,-32767629,-32767629,58137,JTA
2017-12-31,,,34388340,,34388340,2581135,10908548,8327413,8327413,,-908479,,,,0,10908548,2581135,0,26060927,,34388340,34388340,58137,JTA
2016-12-31,,,8758484,,8758484,2454066,9830982,7376916,7376916,,-1055390,,,,0,9830982,2454066,0,1381568,,8758484,8758484,58137,JTA
2020-12-31,342600000,,607500000,38000000,427100000,1001500000,2057500000,639400000,639400000,,-15000000,,,,187700000,9149700000,8510300000,7092200000,-31900000,,419800000,427100000,58140,AGCO
2019-12-31,343400000,,303600000,53200000,125200000,1050800000,1984300000,523300000,523300000,,-28800000,,,,180800000,9041400000,8518100000,7057100000,-219700000,,122800000,125200000,58140,AGCO
2018-12-31,355200000,,394600000,60600000,285500000,1073100000,1996700000,497500000,497500000,,-37400000,,,,110900000,9352000000,8854500000,7355300000,-102900000,,283700000,285500000,58140,AGCO
2017-12-31,323400000,,322900000,65700000,186400000,965900000,1765300000,414400000,414400000,,-54500000,,,,133600000,8306500000,7892100000,6541200000,-91500000,,189300000,186400000,58140,AGCO
2020-12-31,,,293781000,,355766000,411661000,2071093000,368271000,368271000,1037112000,,,,,-61985000,5984634000,5616363000,3913541000,-74490000,,355766000,355766000,58142,CMG
2019-12-31,,,458285000,,350158000,583900000,1903321000,479509000,479509000,616026000,,,,,108127000,5586369000,5106860000,3683048000,-21224000,,350158000,350158000,58142,CMG
2018-12-31,,,268436000,,176553000,460103000,1591023000,352059000,352059000,568336000,,,,,91883000,4864985000,4512926000,3273962000,-83623000,,176553000,176553000,58142,CMG
2017-12-31,,,275743000,,176253000,402733000,1407860000,284139000,284139000,545299000,,,,,99490000,4476412000,4192273000,3068552000,-8396000,,176253000,176253000,58142,CMG
2019-12-31,5108407,,-13751877,,-13751877,7618244,0,-12943388,-12943388,,-822858,,,,0,0,12943388,0,-808489,,-13751877,-13912096,58143,SOLY
2018-12-31,4669747,,-9314936,,-9314936,3412414,0,-8202649,-8202649,,-1115501,,,,0,0,8202649,0,-1112287,,-9314936,-10594936,58143,SOLY
2017-12-31,3965276,,-7480624,,-7480624,3093257,0,-7188608,-7188608,,-295830,,,,0,0,7188608,0,-292016,,-7480624,-8760624,58143,SOLY
2016-12-31,4146777,,-7301259,,-7303571,3088691,0,-7317991,-7317991,,-295830,,,,2312,0,7317991,0,16732,,-7303571,-7303571,58143,SOLY
2019-12-31,,,-14557000,,-13864000,10710000,34134000,156000,156000,,-15000,,,,-693000,78444000,78288000,44310000,-14713000,,-13864000,-13864000,58145,NGS
2018-12-31,,,-394000,,-466000,9096000,30669000,-507000,-507000,,-69000,,,,72000,65478000,65985000,34809000,113000,,-466000,-466000,58145,NGS
2017-12-31,,,1507000,,19794000,10081000,33141000,1744000,1744000,,-14000,,,,-18287000,67693000,65949000,34552000,-237000,,19794000,19794000,58145,NGS
2016-12-31,,,8465000,,6469000,9011000,39782000,8975000,8975000,,-8000,,,,1996000,71654000,62679000,31872000,-510000,,6469000,6469000,58145,NGS
2020-09-30,,,-1873000,,-1873000,11312000,47959000,36647000,36647000,,-11484000,,,,0,47959000,11312000,0,-38520000,,-1873000,-1873000,58146,GLAD
2019-09-30,,,19869000,,19869000,12965000,50035000,37070000,37070000,,-12490000,,,,0,50035000,12965000,0,-17201000,,19869000,19869000,58146,GLAD
2018-09-30,,,18648000,,18648000,12516000,45581000,33065000,33065000,,-9977000,,,,0,45581000,12516000,0,-14417000,,18648000,18648000,58146,GLAD
2017-09-30,,,17180000,,17180000,9481000,39233000,29752000,29752000,,-8319000,,,,0,39233000,9481000,0,-12572000,,17180000,17180000,58146,GLAD
2020-12-31,,,202234000,,178040000,483160000,786049000,0,230606000,72283000,,,,,24194000,786049000,555443000,0,-28372000,,178040000,175905000,58149,FULTP
2019-12-31,,,263988000,,226339000,477485000,825703000,0,286021000,62197000,,,,,37649000,825703000,539682000,0,-22033000,,226339000,226339000,58149,FULTP
2018-12-31,,,232970000,,208393000,466182000,767625000,0,243963000,57480000,,,,,24577000,767625000,523662000,0,-10993000,,208393000,208393000,58149,FULTP
2017-12-31,,,234454000,,171753000,439731000,743905000,0,240403000,63771000,,,,,62701000,743905000,503502000,0,-5949000,,171753000,171753000,58149,FULTP
2020-03-31,804123000000,,789918000000,273764000000,455746000000,1641590000000,3079350000000,633637000000,633637000000,,-24689000000,,,,279986000000,14931009000000,14297372000000,11851659000000,156281000000,,509932000000,455746000000,58150,HMC
2019-03-31,806905000000,,979375000000,298070000000,610316000000,1762891000000,3364258000000,794462000000,794462000000,,-13217000000,,,,303089000000,15888617000000,15094155000000,12524359000000,184913000000,,676286000000,610316000000,58150,HMC
2018-03-31,751856000000,,1114973000000,300557000000,1059337000000,1721412000000,3360565000000,887297000000,887297000000,,-12970000000,,,,-13666000000,15361146000000,14473849000000,12000581000000,227676000000,,1128639000000,1059337000000,58150,HMC
2017-03-31,716871000000,,1006986000000,274330000000,616569000000,1622597000000,3096155000000,756687000000,756687000000,,-12471000000,,,,327592000000,13999200000000,13242513000000,10903045000000,250299000000,,679394000000,616569000000,58150,HMC
2019-12-31,,,-28804000,,1004000,,-7589000,-12168000,-12168000,4579000,-16636000,,,,-29808000,999834000,1012002000,1007423000,-16636000,,1004000,1004000,58151,PRA
2018-12-31,,,29025000,,47057000,,54264000,45142000,45142000,9122000,-16117000,,,,-18032000,886030000,840888000,831766000,-16117000,,47057000,47057000,58151,PRA
2017-12-31,,,128623000,,107264000,,161238000,145467000,145467000,15771000,-16844000,,,,21359000,866149000,720682000,704911000,-16844000,,107264000,107264000,58151,PRA
2016-12-31,,,176201000,,151081000,,200375000,192233000,192233000,8142000,-15032000,,,,25120000,870214000,677981000,669839000,-16032000,,151081000,151081000,58151,PRA
2020-12-31,,,4793000000,76000000,3555000000,5945000000,10446000000,4307000000,4307000000,,-526000000,,,,1224000000,26581000000,22274000000,16135000000,486000000,,3569000000,3555000000,58152,MDLZ
2019-12-31,,,3946000000,76000000,3929000000,6064000000,10337000000,4099000000,4099000000,,-595000000,,,,2000000,25868000000,21769000000,15531000000,-153000000,,3944000000,3929000000,58152,MDLZ
2018-12-31,,,4104000000,76000000,3317000000,6405000000,10352000000,3771000000,3771000000,,-452000000,,,,773000000,25938000000,22167000000,15586000000,333000000,,3331000000,3317000000,58152,MDLZ
2017-12-31,,,3508000000,80000000,2828000000,6106000000,10034000000,3750000000,3750000000,,-396000000,,,,666000000,25896000000,22146000000,15862000000,-242000000,,2842000000,2828000000,58152,MDLZ
2020-08-31,82000000,,324700000,,248300000,906600000,1403600000,373300000,373300000,,-26400000,,,,76400000,3326300000,2953000000,1922700000,-48600000,,248300000,248300000,58154,AYI
2019-08-31,74700000,,424900000,,330400000,912800000,1481800000,463500000,463500000,,-36400000,,,,94500000,3672700000,3209200000,2190900000,-38600000,,330400000,330400000,58154,AYI
2018-08-31,63900000,,425900000,,349600000,961200000,1485400000,460300000,460300000,,-35500000,,,,76300000,3680100000,3219800000,2194700000,-34400000,,349600000,349600000,58154,AYI
2017-08-31,52000000,,492600000,,321700000,871000000,1482700000,531700000,531700000,,-34100000,,,,170900000,3505100000,2973400000,2022400000,-39100000,,321700000,321700000,58154,AYI
2019-12-31,127117,,-1439854,,-1562855,1565762,466686,-1226193,-1226193,,,,,,123001,709630,1935823,242944,-213661,,-1562855,-1562855,58156,AGMH
2018-12-31,1028249,,-2381682,,-8412731,3876872,3459492,-2368846,-2368846,,,,,,-595421,5112520,7481366,1653028,-12836,-6626470.0,-1786261,-8412731,58156,AGMH
2017-12-31,398188,,5720427,,3899891,2931469,9079062,5714405,5714405,,,,,,1300894,12427743,6713338,3348681,6022,-519642.0,4419533,3899891,58156,AGMH
2016-12-31,289487,,2448953,,2350148,1842079,4582271,2450705,2450705,,,,,,783382,6882843,4432138,2300572,-1752,684577.0,1665571,2350148,58156,AGMH
2019-12-31,42545000,,-58306000,,-58306000,16694000,0,-59239000,-59239000,,,,,,0,0,59239000,0,933000,,-58306000,-50577000,58157,SWTX
2018-12-31,9898000,,-17813000,,-17813000,8593000,0,-18491000,-18491000,,,,,,0,0,18491000,0,678000,,-17813000,-17813000,58157,SWTX
2017-12-31,8397000,,-13917000,,-13917000,5583000,0,-13980000,-13980000,,,,,,0,0,13980000,0,63000,,-13917000,-13917000,58157,SWTX
2020-12-31,53651000,,28940000,,15170000,140216000,247852000,42443000,42443000,,-11912000,,,,13770000,417396000,374953000,169544000,-13503000,,15170000,14873000,58159,LMNX
2019-12-31,56228000,,-9502000,,-3838000,127183000,183839000,-10979000,-10979000,,-11912000,,,,-5664000,334638000,345617000,150799000,1477000,,-3838000,-3773000,58159,LMNX
2018-12-31,47164000,,28311000,,18508000,109116000,195491000,30546000,30546000,,-11912000,,,,9803000,315818000,285272000,120327000,-2235000,,18508000,18196000,58159,LMNX
2017-12-31,45717000,,37149000,,29423000,107322000,199046000,37153000,37153000,,-11912000,,,,7726000,306571000,269418000,107525000,-4000,,29423000,28894000,58159,LMNX
2019-12-31,,,66831514,,66831514,4378148,8262739,3884591,3884591,,,,,,0,8262739,4378148,0,62946923,,66831514,66831514,58160,ETB
2018-12-31,,,-27521199,,-27521199,4571131,8431518,3860387,3860387,,,,,,0,8431518,4571131,0,-31381586,,-27521199,-27521199,58160,ETB
2017-12-31,,,53450971,,53450971,4455529,8347229,3891700,3891700,,,,,,0,8347229,4455529,0,49559271,,53450971,53450971,58160,ETB
2016-12-31,,,31481877,,31481877,4193496,8863390,4669894,4669894,,,,,,0,8863390,4193496,0,26811983,,31481877,31481877,58160,ETB
2020-09-30,,,-18582000,,-17333000,19415000,11680000,-9289000,-9289000,,-254000,,,,-1249000,50182000,59471000,38502000,-9293000,,-17333000,-17333000,58161,AEY
2019-09-30,,,-4048000,,-5302000,15826000,13458000,-3821000,-3821000,,-80000,,,,-13000,55118000,58939000,41660000,-227000,-1267000.0,-4035000,-5302000,58161,AEY
2018-09-30,,,-4266697,,-7319856,10274113,7417215,-2856898,-2856898,,-210182,,,,1517000,27473282,30330180,20056067,-1409799,-1536159.0,-5783697,-7319856,58161,AEY
2017-09-30,,,-3285745,,-98116,9988589,7072238,-2916351,-2916351,,-369394,,,,-830000,25907571,28823922,18835333,-769394,2357629.0,-2455745,-98116,58161,AEY
2019-12-31,,,29073863,,29073863,8426694,9237353,810659,810659,,,,,,0,9237353,8426694,0,28263204,,29073863,29073863,58162,IFN
2018-12-31,,,-35739641,,-35739641,9948362,8978489,-969873,-969873,,,,,,0,8978489,9948362,0,-34769768,,-35739641,-35739641,58162,IFN
2017-12-31,,,237326979,,237326979,10520639,10334364,-186275,-186275,,,,,,0,10334364,10520639,0,237513254,,237326979,237326979,58162,IFN
2016-12-31,,,-2631262,,-2631262,10189629,10203428,-51807,-51807,65606.0,,,,,0,10203428,10255235,0,-2579455,,-2631262,-2631262,58162,IFN
2020-10-31,,,3021954,,3021954,3552464,21534577,17982113,17982113,,-4318513,,,,0,21534577,3552464,0,-14960159,,3021954,3021954,58165,NHS
2019-10-31,,,22525617,,22525617,3461857,23762101,20300244,20300244,,-6397932,,,,0,23762101,3461857,0,2225373,,22525617,22525617,58165,NHS
2018-10-31,,,-3092706,,-3092706,2955947,22326528,19370581,19370581,,-3077453,,,,0,22326528,2955947,0,-22463287,,-3092706,-3092706,58165,NHS
2017-10-31,,,23873549,,23873549,3008954,23454260,20445306,20445306,,-2133994,,,,0,23454260,3008954,0,3428243,,23873549,23873549,58165,NHS
2020-03-01,,,14071000,,9552000,7932000,18673000,10741000,10741000,,,,,,3866000,60014000,49273000,41341000,3330000,-653000,10205000,9552000,58167,PKE
2019-03-03,,,8097000,,113545000,8968000,16184000,7216000,7216000,,,,,,1791000,51116000,43900000,34932000,881000,107239000,6306000,113545000,58167,PKE
2018-02-25,,,310000,,20595000,9862000,11288000,1426000,1426000,,-2269000.0,,,,-18162000,40230000,38804000,28942000,-1116000,2123000,18472000,20595000,58167,PKE
2017-02-26,,,-1805000,,9283000,10309000,8299000,-2010000,-2010000,,-1432000.0,,,,-711000,31837000,33847000,23538000,205000,10377000,-1094000,9283000,58167,PKE
2019-12-31,18346000000,,-340000000,9216000000,2057000000,19910000000,44563000000,6307000000,6307000000,,-2960000000,,,,1948000000,107413000000,101106000000,62850000000,-6647000000,,-2288000000,1980000000,58168,BIDU
2018-12-31,15772000000,,27325000000,12855000000,27573000000,19231000000,52133000000,17130000000,17130000000,,-3483000000,,,,4743000000,103877000000,86747000000,51744000000,10195000000,,22582000000,27443000000,58168,BIDU
2017-12-31,12928000000,,21283000000,15026000000,18301000000,13128000000,48415000000,17591000000,17591000000,4768000000.0,-3515000000,,,,2995000000,86709000000,69118000000,38294000000,3692000000,,18288000000,18318000000,58168,BIDU
2016-12-31,10151000000,,14509000000,5469000000,11632000000,15071000000,39191000000,10049000000,10049000000,3920000000.0,-1158000000,,,,2913000000,70549000000,60500000000,31358000000,4460000000,,11596000000,11075000000,58168,BIDU
2019-12-31,,,-45177053,,-45177053,86624249,50617976,-37792699,-37792699,,-7187604,,,,0,840629347,878422046,790011371,-7384354,,-45177053,-45177053,58169,RMBL
2018-12-31,,,-25181817,,-25181817,35963930,13546804,-23401132,-23401132,,-1780685,,,,0,156398231,179799363,142851427,-1780685,,-25181817,-25181817,58169,RMBL
2017-12-31,,,-8573323,,-8573323,7586999,278109,-7977357,-7977357,,-595966,,,,0,7305902,15283259,7027793,-595966,,-8573323,-8573323,58169,RMBL
2016-12-31,,,-225091,,-224578,211493,0,-213393,-213393,,-11698,,,,-513,0,213393,0,-11698,,-224578,-224578,58169,RMBL
2020-06-30,,,424200000,15400000,207500000,427200000,998700000,571500000,571500000,,-144300000,,,,120400000,1960100000,1388600000,961400000,-147300000,-89300000,303800000,207500000,58170,CDK
2019-06-30,,,303900000,15100000,124000000,428900000,1035700000,606800000,606800000,,-139100000,,,,62200000,1914800000,1308000000,879100000,-302900000,-109800000,241700000,124000000,58170,CDK
2018-06-30,,,399200000,17500000,380800000,441200000,943500000,502300000,502300000,,-95900000,,,,88100000,1798000000,1295700000,854500000,-103100000,77600000,311100000,380800000,58170,CDK
2017-06-30,,,327700000,17000000,295600000,432500000,832500000,400000000,400000000,,-57200000,,,,92800000,1730700000,1330700000,898200000,-72300000,67600000,234900000,295600000,58170,CDK
2020-12-31,,,214208000,500000,169569000,89504000,325719000,0,220725000,15490000,,,,,44639000,325719000,104994000,0,-6517000,,169569000,169506000,58172,SFBS
2019-12-31,,,186861000,502000,149243000,71871000,288243000,0,190828000,25544000,,,,,37618000,288243000,97415000,0,-3967000,,149243000,149180000,58172,SFBS
2018-12-31,,,168842000,502000,136940000,64475000,259967000,0,173965000,21527000,,,,,31902000,259967000,86002000,0,-5123000,,136940000,136877000,58172,SFBS
2017-12-31,,,137350000,502000,93092000,59555000,220478000,0,142106000,18817000,,,,,44258000,220478000,78372000,0,-4756000,,93092000,93030000,58172,SFBS
2019-12-31,,,-46836936,,-46836936,1708548,0,-1690548,-1690548,-18000,,,,,0,0,1690548,0,-45146388,,-46836936,-46836936,58175,BSPE
2019-12-31,,,37808000,1483000,33345000,412657000,511391000,71072000,71072000,-70229000,-28356000,,,,4339000,6117359000,6046287000,5605968000,-33264000,,33469000,32044000,58176,TA
2018-12-31,,,-4347000,1495000,-120553000,431503000,531316000,16634000,16634000,-70229000,-29003000,,,,-1574000,6232215000,6215581000,5700899000,-20981000,-117631000.0,-2773000,-120428000,58176,TA
2017-12-31,,,-60348000,1447000,9151000,411159000,479017000,-14748000,-14748000,-70229000,-30016000,,,,-80250000,5316897000,5331645000,4837880000,-45600000,-10619000.0,19902000,8123000,58176,TA
2016-12-31,,,-3662000,1398000,-2018000,401350000,515799000,22060000,22060000,-70229000,-27815000,,,,-1733000,5451124000,5429064000,4935325000,-25722000,-10619000.0,-1929000,-1918000,58176,TA
2019-12-31,,,-50502000,,-51400000,6257000,-34696000,-40953000,-40953000,,-5719000,,,,898000,13211000,54164000,47907000,-9549000,,-51400000,-51400000,58177,INBX
2018-12-31,,,-30925000,,-31163000,4654000,-24859000,-29513000,-29513000,,-1480000,,,,96000,8595000,38108000,33454000,-1412000,,-31021000,-31163000,58177,INBX
2017-12-31,,,-21830000,27402000.0,-19442000,2609000,-17119000,-19728000,-19728000,,-2126000,,,,250000,8391000,28119000,25510000,-2102000,,-22080000,-19442000,58177,INBX
2016-12-31,,,-12885000,10486000.0,-8269000,1821000,-10325000,-12146000,-12146000,,-759000,,,,0,6667000,18813000,16992000,-739000,,-12885000,-8269000,58177,INBX
2019-12-31,,,-9719054,,-9719054,8519625,-96859,-8987396,-8987396,8804,-59738,,,,0,0,8987396,96859,-731658,,-9719054,-9719054,58178,GSV
2018-12-31,,,-10238910,,-10238910,10416352,-73194,-10669865,-10669865,2138,-59738,,,,0,0,10669865,73194,430955,,-10238910,-10238910,58178,GSV
2017-12-31,,,-11426786,,-11426786,8937722,-144136,-9126876,-9126876,2138,-59738,,,,0,0,9126876,144136,-2299910,,-11426786,-11426786,58178,GSV
2016-12-31,,,-9465128,,-9465128,7434210,-495445,-7939804,-7939804,2138,-59738,,,,0,0,7939804,495445,-1525324,,-9465128,-9465128,58178,GSV
2020-06-30,,,237179000,2852000,-85334000,395838000,561947000,166109000,166109000,,-19510000,,,,-6358000,1052001000,885892000,490054000,71070000,-329315000,243537000,-85334000,58180,ATGE
2019-06-30,,,139747000,9543000,95168000,359342000,529561000,170219000,170219000,,-19898000,,,,32878000,1013843000,843624000,484282000,-4294000,-12079000,106869000,95168000,58180,ATGE
2018-06-30,,,156041000,9110000,33769000,327707000,512092000,184385000,184385000,,-11581000,,,,88107000,960277000,775892000,448185000,-28344000,-34660000,67934000,33769000,58180,ATGE
2017-06-30,,,130565000,6285000,122283000,369043000,569664000,200621000,200621000,,-9144000,,,,9594000,1207909000,1007288000,638245000,-70056000,2309000,120971000,122283000,58180,ATGE
2019-12-28,34950000,,100508000,,81845000,904878000,1051923000,112095000,112095000,,-11591000,,,,18663000,1698352000,1586257000,646429000,-11587000,,81845000,81845000,58181,SNBR
2018-12-29,28775000,,86521000,,69539000,806758000,927961000,92428000,92428000,,-5911000,,,,16982000,1531575000,1439147000,603614000,-5907000,,69539000,69539000,58181,SNBR
2017-12-30,27806000,,91038000,,65077000,777626000,897347000,91915000,91915000,,-975000,,,,25961000,1444497000,1352582000,547150000,-779000,,65077000,65077000,58181,SNBR
2016-12-31,27991000,,75933000,,51417000,705519000,810160000,76650000,76650000,,-811000,,,,24516000,1311291000,1234641000,501131000,-717000,,51417000,51417000,58181,SNBR
2019-12-31,33628000,,-45711000,,-45711000,13673000,0,-47301000,-47301000,,,,,,0,0,47301000,0,1590000,,-45711000,-45711000,58183,OYST
2018-12-31,13755000,,-16503000,,-16503000,2981000,0,-16736000,-16736000,,,,,,0,0,16736000,0,233000,,-16503000,-16503000,58183,OYST
2017-12-31,3632000,,-6601000,,-6601000,2051000,0,-5683000,-5683000,,-488000.0,,,,0,0,5683000,0,-918000,,-6601000,-19144000,58183,OYST
2019-12-31,,,-961000,,-913000,6109000,6658000,549000,549000,,-245000,,,,-48000,33817000,33268000,27159000,-1510000,,-913000,-913000,58184,BOSC
2018-12-31,,,949000,,990000,5539000,6743000,1204000,1204000,,-192000,,,,-41000,32650000,31446000,25907000,-255000,,990000,990000,58184,BOSC
2017-12-31,,,789000,,773000,5259000,6345000,1086000,1086000,,-259000,,,,16000,28932000,27846000,22587000,-297000,,773000,773000,58184,BOSC
2016-12-31,,,367000,,360000,4787000,5315000,528000,528000,,-307000,,,,7000,27427000,26899000,22112000,-161000,,360000,360000,58184,BOSC
2019-12-31,,,-16092000,,-16201000,34819000,238671000,75768000,75768000,2197000,-85965000,,,,109000,821365000,745597000,582694000,-91860000,,-16201000,-16201000,58189,SBLK
2018-12-31,,,58458000,,58397000,33972000,289412000,150169000,150169000,1697000,-70767000,,,,61000,651561000,501392000,362149000,-91711000,,58397000,58397000,58189,SBLK
2017-12-31,,,-9535000,,-9771000,30955000,151301000,34948000,34948000,2775000,-49657000,,,,236000,331976000,297028000,180675000,-44483000,,-9771000,-9771000,58189,SBLK
2016-12-31,,,-153961000,,-154228000,24302000,44516000,-64662000,-64662000,2941000,-42732000,,,,267000,222106000,286768000,177590000,-89299000,,-154228000,-154228000,58189,SBLK
2019-12-31,3793000,,-5161000,,-5161000,1656000,0,-5449000,-5449000,,-346000,,,,0,0,5449000,0,288000,,-5161000,-5161000,58190,ATHA
2018-12-31,3589000,,-5097000,,-5097000,1420000,0,-5009000,-5009000,,-9000,,,,0,0,5009000,0,-88000,,-5097000,-5097000,58190,ATHA
2019-12-31,165028000000,,1019334000000,1520160000000,649109000000,3857135000000,10248879000000,1027760000000,1027760000000,1560036000000,-268187000000,,,,320060000000,24899189000000,23871429000000,14650310000000,-8426000000,,699274000000,649109000000,58191,KT
2018-12-31,176758000000,,1033977000000,1528589000000,645571000000,3714715000000,9681914000000,1100860000000,1100860000000,1407849000000,-296682000000,,,,314565000000,23436050000000,22335190000000,13754136000000,-66883000000,,719412000000,645571000000,58191,KT
2017-12-31,168635000000,,816997000000,1391764000000,461559000000,4002913000000,10264154000000,1069092000000,1069092000000,1659012000000,-302509000000,,,,270656000000,23546929000000,22477837000000,13282775000000,-252095000000,,546341000000,461559000000,58191,KT
2017-01-01,167881000000,,1166755000000,1352844000000,745090000000,3886712000000,10358131000000,1383104000000,1383104000000,1575168000000,-337367000000,,,,334910000000,23164202000000,21781098000000,12806071000000,-216349000000,,831845000000,745090000000,58191,KT
2019-12-31,,,-31345000,1692000,-33370000,138776000,117031000,-20839000,-20839000,-3295000,-5930000,,,,2335000,386962000,407801000,269931000,-10506000,,-33680000,-33370000,58192,NTZ
2018-12-31,,,40548000,1634000,33289000,150341000,120289000,-27158000,-27158000,-3639000,-3796000,,,,7429000,428539000,455697000,308250000,67706000,,33119000,33289000,58192,NTZ
2017-12-31,,,-27959000,2039000,-30392000,154359000,130479000,-25605000,-25605000,250000,-4639000,,,,2886000,448880000,474485000,318401000,-2354000,,-30845000,-30392000,58192,NTZ
2016-12-31,,,-2229000,3445000,-6089000,154170000,160040000,3294000,3294000,2576000,-4791000,,,,4241000,457218000,453924000,297178000,-5523000,,-6470000,-6089000,58192,NTZ
2019-12-31,,,-124920000,,-124858000,56485000,-79960000,-136445000,-136445000,,,,,,-62000,73993000,210438000,153953000,11525000,,-124858000,-124858000,58195,XLRN
2018-12-31,,,-118898000,,-118871000,34503000,-89911000,-124414000,-124414000,,,,,,-27000,13991000,138405000,103902000,5516000,,-118871000,-118871000,58195,XLRN
2017-12-31,,,-108422000,,-108454000,33738000,-76245000,-109983000,-109983000,,,,,,32000,13481000,123464000,89726000,1561000,,-108454000,-108454000,58195,XLRN
2016-12-31,,,-56990000,,-57014000,29097000,-37009000,-66106000,-66106000,,,,,,24000,27771000,93877000,64780000,9116000,,-57014000,-57014000,58195,XLRN
2020-12-31,,,2617520000,7938466000,1045363000,2580265000,5202626000,0,2622361000,,,,,,356014000,5935765000,3313404000,733139000,-4841000,,2261506000,1045363000,58198,BX
2019-12-31,,,3818015000,8093268000,2049682000,2517476000,5891095000,0,3373619000,,,,,,-47952000,7138622000,3765003000,1247527000,444396000,,3865967000,2049682000,58198,BX
2018-12-31,,,3512941000,7374862000,1541788000,2283316000,5604535000,0,3321219000,,,,,,249390000,6669269000,3348050000,1064734000,191722000,,3263551000,1541788000,58198,BX
2017-12-31,,,4118089000,7088598000,1471374000,2063854000,5456491000,0,3392637000,,,,,,743147000,6947529000,3554892000,1491038000,1129307000,,3374942000,1471374000,58198,BX
2019-12-31,76273000,,-83364000,,-70877000,121106000,152999000,-50719000,-50719000,,-19777000,,,,-12487000,315484000,366203000,162485000,-32645000,,-70877000,-70877000,58202,QTWO
2018-12-31,51334000,,-39200000,,-35397000,93772000,119245000,-27705000,-27705000,,-10142000,,,,-3803000,241100000,268805000,121855000,-11495000,,-35397000,-35397000,58202,QTWO
2017-12-31,40338000,,-26478000,,-26164000,78349000,94493000,-25675000,-25675000,,-10142000,,,,-314000,193978000,219653000,99485000,-803000,,-26164000,-26164000,58202,QTWO
2016-12-31,32460000,,-35927000,,-36354000,68276000,72795000,-29411000,-29411000,,-10142000,,,,427000,150224000,179635000,77429000,-6516000,,-36354000,-36354000,58202,QTWO
2019-12-31,,,69032000,,54015000,146958000,254413000,91254000,91254000,16201000,-5109000,,,,15017000,659325000,568071000,404912000,-22222000,,54015000,54015000,58203,GLOB
2018-12-31,,,67464000,,51677000,125120000,205534000,74085000,74085000,6329000,-677000,,,,15868000,522310000,448225000,316776000,-6621000,,51596000,51677000,58203,GLOB
2017-12-31,,,38544000,-40000.0,30539000,103786000,150678000,40586000,40586000,6306000,-883000,,,,8081000,413439000,372853000,262761000,-2042000,,30463000,30539000,58203,GLOB
2016-12-31,,,50189000,36000.0,35876000,75606000,131698000,51015000,51015000,5077000,-817000,,,,14327000,322856000,271841000,191158000,-826000,,35862000,35876000,58203,GLOB
2019-12-31,,,121100000,,87100000,258500000,386200000,128800000,128800000,-1100000,-18700000,,,,34000000,1731100000,1602300000,1344900000,-7700000,,87100000,87100000,58204,KRO
2018-12-31,,,293800000,,205000000,257800000,562200000,305200000,305200000,-800000,-19500000,,,,88800000,1661900000,1356700000,1099700000,-11400000,,205000000,205000000,58204,KRO
2017-12-31,,,305700000,,354500000,231900000,569700000,338300000,338300000,-500000,-19000000,,,,-48800000,1729000000,1390700000,1159300000,-32600000,,354500000,354500000,58204,KRO
2016-12-31,,,61200000,,43300000,193000000,264700000,71600000,71600000,100000,-20500000,,,,17900000,1364300000,1292700000,1099600000,-10400000,,43300000,43300000,58204,KRO
2019-12-31,,,-128489000,,-128790000,89135000,-26494000,-115629000,-115629000,,-16403000,,,,301000,16544000,132173000,43038000,-12860000,,-128790000,-128790000,58205,PRTK
2018-12-31,57508000.0,,-111854000,,-112356000,63658000,-40391000,-104049000,-104049000,,-10985000,,,,502000,17117000,121166000,57508000,-7805000,,-112356000,-112356000,58205,PRTK
2017-12-31,57508000.0,,-88316000,,-89069000,36965000,-47456000,-84421000,-84421000,,-5079000,,,,753000,12616000,97037000,60072000,-3895000,,-89069000,-89069000,58205,PRTK
2016-12-31,57508000.0,,-111636000,,-111636000,26400000,-83431000,-109831000,-109831000,,-3223000,,,,0,29000,109860000,83460000,-1805000,,-111636000,-111636000,58205,PRTK
2019-12-31,,,304566000,,155467000,8801162000,10411236000,1350640000,1350640000,49919000,-637619000,,,,149099000,14444690000,13094050000,4033454000,-1046074000,,155467000,155467000,58206,NTCO
2018-12-31,,,673405000,,548379000,8080054000,9614576000,1380437000,1380437000,-83799000,-631475000,,,,125026000,13397419000,12016982000,3782843000,-707032000,,548379000,548379000,58206,NTCO
2017-12-31,,,971192000,,670251000,5500964000,6941631000,1391541000,1391541000,-184588000,-387753000,,,,300941000,9852708000,8461167000,2911077000,-420349000,,670251000,670251000,58206,NTCO
2016-12-31,,,426859000,,296699000,4437262000,5474405000,1088150000,1088150000,-51007000,-319084000,,,,118621000,7912664000,6824514000,2438259000,-661291000,,308238000,296699000,58206,NTCO
2019-12-31,22201000,,-63530000,,-62078000,72211000,32359000,-62053000,-62053000,,,,,,-1452000,49648000,111701000,17289000,-1477000,,-62078000,-62078000,58207,VERI
2018-12-31,20709000,,-61082000,,-61104000,58363000,20568000,-58504000,-58504000,,,,,,22000,27047000,85551000,6479000,-2578000,,-61104000,-61104000,58207,VERI
2017-12-31,13970000,,-59595000,,-59601000,46135000,13343000,-46762000,-46762000,,-14368000.0,,,,6000,14413000,61175000,1070000,-12833000,,-59601000,-64071000,58207,VERI
2016-12-31,7900000,,-26973000,,-26979000,22714000,7334000,-23280000,-23280000,,-3890000.0,,,,6000,8911000,32191000,1577000,-3693000,,-26979000,-30183000,58207,VERI
2020-12-31,,,-257000000,5353000000,-50000000,,554000000,253000000,253000000,30000000,-620000000,,,,-19000000,917000000,664000000,363000000,-510000000,,-238000000,-55000000,58208,NEP
2019-12-31,,,-430000000,4883000000,-71000000,,519000000,233000000,233000000,27000000,-702000000,,,,-26000000,855000000,622000000,336000000,-663000000,,-404000000,-88000000,58208,NEP
2018-12-31,,,273000000,3192000000,192000000,,514000000,290000000,290000000,21000000,-248000000,,,,6000000,771000000,481000000,257000000,-17000000,,267000000,167000000,58208,NEP
2017-12-31,,,281000000,34000000,-61000000,,559000000,312000000,312000000,21000000,-199000000,,,,167000000,807000000,495000000,248000000,-31000000,,114000000,-64000000,58208,NEP
2019-12-31,49020000,,-67483000,,-67484000,23551000,0,-72571000,-72571000,,-6000,,,,1000,0,72571000,0,5088000,,-67484000,-67484000,58209,BCEL
2018-12-31,30756000,,-37941000,,-37940000,8817000,0,-39573000,-39573000,,-9000,,,,-1000,0,39573000,0,1632000,,-37940000,-37940000,58209,BCEL
2017-12-31,23146000,,-27524000,,-27527000,6289000,0,-29435000,-29435000,,-14000,,,,3000,0,29435000,0,1911000,,-27527000,-27527000,58209,BCEL
2020-02-29,,,2470363,,2470363,218555,932804,714249,714249,,-14778,,,,0,932804,218555,0,1756114,,2470363,2470363,58210,NJV
2019-02-28,,,789644,,789644,217225,1074842,857617,857617,,-30021,,,,0,1074842,217225,0,-67973,,789644,789644,58210,NJV
2018-02-28,,,811259,,811259,228549,1132130,903581,903581,,-22348,,,,0,1132130,228549,0,-92322,,811259,811259,58210,NJV
2017-02-28,,,-167821,,-167821,222204,1143676,921472,921472,,-17060,,,,0,1143676,222204,0,-1089292,,-167821,-167821,58210,NJV
2019-12-31,,,6289000,,4125000,67623000,75035000,7412000,7412000,,-934000,,,,2164000,394170000,386758000,319135000,-1866000,,4125000,4125000,58211,CTG
2018-12-31,,,2269000,,-2817000,65207000,68487000,3280000,3280000,,-841000,,,,5086000,358769000,355489000,290282000,-1629000,,-2817000,-2817000,58211,CTG
2017-12-31,,,4057000,,806000,51408000,56376000,4968000,4968000,,-589000,,,,3251000,301210000,296242000,244834000,-911000,,806000,806000,58211,CTG
2016-12-31,,,-33536000,,-34638000,53284000,58482000,5898000,5898000,-700000.0,-793000,,,,1102000,324893000,318995000,266411000,-39434000,,-34638000,-34638000,58211,CTG
2019-12-31,,,-55000000,,-50000000,129600000,241900000,60300000,60300000,,-30300000,,,,-5000000,360900000,300600000,119000000,-115300000,,-50000000,-50000000,58212,EEX
2018-12-31,,,-33400000,,-25100000,113200000,269700000,109700000,109700000,,-29100000,,,,-8300000,380700000,271000000,111000000,-143100000,,-25100000,-25100000,58212,EEX
2017-12-31,,,46800000,,81800000,99200000,247800000,105400000,105400000,,-38300000,,,,-35000000,341700000,236300000,93900000,-58600000,,81800000,81800000,58212,EEX
2016-12-31,,,36200000,,22200000,98900000,239300000,100400000,100400000,,-51400000,,,,14000000,323700000,223300000,84400000,-64200000,,22200000,22200000,58212,EEX
2019-12-29,,,249825000,,259809000,340487000,763661000,395522000,395522000,,-32087000,,,,-9984000,2823901000,2428379000,2060240000,-145697000,,259809000,259809000,58213,GIL
2018-12-30,,,372134000,,350774000,364912000,805953000,437407000,437407000,,-25056000,,,,21360000,2908565000,2471158000,2102612000,-65273000,,350774000,350774000,58213,GIL
2017-12-31,,,376816000,,362334000,377323000,801219000,423896000,423896000,,-17437000,,,,14482000,2750816000,2326920000,1949597000,-47080000,,362334000,362334000,58213,GIL
2017-01-01,,,351838000,,346638000,336433000,719703000,383270000,383270000,,-12904000,,,,5200000,2585070000,2201800000,1865367000,-31432000,,346638000,346638000,58213,GIL
2020-12-31,101687000,,-37074000,,-42731000,297074000,362667000,-36094000,-36094000,,,,,,5657000,440221000,476315000,77554000,-980000,,-42731000,-42731000,58214,TENB
2019-12-31,87064000,,-85649000,,-99013000,297503000,293768000,-90799000,-90799000,,,,,,13364000,354586000,445385000,60818000,1180000,,-99013000,-99013000,58214,TENB
2018-12-31,76698000,,-71157000,,-73521000,220076000,224193000,-72581000,-72581000,,,,,,2364000,267360000,339941000,43167000,1424000,,-73521000,-73955000,58214,TENB
2017-12-31,57673000,,-40851000,,-41022000,145226000,162139000,-40760000,-40760000,,-75000.0,,,,171000,187727000,228487000,25588000,-91000,,-41022000,-41785000,58214,TENB
2019-12-31,166023000,,-197556000,,-197556000,40849000,0,-206872000,-206872000,,,,,,0,0,206872000,0,9316000,,-197556000,-197556000,58218,IOVA
2018-12-31,99828000,,-123580000,,-123580000,28430000,0,-128258000,-128258000,,,,,,0,0,128258000,0,4678000,,-123580000,-123580000,58218,IOVA
2017-12-31,71615000,,-92064000,,-92064000,21262000,0,-92877000,-92877000,,,,,,0,0,92877000,0,813000,,-92064000,-92064000,58218,IOVA
2016-12-31,26941000,,-52894000,,-52894000,17198000,0,-44139000,-44139000,,,,,,0,0,44139000,0,-8755000,,-52894000,-102348000,58218,IOVA
2020-12-31,72548000,,102037000,,91572000,114535000,283737000,96654000,96654000,,-9000,,,,10465000,362963000,266309000,79226000,5383000,,91572000,91572000,58219,QLYS
2019-12-31,69639000,,79983000,,69336000,111598000,252090000,70853000,70853000,,-106000,,,,10647000,321607000,250754000,69517000,9130000,,69336000,69336000,58219,QLYS
2018-12-31,53255000,,55468000,,57304000,109088000,212704000,50361000,50361000,,-172000,,,,-1836000,278889000,228528000,66185000,5107000,,57304000,57304000,58219,QLYS
2017-12-31,42816000,,39378000,,40440000,99189000,179248000,37243000,37243000,,-3000,,,,-1062000,230828000,193585000,51580000,2135000,,40440000,40440000,58219,QLYS
2020-09-30,,,8696000,,6753000,13986000,25107000,11121000,11121000,,-1438000,,,,1943000,182714000,171593000,157607000,-2425000,,6753000,6721000,58223,IEC
2019-09-30,,,5923000,,4747000,14076000,21644000,7568000,7568000,,-1645000,,,,1176000,156981000,149413000,135337000,-1645000,,4747000,4709000,58223,IEC
2018-09-30,,,1573000,,10410000,11438000,14157000,2719000,2719000,,-1146000,,,,-8837000,116922000,114203000,102765000,-1146000,,10410000,10306000,58223,IEC
2017-09-30,,,143000,,81000,10197000,11257000,1060000,1060000,,-917000,,,,62000,96455000,95395000,85198000,-917000,,81000,80000,58223,IEC
2020-12-31,,,354720000,,260824000,656207000,1112628000,368092000,368092000,,-5082000,,,,93896000,2161220000,1793128000,1048592000,-13372000,,260824000,260824000,58224,ROL
2019-12-31,,,261160000,,203347000,623379000,1021884000,317394000,317394000,,-6917000,,,,57813000,2015477000,1698083000,993593000,-56234000,,203347000,203347000,58224,ROL
2018-12-31,,,310733000,,231663000,550698000,927128000,309638000,309638000,,-6917000,,,,79070000,1821565000,1511927000,894437000,1095000,,231663000,231663000,58224,ROL
2017-12-31,,,294502000,,179124000,503433000,854014000,294001000,294001000,,-6917000,,,,115378000,1673957000,1379956000,819943000,501000,,179124000,179124000,58224,ROL
2019-12-31,,,-28719000,,-62371000,1025988000,1128491000,100278000,100278000,2225000,-100113000,,,,-6135000,9210939000,9110661000,8082448000,-128997000,-39787000,-22584000,-62371000,58225,OMI
2018-12-31,,,-427094000,,-437012000,956630000,1070526000,116935000,116935000,-3039000,-70983000,,,,-32429000,9418192000,9301257000,8347666000,-544029000,-42347000,-394665000,-437012000,58225,OMI
2017-12-31,,,57478000,,72793000,1016978000,1171866000,149958000,149958000,4930000,-31773000,,,,-15315000,9318275000,9168317000,8146409000,-92480000,-42347000,72793000,71733000,58225,OMI
2016-12-31,,,172542000,,108787000,970424000,1187310000,224274000,224274000,-7388000,-27057000,,,,63755000,9723431000,9499157000,8536121000,-51732000,-42347000,108787000,107640000,58225,OMI
2020-12-31,31024000,,52680000,,45586000,126074000,212794000,50158000,50158000,,,,,,7094000,312630000,262472000,99836000,2522000,,45586000,45586000,58227,SPSC
2019-12-31,28305000,,42070000,,33712000,114859000,186885000,38406000,38406000,,,,,,8358000,279124000,240718000,92239000,3664000,,33712000,33712000,58227,SPSC
2018-12-31,22087000,,28340000,,23872000,113581000,166492000,26731000,26731000,,,,,,4468000,248240000,221509000,81748000,1609000,,23872000,23872000,58227,SPSC
2017-12-31,23183000,,10693000,,351000,108722000,146460000,9981000,9981000,,,,,,10342000,220085000,210104000,73625000,712000,,351000,351000,58227,SPSC
2020-12-31,,,-499790000,,-549177000,2171934000,2172471000,537000,537000,,-47259000,,,,49387000,4474667000,4474130000,2302196000,-500327000,,-549177000,-549177000,58228,UA
2019-12-31,,,162163000,,92139000,2222163000,2470533000,242270000,242270000,,-21240000,,,,70024000,5267132000,5024862000,2796599000,-80107000,,92139000,92139000,58228,UA
2018-12-31,,,-66854000,,-46302000,2176239000,2361271000,178932000,178932000,,-33568000,,,,-20552000,5193185000,5014253000,2831914000,-245786000,,-46302000,-46302000,58228,UA
2017-12-31,,,-10309000,,-48260000,2091322000,2256491000,156969000,156969000,,-34538000,,,,37951000,4989244000,4832275000,2732753000,-167278000,,-48260000,-48260000,58228,UA
2019-12-31,5039000,,-15429000,,-19514000,16828000,11465000,-10402000,-10402000,,-3475000,,,,4085000,32344000,42746000,20879000,-5027000,,-19514000,-19514000,58229,DNMR
2018-12-31,5079000,,259000,,208000,7358000,11245000,-1192000,-1192000,,-3232000,,,,51000,30454000,31646000,19209000,1451000,,208000,208000,58229,DNMR
2020-12-31,,,4761632000000,857783000000,3455151000000,6833152000000,11449144000000,0,4615992000000,,,,,,1259351000000,11449144000000,6833152000000,0,145640000000,,3502281000000,3455151000000,58230,KB
2019-12-31,,,4533986000000,585407000000,3311828000000,6032347000000,10791557000000,0,4520540000000,238670000000.0,,,,,1220787000000,10791557000000,6271017000000,0,13446000000,,3313199000000,3305315500000,58230,KB
2018-12-31,,,4301532000000,9111000000,3061191000000,5703829000000,10332816000000,0,4414304000000,214683000000.0,,,,,1239586000000,10332816000000,5918512000000,0,-112772000000,,3061946000000,3061191000000,58230,KB
2017-12-31,,,4138424000000,6144000000,3311438000000,5432699000000,9628912000000,0,4000248000000,195965000000.0,,,,,794963000000,9628912000000,5628664000000,0,138176000000,,3343461000000,3311438000000,58230,KB
2019-12-31,,,-54213000,,-54854000,43801000,28441000,-57177000,-57177000,10381000,-8760000,,,,641000,272064000,329241000,243623000,2964000,,-54854000,-60434000,58232,DS
2018-12-31,,,-38399000,,-38683000,36255000,42322000,-16267000,-16267000,147000,-16639000,,,,284000,314369000,330636000,272047000,-22132000,,-38683000,-44263000,58232,DS
2017-12-31,,,-41236000,,-42201000,36386000,41839000,-19291000,-19291000,120000,-19581000,,,,965000,292594000,311885000,250755000,-21945000,,-42201000,-47781000,58232,DS
2016-12-31,,,77525000,,77079000,39324000,38027000,-27793000,-27793000,120000,-52868000,,,,189000,298880000,326673000,260853000,105318000,,77336000,71499000,58232,DS
2020-01-31,2522000000,,1438000000,,6412000000,4970000000,9012000000,1520000000,1520000000,,-149000000,,,,-4918000000,10811000000,9291000000,1799000000,-82000000,,6356000000,6412000000,58233,VMW
2019-02-01,2173000000,,1829000000,1026000000.0,1650000000,4076000000,8061000000,1812000000,1812000000,,-134000000,,,,239000000,9613000000,7801000000,1552000000,17000000,,1590000000,1650000000,58233,VMW
2018-02-02,1917000000,,1577000000,1026000000.0,437000000,3445000000,6929000000,1567000000,1567000000,,-74000000,,,,1152000000,8336000000,6769000000,1407000000,10000000,,425000000,437000000,58233,VMW
2017-02-03,1800000000,,-420000000,1026000000.0,-60000000,3732000000,5028000000,-504000000,-504000000,,-24000000,,,,-360000000,6144000000,6648000000,1116000000,84000000,,-60000000,-60000000,58233,VMW
2019-12-31,73611000,,-116508000,,-116508000,51952000,20662000,-104901000,-104901000,,-10774000,,,,0,23054000,127955000,2392000,-11607000,,-116508000,-116508000,58235,LJPC
2018-12-31,108128000,,-199469000,,-199469000,90336000,8413000,-190051000,-190051000,,-7303000,,,,0,10056000,200107000,1643000,-9418000,,-199469000,-199469000,58235,LJPC
2017-12-31,108128000,,-114803000,,-114803000,30852000,-84575000,-115427000,-115427000,,-7303000,,,,0,0,115427000,84575000,624000,,-114803000,-114803000,58235,LJPC
2016-12-31,108128000,,-78185000,,-78185000,16700000,-61672000,-78372000,-78372000,,-7303000,,,,0,616000,78988000,62288000,187000,,-78185000,-78185000,58235,LJPC
2019-12-31,,,-1100000,,-100200000,1497400000,2153300000,367100000,367100000,49000000,-150200000,,,,104500000,9286900000,8919800000,7133600000,-368200000,5400000,-105600000,-100200000,58238,UNVR
2018-12-31,,,222200000,,172300000,1282900000,1900100000,393000000,393000000,24000000,-135600000,,,,49900000,8632500000,8239500000,6732400000,-170800000,5400000,172300000,172000000,58238,UNVR
2017-12-31,,,168800000,,119800000,1195900000,1805500000,374500000,374500000,15000000,-154200000,,,,49000000,8253700000,7879200000,6448200000,-205700000,5400000,119800000,119600000,58238,UNVR
2016-12-31,,,-79600000,,-68400000,1231700000,1727100000,247100000,247100000,68600000,-153700000,,,,-11200000,8073700000,7826600000,6346600000,-326700000,5400000,-68400000,-68400000,58238,UNVR
2019-12-31,940828000,,2113801000,16065427000,850999000,4621501000,12612420000,5544564000,5544564000,1352384000,-4375831000,,,,625720000,190074161000,184529597000,177461741000,-3430763000,,1488081000,631750000,58239,ACH
2018-12-31,626873000,,2391330000,15254312000,831213000,5362019000,13621133000,6254832000,6254832000,1333217000,-4685050000,,,,822519000,180241414000,173986582000,166620281000,-3863502000,,1568811000,701931000,58239,ACH
2017-12-31,498234000,,3049010000,26054567000,1413028000,5867612000,15130092000,7393543000,7393543000,1310004000,-4830704000,,,,643734000,181020428000,173626885000,165890336000,-4344533000,,2405276000,1303028000,58239,ACH
2016-12-31,498234000,,1625545000,17618510000,368412000,4774225000,10755857000,5165092000,5165092000,863208000,-4755435000,,,,404172000,144228916000,139063824000,133473059000,-3539547000,,1221373000,258412000,58239,ACH
2020-06-30,4973000,,-14336000,,-14336000,9761000,2186000,-12548000,-12548000,,-1788000,,,,0,16842000,29390000,14656000,-1788000,,-14336000,-14336000,58241,FLUX
2019-06-30,4088000,,-12414000,,-12414000,7712000,549000,-11251000,-11251000,,-1247000,,,,0,9317000,20568000,8768000,-1079000,,-12414000,-12414000,58241,FLUX
2018-06-30,1956000,,-6965000,,-6965000,3462000,-795000,-6213000,-6213000,,-752000,,,,0,4118000,10331000,4913000,-752000,,-6965000,-6965000,58241,FLUX
2017-06-30,1052000,,-4435000,,-4435000,2404000,-720000,-4176000,-4176000,,-273000,,,,0,902000,5078000,1622000,-259000,,-4435000,-4435000,58241,FLUX
2019-12-31,,,507888000,,397555000,77616000,574935000,497319000,497319000,,-4791000,,,,110333000,806431000,309112000,231496000,10569000,,397555000,397555000,58244,ARNA
2018-12-31,,,-138834000,,-29399000,45257000,-97059000,-142316000,-142316000,,-5695000,,,,-110265000,17970000,160286000,115029000,3482000,-830000.0,-28569000,-29399000,58244,ARNA
2017-12-31,,,-95854000,,-91407000,30341000,-49651000,-79992000,-79992000,,-6119000,,,,0,21337000,101329000,70988000,-15862000,3122000.0,-95854000,-91407000,58244,ARNA
2016-12-31,,,-12300000,491000.0,-22516000,27529000,28381000,852000,852000,,-6512000,,,,0,92163000,91311000,63782000,-13152000,-10596000.0,-12300000,-22516000,58244,ARNA
2019-12-31,,,1308000000,,992000000,2924000000,5441000000,2041000000,2041000000,372000000,-490000000,,,,316000000,19255000000,17214000000,13814000000,-733000000,,992000000,992000000,58247,NTR
2018-12-31,,,-124000000,,3573000000,2775000000,5392000000,2171000000,2171000000,330000000,-489000000,,,,-93000000,18772000000,16601000000,13380000000,-2295000000,3604000000.0,-31000000,3573000000,58247,NTR
2017-12-31,,,-29000000,,327000000,233000000,999000000,600000000,600000000,166000000,-204000000,,,,-183000000,4010000000,3410000000,3011000000,-629000000,173000000.0,154000000,327000000,58247,NTR
2016-12-31,,,243000000,,323000000,231000000,877000000,519000000,519000000,127000000,-186000000,,,,44000000,3921000000,3402000000,3044000000,-276000000,124000000.0,199000000,323000000,58247,NTR
2020-01-31,37142000,,-18931000,,-18801000,70241000,91663000,-15720000,-15720000,,,,,,-130000,151593000,167313000,59930000,-3211000,,-18801000,-18801000,58249,OOMA
2019-01-31,33903000,,-14956000,,-14572000,57674000,76491000,-15086000,-15086000,,,,,,-384000,129231000,144317000,52740000,130000,,-14572000,-14572000,58249,OOMA
2018-01-31,29328000,,-13121000,,-13121000,52488000,68092000,-13724000,-13724000,,,,,,0,114490000,128214000,46398000,603000,,-13121000,-13121000,58249,OOMA
2017-01-31,24239000,,-12949000,,-12949000,48366000,59329000,-13276000,-13276000,,,,,,0,104524000,117800000,45195000,327000,,-12949000,-12949000,58249,OOMA
2019-12-31,,,1762000,2349000,1741000,3967000,34596000,19382000,19382000,-1543000,-18164000,,,,0,40692000,21310000,6096000,-17620000,,1762000,-2499000,58250,LANDM
2018-12-31,,,2766000,4807000,2629000,3026000,30713000,11018000,11018000,7294000,-13963000,,,,0,36687000,25669000,5974000,-8252000,,2766000,2250000,58250,LANDM
2017-12-31,,,-34000,8034000,-31000,3072000,21758000,11503000,11503000,-54000,-11595000,,,,0,25122000,13619000,3364000,-11537000,,-34000,-31000,58250,LANDM
2016-12-31,,,473000,11087000,448000,2499000,14988000,7311000,7311000,-54000,-6692000,,,,0,17317000,10006000,2329000,-6838000,,473000,448000,58250,LANDM
2019-12-31,,,152132000,36980000,225108000,56500000,290738000,65215000,65215000,,-95585000,,,,17810000,578774000,513559000,288036000,86917000,73215000,134322000,223270000,58251,FTAI
2018-12-31,,,-17657000,56383000,5882000,32852000,205542000,38782000,38782000,,-56845000,,,,2449000,342112000,303330000,136570000,-56439000,4063000,-20106000,5882000,58251,FTAI
2017-12-31,,,-20549000,88007000,134000,30302000,122633000,6258000,6258000,,-37798000,,,,1954000,185052000,178794000,62419000,-26807000,-667000,-22503000,134000,58251,FTAI
2016-12-31,,,-40330000,111868000,-20064000,29056000,77251000,-12015000,-12015000,,-18957000,,,,268000,148720000,160735000,71469000,-28315000,-667000,-40598000,-20064000,58251,FTAI
2020-12-31,2565000000,,5197000000,1522000000,5704000000,11372000000,13514000000,-423000000,-423000000,,-1333000000,,,,-474000000,79619000000,80042000000,66105000000,5620000000,-125000000,5671000000,5066000000,58252,GE
2019-12-31,3118000000,,1148000000,1545000000,-4979000000,12380000000,21916000000,6418000000,6418000000,,-2115000000,,,,726000000,95214000000,88796000000,73298000000,-5270000000,-5335000000,422000000,-5440000000,58252,GE
2018-12-31,3415000000,,-20988000000,20500000000,-22355000000,11450000000,21576000000,6711000000,6711000000,,-2415000000,,,,93000000,97012000000,90301000000,75436000000,-27699000000,-1363000000,-21081000000,-22809000000,58252,GE
2017-12-31,3415000000,,-11345000000,20859000000,-8484000000,12455000000,7111000000,-5344000000,-5344000000,,-2538000000,,,,-2808000000,99279000000,104623000000,92168000000,-6001000000,-312000000,-8537000000,-8944000000,58252,GE
2020-03-31,,,896000,10000,686000,3406000,4153000,747000,747000,,,,,,209000,12558000,11811000,8405000,149000,,687000,686000,58253,HIHO
2019-03-31,,,-694000,11000,-630000,4258000,3580000,-678000,-678000,,,,,,-26000,14277000,14955000,10697000,-16000,,-668000,-630000,58253,HIHO
2018-03-31,,,2072000,49000,1550000,4804000,6742000,1938000,1938000,,,,,,512000,19166000,17228000,12424000,134000,,1560000,1550000,58253,HIHO
2017-03-31,,,761000,39000,527000,4809000,5570000,761000,761000,,,,,,236000,19603000,18842000,14033000,0,,525000,527000,58253,HIHO
2019-12-31,37506000,,-47365000,,-47365000,11684000,0,-49190000,-49190000,,-8000,,,,0,0,49190000,0,1825000,,-47365000,-47365000,58254,KOD
2018-12-31,18793000,,-41443000,,-41443000,7581000,0,-26374000,-26374000,,-5519000,,,,0,0,26374000,0,-15069000,,-41443000,-41443000,58254,KOD
2017-12-31,22022000,,-27936000,,-27936000,3499000,0,-25521000,-25521000,,-1185000,,,,0,0,25521000,0,-2415000,,-27936000,-27936000,58254,KOD
2016-12-31,14053000,,-17132000,,-17132000,3098000,0,-17151000,-17151000,,-6000,,,,0,0,17151000,0,19000,,-17132000,-17132000,58254,KOD
2019-12-31,3702000,,50385000,,39111000,39692000,96488000,53094000,53094000,,-2378000,,,,11274000,818166000,765072000,721678000,-2709000,,39111000,39111000,58255,MLR
2018-12-31,3127000,,41663000,,33746000,36415000,83336000,43794000,43794000,,-1878000,,,,7917000,711706000,667912000,628370000,-2131000,,33746000,33746000,58255,MLR
2017-12-31,1943000,,30339000,,23016000,33618000,67101000,31540000,31540000,,-1588000,,,,7323000,615101000,583561000,548000000,-1201000,,23016000,23016000,58255,MLR
2016-12-31,1797000,,31077000,,19922000,30521000,64279000,31961000,31961000,,-1161000,,,,11155000,601119000,569158000,536840000,-884000,,19922000,19922000,58255,MLR
2019-12-31,,,-18726000,-208000,-23576000,46404000,40368000,-6036000,-6036000,,-14225000,,,,4850000,78110000,84146000,37742000,-12690000,,-23576000,-23576000,58259,PLBY
2018-12-31,,,3944000,-208000,1682000,31887000,50266000,18379000,18379000,,-9211000,,,,2262000,100873000,82494000,50607000,-14435000,,1682000,1682000,58259,PLBY
2010-12-31,,,-45100000,-208000,-48500000,31887000,4900000,4900000,4900000,,-9300000,,,,3400000,215200000,210300000,210300000,-50000000,,-48500000,-48500000,58259,PLBY
2009-12-31,,,-48619000,-208000,-51278000,48405000,55463000,7097000,7097000,-39000.0,-9403000,,,,2659000,240353000,233256000,184890000,-55716000,,-51278000,-51278000,58259,PLBY
2019-12-31,,,-4087000,356000,-3426000,24550000,31455000,2027000,2027000,,-1231000,,,,-642000,41727000,39700000,10272000,-6114000,,-3445000,-3426000,58262,XELB
2018-12-31,,,2919000,356000,1088000,24467000,32764000,4729000,4729000,,-986000,,,,1831000,35466000,30737000,2702000,-1810000,,1088000,1088000,58262,XELB
2017-12-31,,,-10569000,356000,-10122000,23811000,31706000,3149000,3149000,,-1211000,,,,-447000,31706000,28557000,0,-13718000,,-10122000,-10122000,58262,XELB
2016-12-31,,,3018000,356000,2737000,24278000,32692000,2127000,2127000,,-1599000,,,,315000,32692000,30565000,0,891000,34000.0,2703000,2737000,58262,XELB
2020-06-30,,,80818000,13583000,-262267000,1986912000,2732498000,766836000,766836000,-46616000,-31338000,,,,210949000,8978986000,8212150000,6246488000,-686018000,-130045000,-130131000,-228973000,58265,MNSO
2019-06-30,,,289004000,10815000,-290647000,1411523000,2510980000,1030411000,1030411000,-21078000,-25209000,,,,279583000,9394911000,8364500000,6883931000,-741407000,-303830000,9421000,-274318000,58265,MNSO
2019-12-31,,,-78166000,,-78166000,20276000,-58739000,-79015000,-79015000,,,,,,0,1077000,80092000,59816000,849000,,-78166000,-78166000,58266,CNCE
2018-12-31,,,-55711000,,-56024000,22940000,-32644000,-55584000,-55584000,,,,,,313000,10505000,66089000,43149000,-127000,,-56024000,-56024000,58266,CNCE
2017-12-31,,,95339000,,95639000,21019000,-30161000,-51180000,-51180000,,-815000.0,,,,-300000,62000,51242000,30223000,146519000,,95639000,95195000,58266,CNCE
2016-12-31,,,-50720000,,-50720000,14358000,-36809000,-51167000,-51167000,,-815000.0,,,,0,174000,51341000,36983000,447000,,-50720000,-50720000,58266,CNCE
2019-12-31,1702117,,-5447145,,-5447145,2494922,0,-4197039,-4197039,,-819711,,,,0,0,4197039,0,-1250106,,-5447145,-5447145,58267,NLSP
2018-12-31,1437202,,-5146766,,-5146766,2011659,0,-3448861,-3448861,,-1084708,,,,0,0,3448861,0,-1697905,,-5146766,-5146766,58267,NLSP
2017-12-31,4324822,,-6657127,,-6657127,1441902,0,-5766724,-5766724,,-897653,,,,0,0,5766724,0,-890403,,-6657127,-6657127,58267,NLSP
2019-12-31,,,-93833000,60982000,-111513000,78496000,148984000,68672000,68672000,,-57264000,,,,8083000,148984000,80312000,0,-162505000,,-101916000,-111513000,58268,ICON
2018-12-31,,,-83131000,61136000,-100521000,111129000,187689000,74231000,74231000,,-59214000,,,,6538000,187689000,113458000,0,-157362000,,-89669000,-100521000,58268,ICON
2017-12-31,,,-653432000,53731000,-489253000,114606000,225833000,108772000,108772000,,-67901000,,,,-95977000,225833000,117061000,0,-762204000,46025000.0,-557455000,-494842000,58268,ICON
2016-12-31,,,-335949000,173231000,-252134000,113859000,255143000,138491000,138491000,,-76925000,,,,-78125000,255143000,116652000,0,-474440000,2364000.0,-257824000,-252134000,58268,ICON
2019-12-31,2616000,,-10294000,,-10294000,6328000,0,-8944000,-8944000,,-1349000,,,,0,0,8944000,0,-1350000,,-10294000,-10294000,58270,HGEN
2018-12-31,2219000,,-12004000,,-12004000,9112000,0,-11331000,-11331000,,-852000,,,,0,0,11331000,0,-673000,,-12004000,-12004000,58270,HGEN
2017-12-31,11165000,,-21987000,,-21987000,7866000,0,-19031000,-19031000,,-3056000,,,,0,0,19031000,0,-2956000,,-21987000,-21987000,58270,HGEN
2016-12-31,10449000,,-27019000,,-27019000,7576000,0,-18025000,-18025000,,-131000,,,,0,0,18025000,0,-8994000,,-27019000,-27019000,58270,HGEN
2019-12-31,34377000,,-33379000,,-33539000,81349000,84849000,-30877000,-30877000,,,,,,160000,107073000,137950000,22224000,-2502000,,-33539000,-34171000,58271,FVRR
2018-12-31,25285000,,-36061000,,-36061000,69501000,59882000,-34904000,-34904000,,,,,,0,75503000,110407000,15621000,-1157000,,-36061000,-36061000,58271,FVRR
2017-12-31,16074000,,-19030000,,-19324000,42199000,38750000,-19523000,-19523000,,,,,,294000,52112000,71635000,13362000,493000,,-19324000,-19324000,58271,FVRR
2019-12-31,4848000,,-18240000,,-18683000,73473000,62980000,-15341000,-15341000,,-388000,,,,443000,216135000,231476000,153155000,-2899000,,-18683000,-18683000,58274,SREV
2018-12-31,6436000,,-24435000,,-24885000,80638000,73647000,-13427000,-13427000,,-7396000,,,,450000,238340000,251767000,164693000,-11008000,,-24885000,-24885000,58274,SREV
2017-12-31,5729000,,-31493000,,-29846000,86088000,75418000,-16399000,-16399000,,-11683000,,,,-1647000,239127000,255526000,163709000,-15094000,,-29846000,-29846000,58274,SREV
2016-12-31,8344000,,-28697000,,-32126000,93467000,87818000,-13993000,-13993000,,-11030000,,,,3429000,252887000,266880000,165069000,-14704000,,-32126000,-32126000,58274,SREV
2020-12-31,,,169975000,,148600000,233283000,433380000,0,182096000,18001000,,,,,21375000,433380000,251284000,0,-12121000,,148600000,148600000,58275,FRME
2019-12-31,,,193785000,,164460000,218220000,440548000,0,204524000,17804000,,,,,29325000,440548000,236024000,0,-10739000,,164460000,164460000,58275,FRME
2018-12-31,,,188138000,,159139000,191876000,408089000,0,199247000,16966000,,,,,28999000,408089000,208842000,0,-11109000,,159139000,159139000,58275,FRME
2017-12-31,,,133594000,,96070000,179899000,339150000,0,143708000,15543000,,,,,37524000,339150000,195442000,0,-10114000,,96070000,96070000,58275,FRME
2019-12-31,,,-78254000,,-78254000,15734000,-64600000,-80334000,-80334000,,,,,,0,0,80334000,64600000,2080000,,-78254000,-78254000,58276,AGLE
2018-12-31,36719000.0,,-44348000,,-44348000,12632000,-32831000,-45463000,-45463000,,,,,,0,3888000,49351000,36719000,1115000,,-44348000,-44348000,58276,AGLE
2017-12-31,36719000.0,,-27236000,,-27236000,10066000,-17610000,-27676000,-27676000,,,,,,0,5205000,32881000,22815000,440000,,-27236000,-27236000,58276,AGLE
2016-12-31,36719000.0,,-21698000,,-21698000,8391000,-13515000,-21906000,-21906000,,,,,,0,4628000,26534000,18143000,208000,,-21698000,-21698000,58276,AGLE
2019-12-31,,,346769000,213453000,294146000,286644000,654727000,368083000,368083000,,-48768000,,,,43507000,1122599000,754516000,467872000,-21314000,,303262000,296563000,58278,IONS
2018-12-31,,,-76156000,139081000,273741000,244622000,184050000,-60572000,-60572000,,-44789000,,,,-291141000,599674000,660246000,415624000,-15584000,,214985000,276868000,58278,IONS
2017-12-31,374644000.0,,-16763000,84267000,346000,108488000,139935000,31447000,31447000,,-44752000,,,,-5980000,514179000,482732000,374244000,-48210000,,-10783000,18792000,58278,IONS
2016-12-31,374644000.0,,-57466000,84267000,-60400000,48616000,30756000,-17860000,-17860000,,-38795000,,,,2934000,372776000,390636000,342020000,-39606000,,-60400000,-60400000,58278,IONS
2019-12-31,,,151521000,,202243000,46371000,588848000,354876000,354876000,28767000,-141914000,,,,-3035000,649587000,294711000,60739000,-203355000,47687000,154556000,178107000,58279,EPR
2018-12-31,,,224232000,,266983000,48889000,533848000,420821000,420821000,-74257000,-133826000,,,,2285000,563502000,142681000,29654000,-196589000,45036000,221947000,242841000,58279,EPR
2017-12-31,,,227567000,,262968000,43383000,483202000,319020000,319020000,-558000,-131648000,,,,2399000,514529000,195509000,31327000,-91453000,37800000,225168000,234218000,58279,EPR
2016-12-31,,,225535000,,224982000,37543000,458620000,317104000,317104000,-3600000,-95271000,,,,553000,481222000,164118000,22602000,-91569000,37800000,224982000,201176000,58279,EPR
2019-12-31,7360000,,-6637000,,-6443000,15344000,18303000,-5158000,-5158000,,-754000,,,,-194000,25362000,30520000,7059000,-1479000,,-6443000,-6443000,58280,QUMU
2018-12-31,7013000,,-3319000,,-3617000,15405000,16520000,-6802000,-6802000,,-1809000,,,,298000,25013000,31815000,8493000,3483000,,-3617000,-3617000,58280,QUMU
2017-12-31,7279000,,-12082000,,-11724000,18359000,17905000,-8637000,-8637000,,-2852000,,,,-358000,28167000,36804000,10262000,-3445000,,-11724000,-11724000,58280,QUMU
2016-12-31,8528000,,-11427000,,-11175000,20817000,19438000,-10798000,-10798000,,-287000,,,,-252000,31682000,42480000,12244000,-629000,,-11175000,-11175000,58280,QUMU
2020-03-31,,,618716000000,109662000000,448568000000,1378398000000,2411712000000,0,633977000000,399337000000,,,,,161496000000,2411712000000,1777735000000,0,-15261000000,,457220000000,448568000000,58284,MFG
2019-03-31,,,116260000000,444525000000,96566000000,1430850000000,2555627000000,0,612142000000,512635000000,,,,,-2502000000,2555627000000,1943485000000,0,-495882000000,,118762000000,96566000000,58284,MFG
2018-03-31,,,799952000000,754239000000,576547000000,1488973000000,2715720000000,0,780950000000,445797000000,,,,,191627000000,2715720000000,1934770000000,0,19002000000,,608325000000,576547000000,58284,MFG
2017-03-31,,,784192000000,749339000000,603544000000,1420492000000,2676935000000,0,781346000000,475097000000,,,,,137735000000,2676935000000,1895589000000,0,2846000000,,646457000000,603544000000,58284,MFG
2019-12-31,,,-16038000,,-16038000,4606000,-12277000,-16883000,-16883000,,-5000,,,,0,116000,16999000,12393000,845000,,-16038000,-16038000,58285,SEER
2018-12-31,,,-6307000,,-6307000,2982000,-3776000,-6758000,-6758000,,-5000,,,,0,0,6758000,3776000,451000,,-6307000,-6307000,58285,SEER
2019-12-31,272343000,,-443206000,28330000,-364151000,1429406000,1496341000,-205408000,-205408000,,,,,,-17957000,1630309000,1835717000,133968000,-237798000,,-425249000,-364151000,58288,JT
2018-12-31,241270000,,-164259000,115667000,-164615000,1725889000,1788503000,-178656000,-178656000,,,,,,-4473000,2011842000,2190498000,223339000,14397000,,-159786000,-164615000,58288,JT
2017-12-31,153905000,,-173743000,115667000,-202125000,1321614000,1301945000,-173574000,-173574000,,,,,,28382000,1445773000,1619347000,143828000,-169000,,-202125000,-202125000,58288,JT
2016-12-31,72832000,,-182125000,115667000,-182125000,399188000,289704000,-182316000,-182316000,,,,,,0,356387000,538703000,66683000,191000,,-182125000,-182125000,58288,JT
2020-12-31,,,3443000,,2515000,13075000,37338000,0,5265000,18998000,,,,,928000,37338000,32073000,0,-1822000,,2515000,2515000,58289,MBNKP
2019-12-31,,,25990000,,20446000,12104000,59472000,0,27712000,19656000,,,,,5544000,59472000,31760000,0,-1722000,,20446000,20446000,58289,MBNKP
2018-12-31,,,9238000,,5666000,9586000,38117000,0,11587000,16944000,,,,,3572000,38117000,26530000,0,-2349000,,5666000,5666000,58289,MBNKP
2017-12-31,,,19646000,,4553000,8449000,47155000,0,22056000,16650000,,,,,15093000,47155000,25099000,0,-2410000,,4553000,4553000,58289,MBNKP
2019-12-31,471000000,,-1837000000,73000000,-1788000000,2554000000,6251000000,1334000000,1334000000,-5000000,-1612000000,,,,-54000000,8601000000,7267000000,2350000000,-3171000000,,-1783000000,-1788000000,58290,BHC
2018-12-31,413000000,,-4154000000,82000000,-4148000000,2473000000,6029000000,500000000,500000000,-1000000,-1685000000,,,,-10000000,8380000000,7880000000,2351000000,-4654000000,,-4144000000,-4148000000,58290,BHC
2017-12-31,361000000,,-1741000000,95000000,2404000000,2582000000,6176000000,555000000,555000000,-12000000,-1840000000,,,,-4145000000,8724000000,8169000000,2548000000,-2296000000,,2404000000,2404000000,58290,BHC
2016-12-31,421000000,,-2435000000,106000000,-2409000000,2782000000,7101000000,1205000000,1205000000,20000000,-1836000000,,,,-27000000,9674000000,8469000000,2573000000,-3640000000,,-2408000000,-2409000000,58290,BHC
2020-03-28,,,92979000,,75066000,118774000,210586000,83412000,83412000,,,,,,17913000,1061774000,978362000,851188000,9567000,,75066000,75066000,58292,CVCO
2019-03-30,,,86676000,,68622000,102295000,185789000,80694000,80694000,,,,,,18054000,962746000,882052000,776957000,5982000,,68622000,68622000,58292,CVCO
2018-03-31,,,78523000,,61502000,106907000,176283000,69376000,69376000,,,,,,17021000,871235000,801859000,694952000,9147000,,61502000,61502000,58292,CVCO
2017-04-01,,,55281000,,37955000,101231000,153594000,52363000,52363000,,,,,,17326000,773797000,721434000,620203000,2918000,,37955000,37955000,58292,CVCO
2020-12-31,,,5091348000,759241000,16546577000,37176817000,64271356000,0,10052939000,17041600000,,,,,-11652328000,65570797000,55517858000,1299441000,-4961591000,,16743676000,16546577000,58293,BBDO
2019-12-31,,,16179340000,709791000,22582615000,40404592000,87385813000,0,26071554000,20909667000,,,,,-6554360000,88617409000,62545855000,1231596000,-9892214000,,22733700000,22582615000,58293,BBDO
2018-12-31,,,19442015000,400665000,16583915000,38151507000,70798510000,0,20887733000,11759270000,,,,,2693576000,71911018000,51023285000,1112508000,-1445718000,,16748439000,16583915000,58293,BBDO
2017-12-31,,,23743559000,289873000,17089364000,40088318000,72761002000,0,24190341000,8482343000,,,,,6428956000,73919842000,49729501000,1158840000,-446782000,,17314603000,17089364000,58293,BBDO
2019-12-31,67514000,,-88505000,,-88656000,18592000,211000,-85895000,-85895000,,,,,,151000,482000,86377000,271000,-2610000,,-88656000,-105472000,58295,NKLA
2018-12-31,58374000,,-66295000,,-64293000,12238000,123000,-70489000,-70489000,,,,,,-2002000,173000,70662000,50000,4194000,,-64293000,-64459000,58295,NKLA
2017-12-31,11615000,,-19130000,,-17556000,5849000,182000,-17282000,-17282000,,-814000.0,,,,-1574000,486000,17768000,304000,-1848000,,-17556000,-17556000,58295,NKLA
2020-12-31,1173290000,,-1551254000,89914000,-1353608000,1464405000,1243456000,-1335807000,-1335807000,-58432000,-150363000,,,,-137131000,3312290000,4648097000,2068834000,-215447000,,-1414123000,-1353608000,58297,OCFT
2019-12-31,956095000,,-1762436000,150429000,-1660566000,1392354000,766858000,-1724236000,-1724236000,142645000,-172672000,,,,-74924000,2327846000,4052082000,1560988000,-38200000,,-1687512000,-1660566000,58297,OCFT
2018-12-31,459181000,,-1163816000,110601000,-1195712000,961727000,388625000,-1276024000,-1276024000,243741000,-160654000,,,,26469000,1413489000,2689513000,1024864000,112208000,,-1190285000,-1195712000,58297,OCFT
2017-12-31,537226000,,-976633000,110601000,-606956000,478310000,99373000,-923767000,-923767000,7604000,-85590000,,,,-369677000,581912000,1505679000,482539000,-52866000,,-606956000,-606956000,58297,OCFT
2019-12-31,,,926088,-1198732,1909444,6830354,46937924,18470254,18470254,,-19768193,,,,-249480,185788133,167317879,138850209,-17544166,,1175568,-5911251,58298,SOHOB
2018-12-31,,,-138808,441706,109936,6180962,46883665,19818060,19818060,,-19953746,,,,469349,177373121,157555061,130489456,-19956868,,-608157,-5719978,58298,SOHOB
2017-12-31,,,1767293,1154775,442503,6335926,40389325,17053780,17053780,,-15727628,,,,1737804,153666693,136612913,113277368,-15286487,,29489,-3339136,58298,SOHOB
2016-12-31,,,-467485,2329175,926716,6021065,40012581,18972445,18972445,,-17735107,,,,-1367634,152845752,133873307,112833171,-19439930,,900149,-218173,58298,SOHOB
2020-06-30,,,55236000,,24042000,670974000,941636000,229109000,229109000,,-37264000,,,,31194000,3245652000,3016543000,2304016000,-173873000,,24042000,24042000,58301,AIT
2019-06-30,,,194481000,,143993000,698673000,1008323000,267767000,267767000,,-40788000,,,,50488000,3472739000,3204972000,2464416000,-73286000,,143993000,143993000,58301,AIT
2018-06-30,,,204718000,,141625000,623499000,883995000,228431000,228431000,,-24142000,,,,63093000,3073274000,2844843000,2189279000,-23713000,,141625000,141625000,58301,AIT
2017-06-30,,,166966000,,133910000,538734000,737695000,174590000,174590000,,-8831000,,,,33056000,2593746000,2419156000,1856051000,-7624000,,133910000,133910000,58301,AIT
2020-12-31,135000000,,337000000,308000000,1034000000,775000000,1100000000,235000000,235000000,-45000000,-86000000,,,,46000000,6018000000,5783000000,4918000000,102000000,775000000,291000000,1034000000,58302,HUN
2019-12-31,131000000,,391000000,137000000,562000000,777000000,1382000000,451000000,451000000,23000000,-111000000,,,,-38000000,6797000000,6346000000,5415000000,-60000000,169000000,429000000,562000000,58302,HUN
2018-12-31,145000000,,734000000,229000000,337000000,765000000,1764000000,848000000,848000000,6000000,-115000000,,,,45000000,7604000000,6756000000,5840000000,-114000000,-39000000,689000000,337000000,58302,HUN
2017-12-31,132000000,,531000000,751000000,636000000,751000000,1651000000,779000000,779000000,-11000000,-165000000,,,,20000000,6845000000,6066000000,5194000000,-248000000,230000000,511000000,636000000,58302,HUN
2019-12-31,,,9553000,,9553000,17594000,52521000,34927000,34927000,,-15829000,,,,0,52521000,17594000,0,-25374000,,9553000,9553000,58303,OFSSG
2018-12-31,,,9572000,,9572000,15217000,42834000,27617000,27617000,,-9232000,,,,0,42834000,15217000,0,-18045000,,9572000,9572000,58303,OFSSG
2017-12-31,,,7910000,,7910000,11736000,33426000,21690000,21690000,,-5813000,,,,0,33426000,11736000,0,-13780000,,7910000,7910000,58303,OFSSG
2016-12-31,,,13828000,,13828000,11647000,31094000,19447000,19447000,,-5302000,,,,0,31094000,11647000,0,-5619000,,13828000,13828000,58303,OFSSG
2019-12-31,,,550167000,436589000,509664000,274244000,553176000,0,161970000,3640000,,,,,13232000,677214000,515244000,124038000,388197000,,536935000,505791000,58304,STWD
2018-12-31,,,426527000,296757000,385830000,265587000,538802000,0,130364000,10202000,,,,,15330000,674457000,544093000,135655000,296163000,,411197000,382238000,58304,STWD
2017-12-31,,,444289000,100787000,400770000,252286000,491950000,0,121738000,24323000,,,,,31522000,589680000,467942000,97730000,322551000,,412767000,397587000,58304,STWD
2016-12-31,,,375995000,37799000,365186000,270392000,471546000,0,87219000,47149000,,,,,8344000,550109000,462890000,78563000,288776000,,367651000,363133000,58304,STWD
2019-12-31,,,-3000000,-899000,-2966000,6377000,3059000,-3318000,-3318000,,,,,,1000,11454000,14772000,8395000,318000,,-3001000,-2966000,58305,HSTO
2018-12-31,,,-6162000,-864000,-6125000,3184000,-2457000,-5641000,-5641000,,-42000.0,,,,1000,1777000,7418000,4234000,-521000,,-6163000,-6125000,58305,HSTO
2017-12-31,,,1875000,-826000,1875000,3365000,6320000,2955000,2955000,,-295000.0,,,,19000,9648000,6693000,3328000,-1080000,,1856000,1875000,58305,HSTO
2019-12-31,,,3945833,,2750226,487735,0,-526625,-526625,38890,,,,,1195607,0,526625,0,4472458,,2750226,2750226,58306,CRSA
2018-12-31,,,-6621,,-6621,487735,0,0,-526625,38890,,,,,0,0,0,0,-6621,,-6621,-6621,58306,CRSA
2017-12-31,,,-12000,,-12000,487735,0,0,-526625,38890,,,,,0,0,0,0,-12000,,-12000,-12000,58306,CRSA
2019-12-31,4078000,,4000000,,3846000,9439000,16468000,2951000,2951000,,,,,,154000,63333000,60382000,46865000,2098000,,3846000,3846000,58307,SPRT
2018-12-31,2780000,,-9101000,,-9100000,9231000,11945000,-66000,-66000,,,,,,-1000,69549000,69615000,57604000,-9035000,,-9100000,-9100000,58307,SPRT
2017-12-31,3033000,,-922000,,-1526000,11121000,12733000,-1437000,-1437000,,,,,,604000,60121000,61558000,47388000,515000,,-1526000,-1526000,58307,SPRT
2016-12-31,5577000,,-15933000,,-15956000,19629000,10929000,-15305000,-15305000,,,,,,307000,61660000,76965000,50731000,-628000,284000.0,-16240000,-15956000,58307,SPRT
2019-12-31,15085000,,-12263000,,-12348000,94542000,98163000,-11464000,-11464000,,-199000,,,,85000,181712000,193176000,83549000,-799000,,-12348000,-12348000,58309,CUTR
2018-12-31,14359000,,-13515000,,-30770000,79415000,80382000,-13392000,-13392000,,-114000,,,,17255000,162720000,176112000,82338000,-123000,,-30770000,-30770000,58309,CUTR
2017-12-31,12874000,,11960000,,29993000,66160000,86110000,7076000,7076000,,-114000,,,,-18033000,151493000,144417000,65383000,4884000,,29993000,29993000,58309,CUTR
2016-12-31,11232000,,2720000,,2577000,54506000,68135000,2397000,2397000,,-114000,,,,143000,118056000,115659000,49921000,323000,,2577000,2577000,58309,CUTR
2019-12-31,,,1950000000,,1693000000,-177000000,3609000000,2538000000,2538000000,,-569000000,,,,257000000,10076000000,7538000000,6467000000,-588000000,,1693000000,1693000000,58311,PEG
2018-12-31,,,1855000000,,1438000000,-76000000,3402000000,2320000000,2320000000,,-476000000,,,,417000000,9696000000,7376000000,6294000000,-465000000,,1438000000,1438000000,58311,PEG
2017-12-31,,,1268000000,,1574000000,-76000000,3415000000,2393000000,2393000000,,-391000000,,,,-306000000,9094000000,6701000000,5679000000,-1125000000,,1574000000,1574000000,58311,PEG
2016-12-31,,,1298000000,,887000000,22000000,3189000000,2262000000,2262000000,,-385000000,,,,411000000,8966000000,6704000000,5777000000,-964000000,,887000000,887000000,58311,PEG
2020-12-31,,,-4256000000,,-3074000000,168000000,-1877000000,-5043000000,-5043000000,1743000000,-342000000,,,,-1182000000,9048000000,14091000000,10925000000,787000000,,-3074000000,-3074000000,58312,LUV
2019-12-31,,,2957000000,,2300000000,225000000,7020000000,2948000000,2948000000,2628000000,-82000000,,,,657000000,22428000000,19480000000,15408000000,9000000,,2300000000,2300000000,58312,LUV
2018-12-31,,,3164000000,,2465000000,227000000,7245000000,3180000000,3180000000,2637000000,-93000000,,,,699000000,21965000000,18785000000,14720000000,-16000000,,2465000000,2465000000,58312,LUV
2017-12-31,,,3265000000,,3357000000,238000000,7316000000,3354000000,3354000000,2527000000,-65000000,,,,-92000000,21146000000,17792000000,13830000000,-89000000,,3357000000,3357000000,58312,LUV
2019-12-31,,,-60925000,,-60925000,15588000,-47628000,-63216000,-63216000,,,,,,0,18147000,81363000,65775000,2291000,,-60925000,-60925000,58313,SPRO
2018-12-31,,,-41662000,355000.0,-41662000,12887000,-29919000,-42806000,-42806000,,,,,,0,3966000,46772000,33885000,1144000,,-41662000,-41662000,58313,SPRO
2017-12-31,,,-39886000,355000.0,-38743000,10840000,-30890000,-41730000,-41730000,,,,,,0,1979000,43709000,32869000,1844000,,-39886000,-46097000,58313,SPRO
2016-12-31,,,-32641000,-3808000.0,-25491000,7223000,-25998000,-33221000,-33221000,,,,,,0,335000,33556000,26333000,580000,,-32641000,-29928000,58313,SPRO
2019-12-31,1157000,,-33213000,-39427000,-31477000,24653000,-7565000,-33375000,-33375000,,-436000,,,,691000,26022000,59397000,33587000,162000,,-33904000,-31477000,58314,ANTE
2018-12-31,1110000,,-93269000,-37000000,-90097000,38994000,-8084000,-48188000,-48188000,,-106000,,,,150000,24546000,72734000,32630000,-45081000,,-93419000,-90097000,58314,ANTE
2017-12-31,689000,,-178548000,-23970000,-156476000,75565000,-35208000,-111462000,-111462000,,-106000,,,,633000,23759000,135221000,58967000,-67086000,,-179181000,-156476000,58314,ANTE
2016-12-31,689000,,-84759000,-2140000,-65625000,56457000,-32529000,-88986000,-88986000,,-106000,,,,4483000,16513000,105499000,49042000,4227000,,-89242000,-65625000,58314,ANTE
2019-12-31,2676156,,-10587124,,-10587124,5697469,0,-8373625,-8373625,,,,,,0,0,8373625,0,-2213499,,-10587124,-11286939,58317,LTBR
2018-12-31,3458377,,-15676108,,-15676108,6715378,0,-10173755,-10173755,,-982436.0,,,,0,0,10173755,0,-5502353,,-15676108,-18950023,58317,LTBR
2017-12-31,2282938,,-7104897,,-7104897,4383066,68355,-6597649,-6597649,,-507313.0,,,,0,175446,6773095,107091,-507248,,-7104897,-7381475,58317,LTBR
2016-12-31,2748337,,-6345176,,-6345176,5190549,304012,-7634874,-7634874,,-220793.0,,,,0,760577,8395451,456565,1289698,,-6345176,-7007054,58317,LTBR
2019-12-31,10797000,,-19352000,-263000,-19361000,9295000,0,-20092000,-20092000,,,,,,0,0,20092000,0,740000,,-19352000,-19361000,58318,CLBS
2018-12-31,7594000,,-16168000,-272000,-16167000,9393000,0,-16987000,-16987000,,-5000.0,,,,0,0,16987000,0,819000,,-16168000,-16167000,58318,CLBS
2017-12-31,15843000,,-27698000,-318000,22979000,11750000,-2700000,-27593000,-27593000,,-378000.0,,,,-11527000,0,27593000,2700000,-105000,38968000.0,-16171000,22979000,58318,CLBS
2016-12-31,15599213,,-31257751,18582571,-32656319,12802735,0,-28401948,-28401948,,-1779657.0,,,,0,0,28401948,0,-2855803,-1640370.0,-31257751,-32656319,58318,CLBS
2020-08-28,52056000,,9360000,,-1143000,113138000,216396000,51202000,51202000,,-15000000,,,,10503000,1122377000,1071175000,905981000,-41842000,,-1143000,-1143000,58319,SGH
2019-08-30,47920000,,66204000,,51332000,101726000,237527000,87881000,87881000,,-20716000,,,,14872000,1211999000,1124118000,974472000,-21677000,,51332000,51332000,58319,SGH
2018-08-31,39824000,,137778000,,119463000,80841000,291586000,170921000,170921000,,-19144000,,,,18315000,1288821000,1117900000,997235000,-33143000,,119463000,119463000,58319,SGH
2017-08-25,38160000,,2119000,,-7795000,69759000,162622000,54703000,54703000,,-29204000,,,,9914000,761291000,706588000,598669000,-52584000,,-7795000,-7795000,58319,SGH
2020-10-31,,,13047000000,,11895000000,17052000000,36404000000,0,12715000000,6637000000,,,,,1152000000,36404000000,23689000000,0,332000000,,11895000000,11628000000,58321,TD
2019-10-31,,,14421000000,,11668000000,16335000000,38036000000,0,14204000000,7497000000,,,,,2735000000,38036000000,23832000000,0,217000000,,11686000000,11416000000,58321,TD
2018-10-31,,,14516000000,993000000.0,11262000000,15212000000,36412000000,0,14661000000,6539000000,,,,,3182000000,36412000000,21751000000,0,-145000000,,11334000000,11048000000,58321,TD
2017-10-31,,,12770000000,983000000.0,10396000000,14649000000,33986000000,0,13027000000,6310000000,,,,,2253000000,33986000000,20959000000,0,-257000000,,10517000000,10203000000,58321,TD
2019-12-31,,,28067635,,28067635,5785878,29411183,23625305,23625305,,-4714988,,,,0,29411183,5785878,0,4442330,,28067635,28067635,58325,AFT
2018-12-31,,,-4067574,,-4067574,5988663,30080837,24092174,24092174,,-4564015,,,,0,30080837,5988663,0,-28159748,,-4067574,-4067574,58325,AFT
2017-12-31,,,14806714,,14806714,6080209,26946067,20865858,20865858,,-3293596,,,,0,26946067,6080209,0,-6059144,,14806714,14806714,58325,AFT
2016-12-31,,,37261208,,37261208,5911286,28112107,22200821,22200821,,-2831826,,,,0,28112107,5911286,0,15060387,,37261208,37261208,58325,AFT
2019-12-31,18661000,,-26483000,,-26483000,8133000,322000,-26472000,-26472000,,,,,,0,8886000,35358000,8564000,-11000,,-26483000,-26483000,58327,MVIS
2018-12-31,24666000,,-27250000,,-27250000,9523000,6969000,-27220000,-27220000,,,,,,0,17607000,44827000,10638000,-30000,,-27250000,-27250000,58327,MVIS
2017-12-31,15096000,,-25486000,,-25486000,10156000,-228000,-25480000,-25480000,,,,,,0,9634000,35114000,9862000,-6000,,-25486000,-25486000,58327,MVIS
2016-12-31,12134000,,-16472000,,-16472000,8743000,4387000,-16458000,-16458000,-32000.0,,,,,0,14761000,31219000,10374000,-14000,,-16472000,-16472000,58327,MVIS
2019-12-31,24663000,,-107500000,,-107500000,12208000,-24663000,-36871000,-36871000,,,,,,0,0,36871000,24663000,-141258000,,-107500000,-107500000,58329,SESN
2018-12-31,14077000,,-33693000,,-33693000,11623000,-14077000,-25700000,-25700000,,,,,,0,0,25700000,14077000,-7186000,,-33693000,-33693000,58329,SESN
2017-12-31,14077000,,-29029000,,-29029000,8070000,-12085000,-20155000,-20155000,,,,,,0,425000,20580000,12510000,-8869000,,-29029000,-29029000,58329,SESN
2016-12-31,14077000,,1896000,,1891000,11436000,17602000,6166000,6166000,,-247000.0,,,,5000,29981000,23815000,12379000,-4270000,,1891000,1891000,58329,SESN
2020-12-31,,,344300000,,301800000,,1663200000,453100000,453100000,942000000,-108800000,,,,42500000,3821100000,3368000000,2157900000,-108800000,,301800000,301800000,58330,CNO
2019-12-31,,,274200000,,409400000,,1598800000,433800000,433800000,932900000,-152300000,,,,-135200000,4015800000,3582000000,2417000000,-159600000,,409400000,409400000,58330,CNO
2018-12-31,,,-264800000,,-315000000,,2034900000,-111200000,-111200000,1881800000,-149800000,,,,50200000,4313500000,4424700000,2278600000,-157400000,,-315000000,-315000000,58330,CNO
2017-12-31,,,480500000,,175600000,,1694500000,613700000,613700000,841500000,-123700000,,,,304900000,4297200000,3683500000,2602700000,-133200000,,175600000,175600000,58330,CNO
2019-12-31,5602000,,-11830000,,-11830000,5895000,0,-11497000,-11497000,,-1000,,,,0,0,11497000,0,-333000,,-11830000,-11830000,58331,NVIV
2018-12-31,4931000,,-23423000,,-23423000,7836000,0,-12767000,-12767000,,-43000,,,,0,0,12767000,0,-10656000,,-23423000,-23423000,58331,NVIV
2017-12-31,10373000,,-26745000,,-26745000,13322000,0,-23695000,-23695000,,-71000,,,,0,0,23695000,0,-3050000,,-26745000,-26745000,58331,NVIV
2016-12-31,12557000,,-23438000,,-23438000,11506000,0,-24063000,-24063000,,-155000,,,,0,0,24063000,0,625000,,-23438000,-23438000,58331,NVIV
2020-12-31,,,94261000,,70806000,22229000,252115000,78589000,78589000,41360000,,,,,23455000,645262000,566673000,393147000,15672000,,70806000,70806000,58332,HTLD
2019-12-31,,,97178000,,72967000,18903000,217389000,63434000,63434000,34840000,-1052000.0,,,,24211000,596815000,533381000,379426000,33744000,,72967000,72967000,58332,HTLD
2018-12-31,,,91917000,,72677000,19027000,220466000,64824000,64824000,36096000,-1052000.0,,,,19240000,610803000,545979000,390337000,27093000,,72677000,72677000,58332,HTLD
2017-12-31,,,64498000,,75173000,20850000,200691000,36870000,36870000,39281000,-175000.0,,,,-10675000,607336000,570466000,406645000,27628000,,75173000,75173000,58332,HTLD
2020-12-31,,,560311000,2192000,410002000,192840000,1456193000,569773000,569773000,186910000,-17309000,,,,149676000,4673863000,4104090000,3217670000,-9462000,,410635000,410002000,58333,KNX
2019-12-31,,,413976000,2088000,309206000,194336000,1286339000,433829000,433829000,195216000,-29433000,,,,103798000,4843950000,4410121000,3557611000,-19853000,,310178000,309206000,58333,KNX
2018-12-31,,,552038000,1770000,419264000,215362000,1369696000,536605000,536605000,187640000,-30170000,,,,131389000,5344066000,4807461000,3974370000,15433000,,420649000,419264000,58333,KNX
2017-12-31,,,193709000,2638000,484292000,95199000,624319000,233551000,233551000,88464000,-8686000,,,,-291716000,2425453000,2191902000,1801134000,-39842000,,485425000,484292000,58333,KNX
2019-12-31,242124000,,-994634000,,-1007633000,1157688000,405664000,-994148000,-994148000,,,,,,12999000,591155000,1585303000,185491000,-486000,,-1007633000,-1007633000,58334,XM
2018-12-31,65925000,,-32952000,,-37308000,266390000,299194000,-33121000,-33121000,,,,,,4356000,401908000,435029000,102714000,169000,,-37308000,-37308000,58334,XM
2017-12-31,40680000,,4463000,,2556000,167046000,210819000,3093000,3093000,,,,,,1907000,289903000,286810000,79084000,1370000,,2556000,39000,58334,XM
2016-12-31,22303000,,-11009000,,-12034000,117768000,129623000,-10448000,-10448000,,,,,,1025000,190603000,201051000,60980000,-561000,,-12034000,-12034000,58334,XM
2019-12-31,12845000,,-20596000,,-20596000,8489000,-4935000,-13424000,-13424000,,,,,,0,7910000,21334000,12845000,-7172000,,-20596000,-20596000,58335,PULM
2018-12-31,12845000,,-20563000,,-20563000,7518000,-12813000,-20331000,-20331000,,-186000.0,,,,0,153000,20484000,12966000,-232000,,-20563000,-20563000,58335,PULM
2017-12-31,12845000,,-18056000,,-18056000,7567000,-9908000,-17475000,-17475000,,-643000.0,,,,0,335000,17810000,10243000,-581000,,-18056000,-18056000,58335,PULM
2016-12-31,12845000,,-30802000,,-27843000,8015000,-9317000,-17332000,-17332000,,-881000.0,,,,-2959000,835000,18167000,10152000,-13470000,,-27843000,-27843000,58335,PULM
2019-12-31,,,-17238000,,-17238000,18477000,6840000,-17238000,-17238000,666000,,,,,0,11574000,28812000,4734000,0,,-17238000,-17238000,58337,HPK
2020-09-30,,,-30276978,,-30276978,11703429,-17281626,-28985055,-28985055,,-1035725,,,,0,558664,29543719,17840290,-1291923,,-30276978,-30276978,58339,CVM
2019-09-30,,,-22134640,,-22134640,7998573,-12196533,-20195106,-20195106,,-1797481,,,,0,462754,20657860,12659287,-1939534,,-22134640,-22134640,58339,CVM
2018-09-30,9400306.0,,-31851573,,-31851573,6334271,-10437975,-16772246,-16772246,,-3924690,,,,0,476556,17248802,10914531,-15079327,,-31851573,-31851573,58339,CVM
2017-09-30,9400306.0,,-14363287,,-14363287,5800348,-15606985,-21407333,-21407333,,-4032189,,,,0,69020,21407333,15606985,7044046,,-14363287,-14427055,58339,CVM
2019-12-31,15412000,,-23330000,,-23330000,9949000,2073000,-23288000,-23288000,,-514000,,,,0,2073000,25361000,0,-42000,,-23330000,-23330000,58346,SNSS
2018-12-31,14615000,,-26615000,,-26615000,11332000,237000,-25710000,-25710000,,-1154000,,,,0,237000,25947000,0,-905000,,-26615000,-26615000,58346,SNSS
2017-12-31,21540000,,-35458000,,-35458000,13548000,669000,-34419000,-34419000,,-1396000,,,,0,669000,35088000,0,-1039000,,-35458000,-35458000,58346,SNSS
2016-12-31,22881000,,-38023000,,-38023000,16115000,2536000,-36460000,-36460000,,-1721000,,,,0,2536000,38996000,0,-1563000,,-38023000,-38023000,58346,SNSS
2020-09-30,,,37454000,,39224000,44852000,143133000,98281000,98281000,,-26289000,,,,-1770000,143133000,44852000,0,-60827000,,39224000,39224000,58347,OCSL
2019-09-30,,,127171000,,126160000,47367000,147702000,100335000,100335000,,-32426000,,,,1011000,147702000,47367000,0,26836000,,126160000,126160000,58347,OCSL
2018-09-30,,,47384000,,46762000,42948000,138722000,95774000,95774000,,-35728000,,,,622000,138722000,42948000,0,-48390000,,46762000,46762000,58347,OCSL
2017-09-30,,,-196969000,,-196969000,56633000,177964000,121331000,121331000,,-49935000,,,,0,177964000,56633000,0,-318300000,,-196969000,-196969000,58347,OCSL
2019-12-31,869000,,-1221000,-57000,-1261000,6317000,5498000,-1688000,-1688000,,-45000,,,,49000,58080000,59768000,52582000,467000,,-1270000,-1261000,58348,CNET
2018-12-31,933000,,-13363000,-49000,-14025000,7456000,2418000,-5971000,-5971000,,-47000,,,,764000,57146000,63117000,54728000,-7392000,,-14127000,-14025000,58348,CNET
2017-12-31,1261000,,-9760000,177000,-10125000,10198000,4613000,-6846000,-6846000,,-147000,,,,251000,46633000,53479000,42020000,-2914000,,-10011000,-10125000,58348,CNET
2016-12-31,1996000,,-6183000,54000,-6492000,11744000,7751000,-5989000,-5989000,,-13000,,,,102000,34750000,40739000,26999000,-194000,-59000.0,-6285000,-6492000,58348,CNET
2019-12-31,,,-8041000,154000,-19156000,60686000,93178000,1363000,1363000,,-5958000,,,,10745000,242931000,241568000,149753000,-9404000,,-18786000,-19156000,58349,RNET
2018-12-31,,,-65060000,60000,-62453000,60711000,92251000,-1614000,-1614000,,-3969000,,,,-2746000,238854000,240468000,146603000,-63446000,,-62314000,-62453000,58349,RNET
2017-12-31,,,-12725000,78000,-16176000,49140000,73726000,-6259000,-6259000,,-2870000,,,,3472000,204892000,211151000,131166000,-6466000,,-16197000,-16176000,58349,RNET
2016-12-31,,,-5472000,175000,-11507000,58490000,90864000,-1182000,-1182000,,-2708000,,,,5825000,220623000,221805000,129759000,-4290000,,-11297000,-11507000,58349,RNET
2020-09-30,,,1052000000,62000000,818000000,5915000000,7263000000,0,1125000000,223000000,,,,,234000000,7757000000,6632000000,494000000,-73000000,,818000000,817000000,58353,RJF
2019-09-30,,,1375000000,62000000,1034000000,5584000000,7226000000,0,1365000000,277000000,,,,,341000000,7693000000,6328000000,467000000,10000000,,1034000000,1032000000,58353,RJF
2018-09-30,,,1311000000,84000000,857000000,5252000000,6792000000,0,1297000000,243000000,,,,,454000000,7236000000,5939000000,444000000,14000000,,857000000,856000000,58353,RJF
2017-09-30,,,925000000,111638000,636000000,4629000000,6002000000,0,1009000000,364000000,,,,,289000000,6378000000,5369000000,376000000,-84000000,,636000000,635000000,58353,RJF
2020-04-30,,,-5607245,,-5659065,38605428,39421758,-2818341,-2818341,,-1818078,,,,51820,49061080,51879421,9639322,-2788904,,-5659065,-5659065,58355,ASPU
2019-04-30,,,-9278217,,-9278217,32733071,27144751,-8612426,-8612426,,-444680,,,,0,34025418,42637844,6880667,-665791,,-9278217,-9278217,58355,ASPU
2018-04-30,,,-7061061,,-7061061,21757408,17596521,-5253170,-5253170,,-2010152,,,,0,22021512,27274682,4424991,-1807891,,-7061061,-7061061,58355,ASPU
2017-04-30,,,-1105260,,-1105260,11712815,11810549,-458996,-458996,,-337510,,,,0,14246696,14705692,2436147,-646264,,-1105260,-1105260,58355,ASPU
2020-12-31,,,129186000,,98682000,150778000,267986000,117208000,117208000,,,,,,30504000,1760303000,1643095000,1492317000,11978000,,98682000,98682000,58356,HCSG
2019-12-31,,,85096000,,64581000,150022000,227901000,77879000,77879000,,-3459000.0,,,,20515000,1840778000,1762899000,1612877000,7217000,,64581000,64581000,58356,HCSG
2018-12-31,,,99910000,,83524000,136603000,234439000,97836000,97836000,,-3094000.0,,,,16386000,2002601000,1904765000,1768162000,2074000,,83524000,83524000,58356,HCSG
2017-12-31,,,132965000,,88226000,126732000,250616000,123884000,123884000,,-1363000.0,,,,44739000,1861206000,1737322000,1610590000,9081000,,88226000,88226000,58356,HCSG
2020-06-30,339073000,,-63928000,,-67029000,396598000,907250000,171579000,171579000,,-89409000,,,,3101000,2380071000,2208492000,1472821000,-235507000,,-67029000,-67029000,58357,IIVIP
2019-06-30,139163000,,128813000,,107517000,217918000,521349000,164268000,164268000,,-22417000,,,,21296000,1362496000,1198228000,841147000,-35455000,,107517000,107517000,58357,IIVIP
2018-06-30,116875000,,122194000,,88002000,208565000,462203000,136763000,136763000,,-18352000,,,,34192000,1158794000,1022031000,696591000,-14569000,,88002000,88002000,58357,IIVIP
2017-06-30,96806000,,118788000,,95274000,173500000,388362000,118056000,118056000,,-6809000,,,,23514000,972046000,853990000,583684000,732000,,95274000,95274000,58357,IIVIP
2019-12-31,,,-43535000,196678000,-12208000,101258000,335698000,-80977000,-80977000,32568000,-28419000,,,,-25590000,867888000,948865000,532190000,37442000,-10514000,-17945000,-12208000,58359,BVN
2018-12-31,,,27033000,221237000,-13445000,104904000,512967000,27333000,27333000,25546000,-31540000,,,,26879000,1150715000,1123382000,637748000,-300000,-11808000,154000,-13445000,58359,BVN
2017-12-31,,,92667000,215590000,60823000,103628000,588517000,167881000,167881000,1955000,-29072000,,,,17888000,1237642000,1069761000,649125000,-75214000,-10344000,74779000,60823000,58359,BVN
2016-12-31,,,-255237000,226122000,-323492000,104535000,523895000,100054000,100054000,6169000,-23807000,,,,53504000,1068791000,968737000,544896000,-355291000,-19073000,-308741000,-323492000,58359,BVN
2019-12-31,3845000,,-19573000,,-19180000,15905000,85000,-19665000,-19665000,,,,,,-393000,85000,19750000,0,92000,,-19180000,-19180000,58361,VHC
2018-12-31,4815000,,-25403000,,-25406000,20705000,63000,-25457000,-25457000,,,,,,3000,63000,25520000,0,54000,,-25406000,-25406000,58361,VHC
2017-12-31,4159000,,-17275000,,-17278000,14709000,1547000,-17321000,-17321000,,,,,,3000,1547000,18868000,0,46000,,-17278000,-17278000,58361,VHC
2016-12-31,4155000,,-28436000,,-28569000,25016000,666000,-28505000,-28505000,,,,,,133000,1550000,30055000,884000,69000,,-28569000,-28569000,58361,VHC
2020-10-31,,,-26435000,13741000,-16435000,21280000,2774000,-18506000,-18506000,,-2048000,,,,-8494000,164559000,183065000,161785000,-7929000,,-17941000,-16980000,58363,LMNR
2019-10-31,,,-6563000,15422000,-5943000,21249000,15320000,-5929000,-5929000,,-2341000,,,,-1097000,171398000,177327000,156078000,-634000,,-5466000,-6495000,58363,LMNR
2018-10-31,,,13483000,574000,20188000,17939000,29125000,11186000,11186000,,-1323000,,,,-6729000,129392000,118206000,100267000,2297000,,20212000,19653000,58363,LMNR
2017-10-31,,,10626000,587000,6595000,15768000,27808000,12040000,12040000,,-1778000,,,,4077000,121309000,109269000,93501000,-1414000,,6549000,6035000,58363,LMNR
2019-12-31,,,62617000,,49166000,79087000,168817000,78774000,78774000,,-16782000,,,,13451000,571710000,492936000,402893000,-16157000,,49166000,48527000,58366,PLOW
2018-12-31,,,55759000,,43905000,71240000,154890000,72178000,72178000,,-16943000,,,,11854000,524067000,451889000,369177000,-16419000,,43905000,43321000,58366,PLOW
2017-12-31,,,52915000,,55324000,63037000,143086000,68648000,68648000,,-18336000,,,,-2409000,474927000,406279000,331841000,-15733000,,55324000,54609000,58366,PLOW
2016-12-31,,,63696000,,39009000,50665000,134099000,72838000,72838000,,-15195000,,,,24687000,416268000,343430000,282169000,-9142000,,39009000,38469000,58366,PLOW
2020-10-31,398000000,,842000000,,719000000,1395000000,2837000000,1044000000,1044000000,,-78000000,,,,123000000,5339000000,4295000000,2502000000,-202000000,,719000000,719000000,58370,A
2019-10-31,404000000,,919000000,,1071000000,1358000000,2805000000,1043000000,1043000000,,-74000000,,,,-152000000,5163000000,4120000000,2358000000,-124000000,,1071000000,1071000000,58370,A
2018-10-31,387000000,,946000000,4000000.0,316000000,1322000000,2680000000,971000000,971000000,,-75000000,,,,630000000,4914000000,3943000000,2234000000,-25000000,,316000000,316000000,58370,A
2017-10-31,341000000,,803000000,4000000.0,684000000,1205000000,2399000000,853000000,853000000,,-79000000,,,,119000000,4472000000,3619000000,2073000000,-50000000,,684000000,684000000,58370,A
2020-12-31,,,759259000,59633000,584438000,2089909000,3191130000,911631000,911631000,532000,-160871000,,,,172795000,28673363000,27761732000,25482233000,-152372000,,586464000,584438000,58371,ARW
2019-12-31,,,-111830000,54474000,-204087000,2216461000,3298381000,834196000,834196000,57934000,-264327000,,,,88338000,28916847000,28082651000,25618466000,-946026000,,-200168000,-204087000,58371,ARW
2018-12-31,,,909373000,51376000,716195000,2309921000,3700912000,1196885000,1196885000,7722000,-261773000,,,,187799000,29676768000,28479883000,25975856000,-287512000,,721574000,716195000,58371,ARW
2017-12-31,,,693917000,48685000,402176000,2185914000,3356968000,1003532000,1003532000,13923000,-188130000,,,,286541000,26554563000,25551031000,23197595000,-309615000,,407376000,402176000,58371,ARW
2020-12-31,,,17476000,,14293000,,62173000,0,17476000,44697000,,,,,3183000,62173000,44697000,0,0,,14293000,14293000,58372,HWBK
2019-12-31,,,19937000,,16114000,29792000.0,56485000,0,17754000,8939000,,,,,3823000,56485000,38731000,0,2183000,,16114000,16114000,58372,HWBK
2018-12-31,,,12382000,,10714000,31358000.0,52714000,0,12382000,8974000,,,,,1668000,52714000,40332000,0,0,,10714000,10714000,58372,HWBK
2017-12-31,,,11316000,,3414000,29505000.0,50118000,0,11316000,9297000,,,,,7902000,50118000,38802000,0,0,,3414000,3414000,58372,HWBK
2020-12-31,,,-1020000000,,-969900000,403100000,383400000,-19800000,-19800000,100000,-292700000,,,,-50100000,5758000000,5777800000,5374600000,-1000200000,,-969900000,-969900000,58377,OLN
2019-12-31,,,-36900000,,-11300000,400600000,666000000,265800000,265800000,-400000,-243200000,,,,-25600000,6110000000,5844200000,5444000000,-302700000,,-11300000,-11300000,58377,OLN
2018-12-31,,,437300000,,327900000,408900000,1013000000,604500000,604500000,-400000,-243200000,,,,109400000,6946100000,6341600000,5933100000,-167200000,,327900000,327900000,58377,OLN
2017-12-31,,,117200000,,549500000,335400000,766400000,431200000,431200000,-200000,-217400000,,,,-432300000,6268400000,5837200000,5502000000,-314000000,,549500000,549500000,58377,OLN
2020-12-31,19301000000,,35734000000,15622000000,27593000000,23806000000,77984000000,34877000000,34877000000,,-2916000000,,,,6457000000,476978000000,442101000000,398994000000,857000000,,29277000000,27593000000,58379,ASX
2019-12-31,18395334000,,23362050000,13377956000,16849809000,22389055000,64310793000,23526404000,23526404000,,-4186855000,,,,5308926000,413182184000,389655780000,348871391000,-164354000,,18053124000,16849809000,58379,ASX
2018-12-31,14962799000,,32047438000,17647190000,25262356000,19552502000,61163050000,26647749000,26647749000,,-3535886000,,,,5583599000,371092421000,344444672000,309929371000,5399689000,,26463839000,25262356000,58379,ASX
2017-12-31,11746613000,,30928898000,13199937000,22987819000,15767046000,52732271000,25218612000,25218612000,,-1774886000,,,,6261532000,290441208000,265222596000,237708937000,5710286000,,24667366000,22987819000,58379,ASX
2020-07-31,,,6110090,,6110090,1235097,8210351,6975254,6975254,,-1465560,,,,0,8210351,1235097,0,-865164,,6110090,6110090,58381,MFT
2019-07-31,,,9012811,,9012811,1224550,8778007,7553457,7553457,,-2076944,,,,0,8778007,1224550,0,1459354,,9012811,9012811,58381,MFT
2018-07-31,,,811021,,811021,1238023,9290486,8052463,8052463,,-1742463,,,,0,9290486,1238023,0,-7241442,,811021,811021,58381,MFT
2017-07-31,,,-1013348,,-1013348,1243144,9229017,7985873,7985873,,-1326139,,,,0,9229017,1243144,0,-8999221,,-1013348,-1013348,58381,MFT
2019-12-31,83036000,,2461419000,35883000,2348535000,103439000,2833575000,2623176000,2623176000,,-268573000,,,,0,1814254000,-808922000,-1019321000,-161757000,,2461419000,2348535000,58382,RPRX
2018-12-31,392609000,,1517855000,63865000,1377729000,61906000,1852228000,1364446000,1364446000,,-279956000,,,,0,1794894000,430448000,-57334000,153409000,,1517855000,1377729000,58382,RPRX
2017-12-31,117866000,,1343180000,63865000,1210025000,106440000,1197265000,939692000,939692000,,-247339000,,,,0,1597930000,658238000,400665000,403488000,,1343180000,1210025000,58382,RPRX
2019-12-31,19629000,,21331000,,16656000,65356000,94322000,9598000,9598000,-261000,,,,,4675000,154344000,144746000,60022000,11733000,,16656000,16656000,58383,OSUR
2018-12-31,16250000,,31716000,,20396000,58134000,102249000,29576000,29576000,-1711000,,,,,11320000,170379000,140803000,68130000,2140000,,20396000,20396000,58383,OSUR
2017-12-31,13365000,,41032000,,30948000,57853000,98267000,27738000,27738000,-689000,,,,,10084000,166375000,138637000,68108000,13294000,,30948000,30948000,58383,OSUR
2016-12-31,9754000,,20323000,,19720000,58008000,82627000,14865000,14865000,-689000,,,,,603000,122798000,107933000,40171000,5458000,,19720000,19720000,58383,OSUR
2020-12-31,,,2766000000,129000000,2089000000,2153000000,6036000000,3143000000,3143000000,,-357000000,,,,658000000,6036000000,2893000000,0,-377000000,,2108000000,2089000000,58393,ICE
2019-12-31,,,2481000000,109000000,1933000000,1869000000,5202000000,2702000000,2702000000,,-285000000,,,,521000000,5202000000,2500000000,0,-221000000,,1960000000,1933000000,58393,ICE
2018-12-31,,,2520000000,101000000,1988000000,1780000000,4979000000,2613000000,2613000000,,-244000000,,,,500000000,4979000000,2366000000,0,-93000000,,2020000000,1988000000,58393,ICE
2017-12-31,,,2526000000,28000000,2526000000,1679000000,4638000000,2424000000,2424000000,,-187000000,,,,-28000000,4638000000,2214000000,0,102000000,,2554000000,2526000000,58393,ICE
2020-12-31,,,36800000,518600000,37100000,50600000,146700000,74400000,74400000,21700000,-38800000,,,,7000000,859200000,784800000,712500000,-37600000,,29800000,37100000,58395,RYN
2019-12-31,,,95001000,97661000,73488000,42239000,153206000,109455000,109455000,1512000,-19160000,,,,12940000,711556000,602101000,558350000,-14454000,,82061000,73488000,58395,RYN
2018-12-31,,,148486000,97677000,108136000,41751000,210879000,169257000,169257000,-129000,-27498000,,,,25236000,816138000,646881000,605259000,-20771000,,123250000,108136000,58395,RYN
2017-12-31,,,186137000,99917000,151719000,40241000,251343000,212099000,212099000,-997000,-32548000,,,,21681000,819596000,607497000,568253000,-25962000,,164456000,151719000,58395,RYN
2019-12-31,,,56016000,,56016000,53365000,154711000,101346000,101346000,,-28901000,,,,0,154711000,53365000,0,-45330000,,56016000,56016000,58396,SLRC
2018-12-31,,,66874000,,66874000,53909000,153526000,99617000,99617000,,-24728000,,,,0,153526000,53909000,0,-32743000,,66874000,66874000,58396,SLRC
2017-12-31,,,70430000,,70430000,53309000,143338000,90029000,90029000,,-21666000,,,,0,143338000,53309000,0,-19599000,,70430000,70430000,58396,SLRC
2016-12-31,,,106815000,,106815000,56167000,151839000,95672000,95672000,,-24571000,,,,0,151839000,56167000,0,11143000,,106815000,106815000,58396,SLRC
2019-12-31,79003000,,-8824000,,-7230000,184623000,263039000,-587000,-587000,,-13874000,,,,-1594000,351318000,351905000,88279000,-8237000,,-7230000,-7230000,58397,NVCR
2018-12-31,50574000,,-45942000,,-63559000,151119000,168371000,-33322000,-33322000,,-16268000,,,,17617000,248069000,281391000,79698000,-12620000,,-63559000,-63559000,58397,NVCR
2017-12-31,38103000,,-48497000,,-61662000,122642000,121611000,-39134000,-39134000,,-11372000,,,,13165000,177026000,216160000,55415000,-9363000,,-61662000,-61662000,58397,NVCR
2016-12-31,41467000,,-121464000,,-131845000,106856000,43042000,-105281000,-105281000,,-6604000,,,,10381000,82888000,188169000,39846000,-16183000,,-131845000,-131845000,58397,NVCR
2020-03-31,36301000,,-4407000,,-5210000,113981000,172508000,22226000,22226000,,-25350000,,,,803000,402949000,380723000,230441000,-26633000,,-5210000,-5210000,58398,QMCO
2019-03-31,32113000,,-40421000,,-42797000,134677000,167614000,824000,824000,,-21095000,,,,2376000,402680000,401856000,235066000,-41245000,,-42797000,-42797000,58398,QMCO
2018-03-31,38562000,,-46459000,,-43346000,154370000,172784000,-20148000,-20148000,,-11670000,,,,-3113000,437684000,457832000,264900000,-26311000,,-43346000,-43346000,58398,QMCO
2017-03-31,44379000,,-752000,,-2408000,152117000,205272000,8776000,8776000,,-7993000,,,,1656000,493054000,484278000,287782000,-9528000,,-2408000,-2408000,58398,QMCO
2020-05-31,,,11098792,,11098792,5705041,38018714,32313673,32313673,,-7381409,,,,0,38018714,5705041,0,-21214881,,11098792,11098792,58400,MMD
2019-05-31,,,36386267,,36386267,5657539,41451524,35793985,35793985,,-8016553,,,,0,41451524,5657539,0,592282,,36386267,36386267,58400,MMD
2018-05-31,,,28874566,,28874566,5581979,40498190,34916211,34916211,,-6092631,,,,0,40498190,5581979,0,-6041645,,28874566,28874566,58400,MMD
2017-05-31,,,17077548,,17077548,5440164,39732577,34292413,34292413,,-4676429,,,,0,39732577,5440164,0,-17214865,,17077548,17077548,58400,MMD
2019-12-31,,,11415815,,11593050,12808682,23720169,10911487,10911487,,,,,,-177235,40519800,29608313,16799631,504328,,11593050,11593050,58402,OPNT
2018-12-31,,,-21144033,,-21195316,11477701,-9712739,-21190440,-21190440,,,,,,51283,13982177,35172617,23694916,46407,,-21195316,-21195316,58402,OPNT
2017-12-31,,,3716501,,3310510,15181824,18882698,3700874,3700874,,,,,,405991,28229561,24528686,9346862,15626,,3310510,3310510,58402,OPNT
2017-07-31,,,7131087,,6580613,8022132,15274397,7252265,7252265,,-4000.0,,,,550474,18445996,11193731,3171599,-121178,,6580613,6580613,58402,OPNT
2020-10-31,,,6348000000,,5097000000,12343000000,22233000000,0,6972000000,2918000000,,,,,1251000000,22233000000,15261000000,0,-624000000,,5097000000,4850000000,58405,BMO
2019-10-31,,,7272000000,,5758000000,12783000000,24611000000,0,7826000000,4002000000,,,,,1514000000,24611000000,16785000000,0,-554000000,,5758000000,5547000000,58405,BMO
2018-10-31,,,7414000000,,5453000000,11549000000,22243000000,0,7917000000,2777000000,,,,,1961000000,22243000000,14326000000,0,-503000000,,5453000000,5269000000,58405,BMO
2017-10-31,,,6631000000,,5337000000,11315000000,21361000000,0,7116000000,2930000000,,,,,1292000000,21361000000,14245000000,0,-485000000,,5339000000,5153000000,58405,BMO
2019-12-29,36997000,,-168780000,5304000,-183059000,96857000,-2309000,-136163000,-136163000,,-25831000,,,,10122000,1198301000,1334464000,1200610000,-32617000,,-178902000,-183059000,58407,MAXN
2018-12-30,37231000,,-605130000,1147000,-603814000,81741000,-95161000,-214133000,-214133000,,-25889000,,,,-1050000,912313000,1126446000,1007474000,-390997000,,-604080000,-603814000,58407,MAXN
2020-02-29,,,4998352,,4998352,1491255,10056954,8565699,8565699,,-1416273,,,,0,10056954,1491255,0,-3567347,,4998352,4998352,58408,VLT
2019-02-28,,,4771353,,4771353,1543353,10461705,8918352,8918352,,-1431007,,,,0,10461705,1543353,0,-4146999,,4771353,4771353,58408,VLT
2018-02-28,,,4965186,,4965186,1501695,10155924,8635654,8635654,18575.0,-1052174,,,,0,10155924,1520270,0,-3670468,,4965186,4965186,58408,VLT
2017-02-28,,,25321480,,25321480,1463704,10941704,9478000,9478000,18575.0,-727943,,,,0,10941704,1463704,0,15843480,,25321480,25321480,58408,VLT
2019-12-31,,,54600000,1007600000,-74800000,88600000,423800000,260100000,260100000,-1400000,-178900000,,,,9500000,1831400000,1571300000,1407600000,-205500000,,45100000,-110500000,58410,SGRY
2018-12-31,,,-69200000,1020900000,-205700000,92100000,410100000,254300000,254300000,-3700000,-147000000,,,,26400000,1771500000,1517200000,1361400000,-323500000,,-95600000,-238100000,58410,SGRY
2017-12-31,,,82300000,981195000,-53000000,69000000,298600000,178200000,178200000,-500000,-117700000,,,,53600000,1312400000,1134200000,1013800000,-95900000,,28700000,-79100000,58410,SGRY
2016-12-31,,,92178000,495518000,9453000,55154000,300030000,205678000,205678000,-353000,-100571000,,,,7095000,1121226000,915548000,821196000,-113500000,,85083000,9453000,58410,SGRY
2019-12-31,,,52100000,,37600000,211400000,332300000,70900000,70900000,400000,-34000000,,,,14500000,874700000,803800000,542400000,-18800000,,37600000,37600000,58411,DFIN
2018-12-31,,,102700000,,73600000,234100000,375700000,95600000,95600000,200000,-36700000,,,,29100000,963000000,867400000,587300000,25400000,,73600000,73600000,58411,DFIN
2017-12-31,,,56200000,,9700000,216400000,383500000,122400000,122400000,200000,-42900000,,,,46500000,1004900000,882500000,621400000,-66100000,,9700000,9700000,58411,DFIN
2016-12-31,,,94300000,,59100000,205900000,364500000,115100000,115100000,200000,-11700000,,,,35200000,983500000,868400000,619000000,-20800000,,59100000,59100000,58411,DFIN
2019-12-31,,,4911508000000,2752435000000,3403497000000,4936983000000,11390858000000,0,5068942000000,1384933000000,,,,,1269124000000,11390858000000,6321916000000,0,-157434000000,,3642384000000,3341504000000,58412,SHG
2018-12-31,,,4466610000000,925805000000,3156722000000,4565442000000,10078996000000,0,4508066000000,1005488000000,,,,,1268345000000,10078996000000,5570930000000,0,-41456000000,,3198265000000,3116365000000,58412,SHG
2017-12-31,,,3797608000000,883397000000,2918816000000,4645509000000,9135997000000,0,3861807000000,628681000000,,,,,848403000000,9135997000000,5274190000000,0,-64199000000,,2949205000000,2901138000000,58412,SHG
2016-12-31,,,3170472000000,635282000000,2774778000000,4344398000000,8410540000000,0,3104054000000,962088000000,,,,,345553000000,8410540000000,5306486000000,0,66418000000,,2824919000000,2719851000000,58412,SHG
2020-05-31,,,1043100000,74600000,840100000,1288400000,3102800000,1814400000,1814400000,,-490200000,,,,201300000,11054400000,9240000000,7951600000,-771300000,,841800000,840100000,58413,CAG
2019-05-26,,,899100000,79100000,678300000,1083700000,2706000000,1622300000,1622300000,,-386300000,,,,218800000,9538400000,7916100000,6832400000,-723200000,-1900000.0,680300000,678300000,58413,CAG
2018-05-27,,,972100000,80400000,808400000,1082000000,2351500000,1269500000,1269500000,,-162500000,,,,174600000,7938300000,6668800000,5586800000,-297400000,14300000.0,797500000,808400000,58413,CAG
2017-05-28,,,800700000,87000000,639300000,1046300000,2361000000,1314700000,1314700000,,-199200000,,,,254700000,7826900000,6512200000,5465900000,-514000000,102000000.0,546000000,638500000,58413,CAG
2020-12-31,,,75044000,,62210000,71701000,192167000,0,75044000,45422000,,,,,12834000,192167000,117123000,0,0,,62210000,62210000,58414,GABC
2019-12-31,,,71239000,,59222000,92090000,185401000,0,77895000,15416000,,,,,12017000,185401000,107506000,0,-6656000,,59222000,59222000,58414,GABC
2018-12-31,,,56057000,,46529000,74239000,149610000,0,62582000,12789000,,,,,9528000,149610000,87028000,0,-6525000,,46529000,46529000,58414,GABC
2017-12-31,,,52210000,,40676000,66508000,130013000,0,54106000,9399000,,,,,11534000,130013000,75907000,0,-1896000,,40676000,40676000,58414,GABC
2019-12-31,1000000,,7407000,,-15708000,38916000,145881000,37932000,37932000,,-8179000,,,,23115000,1436500000,1398568000,1290619000,-30525000,,-15708000,-15708000,58418,TPIC
2018-12-31,800000,,2246000,,5279000,42742000,147549000,29299000,29299000,,-10417000,,,,-3033000,1029624000,1000325000,882075000,-27053000,,5279000,5279000,58418,TPIC
2017-12-31,1600000,,54532000,,38734000,38773000,151099000,70098000,70098000,,-12381000,,,,15798000,955198000,885100000,804099000,-15566000,,38734000,38734000,58418,TPIC
2016-12-31,1500000,,30698000,,27044000,32392000,104993000,52974000,52974000,,-17614000,,,,3654000,769019000,716045000,664026000,-22276000,,27044000,21573000,58418,TPIC
2020-07-31,61200000,,335200000,16700000,257000000,468000000,871600000,342400000,342400000,,-17400000,,,,78200000,2581800000,2239400000,1710200000,-7200000,,257000000,257000000,58419,DCI
2019-07-31,62300000,,375200000,15400000,267200000,495600000,948300000,390400000,390400000,,-19900000,,,,108000000,2844900000,2454500000,1896600000,-15200000,,267200000,267200000,58419,DCI
2018-07-31,59900000,,363600000,4800000,180300000,495900000,935800000,380000000,380000000,,-21300000,,,,183300000,2734200000,2354200000,1798400000,-16400000,,180300000,180300000,58419,DCI
2017-07-31,54700000,,322000000,4400000,232800000,442600000,820900000,323600000,323600000,,-19500000,,,,89200000,2371900000,2048300000,1551000000,5200000,,232800000,232800000,58419,DCI
2020-06-30,763188000,,-346209000,,-350654000,568092000,1345366000,14086000,14086000,,-49610000,,,,4445000,1614173000,1600087000,268807000,-360295000,,-350654000,-350654000,58421,TEAM
2019-06-30,579134000,,-605556000,,-637621000,484070000,999842000,-63362000,-63362000,,-40241000,,,,32065000,1210127000,1273489000,210285000,-542194000,,-637621000,-637621000,58421,TEAM
2018-06-30,415776000,,-58131000,,-113432000,338557000,708288000,-46045000,-46045000,,-6806000,,,,55301000,880978000,927023000,172690000,-12086000,,-113432000,-113432000,58421,TEAM
2017-06-30,310169000,,-52400000,,-37449000,253188000,507523000,-55834000,-55834000,,-75000,,,,-14951000,626684000,682518000,119161000,3434000,,-37449000,-37449000,58421,TEAM
2019-12-31,24196000,,-28175000,,-28175000,4685000,0,-28881000,-28881000,,-482000,,,,0,0,28881000,0,706000,,-28175000,-28175000,58424,STSA
2018-12-31,6433000,,-7346000,,-7346000,1082000,0,-7515000,-7515000,,-90000,,,,0,0,7515000,0,169000,,-7346000,-7346000,58424,STSA
2017-12-31,4193000,,-5172000,,-5172000,754000,0,-4947000,-4947000,,-15000,,,,0,0,4947000,0,-225000,,-5172000,-5172000,58424,STSA
2020-12-31,,,44353000,,36357000,131524000,196288000,0,49239000,15525000,,,,,7996000,196288000,147049000,0,-4886000,,36357000,36357000,58425,OBNK
2019-12-31,,,66548000,,53882000,128851000,210622000,0,69563000,12208000,,,,,12666000,210622000,141059000,0,-3015000,,53882000,53882000,58425,OBNK
2018-12-31,,,62442000,,51605000,117567000,193678000,0,65860000,10251000,,,,,10837000,193678000,127818000,0,-3418000,,51605000,48653000,58425,OBNK
2017-12-31,,,20482000,,14669000,107057000,151156000,0,33867000,10232000,,,,,5813000,151156000,117289000,0,-13385000,,14669000,9831000,58425,OBNK
2019-12-31,,,5746000000,61000000,148000000,3121000000,20583000000,7381000000,7381000000,-32000000,-1048000000,,,,5591000000,70889000000,63508000000,50306000000,-1635000000,,155000000,148000000,58427,E
2018-12-31,,,10107000000,57000000,4126000000,3928000000,22160000000,9886000000,9886000000,120000000,-611000000,,,,5970000000,76484000000,66598000000,54324000000,221000000,,4137000000,4126000000,58427,E
2018-01-01,,,6844000000,49000000,3374000000,3955000000,17746000000,5099000000,5099000000,296000000,-650000000,,,,3467000000,67689000000,62590000000,49943000000,1745000000,,3377000000,3374000000,58427,E
2016-12-31,,,892000000,49000000,-1464000000,2947000000,13649000000,1831000000,1831000000,296000000,-663000000,,,,1936000000,56679000000,54848000000,43030000000,-939000000,-413000000.0,-1044000000,-1464000000,58427,E
2020-12-31,,,734000000,9409000000,-91000000,968000000,5170000000,2037000000,2037000000,,-1482000000,,,,154000000,37635000000,35598000000,32465000000,-1303000000,,580000000,-91000000,58428,BBU
2019-12-31,,,626000000,8937000000,43000000,905000000,4843000000,2069000000,2069000000,65000000.0,-1274000000,,,,192000000,43032000000,40963000000,38189000000,-1443000000,,434000000,43000000,58428,BBU
2018-12-31,,,1301000000,4946000000,74000000,643000000,3099000000,1643000000,1643000000,65000000.0,-498000000,,,,98000000,37168000000,35525000000,34069000000,-342000000,,1203000000,74000000,58428,BBU
2017-12-31,,,223000000,4479000000,-58000000,340000000,979000000,236000000,236000000,32000000.0,-202000000,,,,8000000,22823000000,22587000000,21844000000,-13000000,,215000000,-58000000,58428,BBU
2019-12-31,,,57765000,-399510000,25040000,117522000,209994000,70149000,70149000,,-12229000,,,,10909000,282293000,212144000,72299000,-12384000,,46856000,25040000,58430,RMAX
2018-12-31,,,66164000,-405976000,26883000,118434000,212626000,73514000,73514000,,-12051000,,,,16342000,212626000,139112000,0,-7350000,,49822000,26883000,58430,RMAX
2017-12-31,,,88862000,-410934000,10099000,98277000,193714000,74925000,74925000,,-9996000,,,,57542000,193714000,118789000,0,13937000,,31320000,10099000,58430,RMAX
2016-12-31,,,62015000,-403983000,22221000,86038000,175642000,73510000,73510000,,-8596000,,,,15167000,175642000,102132000,0,-11495000,,46848000,22221000,58430,RMAX
2019-12-31,29685000,,-113779000,,-113293000,28632000,-38880000,-97197000,-97197000,,,,,,-486000,7804000,105001000,46684000,-16582000,,-113293000,-113293000,58431,TBIO
2018-12-31,22836000,,-102960000,,-97395000,22606000,-33768000,-79210000,-79210000,,,,,,-5565000,1420000,80630000,35188000,-23750000,,-97395000,-98039000,58431,TBIO
2017-12-31,17606000,,-78924000,,-66443000,14311000,-28944000,-60861000,-60861000,,,,,,-12481000,0,60861000,28944000,-18063000,,-66443000,-67162000,58431,TBIO
2016-12-31,9554000,,-26698000,,-26698000,8144000,-6104000,-23802000,-23802000,,,,,,0,0,23802000,6104000,-2896000,,-26698000,-27369000,58431,TBIO
2019-12-31,44604000,,-71728000,,-71728000,22315000,21087000,-45832000,-45832000,,-6666000,,,,0,21087000,66919000,0,-25896000,,-71728000,-71728000,58432,MITO
2018-12-31,53062000,,-96712000,,-96712000,22217000,0,-75279000,-75279000,,-21357000,,,,0,0,75279000,0,-21433000,,-96712000,-96712000,58432,MITO
2017-12-31,63220000,,-82910000,,-82910000,16500000,0,-79720000,-79720000,,-3282000,,,,0,0,79720000,0,-3190000,,-82910000,-82910000,58432,MITO
2016-12-31,48445173,,-61049482,,-61049482,13403332,0,-61848505,-61848505,,-3282000,,,,0,0,61848505,0,799023,,-61049482,-61049482,58432,MITO
2020-12-31,,,17056000,,13473000,40580000,64005000,0,17612000,5813000,,,,,3583000,64005000,46393000,0,-556000,,13473000,13473000,58433,MFNC
2019-12-31,,,17710000,,13850000,36403000,59475000,0,17992000,5080000,,,,,3860000,59475000,41483000,0,-282000,,13850000,13850000,58433,MFNC
2018-12-31,,,10593000,,8367000,31961000,50893000,0,14426000,4506000,,,,,2226000,50893000,36467000,0,-3833000,,8367000,8367000,58433,MFNC
2017-12-31,,,11018000,,5479000,25689000,41354000,0,12187000,3478000,,,,,5539000,41354000,29167000,0,-1169000,,5479000,5479000,58433,MFNC
2019-12-31,,,426989000,39510000,373986000,367248000,862204000,433406000,433406000,,-13276000,,,,51133000,2805839000,2372433000,1943635000,-6417000,,375856000,368938000,58436,ICLR
2018-12-31,,,364614000,39510000,322656000,325794000,777557000,385847000,385847000,,-13502000,,,,41958000,2595777000,2209930000,1818220000,-21233000,,322656000,322656000,58436,ICLR
2017-12-31,,,328057000,39510000,281488000,323741000,731129000,346091000,346091000,,-12627000,,,,46569000,1758439000,1412348000,1027310000,-18034000,,281488000,281488000,58436,ICLR
2016-12-31,,,300172000,39510000,262179000,325726000,705154000,319853000,319853000,,-13006000,,,,37993000,1666487000,1346634000,961333000,-19681000,,262179000,262179000,58436,ICLR
2020-05-31,,,-4392912,,-4392912,7159639,32621230,25461591,25461591,,-1447,,,,0,32621230,7159639,0,-29854503,,-4392912,-5032807,58438,MMU
2019-05-31,,,40423134,,40423134,7003043,38010019,31006976,31006976,,-1199,,,,0,38010019,7003043,0,9416158,,40423134,39658072,58438,MMU
2018-05-31,,,12575334,,12575334,7187820,38646442,31458622,31458622,,-636,,,,0,38646442,7187820,0,-18883288,,12575334,12025612,58438,MMU
2017-05-31,,,7447139,,7447139,7284412,39764270,32479858,32479858,,-636,,,,0,39764270,7284412,0,-25032719,,7447139,7099541,58438,MMU
2019-12-31,39205000,,91982000,6014000,66146000,209981000,349173000,93253000,93253000,,,,,,6138000,488940000,395687000,139767000,-1271000,,85844000,66146000,58440,BMBL
2018-12-31,37517000,,-20638000,-8325000,-21519000,222586000,249846000,-16214000,-16214000,,,,,,3031000,360105000,376319000,110259000,-4424000,,-23669000,-21519000,58440,BMBL
2019-12-31,32505000,,15994000,,16517000,155884000,420841000,100317000,100317000,,-77844000,,,,-523000,533227000,432910000,112386000,-84323000,,16517000,16517000,58443,EVRI
2018-12-31,20497000,,2646000,,12356000,142298000,375078000,85813000,85813000,,-83001000,,,,-9710000,469515000,383702000,94437000,-83167000,,12356000,12356000,58443,EVRI
2017-12-31,18862000,,-72067000,,-51903000,118935000,336403000,81819000,81819000,,-102136000,,,,-20164000,974948000,893129000,638545000,-153886000,,-51903000,-51903000,58443,EVRI
2016-12-31,19356000,,-217783000,,-249479000,118709000,310442000,27744000,27744000,,-99228000,,,,31696000,859456000,831712000,549014000,-245527000,,-249479000,-249479000,58443,EVRI
2020-12-31,,,435420000,1486000,377844000,210380000,501218000,0,271106000,,,,,,57191000,597502000,326396000,96284000,164314000,-300000,378229000,377844000,58445,ENVA
2019-12-31,,,170069000,1486000,36612000,224336000,411997000,0,172606000,,,,,,42053000,1099153000,926547000,687156000,-2537000,-91404000,128016000,36612000,58445,ENVA
2018-12-31,,,68873000,1486000,70098000,201103000,311485000,0,96182000,,,,,,5301000,893257000,797075000,581772000,-27309000,6526000,63572000,70098000,58445,ENVA
2017-12-31,,,19671000,1486000,29240000,176312000,231779000,0,42185000,,,,,,2057000,654898000,612713000,423119000,-22514000,11626000,17614000,29240000,58445,ENVA
2019-12-31,6652000,,-3757000,,-1809000,52783000,54422000,-5013000,-5013000,,,,,,-2417000,73710000,78723000,19288000,1256000,-469000,-1340000,-1809000,58451,OXFD
2018-12-31,5822000,,-24781000,,120779000,54752000,42927000,-17647000,-17647000,,-1797000.0,,,,-37286000,59753000,77400000,16826000,-7134000,108274000,12505000,120779000,58451,OXFD
2017-12-31,9066000,,-31592000,,-32885000,56090000,36263000,-28893000,-28893000,,-3105000.0,,,,1634000,54733000,83626000,18470000,-2699000,341000,-33226000,-32885000,58451,OXFD
2016-12-31,8270000,,-25352000,,-22349000,45746000,30497000,-23519000,-23519000,,-864000.0,,,,-3774000,46988000,70507000,16491000,-1833000,-771000,-21578000,-22349000,58451,OXFD
2020-06-30,,,-16103949,,-16103949,4350462,22229825,17879363,17879363,,-2059077,,,,0,22229825,4350462,0,-33983312,,-16103949,-16743086,58454,EVF
2019-06-30,,,8858281,,8858281,4670455,23988265,19317810,19317810,,-2905387,,,,0,23988265,4670455,0,-10459529,,8858281,9602341,58454,EVF
2018-06-30,,,16105269,,16105269,4947994,21786706,16838712,16838712,,-1521397,,,,0,21786706,4947994,0,-733443,,16105269,15026819,58454,EVF
2017-06-30,,,31907486,,31907486,4980522,21660768,16680246,16680246,,-746861,,,,0,21660768,4980522,0,15227240,,31907486,33788848,58454,EVF
2019-12-31,,,8280824,,8216352,4531836,13231560,0,8280824,366048,,,,,64472,17795038,9514214,4563478,0,,8216352,8216352,58456,LGHL
2018-12-31,,,-2744874,,-2771208,2851323,454598,0,-2444874,15406,,,,,26334,6568145,9013019,6113547,-300000,,-2771208,-2771208,58456,LGHL
2017-12-31,,,-631719,,-734655,2092653,1489418,0,-631719,9068,,,,,102936,9854946,10486665,8365528,0,,-734655,-734655,58456,LGHL
2020-06-30,,,179077000,,136983000,175884000,358036000,177091000,177091000,,-73000,,,,42094000,1334388000,1157297000,976352000,1986000,,136983000,136705000,58457,LANC
2019-06-30,,,195542000,,150549000,145212000,326198000,176387000,176387000,,-73000,,,,44993000,1307787000,1131400000,981589000,19155000,,150549000,150290000,58457,LANC
2018-06-30,,,174203000,,135314000,125920000,303506000,173600000,173600000,,-73000,,,,38889000,1222925000,1049325000,919419000,603000,,135314000,135043000,58457,LANC
2017-06-30,,,175516000,,115314000,122182000,318780000,193145000,193145000,,-73000,,,,60202000,1201842000,1008697000,883062000,-17629000,,115314000,115118000,58457,LANC
2020-12-31,909126000,,-1797391000,,-1752857000,1362458000,529202000,-1742382000,-1742382000,,-32678000,,,,-44534000,2364681000,4107063000,1835479000,-55009000,,-1752857000,-1752857000,58458,LYFT
2019-12-31,1505640000,,-2599885000,,-2602241000,2000215000,803375000,-2702480000,-2702480000,,-32678000,,,,2356000,3615960000,6318440000,2812585000,102595000,,-2602241000,-2602241000,58458,LYFT
2018-12-31,300836000,,-910597000,,-911335000,1249089000,574814000,-975111000,-975111000,,-32678000,,,,738000,2156616000,3131727000,1581802000,64514000,,-911335000,-911335000,58458,LYFT
2017-12-31,136646000,,-687745000,,-688301000,788461000,216835000,-708272000,-708272000,,-32678000,,,,556000,1059881000,1768153000,843046000,20527000,,-688301000,-688301000,58458,LYFT
2019-12-31,,,150700000,,108800000,,531200000,301200000,301200000,,-63500000,,,,41900000,1177200000,876000000,646000000,-150500000,,108800000,108800000,58461,BKI
2018-12-31,,,206200000,,168500000,10900000.0,488600000,276700000,276700000,,-51700000,,,,37700000,1114000000,837300000,625400000,-70500000,,168500000,168500000,58461,BKI
2017-12-31,,,192400000,,182300000,9400000.0,482100000,278900000,278900000,,-57500000,,,,-61800000,1051600000,772700000,569500000,-86500000,,254200000,182300000,58461,BKI
2016-12-31,,,158800000,1063700000.0,45800000,11000000.0,454400000,239200000,239200000,,-67600000,,,,25800000,1026000000,786800000,571600000,-80400000,,133000000,45800000,58461,BKI
2019-12-31,57405921,,487819233,13810752,390913892,429362425,844322449,357554103,357554103,,-13457818,,,,82960493,1440068825,1082514722,595746376,130265130,,404858740,390913892,58464,CANG
2018-12-31,46709014,,396006889,3594671,302692065,318320355,641395190,276365821,276365821,,-19010616,,,,89082554,1091414277,815048456,450019087,119641068,,306924335,302692065,58464,CANG
2017-12-31,19418576,,468460432,25790121,341009811,215421994,665993673,431153103,431153103,,-12993624,,,,119403000,1052203719,621050616,386210046,37307329,,349057432,171494012,58464,CANG
2016-12-31,4999844,,186495374,15294222,128905984,74086748,264235620,185149028,185149028,,-449690,,,,53014312,434279994,249130966,170044374,1346346,,133481062,64826887,58464,CANG
2020-08-31,,,75515000,,60710000,143586000,223017000,77220000,77220000,,-2439000,,,,14805000,408498000,331278000,185481000,-1705000,,60710000,60416000,58466,WDFC
2019-08-31,,,80770000,,55908000,147252000,232340000,82382000,82382000,,-2541000,,,,24862000,423350000,340968000,191010000,-1612000,,55908000,55575000,58466,WDFC
2018-08-31,,,75178000,,65215000,143708000,225263000,78604000,78604000,,-4219000,,,,9963000,408518000,329914000,183255000,-3426000,,65215000,64792000,58466,WDFC
2017-08-31,,,74622000,,52930000,135097000,213885000,75909000,75909000,,-2582000,,,,21692000,380506000,304597000,166621000,-1287000,,52930000,52607000,58466,WDFC
2020-10-31,,,14609929,,14609929,1014623,1763853,749230,749230,,,,,,0,1763853,1014623,0,13860699,,14609929,14609929,58467,JEQ
2019-10-31,,,12956438,,12956438,1039743,1819107,779364,779364,,,,,,0,1819107,1039743,0,12177074,,12956438,12956438,58467,JEQ
2018-10-31,,,-15485192,,-15485192,1093960,2021169,927209,927209,,,,,,0,2021169,1093960,0,-16412401,,-15485192,-15485192,58467,JEQ
2017-10-31,,,14676035,,14676035,1065818,2030583,964765,964765,,,,,,0,2030583,1065818,0,13711270,,14676035,14676035,58467,JEQ
2019-12-31,,,-221638000,,-217751000,79727000,168358000,19720000,19720000,,-39770000,,,,-3887000,832937000,813217000,664579000,-241358000,,-217751000,-217751000,58469,NINE
2018-12-31,,,-50608000,,-52983000,73078000,187876000,50983000,50983000,,-22939000,,,,2375000,827174000,776191000,639298000,-101591000,,-52983000,-52983000,58469,NINE
2017-12-31,,,-72669000,,-67682000,49505000,95193000,-16533000,-16533000,,-16252000,,,,-4987000,543660000,560193000,448467000,-56136000,,-67682000,-67682000,58469,NINE
2016-12-31,,,-97197000,,-70911000,37652000,36245000,-65750000,-65750000,,-14185000,,,,-26286000,282354000,348104000,246109000,-31447000,,-70911000,-70911000,58469,NINE
2019-12-31,,,140459000,109079000,95726000,577752000,755354000,159314000,159314000,34000,-11155000,,,,26607000,2080241000,1920927000,1324887000,-18855000,,113852000,95726000,58472,LHCG
2018-12-31,,,101322000,122145000,63574000,521554000,653606000,115301000,115301000,389000,-9679000,,,,22399000,1809963000,1694662000,1156357000,-13979000,,78923000,63574000,58472,LHCG
2017-12-31,,,71330000,71116000,50112000,297139000,386792000,76193000,76193000,60000,-3352000,,,,10944000,1062602000,986409000,675810000,-4339000,,60386000,50112000,58472,LHCG
2016-12-31,,,68118000,18993000,36583000,258422000,342383000,71761000,71761000,60000,-2444000,,,,22176000,900033000,828272000,557650000,-3151000,,45942000,36583000,58472,LHCG
2020-12-31,,,885000000,581000000,755000000,-118000000,2769000000,1480000000,1480000000,359000000,-563000000,,,,133000000,6680000000,5200000000,3911000000,-595000000,,752000000,755000000,58474,CMS
2019-12-31,,,829000000,37000000,680000000,-91000000,2564000000,1330000000,1330000000,333000000,-523000000,,,,147000000,6845000000,5515000000,4281000000,-501000000,,682000000,680000000,58474,CMS
2018-12-31,,,774000000,37000000,657000000,-90000000,2398000000,1252000000,1252000000,303000000,-461000000,,,,115000000,6873000000,5621000000,4475000000,-478000000,,659000000,657000000,58474,CMS
2017-12-31,,,886000000,37000000,460000000,-24000000,2503000000,1362000000,1362000000,284000000,-440000000,,,,424000000,6583000000,5221000000,4080000000,-476000000,,462000000,460000000,58474,CMS
2020-12-31,,,-178200000,,-205500000,286626000,648400000,0,318819000,42955000,,,,,27300000,648400000,329581000,0,-497019000,,-205500000,-205500000,58476,CADE
2019-12-31,,,262301000,,201958000,263528000,671071000,0,314660000,92883000,,,,,60343000,671071000,356411000,0,-52359000,,201958000,201275000,58476,CADE
2018-12-31,,,211378000,,166261000,178111000,468579000,0,229211000,61257000,,,,,45117000,468579000,239368000,0,-17833000,,166261000,166064000,58476,CADE
2017-12-31,,,182999000,,102353000,170087000,416355000,0,187651000,58617000,,,,,80646000,416355000,228704000,0,-4652000,,102353000,102353000,58476,CADE
2019-12-31,2852000000,,4300000000,2727000000,3201000000,6482000000,15647000000,6353000000,6353000000,-40000000,-247000000,,,,716000000,74731000000,68378000000,59084000000,-2053000000,,3584000000,3201000000,58478,STLA
2018-12-31,2482000000,,3910000000,2509000000,2827000000,6628000000,14794000000,5745000000,5745000000,-61000000,-216000000,,,,615000000,74027000000,68282000000,59233000000,-1835000000,,3295000000,2827000000,58478,STLA
2017-12-31,2153000000,,3053000000,2142000000,1924000000,6252000000,12384000000,3958000000,3958000000,21000000,-210000000,,,,699000000,62256000000,58298000000,49872000000,-905000000,-7000000.0,2354000000,1924000000,58478,STLA
2016-12-31,1915000000,,2666000000,1961000000,1730000000,5137000000,10290000000,3238000000,3238000000,21000000,-255000000,,,,517000000,54030000000,50792000000,43740000000,-572000000,-7000000.0,2149000000,1730000000,58478,STLA
2020-09-30,,,18153246,,18153246,6637791,49387005,42749214,42749214,,-3078,,,,0,49387005,6637791,0,-24595968,,18153246,18153246,58479,HIO
2019-09-30,,,48995290,,48995290,5968758,50654789,44686031,44686031,,-255,,,,0,50654789,5968758,0,4309259,,48995290,48995290,58479,HIO
2018-09-30,,,14878281,,14878281,6337394,49005794,42668400,42668400,,-472,,,,0,49005794,6337394,0,-27790119,,14878281,14878281,58479,HIO
2017-09-30,,,61549806,,61549806,6518282,51477220,44958938,44958938,,-619,,,,0,51477220,6518282,0,16590868,,61549806,61549806,58479,HIO
2019-12-31,20880000,,-26777000,,-26838000,65152000,62343000,-27042000,-27042000,,-40000,,,,61000,154956000,181998000,92613000,265000,,-26838000,-26838000,58480,LEAF
2018-12-31,20183000,,-23095000,,-23190000,62951000,63883000,-23322000,-23322000,,-11000,,,,95000,155042000,178364000,91159000,227000,,-23190000,-23190000,58480,LEAF
2017-12-31,18613000,,-31170000,,-31133000,57888000,50888000,-30641000,-30641000,,-5000,,,,-37000,128990000,159631000,78102000,-529000,,-31133000,-31133000,58480,LEAF
2016-12-31,19364000,,-2021000,,-2011000,56558000,46237000,-38685000,-38685000,,-4000,,,,-10000,113452000,152137000,67215000,36664000,,-2011000,-2011000,58480,LEAF
2019-12-31,7377000,,-13162000,,-13162000,6006000,58000,-13325000,-13325000,,-38000,,,,0,116000,13441000,58000,163000,,-13162000,-13162000,58481,NYMX
2018-12-31,6677000,,-10594000,,-10594000,4125000,161000,-10641000,-10641000,,-18000,,,,0,299000,10940000,138000,47000,,-10594000,-10594000,58481,NYMX
2017-12-31,7874000,,-13429000,,-13429000,5436000,75000,-13235000,-13235000,,-52000,,,,0,224000,13459000,149000,-194000,,-13429000,-13429000,58481,NYMX
2016-12-31,6798000,,-13110000,,-13110000,6182000,111000,-12869000,-12869000,,-118000,,,,0,284000,13153000,173000,-241000,,-13110000,-13110000,58481,NYMX
2019-12-31,96611000,,-120413000,,-114933000,205471000,549212000,201215000,201215000,,-27066000,,,,-5480000,3063117000,2861902000,2513905000,-321628000,,-114933000,-114933000,58483,FSLR
2018-12-31,84472000,,147767000,,144326000,176857000,392177000,40113000,40113000,,-25921000,,,,3441000,2244044000,2203931000,1851867000,107654000,,144326000,144326000,58483,FSLR
2017-12-31,88573000,,206381000,,-165615000,202699000,548947000,215032000,215032000,,-25765000,,,,371996000,2941324000,2726292000,2392377000,-8651000,,-165615000,-165615000,58483,FSLR
2016-12-31,124762000,,-392945000,,-416112000,261994000,638418000,250641000,250641000,,-20538000,,,,23167000,2904563000,2653922000,2266145000,-643586000,,-416112000,-416112000,58483,FSLR
2019-12-31,11013000,,-13434000,,-13205000,6312000,0,-17524000,-17524000,,,,,,-229000,0,17524000,0,4090000,,-13205000,-13205000,58485,MBRX
2018-12-31,9728000,,-11876000,,-11876000,5229000,0,-15025000,-15025000,,,,,,0,0,15025000,0,3149000,,-11876000,-11876000,58485,MBRX
2017-12-31,4545000,,-9805000,,-9805000,4090000,0,-8653000,-8653000,,,,,,0,0,8653000,0,-1152000,,-9805000,-9805000,58485,MBRX
2016-12-31,1496000,,-3926000,,-3926000,2381000,0,-3883000,-3883000,,-43000.0,,,,0,0,3883000,0,-43000,,-3926000,-3926000,58485,MBRX
2019-12-31,,,117484000,46960000,109523000,38220000,247742000,115406000,115406000,,-66639000,,,,1287000,386449000,271043000,138707000,2078000,,116197000,109431000,58487,UE
2018-12-31,,,120482000,101271000,105150000,34984000,260697000,126291000,126291000,,-64868000,,,,3519000,414160000,287869000,153463000,-5809000,,116963000,104966000,58487,UE
2017-12-31,,,72660000,100622000,67070000,30691000,282118000,169146000,169146000,,-56218000,,,,-278000,407042000,237896000,124924000,-96486000,,72938000,66915000,58487,UE
2016-12-31,,,97434000,35811000,90815000,28843000,219220000,133018000,133018000,,-51881000,,,,804000,325976000,192958000,106756000,-35584000,,96630000,90701000,58487,UE
2019-12-31,,,296876907,,296876907,12901853,21265381,8218332,8218332,145196,,,,,0,21265381,13047049,0,288658575,,296876907,285564935,58488,GAM
2018-12-31,,,-71704824,,-71704824,12467382,20777507,8173881,8173881,136244,,,,,0,20777507,12603626,0,-79878705,,-71704824,-83016796,58488,GAM
2017-12-31,,,170734397,,170734397,13623349,22355208,8564156,8564156,167703,,,,,0,22355208,13791052,0,162170241,,170734397,159422425,58488,GAM
2016-12-31,,,84421509,,84421509,13132654,21473727,8172289,8172289,168784,,,,,0,21473727,13301438,0,76249220,,84421509,73109537,58488,GAM
2019-12-31,119218000,,-138664000,,-138664000,27362000,0,-146580000,-146580000,,,,,,0,0,146580000,0,7916000,,-138664000,-200856000,58490,GRCL
2018-12-31,52243000,,-60793000,,-60793000,10261000,0,-62504000,-62504000,,,,,,0,0,62504000,0,1711000,,-60793000,-72992000,58490,GRCL
2019-12-31,,,-36641000,,-34793000,24402000,-10758000,-35160000,-35160000,,,,,,-1848000,100557000,135717000,111315000,-1481000,,-34793000,-52747000,58493,FMTX
2018-12-31,,,13860000,,5292000,21539000,31231000,9692000,9692000,,,,,,8568000,164090000,154398000,132859000,4168000,,5292000,93000,58493,FMTX
2020-01-31,1850000,,-10409000,,-11287000,19716000,16621000,-9615000,-9615000,,-46000,,,,878000,42675000,52290000,26054000,-794000,,-11287000,-13337000,58498,MIND
2019-01-31,1159000,,-19588000,,-19840000,20905000,11740000,-13020000,-13020000,,-46000,,,,252000,42942000,55962000,31202000,-6568000,,-19840000,-21548000,58498,MIND
2018-01-31,1502000,,-20159000,,-21069000,19263000,6634000,-17292000,-17292000,,-46000,,,,910000,48276000,65568000,41642000,-2867000,,-21069000,-21974000,58498,MIND
2017-01-31,974000,,-31339000,,-33153000,19753000,-7414000,-31290000,-31290000,,-643000,,,,1814000,40999000,72289000,48413000,-49000,,-33153000,-33639000,58498,MIND
2020-06-30,,,-1766439,,-1766439,1094173,4492234,3398061,3398061,,-2133934,,,,0,4492234,1094173,0,-5164500,,-1766439,-1766439,58500,JMM
2019-06-30,,,3837527,,3837527,1123170,4696134,3572964,3572964,,-1688407,,,,0,4696134,1123170,0,264563,,3837527,3837527,58500,JMM
2018-06-30,,,2036846,,2036846,1121434,4710344,3588910,3588910,,382334,,,,0,4710344,1121434,0,-1552064,,2036846,2036846,58500,JMM
2017-06-30,,,4885180,,4885180,1087190,4942676,3855486,3855486,,-113099,,,,0,4942676,1087190,0,1029694,,4885180,4885180,58500,JMM
2020-12-31,274007000,,198762000,,143659000,542014000,917176000,101155000,101155000,,,,,,55103000,1286671000,1185516000,369495000,97607000,,143659000,143659000,58502,NATI
2019-12-31,268286000,,180544000,,162151000,570994000,1016324000,177044000,177044000,,,,,,18393000,1353215000,1176171000,336891000,3500000,,162151000,162151000,58502,NATI
2018-12-31,258980000,,176453000,,155057000,578921000,1027462000,189561000,189561000,,,,,,21396000,1359132000,1169571000,331670000,-13108000,,155057000,155057000,58502,NATI
2017-12-31,228771000,,147380000,,52411000,570657000,962270000,162842000,162842000,,,,,,94969000,1289386000,1126544000,327116000,-15462000,,52411000,52411000,58502,NATI
2019-12-31,,,-20446000,-7000,-20039000,14754000,6335000,-9382000,-9382000,844000,-122000,,,,-143000,6837000,16219000,502000,-11064000,,-20303000,-20039000,58506,RIOT
2018-12-31,,,-61008000,-1296000,-58008000,26358000,7525000,-27601000,-27601000,3501000,-123000,,,,-699000,7845000,35446000,320000,-33407000,96000.0,-60309000,-58008000,58506,RIOT
2017-12-31,,,-18036968,758095,-19845873,7313626,244471,-7932839,-7932839,-27205,-4806637,,,,-1609000,269657,8202496,25186,-10104129,-3542964.0,-16427968,-19845873,58506,RIOT
2016-12-31,249164.0,,-3157821,758095,-4272837,4411327,96699,-4657108,-4657108,-27205,-30161,,,,0,96699,4753807,0,1499287,-1115016.0,-3157821,-4272837,58506,RIOT
2020-12-31,,,186294000,,158228000,299248000,599643000,0,245978000,54417000,,,,,28066000,599643000,353665000,0,-59684000,,158228000,152570000,58509,AUB
2019-12-31,,,231255000,,193528000,297947000,649595000,0,305579000,46069000,,,,,37557000,649595000,344016000,0,-74324000,-170000.0,193698000,193528000,58509,AUB
2018-12-31,,,179429000,,146248000,244369000,497230000,0,222805000,30056000,,,,,30016000,497230000,274425000,0,-43376000,-3165000.0,149413000,146248000,58509,AUB
2017-12-31,,,104966000,,72923000,185011000,330634000,0,124259000,21364000,,,,,32790000,330634000,206375000,0,-19293000,747000.0,72176000,72923000,58509,AUB
2019-12-31,,,37967000,,36148000,29410000,147261000,117851000,117851000,,-35623000,,,,1819000,147261000,29410000,0,-79884000,,36148000,36148000,58510,GSBD
2018-12-31,,,55260000,,53678000,36081000,146731000,110650000,110650000,,-25161000,,,,1582000,146731000,36081000,0,-55390000,,53678000,53678000,58510,GSBD
2017-12-31,,,51100000,,49548000,35629000,136781000,101152000,101152000,,-18618000,,,,1552000,136781000,35629000,0,-50052000,,49548000,49548000,58510,GSBD
2016-12-31,,,41689000,,40652000,33545000,125108000,91563000,91563000,,-13727000,,,,1037000,125108000,33545000,0,-49874000,,40652000,40652000,58510,GSBD
2020-06-30,,,14649000,504000,7954000,80780000,176110000,60176000,60176000,,-26386000,,,,6695000,356479000,296303000,180369000,-45527000,,7954000,4286000,58511,GFN
2019-06-30,,,-1646000,504000,-7466000,81566000,185259000,61989000,61989000,,-35344000,,,,5820000,378206000,316217000,192947000,-63635000,,-7466000,-11124000,58511,GFN
2018-06-30,,,-9786000,504000,-8306000,77487000,161110000,43862000,43862000,,-33991000,,,,-679000,347302000,303440000,186192000,-53648000,,-9107000,-11964000,58511,GFN
2017-06-30,,,-872000,88102000,-2962000,67661000,126071000,19110000,19110000,,-19653000,,,,-25000,276928000,257818000,150857000,-19982000,,-847000,-6620000,58511,GFN
2019-12-31,595169000,,-1102196000,,-1111199000,556074000,7709000,-1143534000,-1143534000,,-4925000,,,,9003000,3956353000,5099887000,3948644000,41338000,,-1111199000,-1160924000,58512,KC
2018-12-31,440518000,,-996810000,,-1006442000,338517000,-200390000,-979425000,-979425000,,-38826000,,,,9632000,2218172000,3197597000,2418562000,-17385000,,-1006442000,-1748914000,58512,KC
2017-12-31,399209000,,-713582000,,-714250000,209510000,-118186000,-726905000,-726905000,,-36410000,,,,668000,1235967000,1962872000,1354153000,13323000,,-714250000,-1319765000,58512,KC
2020-09-30,207000000,,-618000000,,-680000000,991000000,1754000000,221000000,221000000,,-226000000,,,,62000000,2873000000,2652000000,1119000000,-839000000,,-680000000,-687000000,58513,AVYA
2019-09-30,204000000,,-669000000,,-671000000,994000000,1749000000,215000000,215000000,,-237000000,,,,2000000,2887000000,2672000000,1138000000,-884000000,,-671000000,-671000000,58513,AVYA
2018-09-30,210000000,,3177000000,,3264000000,1147000000,1643000000,11000000,11000000,,-183000000,,,,-87000000,2851000000,2840000000,1208000000,3166000000,,3264000000,3264000000,58513,AVYA
2017-09-30,225000000,,-198000000,,-182000000,1231000000,2028000000,348000000,348000000,,-246000000,,,,-16000000,3272000000,2924000000,1244000000,-546000000,,-182000000,-213000000,58513,AVYA
2019-12-28,22500000,,303800000,29300000,238900000,510300000,871400000,338600000,338600000,,-53000000,,,,61200000,3238000000,2899400000,2366600000,-34800000,,242600000,238900000,58515,RBC
2018-12-29,29300000,,292200000,28000000,231200000,543200000,967800000,395300000,395300000,,-55200000,,,,56400000,3645600000,3250300000,2677800000,-103100000,,235800000,231200000,58515,RBC
2017-12-30,29900000,,277200000,29200000,213000000,537800000,895100000,327400000,327400000,,-56100000,,,,59100000,3360300000,3032900000,2465200000,-50200000,,218100000,213000000,58515,RBC
2016-12-31,29500000,,266400000,39400000,203400000,519200000,869700000,321000000,321000000,,-58700000,,,,57100000,3224500000,2903500000,2354800000,-54600000,,209300000,203400000,58515,RBC
2020-12-31,,,503000000,,484000000,381000000,1511000000,1130000000,1130000000,,-304000000,,,,19000000,1511000000,381000000,0,-627000000,,484000000,484000000,58516,ARCC
2019-12-31,,,809000000,,793000000,410000000,1528000000,1118000000,1118000000,,-279000000,,,,16000000,1528000000,410000000,0,-309000000,,793000000,793000000,58516,ARCC
2018-12-31,,,877000000,,858000000,384000000,1337000000,953000000,953000000,,-240000000,,,,19000000,1337000000,384000000,0,-76000000,,858000000,858000000,58516,ARCC
2017-12-31,,,686000000,,667000000,405000000,1160000000,755000000,755000000,,-225000000,,,,19000000,1160000000,405000000,0,-69000000,,667000000,667000000,58516,ARCC
2020-12-31,83066000,,99110000,,77553000,315626000,509733000,104923000,104923000,,,,,,21557000,551451000,446528000,41718000,-5813000,,77553000,77553000,58517,CARG
2019-12-31,69462000,,38705000,,42146000,444278000,552616000,34322000,34322000,,,,,,-3441000,588916000,554594000,36300000,3834000,,42146000,42146000,58517,CARG
2018-12-31,47866000,,25484000,,65170000,355414000,429275000,23191000,23191000,,,,,,-39686000,454086000,430895000,24811000,2293000,,65170000,65170000,58517,CARG
2017-12-31,22470000,,15837000,,13199000,258853000,299252000,15274000,15274000,,-29000.0,,,,2638000,316861000,301587000,17609000,563000,,13199000,7101000,58517,CARG
2019-12-31,,,124692000,,96889000,29640000,581318000,274911000,274911000,,-161541000,,,,27803000,739508000,464597000,158190000,-150219000,,96889000,74118000,58518,CRK
2018-12-31,,,-8623000,,-28632000,27098000,311210000,162136000,162136000,,-144806000,,,,20009000,375437000,213301000,64227000,-170759000,,-28632000,-28632000,58518,CRK
2017-12-31,,,-129349000,,-111405000,26137000,194561000,877000,877000,,-146449000,,,,-17944000,249958000,249081000,55397000,-130226000,,-111405000,-111405000,58518,CRK
2016-12-31,,,-127965000,,-135134000,23963000,107253000,-169475000,-169475000,,-128743000,,,,7169000,170773000,340248000,63520000,41510000,,-135134000,-135134000,58518,CRK
2019-12-31,55929000,,-142676000,,-142734000,299665000,219521000,-136073000,-136073000,,-258000,,,,58000,323410000,459483000,103889000,-6603000,,-142734000,-143726000,58519,DKNG
2018-12-31,32885000,,-76115000,,-76220000,221484000,177588000,-76781000,-76781000,,-256000,,,,105000,226277000,303058000,48689000,666000,,-76220000,-76898000,58519,DKNG
2017-12-31,20212000,,-75346000,,-75556000,213080000,160094000,-73198000,-73198000,,-425000,,,,210000,191844000,265042000,31750000,-2148000,,-75556000,-77069000,58519,DKNG
2020-09-26,18752000000,,67091000000,,57411000000,19916000000,104956000000,66288000000,66288000000,,-2873000000,,,,9680000000,274515000000,208227000000,169559000000,803000000,,57411000000,57411000000,58522,AAPL
2019-09-28,16217000000,,65737000000,,55256000000,18245000000,98392000000,63930000000,63930000000,,-3576000000,,,,10481000000,260174000000,196244000000,161782000000,1807000000,,55256000000,55256000000,58522,AAPL
2018-09-29,14236000000,,72903000000,,59531000000,16705000000,101839000000,70898000000,70898000000,,-3240000000,,,,13372000000,265595000000,194697000000,163756000000,2005000000,,59531000000,59531000000,58522,AAPL
2017-09-30,11581000000,,64089000000,,48351000000,15261000000,88186000000,61344000000,61344000000,,-2323000000,,,,15738000000,229234000000,167890000000,141048000000,2745000000,,48351000000,48351000000,58522,AAPL
2019-12-31,3592843,,-3868741,9340551,-3582332,7181529,6602211,-4172161,-4172161,,-499852,,,,-274480,13791303,17963464,7189092,303420,,-3594261,-3582332,58523,TAOP
2018-12-31,4756088,,677555,9347036,1691983,4729182,9654094,168824,168824,,-484403,,,,-1201231,20578340,20409516,10924246,508731,,1878786,1691983,58523,TAOP
2017-12-31,4031313,,-131034,9134005,858605,4741156,8321766,-450703,-450703,,-450024,,,,-1070343,18189274,18639977,9867508,319669,,939309,858605,58523,TAOP
2016-12-31,3044972,,-18466633,9094085,-18170601,9676989,2586400,-10135561,-10135561,,-498931,,,,57844,10193590,20329151,7607190,-8331072,,-18524477,-18170601,58523,TAOP
2019-12-31,,,129004000,,89476000,222929000,656862000,273376000,273376000,,-84178000,,,,39528000,1398244000,1124868000,741382000,-144372000,,89476000,89476000,58524,SEAS
2018-12-31,,,62703000,,44788000,201424000,559732000,197353000,197353000,,-80914000,,,,17915000,1372290000,1174937000,812558000,-134650000,,44788000,44788000,58524,SEAS
2017-12-31,,,-287392000,,-202386000,228836000,473099000,80969000,80969000,,-78001000,,,,-85006000,1263324000,1182355000,790225000,-368361000,,-202386000,-202386000,58524,SEAS
2016-12-31,,,-3201000,,-12531000,238557000,513207000,108701000,108701000,,-62661000,,,,9330000,1344292000,1235591000,831085000,-111902000,,-12531000,-12531000,58524,SEAS
2020-01-31,35304000,,-27149000,4356000,-27594000,66676000,74110000,-27870000,-27870000,,,,,,586000,138180000,166050000,64070000,721000,,-27735000,-27594000,58527,NCNO
2019-01-31,22230000,,-22112000,4356000,-22306000,46069000,45083000,-23216000,-23216000,,,,,,194000,91534000,114750000,46451000,1104000,,-22306000,-22306000,58527,NCNO
2018-01-31,16559000,,-18539000,4356000,-18589000,29887000,27671000,-18775000,-18775000,,,,,,50000,58142000,76917000,30471000,236000,,-18589000,-18589000,58527,NCNO
2019-12-31,,,1415962000,,1107835000,668346000,2518585000,1414239000,1414239000,,-56000,,,,308127000,4200819000,2786580000,1682234000,1723000,,1107835000,1107835000,58528,MNST
2018-12-31,,,1293272000,,993004000,985156000,2295375000,1310219000,1310219000,,-60000,,,,300268000,3807183000,2496964000,1511808000,-16947000,,993004000,993004000,58528,MNST
2017-12-31,,,1201623000,,820678000,903503000,2137690000,1234187000,1234187000,,-80000,,,,380945000,3369045000,2134858000,1231355000,-32564000,,820678000,820678000,58528,MNST
2016-12-31,,,1079685000,,712685000,776862000,1942000000,1165138000,1165138000,,-70000,,,,367000000,3049393000,1884255000,1107393000,-85453000,,712685000,712685000,58528,MNST
2019-12-31,,,60691000,16302000,42018000,5637000,35873000,25799000,25799000,-987000,-324000,,,,10290000,71972000,46173000,36099000,34892000,,50401000,41032000,58529,CMCL
2018-12-31,,,21201000,8345000,10766000,6465000,26069000,20815000,20815000,-6022000,-253000,,,,7445000,64973000,44158000,38904000,386000,,13756000,10486000,58529,CMCL
2017-12-31,,,20587000,5944000,9384000,5911000,30494000,20973000,20973000,-2555000,-44000,,,,8691000,66264000,45291000,35770000,-398000,,11896000,9174000,58529,CMCL
2016-12-31,,,18802000,3708000,8526000,7263000,27391000,16256000,16256000,-815000,-167000,,,,7717000,59069000,42813000,31678000,2546000,,11085000,8288000,58529,CMCL
2020-12-31,,,9059000,,7454000,,28613000,0,9059000,19554000,,,,,1605000,28613000,19554000,0,0,,7454000,7454000,58534,AUBN
2019-12-31,,,12111000,,9741000,14852000.0,29791000,0,10275000,4664000,,,,,2370000,29791000,19516000,0,1836000,,9741000,9741000,58534,AUBN
2018-12-31,,,11021000,,8834000,13020000.0,28895000,0,11331000,4544000,,,,,2187000,28895000,17564000,0,-710000,,8834000,8834000,58534,AUBN
2017-12-31,,,11483000,,7846000,12448000.0,28267000,0,11829000,3990000,,,,,3637000,28267000,16438000,0,-346000,,7846000,7846000,58534,AUBN
2019-12-31,,,5094000000,12753000000,3588000000,854000000,11352000000,7351000000,7351000000,,-2572000000,,,,195000000,54213000000,46862000000,42861000000,-2257000000,,4899000000,3588000000,58536,ET
2018-12-31,,,3634000000,10785000000,1691000000,702000000,9340000000,5779000000,5779000000,,-2008000000,,,,4000000,54087000000,48308000000,44747000000,-2145000000,-265000000.0,3630000000,1658000000,58536,ET
2017-12-31,,,710000000,31194000000,952000000,599000000,6913000000,3760000000,3760000000,,-1959000000,,,,-1833000000,40523000000,36763000000,33610000000,-3050000000,-177000000.0,2543000000,914000000,58536,ET
2016-12-31,,,204000000,24170000000,992000000,791000000,5898000000,2891000000,2891000000,,-1816000000,,,,-258000000,31792000000,28901000000,25894000000,-2687000000,-462000000.0,462000000,983000000,58536,ET
2019-12-31,88792000,,-175809000,278555000,-182292000,621586000,939449000,234376000,234376000,-6862000,-345955000,,,,5437000,3788967000,3554591000,2849518000,-410185000,,-181246000,-182292000,58537,VNET
2018-12-31,92109000,,-162325000,268977000,-205065000,634813000,944871000,223574000,223574000,-5027000,-236066000,,,,24411000,3401037000,3177463000,2456166000,-385899000,,-186736000,-205065000,58537,VNET
2017-12-31,149143000,,-1007814000,151471000,-772730000,776632000,758410000,-199353000,-199353000,-5439000,-185313000,,,,-90170000,3392705000,3592058000,2634295000,-808461000,,-917644000,-914626000,58537,VNET
2016-12-31,149337000,,-943082000,725802000,-633598000,992574000,712136000,-540556000,-540556000,-6783000,-198589000,,,,-11160000,3641774000,4182330000,2929638000,-402526000,,-931922000,-844082000,58537,VNET
2019-12-31,54656000,,-103596000,,-103596000,30032000,-24357000,-109045000,-109045000,,-503000,,,,0,26439000,135484000,50796000,5449000,,-103596000,-103596000,58539,DM
2018-12-31,59607000,,-121339000,,-121339000,23372000,-4434000,-87413000,-87413000,,-261000,,,,0,1034000,88447000,5468000,-33926000,,-121339000,-121339000,58539,DM
2019-12-31,,,16879000,,14820000,,16879000,16879000,16879000,,,,,,2059000,1201165000,1184286000,1184286000,0,,14820000,14820000,58541,UFCS
2018-12-31,,,-9150000,,27650000,,-9150000,-9150000,-9150000,,,,,,-11405000,1070166000,1079316000,1079316000,0,25395000.0,2255000,27650000,58541,UFCS
2017-12-31,,,15650000,,51023000,,15650000,15650000,15650000,,,,,,-29220000,1052737000,1037087000,1037087000,0,6153000.0,44870000,51023000,58541,UFCS
2016-12-31,,,57497000,,49904000,,57497000,57497000,57497000,19881000.0,,,,,8379000,996362000,938865000,938865000,0,786000.0,49118000,49904000,58541,UFCS
2020-03-28,347647000,,181266000,,159498000,131115000,674167000,195405000,195405000,,-1057000,,,,21768000,1281124000,1085719000,606957000,-14139000,,159498000,159498000,58542,CRUS
2019-03-30,375139000,,93744000,,89991000,126502000,597497000,95856000,95856000,,-1057000,,,,3753000,1185524000,1089668000,588027000,-2112000,,89991000,89991000,58542,CRUS
2018-03-31,366444000,,265099000,,161995000,131811000,760716000,262461000,262461000,,-1153000,,,,103104000,1532186000,1269725000,771470000,2638000,,161995000,161995000,58542,CRUS
2017-03-25,303658000,,315047000,,261209000,127265000,757815000,326892000,326892000,,-3600000,,,,53838000,1538940000,1212048000,781125000,-11845000,,261209000,261209000,58542,CRUS
2019-12-31,6885000,,8949000,,4155000,83174000,99523000,9464000,9464000,,,,,,4794000,111412000,101948000,11889000,-515000,,4155000,4155000,58546,TZOO
2018-12-31,8993000,,8286000,,4661000,81823000,99054000,8238000,8238000,,,,,,3625000,111322000,103084000,12268000,48000,,4661000,4661000,58546,TZOO
2017-12-31,9224000,,4718000,,3530000,79846000,93615000,4545000,4545000,,,,,,3126000,106524000,101979000,12909000,173000,1938000.0,1592000,3530000,58546,TZOO
2016-12-31,9096000,,9999000,,6631000,81126000,100408000,10186000,10186000,,,,,,3992000,114263000,104077000,13855000,-187000,624000.0,6007000,6631000,58546,TZOO
2019-12-31,6032243,,-15341689,,-15341689,6499331,-1923617,-14455191,-14455191,,-891553,,,,0,987850,15443041,2911467,-886498,,-15341689,-15341689,58548,FUV
2018-12-31,3814844,,-11051015,,-11051015,7174393,-32535,-11021772,-11021772,,-100946,,,,0,94996,11116768,127531,-29243,,-11051015,-11051015,58548,FUV
2017-12-31,1451394,,-3315327,,-3315327,1891576,48577,-3294393,-3294393,,-34143,,,,0,127016,3421409,78439,-20934,,-3315327,-3315327,58548,FUV
2016-12-31,974806,,-1919479,,-1919479,932098,-974806,-1906904,-1906904,,-12816,,,,0,0,1906904,974806,-12575,,-1919479,-1919479,58548,FUV
2019-12-31,,,-140000000,4000000,-188000000,1897000000,2442000000,376000000,376000000,,-249000000,,,,-22000000,5598000000,5222000000,3156000000,-516000000,-67000000,-118000000,-188000000,58549,RLGY
2018-12-31,,,213000000,4000000,137000000,1872000000,2500000000,464000000,464000000,,-187000000,,,,67000000,5782000000,5318000000,3282000000,-251000000,-6000000,146000000,137000000,58549,RLGY
2017-12-31,,,362000000,4000000,431000000,1905000000,2580000000,509000000,509000000,,-157000000,,,,-66000000,5810000000,5301000000,3230000000,-147000000,6000000,428000000,431000000,58549,RLGY
2016-12-31,,,361000000,5000000,213000000,2104000000,2865000000,559000000,559000000,,-174000000,,,,144000000,5810000000,5251000000,2945000000,-198000000,6000000,217000000,213000000,58549,RLGY
2019-12-31,,,4599656000,172385000,3219798000,692772000,5962175000,4855306000,4855306000,-1155000,-376008000,,,,1372222000,8527101000,3671795000,2564926000,-254495000,,3227434000,3219798000,58550,OMAB
2018-12-31,,,3985582000,164749000,2851822000,735761000,5219837000,4132331000,4132331000,-205000,-325557000,,,,1121403000,7907054000,3774723000,2687217000,-146749000,,2864179000,2851822000,58550,OMAB
2017-12-31,,,2950515000,159448000,2127576000,722991000,4259935000,3237779000,3237779000,-40000,-352822000,,,,813073000,7129827000,3892048000,2869892000,-287264000,,2137442000,2127576000,58550,OMAB
2016-12-31,,,2623283000,132433000,1870187000,760332000,3798270000,2761304000,2761304000,-40000,-330694000,,,,746782000,5550269000,2788965000,1751999000,-138021000,,1876501000,1870187000,58550,OMAB
2019-12-31,,,4357000000,1231000000,3274000000,13420000000,19730000000,0,6310000000,,,,,,1003000000,19730000000,13420000000,0,-1953000000,,3354000000,2461000000,58551,BCS
2018-12-31,,,3494000000,1223000000,2349000000,13894000000,19768000000,0,5874000000,,,,,,911000000,19768000000,13894000000,0,-2380000000,,2583000000,1597000000,58551,BCS
2017-12-31,,,3541000000,2111000000,-1109000000,14089000000,18927000000,0,4838000000,700000000.0,,,,,2066000000,18927000000,14089000000,0,-1297000000,-2335000000.0,1475000000,-1748000000,58551,BCS
2016-12-31,,,3230000000,6492000000,2080000000,14876000000,19818000000,0,4942000000,1000000000.0,,,,,993000000,19818000000,14876000000,0,-1712000000,189000000.0,2237000000,1751000000,58551,BCS
2020-02-29,,,-105380000,44202000,-109493000,173737000,188116000,14379000,14379000,,,,,,4189000,389049000,374670000,200933000,-119759000,,-109569000,-109493000,58552,FEDU
2019-02-28,,,8646000,44242000,-601000,160094000,163821000,3727000,3727000,,,,,,10116000,335643000,331916000,171822000,4919000,,-1470000,-601000,58552,FEDU
2018-02-28,,,68268000,6413000,44373000,129497000,191089000,61592000,61592000,,,,,,26424000,300533000,238941000,109444000,6676000,,41844000,36605000,58552,FEDU
2017-02-28,,,37143000,5782000,17666000,54634000,117839000,63205000,63205000,,,,,,19804000,203188000,139983000,85349000,-26062000,,17339000,13608000,58552,FEDU
2020-07-03,2261000000,,-46000000,,-250000000,1152000000,3781000000,368000000,368000000,,-413000000,,,,204000000,16736000000,16368000000,12955000000,-414000000,,-250000000,-250000000,58553,WDC
2019-06-28,2182000000,,-287000000,,-754000000,1348000000,3752000000,222000000,222000000,,-469000000,,,,467000000,16569000000,16347000000,12817000000,-509000000,,-754000000,-754000000,58553,WDC
2018-06-29,2400000000,,2085000000,,675000000,1475000000,7705000000,3830000000,3830000000,,-676000000,,,,1410000000,20647000000,16817000000,12942000000,-1745000000,,675000000,675000000,58553,WDC
2017-06-30,2441000000,,769000000,,397000000,1445000000,6072000000,2186000000,2186000000,,-847000000,,,,372000000,19093000000,16907000000,13021000000,-1417000000,,397000000,397000000,58553,WDC
2020-12-31,,,-1456420000,,-1523420000,630897000,1089667000,0,346018000,112752000,,,,,67000000,1089667000,743649000,0,-1802438000,,-1523420000,-1523420000,58554,UMPQ
2019-12-31,,,468903000,,354095000,646558000,1187943000,0,489617000,51768000,,,,,114808000,1187943000,698326000,0,-20714000,,354095000,354095000,58554,UMPQ
2018-12-31,,,422686000,,316263000,665575000,1162151000,0,445813000,50763000,,,,,106423000,1162151000,716338000,0,-28727000,,316263000,316263000,58554,UMPQ
2017-12-31,,,349043000,,242313000,661877000,1096918000,0,379580000,55461000,,,,,106730000,1096918000,717338000,0,-30537000,,242313000,242313000,58554,UMPQ
2019-12-31,,,-55582000,,-54812000,236597000,208065000,-28532000,-28532000,,,,,,-770000,417795000,446327000,209730000,-27050000,,-54812000,-54812000,58555,ZVO
2018-12-31,,,-2946000,,4636000,221731000,225673000,3942000,3942000,,,,,,-7582000,443373000,439431000,217700000,-6888000,,4636000,4636000,58555,ZVO
2017-12-31,,,7937000,,9111000,222770000,239723000,16953000,16953000,,,,,,-1174000,475113000,458160000,235390000,-9016000,,9111000,9111000,58555,ZVO
2016-12-31,,,-40926000,,-33051000,251049000,260181000,9132000,9132000,,,,,,-7875000,523518000,514386000,263337000,-50058000,,-33051000,-33051000,58555,ZVO
2019-12-31,5203000,,75339000,95401000,46866000,124193000,216372000,79591000,79591000,,-2793000,,,,16768000,395664000,316073000,179292000,-4252000,,58571000,46866000,58556,IMAX
2018-12-31,13728000,,43113000,87196000,22844000,117976000,208529000,69550000,69550000,,-2916000,,,,9518000,374401000,304851000,165872000,-26437000,,33595000,22844000,58556,IMAX
2017-12-31,20855000,,29308000,75864000,2344000,110400000,185246000,48325000,48325000,,-1942000,,,,16790000,380767000,332442000,195521000,-19017000,,12518000,2344000,58556,IMAX
2016-12-31,16315000,,55532000,64542000,28788000,124745000,202003000,59185000,59185000,-1275000.0,-1805000,,,,16212000,376059000,316874000,174056000,-3653000,,39320000,28788000,58556,IMAX
2020-08-31,,,338767,,338767,873230,3068853,2195623,2195623,,,,,,0,3068853,873230,0,-1856856,,338767,338767,58557,PCF
2019-08-31,,,1306612,,1306612,988877,2346353,1357476,1357476,,,,,,0,2346353,988877,0,-50864,,1306612,1306612,58557,PCF
2018-08-31,,,6096122,,6096122,1803348,4680332,2876984,2876984,,,,,,0,4680332,1803348,0,3219138,,6096122,6096122,58557,PCF
2017-08-31,,,12331473,,12331473,1462337,5407745,3945408,3945408,,,,,,0,5407745,1462337,0,8386065,,12331473,12331473,58557,PCF
2020-12-31,,,41359000,,40324000,4206000,57220000,49208000,49208000,,-8513000,,,,212000,83345000,34137000,26125000,-7849000,,41147000,40324000,58558,GPP
2019-12-31,,,41699000,-1449000.0,40649000,4055000,56729000,49233000,49233000,,-8310000,,,,220000,82387000,33154000,25658000,-7534000,,41479000,40649000,58558,GPP
2018-12-31,,,55782000,-1171000.0,54567000,5258000,69882000,62903000,62903000,-2721000.0,-7307000,,,,101000,100748000,37845000,30866000,-7121000,,55681000,54567000,58558,GPP
2017-12-31,,,58976000,-712000.0,57690000,4223000,73492000,64158000,64158000,-2721000.0,-5402000,,,,109000,106993000,42835000,33501000,-5182000,,58867000,57690000,58558,GPP
2019-12-31,,,53566000,,35504000,534227000,945019000,204522000,204522000,,-92951000,,,,18062000,1421374000,1216852000,476355000,-150956000,,35504000,35504000,58559,THRY
2018-12-31,,,60758000,,52271000,621001000,1137113000,249137000,249137000,,-82697000,,,,8487000,1784401000,1535264000,647288000,-188379000,,52271000,52271000,58559,THRY
2017-12-31,,,-238865000,,-171324000,569594000,764873000,-106156000,-106156000,,-67815000,,,,-67541000,1318166000,1424322000,553293000,-132709000,,-171324000,-171324000,58559,THRY
2016-12-31,,,828856000,,674080000,376084000,541634000,-113851000,-113851000,,-162337000,,,,154776000,942969000,1056820000,401335000,942707000,,674080000,-622515000,58559,THRY
2020-09-30,,,206700000,,169600000,607800000,805800000,0,136200000,29100000,,,,,37100000,54035600000,53899400000,53229800000,70500000,,169600000,165600000,58560,SNEX
2019-09-30,,,111000000,,85100000,458800000,591600000,0,95500000,23200000,,,,,25900000,32742300000,32646800000,32150700000,15500000,,85100000,83600000,58560,SNEX
2018-09-30,,,101500000,,55500000,392400000,527700000,0,100500000,20100000,,,,,46000000,27542000000,27441500000,27014300000,1000000,,55500000,54600000,58560,SNEX
2017-09-30,,,15200000,,6400000,337700000,439900000,0,15300000,25800000,,,,,8800000,29381500000,29366200000,28941600000,-100000,,6400000,6300000,58560,SNEX
2019-12-31,37378000,,35101000,1679000,26247000,54274000,129521000,37869000,37869000,,-3030000,,,,8610000,325674000,287805000,196153000,-2768000,,26491000,26247000,58563,SPNS
2018-12-31,34414000,,19031000,1440000,13785000,52133000,109569000,23022000,23022000,,-3225000,,,,5031000,289707000,266685000,180138000,-3991000,,14000000,13785000,58563,SPNS
2017-12-31,31955000,,-2008000,2184000,352000,59211000,93516000,2350000,2350000,,-1688000,,,,-2564000,269194000,266844000,175678000,-4358000,,556000,352000,58563,SPNS
2016-12-31,16488000,,25373000,1704000,19336000,44460000,85788000,24840000,24840000,,-270000,,,,5772000,216190000,191350000,130402000,533000,,19601000,19336000,58563,SPNS
2019-12-31,,,-80803710,,-64528568,-4657825,1789651,6447476,6447476,,,,,,-16275142,1789651,-4657825,0,-87251186,,-64528568,-64528568,58564,SVVC
2018-12-31,,,28305087,,19872529,12844659,3467838,-9376821,-9376821,,,,,,8432558,3467838,12844659,0,37681908,,19872529,19872529,58564,SVVC
2017-12-31,,,26179569,,26179569,6084132,1565791,-4518341,-4518341,,,,,,0,1565791,6084132,0,30697910,,26179569,26179569,58564,SVVC
2016-12-31,,,-24661554,,-24661554,4713526,878023,-3835503,-3835503,,,,,,0,878023,4713526,0,-20826051,,-24661554,-24661554,58564,SVVC
2019-12-31,,,76129795,,76129795,4163303,15527473,11364170,11364170,,-7265749,,,,0,15527473,4163303,0,61174550,,76129795,76129795,58570,JRS
2018-12-31,,,-29877608,,-29877608,3928938,16806258,12877320,12877320,,-2535561,,,,0,16806258,3928938,0,-41834291,,-29877608,-29877608,58570,JRS
2017-12-31,,,27679327,,27679327,4428149,18757990,14329841,14329841,,-1782981,,,,0,18757990,4428149,0,13349486,,27679327,27679327,58570,JRS
2016-12-31,,,19103179,,19103179,4470005,17499852,13029847,13029847,,-1947904,,,,0,17499852,4470005,0,6073332,,19103179,19103179,58570,JRS
2019-12-28,,,9400000,,2900000,1113000000,1227800000,114800000,114800000,,-78200000,,,,9500000,2394500000,2279700000,1166700000,-105400000,3000000,-100000,2900000,58571,PRMW
2018-12-29,,,24100000,,382900000,1091700000,1175600000,83900000,83900000,,-77600000,,,,-4800000,2372900000,2289000000,1197300000,-59800000,354000000,28900000,382900000,58571,PRMW
2017-12-30,,,-33600000,6100000.0,-1400000,1043300000,1127700000,84400000,84400000,,-85500000,,,,-30000000,2269700000,2185300000,1142000000,-118000000,2200000,-3600000,-1400000,58571,PRMW
2016-12-31,,,-39100000,5300000.0,-77800000,806300000,850100000,43800000,43800000,,-43000000,,,,21200000,1623200000,1579400000,773100000,-82900000,-17500000,-60300000,-77800000,58571,PRMW
2019-12-31,,,-1274000000,1256599000,-369670000,10301000,79940000,14928000,14928000,13231000,-1792000,,,,64900000,135798000,120870000,55858000,-1288928000,,-1338900000,-369670000,58573,ALTM
2018-12-31,,,-10740000,1940500000,-4388000,7368000,22828000,-12241000,-12241000,7633000,-107000,,,,-10501000,76750000,88991000,53922000,1501000,,-239000,-4388000,58573,ALTM
2017-12-31,,,-11534000,1940500000,-18575000,3991000,-1455000,-11534000,-11534000,97000,-107000,,,,7041000,15142000,26676000,16597000,0,,-18575000,-18575000,58573,ALTM
2019-12-31,,,3825000,,2550000,37180000,79922000,9202000,9202000,31038000,-3057000,,,,1275000,338286000,329084000,258364000,-5377000,,2550000,2550000,58574,HWCC
2018-12-31,,,10991000,,8636000,38110000,85208000,13958000,13958000,30962000,-2907000,,,,2355000,356858000,342900000,271650000,-2967000,,8636000,8636000,58574,HWCC
2017-12-31,,,2531000,,-222000,36570000,72662000,4604000,4604000,28716000,-2073000,,,,2753000,317697000,313093000,245035000,-2073000,,-222000,-222000,58574,HWCC
2016-12-31,,,-7380000,,-6006000,31969000,52950000,-4151000,-4151000,22114000,-845000,,,,-1374000,261644000,265795000,208694000,-3229000,,-6006000,-6006000,58574,HWCC
2020-12-31,,,2793000000,,2016000000,,7352000000,3323000000,3323000000,4029000000,-515000000,,,,747000000,17224000000,13901000000,9872000000,-530000000,,2046000000,2016000000,58576,MMC
2019-12-31,,,2439000000,150000000.0,1742000000,,7337000000,3402000000,3402000000,3935000000,-524000000,,,,666000000,16652000000,13250000000,9315000000,-963000000,,1773000000,1742000000,58576,MMC
2018-12-31,,,2244000000,73000000.0,1650000000,,6560000000,2976000000,2976000000,3584000000,-290000000,,,,574000000,14950000000,11974000000,8390000000,-732000000,,1670000000,1650000000,58576,MMC
2017-12-31,,,2643000000,83000000.0,1492000000,,6140000000,2856000000,2856000000,3284000000,-237000000,,,,1133000000,14024000000,11168000000,7884000000,-213000000,2000000.0,1510000000,1492000000,58576,MMC
2019-12-28,21000000,,105807000,,83762000,175397000,345525000,132428000,132428000,16700000,,,,,22045000,991329000,858901000,645804000,-26621000,,83762000,83762000,58577,DORM
2018-12-29,20100000,,171135000,,133602000,167538000,375281000,173143000,173143000,14500000,,,,,37533000,973705000,800562000,598424000,-2008000,,133602000,133602000,58577,DORM
2017-12-30,20000000,,176588000,,106599000,151009000,358649000,176240000,176240000,11400000,,,,,69989000,903221000,726981000,544572000,348000,,106599000,106599000,58577,DORM
2016-12-31,18900000,,168360000,,106049000,141673000,338074000,168601000,168601000,8900000,-241000.0,,,,62311000,859604000,691003000,521530000,-482000,,106049000,106049000,58577,DORM
2020-12-31,,,374359000,,299377000,87424000,498148000,374728000,374728000,,-1142000,,,,74982000,689125000,314397000,190977000,-369000,,299377000,299377000,58578,MKTX
2019-12-31,,,257424000,,204902000,76464000,353481000,250160000,250160000,,-1142000,,,,52522000,511352000,261192000,157871000,7264000,,204902000,204902000,58578,MKTX
2018-12-31,,,218086000,,172852000,66918000,302582000,212584000,212584000,,-1142000,,,,45234000,435565000,222981000,132983000,5502000,,172852000,172852000,58578,MKTX
2017-12-31,,,201768000,,148089000,52172000,271061000,199615000,199615000,,-1142000,,,,53679000,393422000,193807000,122361000,2153000,,148089000,148089000,58578,MKTX
2020-12-31,82494000,,-26217000,,-29271000,119611000,196091000,-9033000,-9033000,,-11509000,,,,3054000,378831000,387864000,182740000,-17184000,,-29271000,-29271000,58579,HLIT
2019-12-31,84614000,,-6596000,,-5924000,119035000,224403000,17615000,17615000,,-11591000,,,,-672000,402874000,385259000,178471000,-24211000,,-5924000,-5924000,58579,HLIT
2018-12-31,89163000,,-16948000,,-21035000,118952000,210066000,-1236000,-1236000,,-11190000,,,,4087000,403558000,404794000,193492000,-15712000,,-21035000,-21035000,58579,HLIT
2017-12-31,95978000,,-84707000,,-82955000,130270000,171099000,-58291000,-58291000,,-10619000,,,,-1752000,358246000,416537000,187147000,-26416000,,-82955000,-82955000,58579,HLIT
2019-12-31,,,1171000,54000,999000,113822000,97597000,-16052000,-16052000,-173000,-66000,,,,113000,243626000,259678000,146029000,17223000,,1058000,999000,58581,LITB
2018-12-31,,,-59569000,-5000,-59601000,98677000,61196000,-37481000,-37481000,-173000,-5000,,,,33000,227539000,265020000,166343000,-22088000,,-59602000,-59601000,58581,LITB
2017-12-31,,,-9467000,-5000,-9548000,115787000,105620000,-10167000,-10167000,-173000,-5000,,,,81000,319881000,330048000,214261000,700000,,-9548000,-9548000,58581,LITB
2016-12-31,,,-8669000,-5000,-8723000,112634000,103550000,-9084000,-9084000,-173000,-5000,,,,54000,292487000,301571000,188937000,415000,,-8723000,-8723000,58581,LITB
2020-12-31,,,2219100000,20700000,1556100000,1729300000,4952800000,2948100000,2948100000,,-207400000,,,,662100000,13978500000,11030400000,9025700000,-729000000,,1557000000,1556100000,58585,LH
2019-12-31,,,1104900000,20100000,823800000,1544100000,3252500000,1465200000,1465200000,,-240700000,,,,280000000,11554800000,10089600000,8302300000,-360300000,,824900000,823800000,58585,LH
2018-12-31,,,1268300000,19100000,883700000,1485400000,3176400000,1461600000,1461600000,,-244200000,,,,384400000,11333400000,9871800000,8157000000,-193300000,,883900000,883700000,58585,LH
2017-12-31,,,1077500000,20800000,1227100000,1499200000,3091800000,1376100000,1376100000,6100000.0,-235100000,,,,-155400000,10308000000,8931900000,7216200000,-298600000,,1232900000,1227100000,58585,LH
2020-12-31,175307000,,378949000,,1775888000,1200757000,1763235000,387171000,387171000,,,,,,-1396939000,2471941000,2084770000,708706000,-8222000,,1775888000,1775888000,58586,ALGN
2019-12-31,157361000,,555123000,,442776000,1072053000,1743897000,514483000,514483000,,,,,,112347000,2406796000,1892313000,662899000,40640000,,442776000,442776000,58586,ALGN
2018-12-31,128899000,,457958000,,400235000,852404000,1447867000,466564000,466564000,,,,,,57723000,1966492000,1499928000,518625000,-8606000,,400235000,400235000,58586,ALGN
2017-12-31,97559000,,361580000,,231418000,665777000,1116947000,353611000,353611000,,,,,,130162000,1473413000,1119802000,356466000,7969000,,231418000,231418000,58586,ALGN
2019-12-31,,,-1286000,-618000,-1320000,2305000,159000,-2706000,-2706000,,-1092000,,,,0,967000,3673000,808000,1420000,,-1286000,-1320000,58588,CUEN
2018-12-31,,,-3585000,-652000,-3562000,3769000,473000,-982000,-982000,,-978000,,,,0,74650000,75632000,74177000,-2603000,,-3585000,-3562000,58588,CUEN
2017-12-31,,,-1484000,-630000,-708000,3956000,2394000,-1065000,-1065000,,-1054000,,,,-1087000,53793000,54858000,51399000,-419000,-328000.0,-397000,-708000,58588,CUEN
2016-12-31,,,-8412069,-3156736,-9442476,5172969,-30794,-5203763,-5203763,,-1554618,,,,0,1027984,6231747,1058778,-3208306,-1629316.0,-8412069,-9442476,58588,CUEN
2020-12-31,906000000,,2338000000,927000000,1789000000,2060000000,4894000000,1912000000,1912000000,16000000,-100000000,,,,527000000,19811000000,17899000000,14917000000,426000000,,1811000000,1789000000,58590,CMI
2019-12-31,1001000000,,2834000000,958000000,2260000000,2383000000,5980000000,2584000000,2584000000,12000000,-109000000,,,,566000000,23571000000,20987000000,17591000000,250000000,,2268000000,2260000000,58590,CMI
2018-12-31,902000000,,2753000000,911000000,2141000000,2437000000,5737000000,2392000000,2392000000,6000000,-114000000,,,,566000000,23771000000,21379000000,18034000000,361000000,,2187000000,2141000000,58590,CMI
2017-12-31,754000000,,2365000000,905000000,999000000,2429000000,5100000000,1977000000,1977000000,-60000000,-81000000,,,,1371000000,20428000000,18451000000,15328000000,388000000,,994000000,999000000,58590,CMI
2020-12-31,,,-35222000,,-35655000,33036000,113290000,55498000,55498000,23735000,-9668000,,,,433000,253699000,198201000,140409000,-90720000,,-35655000,-35655000,58591,WETF
2019-12-31,,,121000,,-10425000,42382000,119172000,54436000,54436000,21309000,-11240000,,,,10546000,268403000,213967000,149231000,-54315000,,-10425000,-12588000,58591,WETF
2018-12-31,,,51039000,,36633000,45224000,136304000,72733000,72733000,17046000,-7962000,,,,14406000,274116000,201383000,137812000,-21694000,,36633000,33629000,58591,WETF
2017-12-31,,,58192000,,27199000,38882000,101265000,53920000,53920000,7068000,-7962000,,,,30993000,228295000,174375000,127030000,4272000,,27199000,26503000,58591,WETF
2019-12-31,,,-8222000,,-7977000,96920000,-40329000,0,-172851000,35602000,,,,,-245000,-40329000,132522000,0,163200000,,-7977000,-7977000,58592,IMH
2018-12-31,,,-140406000,,-145410000,126418000,-77151000,0,-202361000,-1208000,,,,,5004000,-77151000,125210000,0,61955000,,-145410000,-145410000,58592,IMH
2017-12-31,,,-11383000,,-31521000,167347000,-49285000,0,-248323000,31691000,,,,,20138000,-49285000,199038000,0,236940000,,-31521000,-31521000,58592,IMH
2016-12-31,,,47763000,,46670000,200901000,72022000,0,-153590000,24711000,,,,,1093000,72022000,225612000,0,201353000,,46670000,46670000,58592,IMH
2020-06-30,,,1464000000,322000000,999000000,1741000000,4496000000,2497000000,2497000000,,-369000000,,,,402000000,12303000000,9806000000,7807000000,-1033000000,,1062000000,999000000,58594,FOXA
2019-06-30,,,2224000000,200000000,1595000000,1419000000,4062000000,2431000000,2431000000,,-203000000,,,,581000000,11389000000,8958000000,7327000000,-207000000,,1643000000,1595000000,58594,FOXA
2018-06-30,,,2170000000,275000000,2187000000,1262000000,3648000000,2215000000,2215000000,,-43000000,,,,-58000000,10153000000,7938000000,6505000000,-45000000,,2228000000,2187000000,58594,FOXA
2017-06-30,,,2241000000,154000000,1372000000,1117000000,3821000000,2535000000,2535000000,,-23000000,,,,832000000,9921000000,7386000000,6100000000,-294000000,,1409000000,1372000000,58594,FOXA
2020-03-31,,,-14826821,,-14826821,30206391,16839569,-14378063,-14378063,,-448758,,,,0,41142443,55520506,24302874,-448758,,-14826821,-14826821,58595,WTER
2019-03-31,,,-8617565,,-8617565,20429462,12946760,-8063371,-8063371,,-554482,,,,0,32199528,40262899,19252768,-554194,,-8617565,-8617565,58595,WTER
2018-03-31,,,-6687280,,-6687280,13636468,8125182,-5930063,-5930063,,-760336,,,,0,19812199,25742262,11687017,-757217,,-6687280,-6687280,58595,WTER
2017-03-31,,,-3454600,,-3454600,7592673,5413236,-2538993,-2538993,,-923446,,,,0,12763630,15302623,7350394,-915607,,-3454600,-3454600,58595,WTER
2019-12-31,42157641,,-60461243,,-60461243,19251826,0,-61409467,-61409467,,,,,,0,0,61409467,0,948224,,-60461243,-60461243,58596,OVID
2018-12-31,33790031,,-51979610,,-51979610,19141652,0,-52931683,-52931683,,,,,,0,0,52931683,0,952073,,-51979610,-51979610,58596,OVID
2017-12-31,49972102,,-64806054,,-64806054,15035461,0,-65007563,-65007563,,,,,,0,0,65007563,0,201509,,-64806054,-64806054,58596,OVID
2016-12-31,9585649,,-22414352,,-22414352,12949525,0,-22535174,-22535174,,,,,,0,0,22535174,0,120822,,-22414352,-22414352,58596,OVID
2020-12-31,,,252382000,,201209000,234909000,558516000,0,289461000,34146000,,,,,51173000,558516000,269055000,0,-37079000,,201209000,201209000,58597,IBTX
2019-12-31,,,246264000,,192736000,218207000,568128000,0,310714000,39207000,,,,,53528000,568128000,257414000,0,-64450000,,192736000,192736000,58597,IBTX
2018-12-31,,,159997000,,128259000,157053000,358616000,0,175602000,25961000,,,,,31738000,358616000,183014000,0,-15605000,,128259000,128259000,58597,IBTX
2017-12-31,,,121687000,,76512000,135293000,298500000,0,145251000,17956000,,,,,45175000,298500000,153249000,0,-23564000,,76512000,76512000,58597,IBTX
2020-06-30,1114486,,-1858095,,-1863253,2058967,1268400,-1905053,-1905053,,,,,,5158,1414780,3319833,146380,46958,,-1863253,-1863253,58598,DTSS
2019-06-30,168248,,-1425181,,-1425181,1331060,0,-1499308,-1499308,,,,,,0,0,1499308,0,74127,,-1425181,-1425181,58598,DTSS
2018-06-30,361616,,-1604141,,-1604141,1305563,5752,-1661427,-1661427,,-274.0,,,,0,10571,1671998,4819,57286,,-1604141,-1604141,58598,DTSS
2017-06-30,203600,,-1193216,,-1193216,1105367,55377,-1253590,-1253590,,-274.0,,,,0,140774,1394364,85397,60374,,-1193216,-1193216,58598,DTSS
2019-12-31,,,-8095000,,-8915000,17084000,4014000,-13070000,-13070000,,-162000,,,,820000,29206000,42276000,25192000,4975000,,-8915000,-8915000,58600,AXU
2018-12-31,,,-6994000,,-8501000,12078000,3449000,-8629000,-8629000,,-162000,,,,1507000,19880000,28509000,16431000,1635000,,-8501000,-8501000,58600,AXU
2017-12-31,,,-6341000,,-7813000,9589000,2112000,-7477000,-7477000,,-162000,,,,1472000,10732000,18209000,8620000,1136000,,-7813000,-7813000,58600,AXU
2016-12-31,,,-3967000,,-4359000,7514000,912000,-6666000,-6666000,64000.0,-162000,,,,392000,11361000,18027000,10449000,2699000,,-4359000,-4359000,58600,AXU
2020-06-30,,,13510000000,4310000000,7956000000,10972001000,34118001000,15149000000,15149000000,1368000000,-881000000,,,,4774000000,42931000000,27782000000,8812999000,-1639000000,,8736000000,7956000000,58602,BHP
2019-06-30,,,15049000000,4584000000,8306000000,11421725000,35455725000,16079000000,16079000000,1603000000,-1095000000,,,,5529000000,44288000000,28209000000,8832275000,-1030000000,-335000000.0,9520000000,8306000000,58602,BHP
2018-06-30,,,14751000000,5078000000,3705000000,11367687000,35216687000,15777000000,15777000000,1143000000,-1088000000,,,,7007000000,43129000000,27352000000,7912313000,-1026000000,-2921000000.0,7744000000,3705000000,58602,BHP
2017-06-30,,,11137000000,5468000000,5890000000,9803000000,29709000000,12428000000,12428000000,896000000,-1050000000,,,,4443000000,35947000000,23519000000,6238000000,-1291000000,-472000000.0,6694000000,5890000000,58602,BHP
2019-12-31,5351000,,-66402000,,30001000,42093000,43314000,-15895000,-15895000,,-12639000,,,,-24111000,73150000,89045000,29836000,-50507000,72292000,-42291000,30001000,58603,ASUR
2018-12-31,5998000,,-19355000,,-7548000,35418000,39504000,-9393000,-9393000,,-9104000,,,,-7982000,63626000,73019000,24122000,-9962000,3825000,-11373000,-7548000,58603,ASUR
2017-12-31,4459000,,-5626000,,-5722000,30775000,41823000,2112000,2112000,,-4626000,,,,96000,54442000,52330000,12619000,-7738000,3825000,-5722000,-5722000,58603,ASUR
2016-12-31,2897000,,-783000,,-972000,20515000,27425000,1760000,1760000,,-2010000,,,,189000,35542000,33782000,8117000,-2543000,3825000,-972000,-972000,58603,ASUR
2020-03-31,,,12465509,,12465509,679618,8153356,7473738,7473738,,,,,,0,8153356,679618,0,4991771,,12465509,12465509,58604,NXR
2019-03-31,,,12823354,,12823354,638916,7917355,7278439,7278439,,,,,,0,7917355,638916,0,5544915,,12823354,12823354,58604,NXR
2018-03-31,,,8299258,,8299258,664754,7886623,7221869,7221869,,,,,,0,7886623,664754,0,1077389,,8299258,8299258,58604,NXR
2017-03-31,,,855253,,855253,684979,8085322,7400343,7400343,,211934.0,,,,0,8085322,684979,0,-6545090,,855253,855253,58604,NXR
2020-12-31,1829600000,,3199349000,,2761395000,3304848000,9719737000,4585289000,4585289000,,-767499000,,,,437954000,24996056000,20410767000,15276319000,-1385940000,,2761395000,2761395000,58605,NFLX
2019-12-31,1545149000,,2062231000,,1866916000,3566831000,7716234000,2604254000,2604254000,,-626023000,,,,195315000,20156447000,17552193000,12440213000,-542023000,,1866916000,1866916000,58605,NFLX
2018-12-31,1221814000,,1226458000,,1211242000,2999763000,5826803000,1605226000,1605226000,,-420493000,,,,15216000,15794341000,14189115000,9967538000,-378768000,,1211242000,1211242000,58605,NFLX
2017-12-31,953710000,,485321000,,558929000,1867324000,3659713000,838679000,838679000,,-238204000,,,,-73608000,11692713000,10854034000,8033000000,-353358000,,558929000,558929000,58605,NFLX
2020-09-30,34100000,,67700000,,-93300000,589900000,1113900000,433400000,433400000,,-195000000,,,,20900000,2744800000,2311400000,1630900000,-365700000,-140100000,46800000,-109500000,58610,ENR
2019-09-30,31700000,,73100000,,51100000,562100000,1062500000,425500000,425500000,,-226000000,,,,8400000,2494500000,2069000000,1432000000,-352400000,-13600000,64700000,39100000,58610,ENR
2018-09-30,22400000,,175200000,,93500000,479500000,831100000,317700000,317700000,,-98400000,,,,81700000,1797700000,1480000000,966600000,-142500000,-13600000,93500000,93500000,58610,ENR
2017-09-30,22000000,,273300000,,201500000,461700000,812400000,317500000,317500000,,-53100000,,,,71800000,1755700000,1438200000,943300000,-44200000,-13600000,201500000,201500000,58610,ENR
2019-12-31,,,315000000,,234000000,394000000,3536000000,729000000,729000000,398000000,-382000000,,,,81000000,7013000000,6284000000,3477000000,-414000000,,234000000,234000000,58611,OVV
2018-12-31,,,1163000000,,1069000000,90000000,2673000000,1694000000,1694000000,-383000000,-351000000,,,,94000000,5457000000,3763000000,2784000000,-531000000,,1069000000,1069000000,58611,OVV
2017-12-31,,,1430000000,,827000000,179000000,1641000000,1074000000,1074000000,-445000000,-363000000,,,,603000000,3892000000,2818000000,2251000000,356000000,,827000000,827000000,58611,OVV
2016-12-31,,,-1620000000,,-944000000,204000000,938000000,-451000000,-451000000,326000000,-397000000,,,,-676000000,3122000000,3573000000,2184000000,-1169000000,,-944000000,-944000000,58611,OVV
2019-12-31,4151000,,-22425000,,-22425000,24283000,9576000,-19162000,-19162000,,-3609000,,,,0,15446000,34608000,5870000,-3263000,,-22425000,-30208000,58617,TELA
2018-12-31,4339000,,-21092000,,-21092000,18545000,3727000,-19942000,-19942000,,-1802000,,,,0,8274000,28216000,4547000,-1150000,,-21092000,-29915000,58617,TELA
2017-12-31,5786000,,-21334000,,-21334000,13670000,2532000,-16924000,-16924000,,-4558000,,,,0,4245000,21169000,1713000,-4410000,,-21334000,-27227000,58617,TELA
2019-12-31,,,269519000,34293000,217882000,2806000,606160000,345868000,345868000,257486000,-92789000,,,,51637000,2874601000,2528733000,2268441000,-76349000,,217882000,217882000,58619,HE
2018-12-31,,,252571000,34293000,201774000,5962000,589857000,327394000,327394000,256501000,-90567000,,,,50797000,2860849000,2533455000,2270992000,-74823000,,201774000,201774000,58619,HE
2017-12-31,,,274690000,34293000,165297000,7942000,578428000,338291000,338291000,232195000,-80862000,,,,109393000,2555625000,2217334000,1977197000,-63601000,,165297000,165297000,58619,HE
2016-12-31,,,371951000,34293000,248256000,7663000,578521000,349175000,349175000,221683000,-77693000,,,,123695000,2380654000,2031479000,1802133000,22776000,,248256000,248256000,58619,HE
2019-12-31,,,-3716000,,-2817000,23174000,22938000,0,-2483000,2247000,,,,,-899000,22938000,25421000,0,-1233000,,-2817000,-2817000,58620,PNBK
2018-12-31,,,4086000,,3196000,19241000,28321000,0,7326000,1669000,,,,,890000,28321000,20995000,0,-3240000,,3196000,3196000,58620,PNBK
2017-12-31,,,7022000,,4147000,18173000,25394000,0,5706000,1437000,,,,,2875000,25394000,19688000,0,1316000,,4147000,4147000,58620,PNBK
2016-12-31,,,3137000,,1930000,16303000,21492000,0,3740000,1388000,,,,,1207000,21492000,17752000,0,-603000,,1930000,1930000,58620,PNBK
2020-09-30,,,500467,,500467,,0,0,,,,,,,0,0,0,0,500467,,500467,500467,58622,LATN
2019-09-30,,,-18210,,-18210,,0,0,,,,,,,0,0,0,0,-18210,,-18210,-18210,58622,LATN
2018-12-31,,,-56616,,-56616,56616.0,0,-56616,-56616.0,,,,,,0,0,56616,0,0,,-56616,-56616,58622,LATN
2019-12-28,,,-632746,,-638202,3137440,2540241,-597199,-597199,,-44000,,,,5456,21468414,22065613,18928173,-35547,,-638202,-638202,58623,CPSH
2018-12-29,,,-921548,,-3705967,3813415,2912852,-900563,-900563,,-44000,,,,2784419,21580904,22481467,18668052,-20985,,-3705967,-3705967,58623,CPSH
2017-12-30,,,-1939734,,-1717702,3209328,1658118,-1551210,-1551210,,-44000,,,,-222032,14577183,16128393,12919065,-388524,,-1717702,-1717702,58623,CPSH
2016-12-31,,,-1129761,,-453617,3336631,2155552,-1181079,-1181079,,-44000,,,,-676144,15351053,16532132,13195501,51318,,-453617,-453617,58623,CPSH
2020-01-03,25298000,,13026000,,14048000,74842000,111954000,11814000,11814000,,,,,,-1022000,150185000,138371000,38231000,1212000,,14048000,14048000,58624,STAA
2018-12-28,22028000,,6639000,,4968000,62919000,91510000,6563000,6563000,,,,,,1671000,123954000,117391000,32444000,76000,,4968000,4968000,58624,STAA
2017-12-29,20044000,,-2296000,,-2139000,47867000,64280000,-3631000,-3631000,,-112000.0,,,,-157000,90611000,94242000,26331000,1335000,,-2139000,-2139000,58624,STAA
2016-12-30,20668000,,-12444000,,-12129000,50255000,58369000,-12554000,-12554000,,-112000.0,,,,-315000,82432000,94986000,24063000,110000,,-12129000,-12129000,58624,STAA
2019-12-31,,,11259000,434725000,9099000,127597000,435509000,266420000,266420000,41492000,-92687000,,,,17079000,1558640000,1292220000,1123131000,-255161000,,-5820000,9099000,58625,CAAP
2018-12-31,,,3502000,454453000,7125000,123262000,469338000,302144000,302144000,43932000,-96301000,,,,14101000,1426145000,1124001000,956807000,-298642000,,-10599000,7125000,58625,CAAP
2017-12-31,,,113816000,335359000,63491000,135103000,560466000,369294000,369294000,56069000,-115223000,,,,46925000,1575153000,1205859000,1014687000,-255478000,,66891000,63491000,58625,CAAP
2016-12-31,,,95077000,354174000,33759000,114831000,519692000,348472000,348472000,56389000,-118219000,,,,56359000,1366336000,1017864000,846644000,-253395000,-9478000.0,38718000,33759000,58625,CAAP
2019-12-31,58245000,,-75438000,,-75438000,21478000,1982000,-77741000,-77741000,,,,,,0,1982000,79723000,0,2303000,,-75438000,-75438000,58627,SYRS
2018-12-31,50182000,,-62279000,,-62279000,16164000,2050000,-64296000,-64296000,,,,,,0,2050000,66346000,0,2017000,,-62279000,-62279000,58627,SYRS
2017-12-31,41896000,,-54010000,,-54010000,13891000,1101000,-54686000,-54686000,,,,,,0,1101000,55787000,0,676000,,-54010000,-54010000,58627,SYRS
2016-12-31,37817000,,-47743000,,-47743000,10463000,317000,-47963000,-47963000,,,,,,0,317000,48280000,0,220000,,-47743000,-51424000,58627,SYRS
2020-01-31,,,239720000,,168096000,993990000,1254437000,260447000,260447000,,,,,,71624000,3983789000,3723342000,2729352000,-20727000,,168096000,168096000,58628,URBN
2019-01-31,,,385553000,,298003000,965399000,1350256000,384857000,384857000,,,,,,87550000,3950623000,3565766000,2600367000,696000,,298003000,298003000,58628,URBN
2018-01-31,,,261366000,,108263000,915615000,1186917000,271302000,271302000,,,,,,153103000,3616014000,3344712000,2429097000,-9936000,,108263000,108263000,58628,URBN
2017-01-31,,,338099000,,218120000,906086000,1248954000,342868000,342868000,,,,,,119979000,3545794000,3202926000,2296840000,-4769000,,218120000,218120000,58628,URBN
2019-12-31,,,39991000,,36878000,36934000,197994000,58767000,58767000,,-21730000,,,,2858000,719067000,660300000,521073000,-18776000,,37133000,36878000,58629,NOA
2018-12-31,,,21417000,494000.0,15286000,38842000,127426000,29822000,29822000,,-8759000,,,,6096000,410061000,380239000,282635000,-8405000,,15321000,15286000,58629,NOA
2017-12-31,,,6468000,494000.0,5264000,25299000,84382000,15051000,15051000,,-7087000,,,,1204000,292557000,277506000,208175000,-8583000,,5264000,5264000,58629,NOA
2016-12-31,,,-494000,494000.0,-445000,27222000,73137000,4989000,4989000,,-5978000,,,,-49000,213180000,208191000,140043000,-5483000,,-445000,-445000,58629,NOA
2020-12-31,,,4302000000,6476000000,3222000000,3097000000,21198000000,8397000000,8397000000,,-3848000000,,,,626000000,48097000000,39700000000,26899000000,-4095000000,,3676000000,3222000000,58630,CHTR
2019-12-31,,,2431000000,7366000000,1668000000,3113000000,19584000000,6545000000,6545000000,,-3797000000,,,,439000000,45764000000,39219000000,26180000000,-4114000000,,1992000000,1668000000,58630,CHTR
2018-12-31,,,1686000000,7987000000,1230000000,2850000000,18816000000,5648000000,5648000000,235000000.0,-3540000000,,,,180000000,43634000000,37986000000,24818000000,-3962000000,,1506000000,1230000000,58630,CHTR
2017-12-31,,,1028000000,8447000000,9895000000,11484000000,26525000000,4453000000,4453000000,235000000.0,-3090000000,,,,-9087000000,41581000000,37128000000,15056000000,-3425000000,,10115000000,9895000000,58630,CHTR
2019-12-31,81326000,,-101660000,46317000,-39960000,55590000,26097000,-110819000,-110819000,,-11849000,,,,0,36629000,147448000,10532000,9159000,,-101660000,-39960000,58631,FBIOP
2018-12-31,87383000,,-130800000,17891000,-84147000,53371000,20757000,-119997000,-119997000,,-10340000,,,,0,26882000,146879000,6125000,-10803000,-11136000.0,-130800000,-84147000,58631,FBIOP
2017-12-31,52486000,,-97513000,67929000,-66876000,48697000,13587000,-87596000,-87596000,,-7687000,,,,1513000,17245000,104841000,3658000,-9917000,-2323000.0,-97513000,-66876000,58631,FBIOP
2016-12-31,35134000,,-71290000,44473000,-55095000,32915000,4985000,-63609000,-63609000,,-3691000,,,,0,16480000,80089000,11495000,-7681000,-2323000.0,-71290000,-55095000,58631,FBIOP
2020-09-30,,,-13750000,,-14347000,40124000,44704000,-706000,-706000,,-12233000,,,,597000,129835000,130541000,85131000,-13044000,,-14347000,10128000,58633,JOB
2019-09-30,,,-17393000,,-17763000,42458000,52021000,3628000,3628000,,-12440000,,,,370000,151674000,148046000,99653000,-21021000,,-17763000,-17763000,58633,JOB
2018-09-30,,,-8423000,,-7564000,47406000,58932000,5554000,5554000,,-11502000,,,,-859000,165284000,159730000,106352000,-13977000,,-7564000,-7564000,58633,JOB
2017-09-30,,,-8390000,,-2372000,39498000,44975000,1524000,1524000,,-5995000,,,,-6018000,134978000,133454000,90003000,-9914000,,-2372000,-2372000,58633,JOB
2019-12-31,,,958107,,958107,439804,0,-439804,-439804,,,,,,0,0,439804,0,1397911,,958107,958107,58634,SCPE
2018-12-31,,,-30000,,-30000,30000,0,-30000,-30000,,,,,,0,0,30000,0,0,,-30000,-30000,58634,SCPE
2020-12-31,,,2465000000,88000000,1969000000,1967000000,5174000000,2794000000,2794000000,,-334000000,,,,448000000,11066000000,8272000000,5892000000,-329000000,1000000,2017000000,1969000000,58635,AON
2019-12-31,,,1871000000,74000000,1532000000,1980000000,5173000000,2643000000,2643000000,,-307000000,,,,297000000,11013000000,8370000000,5840000000,-772000000,-1000000,1574000000,1532000000,58635,AON
2018-12-31,,,1246000000,68000000,1134000000,1922000000,4783000000,2281000000,2281000000,,-278000000,,,,146000000,10770000000,8489000000,5987000000,-1035000000,74000000,1100000000,1134000000,58635,AON
2017-12-31,,,685000000,65000000,1226000000,1867000000,4208000000,1856000000,1856000000,,-282000000,,,,250000000,9998000000,8142000000,5790000000,-1171000000,828000000,435000000,1226000000,58635,AON
2019-12-31,,,17149000,,16967000,7506000,91260000,55007000,55007000,,-37263000,,,,182000,119967000,64960000,28707000,-37858000,,16967000,16967000,58636,FLNG
2018-12-31,,,11769000,,11779000,4639000,51048000,28997000,28997000,,-17781000,,,,-10000,77209000,48212000,26161000,-17228000,,11779000,11779000,58636,FLNG
2017-12-31,,,-10391000,,-10408000,3409000,-9203000,-12614000,-12614000,,-234000,,,,17000,27329000,39943000,36532000,2223000,,-10408000,-10408000,58636,FLNG
2016-12-31,,,-1790000,,-1789000,1483000,0,-1485000,-1485000,,-314000,,,,-1000,0,1485000,0,-305000,,-1789000,-1789000,58636,FLNG
2020-06-30,9494000,,-12765000,,-12467000,3690000,988000,-12194000,-12194000,-2000,,,,,-298000,988000,13182000,0,-571000,,-12467000,-12467000,58639,KZIA
2019-06-30,6475000,,-10568000,,-10270000,3785000,1440000,-8795000,-8795000,-25000,,,,,-298000,1440000,10235000,0,-1773000,,-10270000,-10270000,58639,KZIA
2018-06-30,9774000,,-6344000,,-6039000,5598000,3004000,-12360000,-12360000,-8000,,,,,-305000,3004000,15364000,0,6016000,,-6039000,-6039000,58639,KZIA
2017-06-30,11136178,,-10868921,,-10670377,8528850,8788237,-10852760,-10852760,-24031,-276.0,,,,-198544,8788237,19640997,0,-16161,,-10670377,-10670377,58639,KZIA
2019-12-31,,,-9445000,,-9501000,36432000,81326000,-23766000,-23766000,,-315000,,,,56000,327581000,351347000,246255000,14321000,,-9501000,-9501000,58640,AEHL
2018-12-31,,,-418465000,,-418674000,29016000,-1166000,-348081000,-348081000,1461000.0,-315000,,,,209000,498189000,846270000,499355000,-70384000,,-418674000,-418674000,58640,AEHL
2017-12-31,,,-78285000,,-88026000,29211000,50354000,-54906000,-54906000,4484000.0,-213000,,,,9741000,821792000,876698000,771438000,-23379000,,-88026000,-88026000,58640,AEHL
2016-12-31,,,-316221000,,-321802000,35579000,-30111000,-94765000,-94765000,5135000.0,-84000,,,,5581000,793745000,888510000,823856000,-221456000,,-321802000,-321802000,58640,AEHL
2019-12-31,,,-1241980000,,-1497702000,404643000,891998000,408495000,408495000,,-119381000,,,,-91886000,3513542000,3105047000,2621544000,-1650475000,-347608000,-1150094000,-1497702000,58641,MD
2018-12-31,,,355064000,,268629000,403934000,919583000,431817000,431817000,,-88789000,,,,96453000,3454810000,3022993000,2535227000,-76753000,10018000,258611000,268629000,58641,MD
2017-12-31,,,385673000,,320372000,385864000,919612000,454892000,454892000,,-74556000,,,,80231000,3253391000,2798499000,2333779000,-69219000,14930000,305442000,320372000,58641,MD
2016-12-31,,,513799000,,324914000,410572000,1071523000,571687000,571687000,,-63092000,,,,189203000,3183159000,2611472000,2111636000,-57888000,14930000,324596000,324914000,58641,MD
2020-12-31,,,457512000,,367582000,403218000,861706000,458488000,458488000,,,,,,89930000,3901211000,3442723000,3039505000,-976000,,367582000,365251000,58642,MDC
2019-12-31,,,304989000,,238312000,362790000,665279000,302489000,302489000,,,,,,66677000,3293253000,2990764000,2627974000,2500000,,238312000,236826000,58642,MDC
2018-12-31,,,263854000,,210780000,329801000,613032000,283231000,283231000,,,,,,53074000,3065216000,2781985000,2452184000,-19377000,,210780000,209521000,58642,MDC
2017-12-31,,,229732000,,141835000,287488000,468762000,181274000,181274000,,,,,,87897000,2577614000,2396340000,2108852000,48458000,,141835000,141137000,58642,MDC
2019-12-31,,,115517000,,92690000,27520000,143037000,115517000,115517000,,,,,,22827000,370370000,254853000,227333000,0,,92690000,92690000,58643,AMSF
2018-12-31,,,87581000,,71632000,26492000,114073000,87581000,87581000,,,,,,15949000,377753000,290172000,263680000,0,,71632000,71632000,58643,AMSF
2017-12-31,,,82240000,,46231000,26131000,108371000,82240000,82240000,,,,,,36009000,375208000,292968000,266837000,-2000,,46231000,46231000,58643,AMSF
2016-12-31,,,112821000,,77865000,25581000,138402000,112821000,112821000,,,,,,34956000,396662000,283841000,258260000,-1000,,77865000,77865000,58643,AMSF
2020-01-31,94964000,,-51324000,,-31666000,257179000,299969000,-52174000,-52174000,,,,,,-19658000,552765000,604939000,252796000,850000,,-31666000,-31666000,58645,SCWX
2019-02-01,87608000,,-45954000,,-39101000,233716000,272592000,-48732000,-48732000,,,,,,-6853000,518709000,567441000,246117000,2778000,,-39101000,-39101000,58645,SCWX
2018-02-02,80164000,,-72716000,,-10417000,232663000,242846000,-69981000,-69981000,,,,,,-62299000,467930000,537911000,225084000,-2735000,,-10417000,-10417000,58645,SCWX
2017-02-03,71030000,,-53389000,,-31641000,205111000,220262000,-55879000,-55879000,,,,,,-21748000,432751000,488630000,212489000,2490000,,-31641000,-31641000,58645,SCWX
2019-12-31,,,499985000,,498001000,80684000,718019000,637335000,637335000,,-136445000,,,,1984000,718019000,80684000,0,-137350000,,498001000,498001000,58650,ORCC
2018-12-31,,,203336000,,202243000,65469000,388858000,323389000,323389000,,-76774000,,,,1093000,388858000,65469000,0,-120053000,,202243000,202243000,58650,ORCC
2017-12-31,,,103898000,,103740000,41351000,159879000,118528000,118528000,,-24580000,,,,158000,159879000,41351000,0,-14630000,,103740000,103740000,58650,ORCC
2016-12-31,,,20386800,,19964400,20025600,34564800,14539200,14539200,,-3309600,,,,422400,34564800,20025600,0,5847600,,19964400,19964400,58650,ORCC
2020-11-28,,,-16786000,,-10421000,223557000,222296000,-1261000,-1261000,,-49000,,,,-6365000,385863000,387124000,163567000,-15525000,,-10421000,-10421000,58653,BSET
2019-11-30,,,-1740000,,-1928000,265163000,272843000,6563000,6563000,,-6000,,,,188000,452087000,445524000,179244000,-8303000,,-1928000,-1928000,58653,BSET
2018-11-24,,,12206000,,8218000,260339000,277274000,14854000,14854000,,-57000,,,,3988000,456855000,442001000,179581000,-2648000,,8218000,8218000,58653,BSET
2017-11-25,,,27876000,,18256000,246542000,274924000,25969000,25969000,,-234000,,,,9620000,452503000,426534000,177579000,1907000,,18256000,18256000,58653,BSET
2020-03-31,,,-291132713,,-291132713,33733029,122151901,88418872,88418872,,-15479924,,,,0,122151901,33733029,0,-379551585,,-291132713,-291132713,58654,OXLCM
2019-03-31,,,-20981998,,-20981998,25262087,89398979,64136892,64136892,,-15051475,,,,0,89398979,25262087,0,-85118890,,-20981998,-20981998,58654,OXLCM
2018-03-31,,,38005588,,38005588,21061618,74815772,53754154,53754154,,-13400159,,,,0,74815772,21061618,0,-15748566,,38005588,38005588,58654,OXLCM
2017-03-31,,,105201826,,105201826,16089994,57944128,41854134,41854134,,-11711709,,,,0,57944128,16089994,0,63347692,,105201826,105201826,58654,OXLCM
2019-12-31,68853000,,60228000,46162000,48939000,63109000,131923000,-39000,-39000,,-119000,,,,13723000,322357000,322396000,190434000,60267000,,46505000,48939000,58656,AMPH
2018-12-31,57564000,,-9926000,31924000,-5738000,58044000,106985000,-8623000,-8623000,,-243000,,,,-3266000,294666000,303289000,187681000,-2950000,,-6660000,-5738000,58656,AMPH
2017-12-31,43503000,,1249000,31924000,3647000,50918000,90509000,-3912000,-3912000,,-826000,,,,-2398000,240175000,244087000,149666000,5161000,,3647000,3647000,58656,AMPH
2016-12-31,41522000,,14630000,31924000,9820000,46898000,104196000,15776000,15776000,,-1024000,,,,4810000,255165000,239389000,150969000,-1146000,,9820000,9820000,58656,AMPH
2019-12-31,,,-274595000,,-234195000,29804000,129718000,-190863000,-190863000,,-23548000,,,,-40400000,392599000,583462000,262881000,-83732000,,-234195000,-234195000,58657,OR
2018-12-31,,,-140735000,,-105587000,22681000,119167000,-121853000,-121853000,,-25999000,,,,-35148000,490472000,612325000,371305000,-18882000,,-105587000,-105587000,58657,OR
2017-12-31,,,-65935000,,-42501000,31887000,87571000,-61565000,-61565000,,-8384000,,,,-23147000,213216000,274781000,125645000,-4370000,,-42788000,-42501000,58657,OR
2016-12-31,,,51578000,1867000.0,42113000,24997000,62534000,26818000,26818000,,-3435000,,,,9724000,62677000,35859000,143000,24760000,,41854000,42113000,58657,OR
2019-12-31,,,92605000,,68159000,286486000,434820000,123824000,123824000,,-28104000,,,,24446000,1511629000,1387805000,1076809000,-31219000,,68159000,68159000,58658,IBP
2018-12-31,,,72186000,,54748000,250255000,371591000,95917000,95917000,,-20496000,,,,17438000,1336432000,1240515000,964841000,-23731000,,54748000,54748000,58658,IBP
2017-12-31,,,55820000,,41140000,219003000,324026000,78166000,78166000,,-17381000,,,,14680000,1132927000,1054761000,808901000,-22346000,,41140000,41140000,58658,IBP
2016-12-31,,,59610000,,38436000,172839000,252448000,68350000,68350000,,-6177000,,,,21174000,862980000,794630000,610532000,-8740000,,38436000,38436000,58658,IBP
2020-12-31,3984600000,,5052800000,-14200000,4000600000,2511500000,11639400000,4655300000,4655300000,232900000,-213100000,,,,992300000,13444600000,8789300000,1805200000,397500000,,4060500000,4000600000,58659,BIIB
2019-12-31,2264900000,,7046500000,-4100000,5888500000,2362900000,12422500000,7279100000,7279100000,241600000,-187400000,,,,1158000000,14377900000,7098800000,1955400000,-232600000,,5888500000,5888500000,58659,BIIB
2018-12-31,2597200000,,5899600000,-8000000,4430700000,2109100000,11636600000,6364100000,6364100000,185000000,-200600000,,,,1425600000,13452900000,7088800000,1816300000,-464500000,,4474000000,4430700000,58659,BIIB
2017-12-31,2253600000,,5128800000,-14700000,2539100000,1936400000,10643900000,5886300000,5886300000,112300000,-250800000,,,,2458700000,12273900000,6387600000,1630000000,-757500000,,2670100000,2539100000,58659,BIIB
2019-12-31,11633000,,-9151000,,-8926000,58658000,128741000,19613000,19613000,,-28004000,,,,-225000,208511000,188898000,79770000,-28764000,,-8926000,-8926000,58661,CERT
2018-12-31,10478000,,-32561000,,-33258000,52809000,92676000,-4652000,-4652000,,-27802000,,,,697000,163719000,168371000,71043000,-27909000,,-33258000,-33258000,58661,CERT
2020-12-31,,,29219000,,22117000,57668000,127869000,0,29219000,40982000,,,,,6795000,127869000,98650000,0,0,,22424000,22117000,58662,CFFI
2019-12-31,,,23932000,481000.0,18859000,57725000,103951000,0,24641000,21585000,,,,,5082000,103951000,79310000,0,-709000,,18850000,18859000,58662,CFFI
2018-12-31,,,22541000,481000.0,18020000,51912000,96273000,0,22541000,21820000,,,,,4521000,96273000,73732000,0,0,,18020000,18020000,58662,CFFI
2017-12-31,,,17966000,481000.0,6572000,52849000,90789000,0,17966000,19974000,,,,,11394000,90789000,72823000,0,0,,6572000,6572000,58662,CFFI
2019-12-31,,,2986000,,3899000,15874000,18429000,2250000,2250000,,-64000,,,,-913000,26168000,23918000,7739000,736000,,3899000,3899000,58663,HGBL
2018-12-31,,,4021000,,3751000,15219000,19616000,4078000,4078000,,-214000,,,,270000,23664000,19586000,4048000,-57000,,3751000,3751000,58663,HGBL
2017-12-31,,,-669000,,-249000,13597000,15416000,1506000,1506000,,-95000,,,,-420000,20129000,18623000,4713000,-2175000,,-249000,-249000,58663,HGBL
2016-12-31,,,35000,,14000,12009000,12515000,190000,190000,,-60000,,,,21000,23833000,23643000,11318000,-155000,,14000,14000,58663,HGBL
2019-12-31,,,39012913,,39012913,4774592,28414469,23639877,23639877,,-1059000,,,,0,28414469,4774592,0,15373036,,39012913,39012913,58664,MCI
2018-12-31,,,9586471,,9586471,5164062,30435014,25270952,25270952,,-1059000,,,,0,30435014,5164062,0,-15684481,,9586471,9586471,58664,MCI
2017-12-31,,,43579118,,43579118,4740307,31510571,26770264,26770264,,-1516917,,,,0,31510571,4740307,0,16808854,,43579118,43579118,58664,MCI
2016-12-31,,,27240056,,27240056,4426968,28182807,23755839,23755839,,-1584000,,,,0,28182807,4426968,0,3484217,,27240056,27240056,58664,MCI
2020-02-29,,,74279629,,74279629,5761372,36341132,30579760,30579760,,-7392884,,,,0,36341132,5761372,0,43699869,,74279629,74279629,58665,NQP
2019-02-28,,,33664461,,33664461,5579610,36614178,31034568,31034568,,-8196249,,,,0,36614178,5579610,0,2629893,,33664461,33664461,58665,NQP
2018-02-28,,,23062735,,23062735,5691817,37679392,31987575,31987575,,-5315134,,,,0,37679392,5691817,0,-8924840,,23062735,23062735,58665,NQP
2017-02-28,,,-29314832,,-29314832,7345159,38152979,30807820,30807820,,-2206846,,,,0,38152979,7345159,0,-60122652,,-29314832,-29314832,58665,NQP
2019-12-31,,,41318000,,39132000,65319000,473393000,176627000,176627000,,-127818000,,,,2186000,698365000,521738000,224972000,-135309000,,39132000,-9618000,58666,USAC
2018-12-31,,,-13025000,,-10551000,54843000,369628000,101093000,101093000,,-79086000,,,,-2474000,584352000,483259000,214724000,-114118000,,-10551000,-46981000,58666,USAC
2017-12-31,,,-262891000,,-264734000,24944000,151467000,-40035000,-40035000,,-79086000,,,,1843000,276671000,316706000,125204000,-222856000,,-264734000,-264734000,58666,USAC
2016-12-31,,,-27107000,,-26944000,22739000,151039000,-26834000,-26834000,,-79086000,,,,-163000,263937000,290771000,112898000,-273000,,-26944000,-26944000,58666,USAC
2020-12-31,34978000,,-33811000,,-35406000,79534000,80587000,-33925000,-33925000,,,,,,1595000,100834000,134759000,20247000,114000,,-35406000,-35406000,58668,TUFN
2019-12-31,31571000,,-27108000,,-28119000,78865000,83413000,-27023000,-27023000,,-85000.0,,,,1011000,103270000,130293000,19857000,-85000,,-28119000,-28119000,58668,TUFN
2018-12-31,21363000,,-2979000,,-4262000,52114000,71545000,-1932000,-1932000,,-218000.0,,,,1283000,84981000,86913000,13436000,-1047000,,-4262000,-4262000,58668,TUFN
2017-12-31,17672000,,-1995000,,-2792000,39650000,55060000,-2262000,-2262000,,-137000.0,,,,797000,64540000,66802000,9480000,267000,,-2792000,-2792000,58668,TUFN
2019-12-31,9730000,,8131000,2871000,-11765000,160237000,162276000,-7691000,-7691000,,-6093000,,,,21580000,2055789000,2063480000,1893513000,15822000,,-13449000,-11765000,58670,QH
2018-12-31,6702000,,-40316000,4555000,-42614000,161035000,116638000,-51099000,-51099000,,-3913000,,,,3979000,1474475000,1525574000,1357837000,10783000,,-44295000,-42614000,58670,QH
2017-12-31,3222000,,-13564000,4555000,-13969000,43181000,28609000,-17794000,-17794000,,-1364000,,,,405000,654802000,672596000,626193000,4230000,,-13969000,-13969000,58670,QH
2019-12-31,191621000,,-218250000,,-218016000,48473000,13375000,-226719000,-226719000,,-1221000,,,,-234000,13375000,240094000,0,8469000,,-218016000,-218016000,58672,ASND
2018-12-31,140281000,,-130491000,,-130097000,25057000,10581000,-154757000,-154757000,,-127000,,,,-394000,10581000,165338000,0,24266000,,-130097000,-130097000,58672,ASND
2017-12-31,99589000,,-124374000,,-123897000,13482000,1530000,-111541000,-111541000,,-97000,,,,-477000,1530000,113071000,0,-12833000,,-123897000,-123897000,58672,ASND
2016-12-31,66022000,,-68732000,,-68505000,11504000,4606000,-72920000,-72920000,,-5000,,,,-227000,4606000,77526000,0,4188000,,-68505000,-68505000,58672,ASND
2020-11-30,,,2431779,,2431779,627583,3546822,2919239,2919239,,-220735,,,,0,3546822,627583,0,-487460,,2431779,2431779,58674,CIF
2019-11-30,,,6708166,,6708166,666736,3939127,3272391,3272391,,-566482,,,,0,3939127,666736,0,3435775,,6708166,6708166,58674,CIF
2018-11-30,,,-1613353,,-1613353,691466,4102425,3410959,3410959,,-553627,,,,0,4102425,691466,0,-5024312,,-1613353,-1613353,58674,CIF
2017-11-30,,,5629852,,5629852,753631,4365180,3611549,3611549,,-393859,,,,0,4365180,753631,0,2018303,,5629852,5629852,58674,CIF
2019-12-31,,,19718000,3806000,3950000,344303000,449878000,105575000,105575000,,-41409000,,,,15865000,1561771000,1456196000,1111893000,-85857000,,3853000,3950000,58677,SPLP
2018-12-31,,,-18931000,3721000,-32604000,352794000,445290000,92496000,92496000,,-39234000,,,,12559000,1584614000,1492118000,1139324000,-111427000,,-31490000,-32604000,58677,SPLP
2017-12-31,,,57311000,20933000,-16000,337719000,403213000,65494000,65494000,,-22804000,,,,51299000,1372027000,1306533000,968814000,-8183000,,6012000,-16000,58677,SPLP
2016-12-31,,,26523000,155517000,6630000,280398000,347904000,67506000,67506000,,-11052000,,,,23952000,1163549000,1096043000,815645000,-40983000,,2571000,6630000,58677,SPLP
2019-12-31,,,-147720578,,-147722178,64947625,-89064225,-154011850,-154011850,,,,,,1600,60613,154072463,89124838,6291272,,-147722178,-147722178,58678,ITCI
2018-12-31,,,-155125811,,-155127411,30099855,-132166913,-162266768,-162266768,,,,,,1600,0,162266768,132166913,7140957,,-155127411,-155127411,58678,ITCI
2017-12-31,,,-98834265,,-97773414,23666957,-79173172,-102840129,-102840129,,,,,,-1060851,245837,103085966,79419009,4005864,,-97773414,-97773414,58678,ITCI
2016-12-31,,,-115360595,,-116426268,24758063,-93500828,-118258891,-118258891,,-36781.0,,,,1065673,330702,118589593,93831530,2898296,,-116426268,-116426268,58678,ITCI
2020-12-31,,,14939000,,10518000,12353000,32608000,0,14939000,5316000,,,,,4421000,32608000,17669000,0,0,,10518000,10518000,58684,SSBI
2019-12-31,,,8875000,,6477000,12178000,24938000,0,8875000,3885000,,,,,2398000,24938000,16063000,0,0,,6477000,6477000,58684,SSBI
2018-12-31,,,8044000,,5827000,11495000,23401000,0,8044000,3862000,,,,,2217000,23401000,15357000,0,0,,5827000,5827000,58684,SSBI
2017-12-31,,,5922000,,3292000,10119000,19767000,0,5922000,3726000,,,,,2630000,19767000,13845000,0,0,,3292000,3292000,58684,SSBI
2020-08-31,,,867000000,,688000000,52000000,2378000000,1174000000,1174000000,-16000000,-277000000,,,,179000000,5407000000,4233000000,3029000000,-307000000,,688000000,679000000,58687,SJR
2019-08-31,,,851000000,3000000.0,731000000,164000000,2233000000,1116000000,1116000000,-21000000,-261000000,,,,118000000,5340000000,4224000000,3107000000,-265000000,,733000000,722000000,58687,SJR
2018-08-31,,,167000000,1000000.0,33000000,153000000,2100000000,1032000000,1032000000,-30000000,-251000000,,,,128000000,5189000000,4157000000,3089000000,-865000000,-6000000.0,39000000,25000000,58687,SJR
2017-08-31,,,738000000,1000000.0,851000000,153000000,1875000000,1053000000,1053000000,-38000000,-269000000,,,,181000000,4882000000,3829000000,3007000000,-315000000,294000000.0,557000000,843000000,58687,SJR
2019-12-31,,,-8330000,,-8330000,4061000,9635000,228000,228000,,-5775000,,,,0,27753000,27525000,18118000,-8558000,,-8330000,-8330000,58689,PXS
2018-12-31,,,-8214000,,-8214000,4054000,3838000,-5729000,-5729000,,-4434000,,,,0,28457000,34186000,24619000,-2485000,,-8214000,-8214000,58689,PXS
2017-12-31,,,-5243000,,-5243000,4830000,8282000,-2346000,-2346000,,-2897000,,,,0,29579000,31925000,21297000,-3197000,,-5243000,-5243000,58689,PXS
2016-12-31,,,-5813000,,-5813000,4229000,10386000,389000,389000,,-2810000,,,,0,30387000,29998000,20001000,-6202000,,-5813000,-5813000,58689,PXS
2019-12-31,,,-159576000,,-159796000,20761000,43307000,-149911000,-149911000,3357000,-8596000,,,,220000,76512000,226423000,33205000,-9665000,,-159796000,-159796000,58690,MCF
2018-12-31,,,-121448000,,-121568000,22357000,51535000,-115909000,-115909000,-1939000,-5548000,,,,120000,77087000,192996000,25552000,-5539000,,-121568000,-121568000,58690,MCF
2017-12-31,,,-18038000,,-17643000,24161000,51362000,-20190000,-20190000,-3325000,-4100000,,,,-395000,78545000,98735000,27183000,2152000,,-17643000,-17643000,58690,MCF
2016-12-31,,,-57687000,,-58029000,26802000,49072000,-55073000,-55073000,1632000,-3802000,,,,342000,78183000,133256000,29111000,-2614000,,-58029000,-58029000,58690,MCF
2019-12-31,4020000,,-28660000,,-28660000,10085000,-12246000,-26351000,-26351000,,-2732000,,,,0,24487000,50838000,36733000,-2309000,,-28660000,-28660000,58692,GEVO
2018-12-31,5374000,,-27976000,,-27976000,8122000,-8705000,-22201000,-22201000,,-3237000,,,,0,32863000,55064000,41568000,-5775000,,-27976000,-27976000,58692,GEVO
2017-12-31,5182000,,-24630000,,-24630000,7471000,-10629000,-23282000,-23282000,,-2951000,,,,0,27536000,50818000,38165000,-1348000,,-24630000,-24630000,58692,GEVO
2016-12-31,5216000,,-37228000,,-37228000,8965000,-9804000,-23985000,-23985000,,-7837000,,,,0,27213000,51198000,37017000,-13243000,,-37228000,-37228000,58692,GEVO
2019-12-31,,,-41692000,196000,-19402000,4350000,1212000,-3138000,-3138000,,-218000,,,,-4640000,5525000,8663000,4313000,-38554000,-4000,-37052000,-19402000,58693,SGOC
2018-12-31,,,-13862000,30105000,-12372000,2391000,-1055000,-3446000,-3446000,,-198000,,,,-311000,1580000,5026000,2635000,-10416000,-4198000,-13551000,-12372000,58693,SGOC
2017-12-31,,,-9153000,30105000,-11214000,2216000,-1292000,-3508000,-3508000,,-13000,,,,-350000,51000,3559000,1343000,-5645000,-2411000,-8803000,-11214000,58693,SGOC
2016-12-31,,,-5362000,30105000,-5047000,4170000,202000,-3968000,-3968000,,-15000,,,,-315000,5069000,9037000,4867000,-1394000,-2411000,-5047000,-5047000,58693,SGOC
2020-12-31,,,249520000,,177159000,165631000,442423000,0,258872000,17920000,,,,,72361000,442423000,183551000,0,-9352000,,177159000,177159000,58696,CVBF
2019-12-31,,,291074000,,207827000,164232000,484129000,0,302634000,17263000,,,,,83247000,484129000,181495000,0,-11560000,,207827000,207339000,58696,CVBF
2018-12-31,,,211115000,,152003000,141876000,391026000,0,232773000,16377000,,,,,59112000,391026000,158253000,0,-21658000,,152003000,151574000,58696,CVBF
2017-12-31,,,188795000,,104411000,120985000,325879000,0,188706000,16188000,,,,,84384000,325879000,137173000,0,89000,,104411000,104029000,58696,CVBF
2020-12-31,,,224500000,,181000000,737600000,1000500000,262900000,262900000,,-55300000,,,,43400000,2936900000,2674000000,1936400000,-38400000,,181100000,181000000,58701,CR
2019-12-31,,,170700000,2600000.0,133300000,691700000,1179000000,468400000,468400000,18900000.0,-46800000,,,,37100000,3283100000,2814700000,2104100000,-297700000,,133600000,133300000,58701,CR
2018-12-31,,,411400000,2900000.0,335600000,699700000,1198400000,498700000,498700000,2904200000.0,-50900000,,,,75900000,3345500000,2846800000,2147100000,-87300000,,335500000,335600000,58701,CR
2017-12-31,,,367500000,3300000.0,171800000,592000000,1015100000,423100000,423100000,2904200000.0,-36100000,,,,195000000,2786000000,2362900000,1770900000,-55600000,,172500000,171800000,58701,CR
2019-12-31,4765000,,-17899000,,-17855000,25144000,14288000,-15621000,-15621000,,-2157000,,,,-44000,37799000,53420000,23511000,-2278000,,-17855000,-17855000,58702,BIOL
2018-12-31,5203000,,-21453000,,-21516000,29892000,16895000,-18200000,-18200000,,-510000,,,,63000,46155000,64355000,29260000,-3253000,,-21516000,-21516000,58702,BIOL
2017-12-31,6229000,,-17433000,,-16851000,26430000,15126000,-17533000,-17533000,,-510000,,,,-582000,46926000,64459000,31800000,100000,,-16851000,-20829000,58702,BIOL
2016-12-31,7799000,,-15220000,,-15371000,27471000,20308000,-14962000,-14962000,,-510000,,,,151000,51810000,66772000,31502000,-258000,,-15371000,-17555000,58702,BIOL
2019-12-31,8900837,,-26476370,,-26476370,10815703,-4408121,-26676511,-26676511,110269,,,,,0,6670604,33347115,11078725,200141,,-26476370,-28408230,58705,VUZI
2018-12-31,10378728,,-21875713,,-21875713,11795877,1979698,-21722488,-21722488,57917,-19332.0,,,,0,8094368,29816856,6114670,-153225,,-21875713,-23695881,58705,VUZI
2017-12-31,6706690,,-19633502,,-19633502,9821248,-1828080,-19382909,-19382909,28363,-263494.0,,,,0,5537753,24920662,7365833,-250593,,-19633502,-21348436,58705,VUZI
2016-12-31,6947878,,-19250082,,-19250082,8508719,-2287989,-18567525,-18567525,52271,-664519.0,,,,0,2127378,20694903,4415367,-682557,,-19250082,-20870130,58705,VUZI
2019-12-31,131619000,,-102665000,,-102238000,36765000,57489000,-110895000,-110895000,,,,,,-427000,57489000,168384000,0,8230000,,-102238000,-102238000,58706,CTMX
2018-12-31,103866000,,-70301000,,-84604000,33510000,59502000,-77874000,-77874000,,,,,,14303000,59502000,137376000,0,7573000,,-84604000,-84604000,58706,CTMX
2017-12-31,92277000,,-43612000,,-43099000,25605000,71623000,-46259000,-46259000,,,,,,-513000,71623000,117882000,0,2647000,,-43099000,-43099000,58706,CTMX
2016-12-31,54755000,,-58919000,,-58900000,19874000,15043000,-59586000,-59586000,,,,,,-19000,15043000,74629000,0,667000,,-58900000,-58900000,58706,CTMX
2020-06-30,,,56130000,,41054000,186649000,250761000,63912000,63912000,,-79000,,,,15076000,727859000,663947000,477098000,-7782000,,41054000,41054000,58707,KBAL
2019-06-30,,,51670000,,39344000,201090000,254552000,53062000,53062000,,-174000,,,,12326000,768070000,715008000,513518000,-1392000,,39344000,39344000,58707,KBAL
2018-06-30,,,52325000,,34439000,184268000,235631000,51063000,51063000,,-221000,,,,17886000,704554000,653491000,468923000,1262000,,34439000,34439000,58707,KBAL
2017-06-30,,,58018000,,37506000,183657000,237861000,54104000,54104000,,-37000,,,,20512000,692967000,638863000,455106000,3914000,,37506000,37506000,58707,KBAL
2020-12-31,,,25320000,,18605000,37073000,62745000,0,25672000,,,,,,6715000,62745000,37073000,0,-352000,,18605000,18605000,58708,TBNK
2019-12-31,,,28306000,,21995000,37718000,66312000,0,28594000,,,,,,6311000,66312000,37718000,0,-288000,,21995000,21846000,58708,TBNK
2018-12-31,,,25323000,,19212000,36886000,62817000,0,25931000,,,,,,6111000,62817000,36886000,0,-608000,,19212000,19122000,58708,TBNK
2017-12-31,,,26064000,,14962000,35869000,62538000,0,26669000,,,,,,11102000,62538000,35869000,0,-605000,,14962000,14935000,58708,TBNK
2019-12-31,139000,,-16582000,,-1129000,20063000,5812000,-16045000,-16045000,-20000,-61000,,,,-2956000,23492000,39537000,17680000,-537000,12497000,-13626000,-1129000,58710,OEG
2018-12-31,155000,,-22666000,,-17325000,18629000,2559000,-17787000,-17787000,13000,-87000,,,,-1342000,20342000,38129000,17783000,-4879000,3999000,-21324000,-17325000,58710,OEG
2017-12-31,222000,,-16196000,,-12589000,17506000,5930000,-13153000,-13153000,5000,-90000,,,,-2251000,18843000,31996000,12913000,-3043000,1356000,-13945000,-12589000,58710,OEG
2016-12-31,2016000,,-7228000,,-7266000,33639000,32261000,-5910000,-5910000,57000,-354000,,,,38000,86461000,92371000,54200000,-1318000,1356000,-7266000,-7266000,58710,OEG
2019-12-31,,,13742000,,13742000,14527000,28757000,0,14230000,,,,,,0,28757000,14527000,0,-488000,,13742000,11142000,58711,AAIC
2018-12-31,,,-91064000,,-91797000,13370000,-77694000,0,-91064000,,,,,,733000,-77694000,13370000,0,0,,-91797000,-92387000,58711,AAIC
2017-12-31,,,57038000,,17435000,18570000,75608000,0,57038000,,,,,,39603000,75608000,18570000,0,0,,17435000,17184000,58711,AAIC
2016-12-31,,,-13960000,,-41347000,16777000,6796000,0,-9981000,,,,,,27387000,6796000,16777000,0,-3979000,,-41347000,-41347000,58711,AAIC
2019-12-31,,,-16414159,,-16414159,5760890,-10917604,-16678494,-16678494,,,,,,0,244632,16923126,11162236,264335,,-16414159,-16706668,58713,CRDF
2018-12-31,,,-16461178,,-16461178,8005583,-8383143,-16388726,-16388726,,-25409.0,,,,0,378325,16767051,8761468,-72452,,-16461178,-19254951,58713,CRDF
2017-12-31,,,-24906744,,-24906744,12132876,-9188670,-21321546,-21321546,,-1033939.0,,,,0,505404,21826950,9694074,-3585198,,-24906744,-24930984,58713,CRDF
2016-12-31,,,-39203719,,-39203719,22462091,-16356082,-38818173,-38818173,,-1674341.0,,,,0,381072,39199245,16737154,-385546,,-39203719,-39227959,58713,CRDF
2020-12-31,25040000,,-25931000,,-26529000,19840000,20358000,-24522000,-24522000,,,,,,598000,40855000,65377000,20497000,-1409000,,-26529000,-26529000,58715,PXLW
2019-12-31,26018000,,-8624000,,-9077000,21202000,34507000,-12713000,-12713000,,-158000.0,,,,453000,68755000,81468000,34248000,4089000,,-9077000,-9077000,58715,PXLW
2018-12-31,22881000,,-3465000,,-3913000,19953000,39953000,-2881000,-2881000,,-438000.0,,,,448000,76554000,79435000,36601000,-584000,,-3913000,-3913000,58715,PXLW
2017-12-31,21427000,,-3067000,,-3560000,17990000,43729000,4312000,4312000,,-651000.0,,,,493000,80637000,76325000,36908000,-7379000,,-3560000,-3560000,58715,PXLW
2019-12-31,,,133828000,448000,100974000,364942000,602132000,237190000,237190000,,-138448000,,,,32813000,1452455000,1215265000,850323000,-103362000,,101015000,93510000,58718,VGR
2018-12-31,,,79559000,693000,58105000,349389000,577778000,228389000,228389000,,-203780000,,,,21552000,1400426000,1172037000,822648000,-148830000,,58007000,51089000,58718,VGR
2017-12-31,,,89168000,82159000,84572000,326342000,579430000,253088000,253088000,,-173685000,,,,-1582000,1346915000,1093827000,767485000,-163920000,,90750000,78501000,58718,VGR
2016-12-31,,,126429000,78728000,71127000,313956000,593605000,279649000,279649000,,-142982000,,,,49163000,1264969000,985320000,671364000,-153220000,,77266000,68886000,58718,VGR
2020-12-31,,,108391000,880000,108363000,15065000,259301000,127877000,127877000,,-33927000,,,,0,362669000,234792000,103368000,-19486000,,108391000,108363000,58721,EGP
2019-12-31,,,123340000,1765000,121662000,16817000,237539000,115998000,115998000,,-34463000,,,,0,330813000,214815000,93274000,7342000,,123340000,121662000,58721,EGP
2018-12-31,,,88636000,1644000,88506000,13738000,212624000,107182000,107182000,,-35106000,,,,0,299018000,191836000,86394000,-18546000,,88636000,88506000,58721,EGP
2017-12-31,,,83589000,1658000,83183000,14972000,194042000,95196000,95196000,,-34775000,,,,0,274150000,178954000,80108000,-11607000,,83589000,83183000,58721,EGP
2020-12-31,403515000,,-280217000,,-282308000,471395000,600098000,-274812000,-274812000,,-1520000,,,,2091000,772445000,1047257000,172347000,-5405000,,-282308000,-282308000,58723,U
2019-12-31,255928000,,-153242000,,-163190000,300823000,423182000,-133569000,-133569000,,-1520000,,,,9948000,541779000,675348000,118597000,-19673000,,-163190000,-273431000,58723,U
2018-12-31,204071000,,-132628000,,-131602000,225718000,299488000,-130301000,-130301000,,-1520000,,,,-1026000,380755000,511056000,81267000,-2327000,,-131602000,-131602000,58723,U
2020-12-31,,,59495000,,42196000,109031000,177548000,0,58696000,9821000,,,,,17299000,177548000,118852000,0,799000,,42196000,42196000,58725,HAFC
2019-12-31,,,47348000,,32788000,109512000,173254000,0,49082000,14660000,,,,,14560000,173254000,124172000,0,-1734000,,32788000,32558000,58725,HAFC
2018-12-31,,,83970000,,57868000,105471000,201543000,0,84816000,11256000,,,,,26102000,201543000,116727000,0,-846000,,57868000,57509000,58725,HAFC
2017-12-31,,,95284000,,54660000,102972000,209386000,0,95244000,11170000,,,,,40624000,209386000,114142000,0,40000,,54660000,54321000,58725,HAFC
2020-12-31,54000000,,49000000,158000000,11000000,998000000,1490000000,202000000,202000000,236000000,-219000000,,,,25000000,5043000000,4841000000,3553000000,-153000000,,24000000,11000000,58726,ICL
2019-12-31,50000000,,628000000,136000000,475000000,1060000000,1817000000,707000000,707000000,236000000,-109000000,,,,147000000,5271000000,4564000000,3454000000,-79000000,,481000000,475000000,58726,ICL
2018-12-31,55000000,,1364000000,134000000,1240000000,1048000000,1854000000,742000000,742000000,9000000,-95000000,,,,129000000,5556000000,4814000000,3702000000,622000000,,1235000000,1240000000,58726,ICL
2017-12-31,55000000,,505000000,71000000,364000000,1045000000,1672000000,590000000,590000000,-18000000,-97000000,,,,158000000,5418000000,4828000000,3746000000,-85000000,,347000000,364000000,58726,ICL
2020-12-31,,,184411000,,155810000,322394000,570004000,0,207904000,39706000,,,,,28601000,570004000,362100000,0,-23493000,,155810000,155810000,58730,FFBC
2019-12-31,,,242862000,,198075000,292343000,582129000,0,254506000,35280000,,,,,44787000,582129000,327623000,0,-11644000,,198075000,198075000,58730,FFBC
2018-12-31,,,214221000,,172595000,279227000,538031000,0,225549000,33255000,,,,,41626000,538031000,312482000,0,-11328000,,172595000,172595000,58730,FFBC
2017-12-31,,,116163000,,96787000,197145000,356105000,0,121405000,37555000,,,,,19376000,356105000,234700000,0,-5242000,,96787000,96787000,58730,FFBC
2019-09-30,,,-137293000,,-138001000,261740000,173588000,-90372000,-90372000,,-22134000,,,,708000,434261000,524633000,260673000,-46921000,,-138001000,-192967000,58732,ESGC
2018-09-30,,,-192384000,,-193195000,322335000,150600000,-173549000,-173549000,,-18934000,,,,811000,448846000,622395000,298246000,-18835000,,-193195000,-231694000,58732,ESGC
2017-09-30,,,-85974000,,-86361000,130515000,61672000,-70147000,-70147000,,-15943000,,,,387000,201441000,271588000,139769000,-15827000,,-86361000,-113646000,58732,ESGC
2019-12-31,7569000,,-14657000,,-14657000,17147000,13229000,-12714000,-12714000,,-2001000,,,,0,30528000,43242000,17299000,-1943000,,-14657000,-14657000,58734,LNSR
2018-12-31,2784000,,-12573000,,-12593000,16143000,10748000,-9316000,-9316000,,-3321000,,,,20000,24388000,33704000,13640000,-3257000,,-12593000,-14044000,58734,LNSR
2019-12-31,,,19860920,,19860920,1396760,4480801,3084041,3084041,,-11103,,,,0,4480801,1396760,0,16776879,,19860920,15415406,58735,GLU
2018-12-31,,,-7187883,,-7187883,1125106,3484444,2359338,2359338,,-14504,,,,0,3484444,1125106,0,-9547221,,-7187883,-8328013,58735,GLU
2017-12-31,,,17569477,,17569477,1192931,3751242,2558311,2558311,,-1563,,,,0,3751242,1192931,0,15011166,,17569477,15619921,58735,GLU
2016-12-31,,,7785028,,7785028,992582,4203787,3211205,3211205,,-65,,,,0,4203787,992582,0,4573823,,7785028,6030712,58735,GLU
2020-04-30,,,-3745597,,-3745597,1766717,11470320,9703603,9703603,,-2461824,,,,0,11470320,1766717,0,-13449200,,-3745597,-3745597,58737,MUS
2019-04-30,,,10163456,,10163456,1694873,12017862,10322989,10322989,,-2686690,,,,0,12017862,1694873,0,-159533,,10163456,10163456,58737,MUS
2018-04-30,,,2082938,,2082938,1785320,13215853,11430533,11430533,,-2256188,,,,0,13215853,1785320,0,-9347595,,2082938,2082938,58737,MUS
2017-04-30,,,-1144388,,-1144388,1837552,13394523,11556971,11556971,,-1751488,,,,0,13394523,1837552,0,-12701359,,-1144388,-1144388,58737,MUS
2019-12-31,,,-100405000,24891000,-106024000,52934000,-93452000,-146386000,-146386000,,-1030000,,,,3274000,204890000,351276000,298342000,45981000,,-103679000,-106024000,58739,HCM
2018-12-31,,,-67322000,23259000,-74805000,48645000,-43996000,-92641000,-92641000,,-1009000,,,,3964000,214109000,306750000,258105000,25319000,,-71286000,-74805000,58739,HCM
2017-12-31,,,-19883000,23233000,-26737000,43277000,-10140000,-53417000,-53417000,,-1455000,,,,3080000,241203000,294620000,251343000,33534000,,-22963000,-26737000,58739,HCM
2016-12-31,,,18888000,19790000,11698000,39578000,-7119000,-46697000,-46697000,,-1631000,,,,4331000,216080000,262777000,223199000,65585000,,14557000,11698000,58739,HCM
2019-12-31,27140000,,-47286000,,-47350000,43277000,28603000,-41814000,-41814000,,-5961000,,,,64000,88021000,129835000,59418000,-5472000,,-47350000,-47350000,58741,GNMK
2018-12-31,27931000,,-50361000,,-50500000,39322000,19481000,-47772000,-47772000,,-3108000,,,,139000,70759000,118531000,51278000,-2589000,,-50500000,-50500000,58741,GNMK
2017-12-31,42760000,,-61749000,,-61850000,36762000,20005000,-59517000,-59517000,,-3042000,,,,101000,52519000,112036000,32514000,-2232000,,-61850000,-61850000,58741,GNMK
2016-12-31,49458000,,-50501000,,-50601000,29097000,29574000,-48981000,-48981000,,-1536000,,,,100000,49274000,98255000,19700000,-1511000,,-50601000,-50601000,58741,GNMK
2020-06-30,109988000,,381076000,,296668000,197988000,688603000,380627000,380627000,,-688000,,,,84408000,1697067000,1316440000,1008464000,449000,,296668000,296668000,58743,JKHY
2019-06-30,96378000,,347235000,,271885000,185939000,629661000,347344000,347344000,,-926000,,,,75350000,1552691000,1205347000,923030000,-109000,,271885000,271885000,58743,JKHY
2018-06-30,90340000,,356158000,,365034000,171710000,617659000,355609000,355609000,,-1920000,,,,-8876000,1470797000,1115188000,853138000,549000,,365034000,365034000,58743,JKHY
2017-06-30,84753000,,340969000,,229561000,159235000,582435000,338447000,338447000,,-996000,,,,111408000,1388290000,1049843000,805855000,2522000,,229561000,229561000,58743,JKHY
2019-12-31,,,-42534000,,-9431000,360382000,455579000,83293000,83293000,11904000,-43695000,,,,-33103000,572837000,489544000,117258000,-125827000,,-9431000,-9431000,58744,ARCE
2018-12-31,,,-100901000,-294000.0,-82380000,240166000,300236000,62068000,62068000,-1998000,-9781000,,,,-17985000,380981000,318913000,80745000,-162969000,,-82916000,-82380000,58744,ARCE
2017-12-31,,,66356000,111000.0,44255000,111946000,185865000,74318000,74318000,-399000,-11179000,,,,22716000,244382000,170064000,58517000,-7962000,,43640000,44255000,58744,ARCE
2016-12-31,,,92838000,116000.0,75129000,71493000,117946000,48803000,48803000,-2350000,-90000,,,,18443000,159270000,110467000,41324000,44035000,,74395000,75129000,58744,ARCE
2019-12-31,,,55846000,427644000,44029000,71947000,515246000,161211000,161211000,,-105845000,,,,0,817435000,656224000,302189000,-105365000,,55846000,42725000,58746,HPP
2018-12-31,,,111781000,409540000,99371000,61027000,460173000,148143000,148143000,,-83167000,,,,0,728418000,580275000,268245000,-36362000,,111781000,98090000,58746,HPP
2017-12-31,,,94561000,283370000,69226000,54459000,474034000,136005000,136005000,,-90107000,,,,0,728139000,592134000,254105000,-41444000,,94561000,67587000,58746,HPP
2016-12-31,,,43758000,609644000,28620000,52400000,410518000,89031000,89031000,,-76044000,,,,0,639639000,550608000,229121000,-45273000,,43758000,27218000,58746,HPP
2019-12-31,,,-38094000,3696000,-37978000,14453000,-12433000,-40581000,-40581000,13695000,-1491000,,,,0,5865000,46446000,18298000,2487000,,-38094000,-37978000,58747,UUUU
2018-12-31,,,-25362000,3766000,-25245000,14341000,12390000,-21312000,-21312000,16859000,-1722000,,,,0,31721000,53033000,19331000,-4050000,,-25362000,-25245000,58747,UUUU
2017-12-31,,,-27990000,3883000,-27766000,15198000,8336000,-24659000,-24659000,14213000,-2101000,,,,0,31046000,55705000,22710000,-3331000,,-27990000,-27766000,58747,UUUU
2016-12-31,,,-39864000,3742000,-39413000,15898000,13737000,-38774000,-38774000,32258000,-2289000,,,,0,54552000,93326000,40815000,-1090000,,-39864000,-39413000,58747,UUUU
2020-02-29,,,50713216,,50713216,3041191,23505769,20464578,20464578,,-2610965,,,,0,23505769,3041191,0,30248638,,50713216,50713216,58748,OIA
2019-02-28,,,15659627,,15659627,2859185,23602639,20705047,20705047,38407.0,-2772514,,,,0,23602639,2897592,0,-5045420,,15659627,15659627,58748,OIA
2018-02-28,,,17829193,,17829193,2784885,24471940,21491058,21491058,195997.0,-1319433,,,,0,24471940,2980882,0,-3661865,,17829193,17829193,58748,OIA
2017-02-28,,,9548543,,9548543,2638349,22984787,20204912,20204912,141526.0,-784191,,,,0,22984787,2779875,0,-10656369,,9548543,9548543,58748,OIA
2019-12-31,,,-65004000,,-65004000,11304000,89584000,-1254000,-1254000,26831000,-12878000,,,,0,129146000,130400000,39562000,-63750000,,-65004000,-65004000,58749,AXAS
2018-12-31,,,57821000,,57821000,12041000,112844000,65588000,65588000,-8060000,-7493000,,,,0,149167000,83579000,36323000,-7767000,,57821000,57821000,58749,AXAS
2017-12-31,,,16006000,,16006000,16276000,63839000,19037000,19037000,1849000,-2920000,,,,0,86264000,67227000,22425000,-3031000,,16006000,16006000,58749,AXAS
2016-12-31,,,-96378000,,-96378000,13562000,32232000,-24280000,-24280000,18028000,-4847000,,,,0,56555000,80835000,24323000,-72098000,,-96378000,-96378000,58749,AXAS
2019-12-31,,,-43399000,22602000,-34360000,13793000,4271000,-30287000,-30287000,,-2062000,,,,-5272000,4271000,34558000,0,-13112000,,-38127000,-34958000,58751,FUBO
2018-12-31,,,-15206000,26742000,-10610000,6746000,0,-14963000,-14963000,,-2651000,,,,-2114000,0,14963000,0,-243000,,-13092000,-10610000,58751,FUBO
2017-12-31,,,10485000,26742000,10474000,1185000,41000,-1144000,-1144000,,-911000,,,,0,41000,1185000,0,11629000,-11000.0,10485000,10474000,58751,FUBO
2016-12-31,161000.0,,-9862000,-189000,-10066000,778000,18000,-921000,-921000,,-168000,,,,0,24000,945000,6000,-8941000,-204000.0,-9862000,-10066000,58751,FUBO
2020-09-30,3713000,,-7498000,,-6478000,46929000,45332000,-5310000,-5310000,,-1332000,,,,-1020000,380530000,385840000,335198000,-2188000,,-6478000,-6565000,58752,HAYN
2019-09-30,3592000,,13370000,,9745000,47641000,65503000,14270000,14270000,,-986000,,,,3625000,490215000,475945000,424712000,-900000,,9745000,9695000,58752,HAYN
2018-09-30,3785000,,-4054000,,-21751000,55268000,55835000,-3218000,-3218000,,-918000,,,,17697000,435326000,438544000,379491000,-836000,,-21751000,-21845000,58752,HAYN
2017-09-30,3855000,,-17217000,,-10190000,58372000,45689000,-16538000,-16538000,,-865000,,,,-7027000,395209000,411747000,349520000,-679000,,-10190000,-10294000,58752,HAYN
2020-12-31,,,6514520000,1148102000,13563886000,21732689000,38566446000,0,7555899000,9277858000,,,,,-7183345000,38851282000,31295383000,284836000,-1041379000,,13697865000,13563886000,58753,BSBR
2019-12-31,,,14437868000,1688116000,14090840000,21472022000,48895909000,0,15684630000,11739257000,,,,,-30095000,49149426000,33464796000,253517000,-1246762000,,14467963000,14090840000,58753,BSBR
2018-12-31,,,15909771000,529990000,12582477000,16589316000,35619233000,0,16733891000,2296026000,,,,,3109853000,36949782000,20215891000,1330549000,-824120000,,12799918000,12582477000,58753,BSBR
2017-12-31,,,14513684000,436894000,8924064000,15904502000,34777986000,0,15291074000,3582410000,,,,,5375636000,36062476000,20771402000,1284490000,-777390000,,9138048000,8924064000,58753,BSBR
2020-02-01,,,-58423000,,-58744000,117828000,96099000,-33192000,-33192000,,-884000,,,,321000,325935000,359127000,229836000,-25231000,,-58744000,-58744000,58754,KSPN
2019-02-02,,,-97302000,,-97382000,156106000,128074000,-37148000,-37148000,,-723000,,,,80000,418190000,455338000,290116000,-60154000,,-97382000,-97382000,58754,KSPN
2018-02-03,,,-42852000,,-42553000,154428000,143843000,-24081000,-24081000,,-332000,,,,-299000,442856000,466937000,299013000,-18771000,,-42553000,-42553000,58754,KSPN
2017-01-28,,,-3562000,,3211000,126605000,136659000,1428000,1428000,-400000.0,-775000,,,,-6773000,353470000,352042000,216811000,-4990000,,3211000,3211000,58754,KSPN
2019-12-31,,,9519246,,9519246,928014,9498646,8570632,8570632,,,,,,0,9498646,928014,0,948614,,9519246,9519246,58756,PVL
2018-12-31,,,14354736,,14354736,1132964,15196364,14063400,14063400,,,,,,0,15196364,1132964,0,291336,,14354736,14354736,58756,PVL
2017-12-31,,,44744073,,44744073,682938,7659288,6976350,6976350,,,,,,0,7659288,682938,0,37767723,,44744073,44744073,58756,PVL
2016-12-31,,,8486280,,8486280,654132,9216892,8562760,8562760,,,,,,0,9216892,654132,0,-76480,,8486280,8486280,58756,PVL
2020-12-31,131429000,,165641000,,164286000,294725000,955734000,400031000,400031000,,-171757000,,,,1355000,3045578000,2645547000,2089844000,-234390000,,164286000,164286000,58760,ST
2019-12-31,148425000,,390423000,,282714000,300752000,1199322000,607647000,607647000,-388000.0,-158554000,,,,107709000,3450631000,2842984000,2251309000,-217224000,,282714000,282714000,58760,ST
2018-12-31,147279000,,526375000,,598995000,323543000,1275764000,665554000,665554000,62000.0,-153679000,,,,-72620000,3521627000,2856073000,2245863000,-139179000,,598995000,598995000,58760,ST
2017-12-31,130127000,,402441000,,408357000,318398000,1187535000,577960000,577960000,62000.0,-159761000,,,,-5916000,3306733000,2728773000,2119198000,-175519000,,408357000,408357000,58760,ST
2019-12-31,,,77072000,,86138000,54507000,602773000,125528000,125528000,,-44942000,,,,-9066000,861332000,735804000,258559000,-48456000,,86138000,86138000,58762,WPM
2018-12-31,,,442983000,,427115000,51650000,548218000,244281000,244281000,,-40156000,,,,15868000,794012000,549731000,245794000,198702000,,427115000,427115000,58762,WPM
2017-12-31,,,56817000,,57703000,31560000,599414000,75822000,75822000,,-24993000,,,,-886000,843215000,767393000,243801000,-19005000,,57703000,57703000,58762,WPM
2016-12-31,,,193807000,,195137000,31511000,637123000,291894000,291894000,4064000.0,-24829000,,,,-1330000,891557000,599663000,254434000,-98087000,,195137000,195137000,58762,WPM
2020-06-30,,,192596000,29902000,199343000,30195000,411105000,198945000,198945000,,-9813000,,,,-3654000,494995000,296050000,83890000,-6349000,,196250000,199343000,58764,RGLD
2019-06-30,,,106577000,33772000,93825000,30488000,341409000,140707000,140707000,,-29650000,,,,17498000,418944000,278237000,77535000,-34130000,,89079000,93825000,58764,RGLD
2018-06-30,,,-104579000,39102000,-113134000,35464000,372935000,-74535000,-74535000,,-34214000,,,,14772000,456774000,531309000,83839000,-30044000,,-119351000,-113134000,58764,RGLD
2017-06-30,,,118866000,44887000,101530000,33350000,351789000,145942000,145942000,,-33500000,,,,26441000,439054000,293112000,87265000,-27076000,,92425000,101530000,58764,RGLD
2019-12-31,,,132252000,-693000,92894000,569406000,709330000,139924000,139924000,,-7672000,,,,39375000,3375586000,3235662000,2666256000,-7672000,,92877000,92894000,58765,GTS
2018-12-31,,,-93172000,-676000,-63302000,554715000,468446000,-86269000,-86269000,,-6903000,,,,-29866000,2996059000,3082328000,2527613000,-6903000,,-63306000,-63302000,58765,GTS
2017-12-31,,,78977000,-682000,54486000,477213000,562984000,85771000,85771000,,-6794000,,,,24496000,2916085000,2830314000,2353101000,-6794000,,54481000,54486000,58765,GTS
2016-12-31,,,11086000,-677000,17438000,493894000,512615000,18721000,18721000,,-7635000,,,,-6345000,2984806000,2966085000,2472191000,-7635000,,17431000,17438000,58765,GTS
2020-12-31,,,53180000,,46570000,129187000,202120000,0,58349000,14584000,,,,,6610000,202120000,143771000,0,-5169000,,46570000,46570000,58767,HFWA
2019-12-31,,,81045000,,67557000,126775000,227833000,0,86255000,14803000,,,,,13488000,227833000,141578000,0,-5210000,,67557000,67500000,58767,HFWA
2018-12-31,,,64295000,,53057000,119460000,213482000,0,80091000,13931000,,,,,11238000,213482000,133391000,0,-15796000,,53057000,52736000,58767,HFWA
2017-12-31,,,60147000,,41791000,95560000,170722000,0,62798000,12364000,,,,,18356000,170722000,107924000,0,-3461000,,41791000,41498000,58767,HFWA
2019-12-31,12032000,,-16306000,,-16306000,4487000,0,-16519000,-16519000,,,,,,0,0,16519000,0,213000,,-16306000,-16619000,58771,LYRA
2018-12-31,4975000,,-6029000,,-6029000,3528000,1244000,-7259000,-7259000,,,,,,0,1244000,8503000,0,1230000,,-6029000,-6110000,58771,LYRA
2019-12-31,,,-82177000,,-82177000,20046000,-70957000,-91003000,-91003000,,,,,,0,0,91003000,70957000,8826000,,-82177000,-82177000,58772,UBX
2018-12-31,,,-76398000,,-76398000,16016000,-58907000,-74923000,-74923000,,,,,,0,0,74923000,58907000,-1475000,,-76398000,-76398000,58772,UBX
2017-12-31,,,-44656000,,-44656000,9617000,-35991000,-45608000,-45608000,,,,,,0,1382000,46990000,37373000,952000,,-44656000,-44656000,58772,UBX
2016-12-31,,,-30404000,,-30404000,5137000,-13707000,-18844000,-18844000,,-2183000.0,,,,0,0,18844000,13707000,-11560000,,-30404000,-30404000,58772,UBX
2019-12-31,,,-29397000,,-29397000,4032000,0,-27365000,-27365000,,-219000,,,,0,0,27365000,0,-2032000,,-29397000,-29397000,58774,ORLA
2018-12-31,,,-29913000,,-29913000,2876000,0,-29847000,-29847000,,-219000,,,,0,0,29847000,0,-66000,,-29913000,-29913000,58774,ORLA
2017-12-31,,,-18700000,,-18700000,2045000,0,-18197000,-18197000,,-219000,,,,0,0,18197000,0,-503000,,-18700000,-18700000,58774,ORLA
2016-12-31,,,-2890183,,-2890183,971549,-145357,-1824900,-1824900,,-859,,,,0,0,1824900,145357,-1065283,,-2890183,-2890183,58774,ORLA
2020-06-30,4915943,,-21916952,,-17418374,55087118,43709483,-16293578,-16293578,,-2620290,,,,-4498578,62483651,78777229,18774168,-5623374,,-17418374,-17418374,58775,MSON
2019-06-30,4467969,,-7358250,,-7386797,30222046,27280152,-7409863,-7409863,,-2620290,,,,28547,38848491,46258354,11568339,51613,,-7386797,-7386797,58775,MSON
2018-06-30,4394149,,-2386906,,-7612435,25431520,26884928,-2940741,-2940741,,-2620290,,,,5416646,36679826,39620567,9794898,553835,191117.0,-7803552,-7612435,58775,MSON
2017-06-30,1837497,,-2865612,,-1681179,21081113,19052524,-3866086,-3866086,,-2620290,,,,-1022808,27269963,31136049,8217439,1000474,161625.0,-1842804,-1681179,58775,MSON
2021-01-01,,,1322000000,,1119000000,3315000000,5339000000,2024000000,2024000000,,-270000000,,,,234000000,18194000000,16170000000,12855000000,-702000000,-2000000,1088000000,1119000000,58776,LHX
2020-01-03,,,1816000000,157000000.0,1644000000,2684000000,5358000000,2674000000,2674000000,,-270000000,,,,146000000,18526000000,15852000000,13168000000,-858000000,-2000000,1670000000,1644000000,58776,LHX
2019-06-28,,,1113000000,157000000.0,949000000,991000000,2334000000,1343000000,1343000000,,-169000000,,,,160000000,6801000000,5458000000,4467000000,-230000000,-4000000,953000000,947000000,58776,LHX
2018-06-29,,,908000000,157000000.0,699000000,946000000,2102000000,1156000000,1156000000,,-170000000,,,,206000000,6168000000,5012000000,4066000000,-248000000,-3000000,702000000,697000000,58776,LHX
2020-06-30,1714077,,1630927,,866929,8961150,13842499,2037931,2037931,,-339446,,,,763998,34967963,32930032,21125464,-407004,,866929,866929,58777,LPTH
2019-06-30,2016615,,-2225117,,-2680323,9298651,12518920,-17010,-17010,,-603113,,,,455206,33749088,33766098,21230168,-2208107,,-2680323,-2680323,58777,LPTH
2018-06-30,1618994,,233027,,1060104,9218346,12527731,373309,373309,,-653948,,,,-827077,32525471,32152162,19997740,-140282,,1060104,1060104,58777,LPTH
2017-06-30,1235934,,3361786,,7703086,8001023,14719459,4788555,4788555,,-413427,,,,-4341300,28367489,23578934,13648030,-1426769,,7703086,7703086,58777,LPTH
2020-10-31,,,-338013078,,-338013078,28857119,120139068,91281949,91281949,,-28064628,,,,0,120139068,28857119,0,-429295027,,-338013078,-338013078,58778,DNP
2019-10-31,,,646164524,,646164524,29530343,126924178,97393835,97393835,,-37667115,,,,0,126924178,29530343,0,548770689,,646164524,646164524,58778,DNP
2018-10-31,,,-47175853,,-47175853,27494741,120141921,92647180,92647180,,-34855717,,,,0,120141921,27494741,0,-139823033,,-47175853,-47175853,58778,DNP
2017-10-31,,,389071837,,389071837,28214629,119313065,91098436,91098436,,-28854117,,,,0,119313065,28214629,0,297973401,,389071837,389071837,58778,DNP
2020-12-31,,,2899000000,,2420000000,6356000000,11615000000,0,3316000000,1943000000,,,,,479000000,11615000000,8299000000,0,-417000000,,2420000000,2257000000,58779,STT
2019-12-31,,,2712000000,,2242000000,6480000000,11702000000,0,3091000000,2131000000,,,,,470000000,11702000000,8611000000,0,-379000000,,2242000000,2009000000,58779,STT
2018-12-31,,,3101000000,,2593000000,6419000000,12116000000,0,3651000000,2046000000,,,,,508000000,12116000000,8465000000,0,-550000000,,2593000000,2404000000,58779,STT
2017-12-31,,,2995000000,,2156000000,6089000000,11264000000,0,3475000000,1700000000,,,,,839000000,11264000000,7789000000,0,-480000000,,2156000000,1972000000,58779,STT
2020-12-31,,,-2181000000,565000000,-1685000000,1334000000,1838000000,-1608000000,-1608000000,834000000,-536000000,,,,-38000000,3612000000,5220000000,1774000000,-573000000,,-2143000000,-1685000000,58780,LVS
2019-12-31,,,3772000000,1320000000,2698000000,1890000000,10887000000,3788000000,3788000000,3980000000,-555000000,,,,468000000,13739000000,9951000000,2852000000,-16000000,,3304000000,2698000000,58780,LVS
2018-12-31,,,3326000000,1061000000,2413000000,1732000000,10845000000,3901000000,3901000000,4090000000,-446000000,,,,375000000,13729000000,9828000000,2884000000,-575000000,,2951000000,2413000000,58780,LVS
2017-12-31,,,3054000000,1141000000,2808000000,1640000000,9999000000,3484000000,3484000000,3600000000,-327000000,,,,-209000000,12728000000,9244000000,2729000000,-430000000,,3263000000,2808000000,58780,LVS
2019-12-31,5174000,,11129000,,10971000,117416000,134236000,11646000,11646000,,,,,,158000,189492000,177846000,55256000,-517000,,10971000,10971000,58781,TCMD
2018-12-31,5289000,,3476000,,6623000,92179000,102258000,4790000,4790000,,,,,,-3147000,143751000,138961000,41493000,-1314000,,6623000,6623000,58781,TCMD
2017-12-31,5060000,,4190000,,5855000,71310000,80268000,3898000,3898000,,,,,,-1665000,109283000,105385000,29015000,292000,,5855000,5855000,58781,TCMD
2016-12-31,4476000,,4310000,,2879000,52854000,61602000,4272000,4272000,,,,,,1431000,84542000,80270000,22940000,38000,,2879000,1632000,58781,TCMD
2019-12-31,,,359499,,359499,207554,0,-207554,-207554,,,,,,0,0,207554,0,359499,,359499,-182604,58782,ALUS
2019-12-31,,,-89860000,,-89860000,16605000,-76290000,-92895000,-92895000,,,,,,0,0,92895000,76290000,3035000,,-89860000,-89860000,58783,CALA
2018-12-31,,,-54629000,,-54629000,13340000,-43941000,-57281000,-57281000,,,,,,0,22254000,79535000,66195000,2652000,,-54629000,-54629000,58783,CALA
2017-12-31,,,-27826000,,-27826000,12530000,-17156000,-29686000,-29686000,,,,,,0,25955000,55641000,43111000,1860000,,-27826000,-27826000,58783,CALA
2016-12-31,,,-38004000,,-38004000,10586000,-27748000,-38334000,-38334000,,,,,,0,0,38334000,27748000,330000,,-38004000,-38004000,58783,CALA
2019-12-31,194311,,-10878308,,-10878308,9109260,561622,-8741949,-8741949,,-258365,,,,0,902937,9644886,341315,-2136359,,-10878308,-10878308,58784,GHSI
2018-12-31,231847,,-7767407,,-7767407,6455848,543974,-6143721,-6143721,,-2289,,,,0,942153,7085874,398179,-1623686,,-7767407,-7767407,58784,GHSI
2017-12-31,259463,,-5305169,,-5305169,5283858,261879,-5281442,-5281442,,-23727,,,,0,437349,5718791,175470,-23727,,-5305169,-6215749,58784,GHSI
2016-12-31,33084,,-5748397,,-5748397,3728197,65327,-3695954,-3695954,,-1104557,,,,0,141029,3836983,75702,-2052443,,-5748397,-6543426,58784,GHSI
2019-12-31,69122000,,-81571000,,-85951000,104309000,35873000,-137558000,-137558000,,,,,,4380000,370007000,507565000,334134000,55987000,,-85951000,-85951000,58785,ARLO
2018-12-31,58794000,,-74711000,,-75483000,80802000,92075000,-47521000,-47521000,,,,,,772000,464918000,512439000,372843000,-27190000,,-75483000,-75483000,58785,ARLO
2017-12-31,34683000,,7677000,,6549000,49436000,91234000,7115000,7115000,,,,,,1128000,370658000,363543000,279424000,562000,,6549000,6549000,58785,ARLO
2016-12-31,24438000,,-13660000,,-13743000,26744000,38034000,-13148000,-13148000,,,,,,83000,184604000,197752000,146570000,-512000,,-13743000,-13743000,58785,ARLO
2020-12-26,,,968147000,,748958000,2473446000,3761549000,1070979000,1070979000,,-28781000,,,,219189000,10620352000,9549373000,6858803000,-102832000,,748958000,748958000,58787,TSCO
2019-12-28,,,723377000,,562354000,1929672000,2871770000,746120000,746120000,,-19843000,,,,161023000,8351931000,7605811000,5480161000,-22743000,,562354000,562354000,58787,TSCO
2018-12-29,,,683385000,,532357000,1823440000,2702528000,701737000,701737000,,-18352000,,,,151028000,7911046000,7209309000,5208518000,-18352000,,532357000,532357000,58787,TSCO
2017-12-30,,,672523000,,422599000,1639749000,2491965000,686382000,686382000,,-13859000,,,,249924000,7256382000,6570000000,4764417000,-13859000,,422599000,422599000,58787,TSCO
2019-12-31,,,6357000000,8395000000,3969000000,201000000,2861000000,2897000000,2897000000,-95000000,-429000000,,,,1783000000,9717000000,6820000000,6856000000,3460000000,,4574000000,3969000000,58788,GOLD
2018-12-31,,,-237000000,1792000000,-1545000000,225000000,2195000000,1201000000,1201000000,168000000,-448000000,,,,1198000000,7243000000,6042000000,5048000000,-1438000000,,-1435000000,-1545000000,58788,GOLD
2017-12-31,,,2747000000,1781000000,1438000000,258000000,3095000000,2672000000,2672000000,168000000,-517000000,,,,1231000000,8374000000,5702000000,5279000000,75000000,,1516000000,1438000000,58788,GOLD
2016-12-31,,,1778000000,2378000000,655000000,261000000,3197000000,2605000000,2605000000,190000000,-610000000,,,,917000000,8558000000,5953000000,5361000000,-827000000,,861000000,655000000,58788,GOLD
2020-06-30,,,551046,,551046,275927,0,-275927,-275927,,,,,,0,0,275927,0,826973,,551046,551046,58790,ESSC
2019-06-30,,,-16176,,-16176,16176,0,-16176,-16176,,,,,,0,0,16176,0,0,,-16176,-16176,58790,ESSC
2019-12-31,,,140334000,,127293000,339304000,1021242000,128148000,128148000,452234000,-2497000,,,,13041000,2482692000,2354544000,1461450000,12186000,,127293000,127293000,58792,CAKE
2019-01-01,,,107411000,,99035000,258916000,965317000,136809000,136809000,462392000,-6783000,,,,8376000,2332331000,2195522000,1367014000,-29398000,,99035000,99035000,58792,CAKE
2018-01-02,,,146466000,,157392000,244479000,963519000,163188000,163188000,449602000,-5900000,,,,-10926000,2260502000,2097314000,1296983000,-16722000,,157392000,157392000,58792,CAKE
2017-01-03,,,191768000,,139494000,284978000,989093000,201107000,201107000,401178000,-5600000,,,,52274000,2275719000,2074612000,1286626000,-9339000,,139494000,139494000,58792,CAKE
2019-12-31,,,-53467000,1081000,-55548000,161210000,159345000,-1865000,-1865000,,-15935000,,,,1912000,598649000,600514000,439304000,-51602000,,-55379000,-56031000,58793,JAKK
2018-12-31,,,-39474000,912000,-42368000,185142000,155716000,-29426000,-29426000,,-10243000,,,,2951000,567810000,597236000,412094000,-10048000,,-42425000,-42368000,58793,JAKK
2017-12-31,,,-81422000,969000,-83085000,196323000,155681000,-49542000,-49542000,,-9829000,,,,1606000,613111000,662653000,457430000,-31880000,,-83028000,-83085000,58793,JAKK
2016-12-31,,,5376000,912000,1243000,205915000,223021000,17106000,17106000,,-12975000,,,,4127000,706603000,689497000,483582000,-11730000,,1249000,1243000,58793,JAKK
2020-08-31,,,370778000,212000,279503000,504572000,944798000,440226000,440226000,,-61837000,,,,92476000,5476486000,5036260000,4531688000,-69448000,1201000,278302000,279503000,58794,CMC
2019-08-31,,,268460000,196000,198093000,412271000,803488000,391217000,391217000,,-71373000,,,,69681000,5829002000,5437785000,5025514000,-122757000,-686000,198779000,198093000,58794,CMC
2018-08-31,,,165384000,186000,138506000,401452000,622165000,220713000,220713000,,-40957000,,,,30147000,4643723000,4423010000,4021558000,-55329000,3269000,135237000,138506000,58794,CMC
2017-08-31,,,65451000,173000,46332000,387354000,521358000,134004000,134004000,,-44151000,,,,15276000,3844069000,3710065000,3322711000,-68553000,-3843000,50175000,46332000,58794,CMC
2019-12-31,,,3661948000,10838616000,1316341000,2358928000,6451176000,4227361000,4227361000,-135113000,-2004654000,,,,779596000,20611409000,16384048000,14160233000,-565413000,11021000,2882352000,1316341000,58798,CZZ
2018-12-31,,,2871897000,11354953000,975448000,1994774000,4726463000,2936413000,2936413000,-204724000,-1749657000,,,,760487000,16834768000,13898355000,12108305000,-64516000,-28230000,2111410000,975448000,58798,CZZ
2017-12-31,,,1514851000,11020656000,551021000,1992163000,4354707000,2394502000,2394502000,-31958000,-1830000000,,,,428355000,13579021000,11184519000,9224314000,-879651000,-40199000,1086496000,551021000,58798,CZZ
2016-12-31,,,555987000,9737286000,277804000,2038276000,4200649000,2168079000,2168079000,-5706000,-2333294000,,,,61702000,12518139000,10350060000,8317490000,-1612092000,-35262000,494285000,277804000,58798,CZZ
2020-12-31,,,26831000000,39000000,20154000000,31904000000,67183000000,0,30127000000,5152000000,,,,,6677000000,67183000000,37056000000,0,-3296000000,,20154000000,20154000000,58799,BSMX
2019-12-31,,,28688000000,42000000,21332000000,30763000000,67197000000,0,31685000000,4749000000,,,,,7356000000,67197000000,35512000000,0,-2997000000,,21332000000,21332000000,58799,BSMX
2018-12-31,,,25139000000,32000000,19584000000,27695000000,60575000000,0,28415000000,4465000000,,,,,5555000000,60575000000,32160000000,0,-3276000000,,19584000000,19584000000,58799,BSMX
2017-12-31,,,22042000000,30000000,17645000000,24573000000,52884000000,0,24563000000,3748000000,,,,,4397000000,52884000000,28321000000,0,-2521000000,,17645000000,17645000000,58799,BSMX
2019-12-31,128700000,,21641000,,32839000,72981000,220682000,19001000,19001000,,,,,,-11198000,464663000,445662000,243981000,2640000,,32839000,32839000,58803,ACIA
2018-12-31,102406000,,-404000,,4916000,51864000,147120000,-7150000,-7150000,,,,,,-5320000,339891000,347041000,192771000,6746000,,4916000,4916000,58803,ACIA
2017-12-31,92027000,,40303000,,38508000,38807000,167840000,37006000,37006000,,,,,,1795000,385166000,348160000,217326000,3297000,,38508000,38508000,58803,ACIA
2016-12-31,75696000,,114621000,,131577000,27676000,220987000,117615000,117615000,,,,,,-16956000,478412000,360797000,257425000,-2994000,,131577000,95284000,58803,ACIA
2019-12-31,,,364101000,,364101000,46174000,410275000,0,364101000,,,,,,0,410275000,46174000,0,0,,364101000,319675000,58805,IVR
2018-12-31,,,-70536000,,-70790000,47792000,-22718000,0,-70510000,,,,,,0,-22718000,47792000,0,-26000,,-70536000,-115216000,58805,IVR
2017-12-31,,,353057000,26387000.0,348607000,44746000,404617000,0,359871000,,,,,,0,404617000,44746000,0,-6814000,,353057000,320527000,58805,IVR
2016-12-31,,,257698000,28624000.0,254411000,44106000,299504000,0,255398000,,,,,,0,299504000,44106000,0,2300000,,257698000,231547000,58805,IVR
2019-12-31,77649000,,6072000,129961000,-10806000,138283000,325779000,20722000,20722000,,-5010000,,,,4105000,438722000,418000000,112943000,-14650000,,1967000,-10806000,58806,ATNI
2018-12-31,73031000,,53742000,127937000,19815000,137933000,336729000,40046000,40046000,,-7973000,,,,18870000,451207000,411161000,114478000,13696000,,34872000,19815000,58806,ATNI
2017-12-31,74614000,,47553000,141496000,31488000,137018000,360569000,62003000,62003000,,-8838000,,,,-1341000,481193000,419190000,120624000,-14450000,,48894000,31488000,58806,ATNI
2016-12-31,60414000,,45374000,132114000,12101000,122084000,330560000,72082000,72082000,,-5362000,,,,21160000,457003000,384921000,126443000,-26708000,,24214000,12101000,58806,ATNI
2020-04-30,,,-12778894,,-12778894,2860325,21417064,18556739,18556739,,-4013117,,,,0,21417064,2860325,0,-31335633,,-12778894,-12778894,58810,MVT
2019-04-30,,,19920393,,19920393,2843009,23493434,20650425,20650425,,-4797406,,,,0,23493434,2843009,0,-730032,,19920393,19920393,58810,MVT
2018-04-30,,,8887805,,8887805,2947822,24369325,21421503,21421503,,-3862101,,,,0,24369325,2947822,0,-12533698,,8887805,8887805,58810,MVT
2017-04-30,,,-732993,,-732993,3054372,25437537,22383165,22383165,,-3176849,,,,0,25437537,3054372,0,-23116158,,-732993,-732993,58810,MVT
2019-12-31,,,-110273000,,-131903000,47218000,-46454000,-93672000,-93672000,,-19320000,,,,-911000,576135000,669807000,622589000,-16601000,-22541000,-109362000,-131903000,58812,MHLD
2018-12-31,,,-449851000,641000.0,-544624000,59440000,-370054000,-429494000,-429494000,,-19318000,,,,441000,2164807000,2594301000,2534861000,-20357000,-94113000,-450292000,-570277000,58812,MHLD
2017-12-31,,,-154406000,452000.0,-169896000,53004000,-60412000,-113416000,-113416000,,-26069000,,,,-6757000,2138818000,2252234000,2199230000,-40990000,-22096000,-147649000,-199075000,58812,MHLD
2016-12-31,,,79473000,355000.0,48980000,50254000,146833000,96579000,96579000,,-30518000,,,,413000,2051868000,1955289000,1905035000,-18906000,-30922000,79060000,15217000,58812,MHLD
2020-11-27,2188000000,,4176000000,,5260000000,4559000000,11146000000,4237000000,4237000000,,-116000000,,,,-1084000000,12868000000,8631000000,1722000000,-61000000,,5260000000,5260000000,58813,ADBE
2019-11-29,1930000000,,3205000000,,2951000000,4125000000,9498000000,3268000000,3268000000,,-157000000,,,,254000000,11171000000,7903000000,1673000000,-63000000,,2951000000,2951000000,58813,ADBE
2018-11-30,1538000000,,2794000000,,2591000000,3366000000,7835000000,2840000000,2840000000,,-89000000,,,,203000000,9030000000,6190000000,1195000000,-46000000,,2591000000,2591000000,58813,ADBE
2017-12-01,1224059000,,2137641000,,1693954000,2822298000,6291014000,2168095000,2168095000,,-74402000,,,,443687000,7301505000,5133410000,1010491000,-30454000,,1693954000,1693954000,58813,ADBE
2019-12-31,1095031000,,3844569000,188724000,2970890000,4218106000,8522993000,3554699000,3554699000,-344843000,-78611000,,,,883801000,17015089000,13460390000,8492096000,289870000,,2960768000,2970890000,58815,MOMO
2018-12-31,760644000,,3488195000,92300000,2815775000,2452285000,6225524000,3266292000,3266292000,-253697000,-56503000,,,,699648000,13408421000,10142129000,7182897000,221903000,,2788547000,2815775000,58815,MOMO
2017-12-31,346144000,,2589464000,18537000,2148098000,1889381000,4513013000,2434252000,2434252000,-156764000,-56503000,,,,445001000,8886390000,6452138000,4373377000,155212000,,2144463000,2148098000,58815,MOMO
2016-12-31,208647000,,1013607000,18537000,978969000,906950000,2088031000,975093000,975093000,-2659000,-56503000,,,,34638000,3707358000,2732265000,1619327000,38514000,,978969000,957419000,58815,MOMO
2020-10-31,,,364855000,251638000,313984000,304964000,682127000,377163000,377163000,,-13159000,,,,29000000,1787009000,1409846000,1104882000,-12308000,,335855000,313984000,58816,HEI
2019-10-31,,,437841000,216382000,327896000,354113000,813840000,459727000,459727000,,-21695000,,,,78100000,2055647000,1595920000,1241807000,-21886000,,359741000,327896000,58816,HEI
2018-10-31,,,356286000,236803000,259233000,315835000,690715000,374880000,374880000,,-19901000,,,,70600000,1777721000,1402841000,1087006000,-18594000,,285686000,259233000,58816,HEI
2017-10-31,,,297960000,218335000,185985000,266967000,574725000,307758000,307758000,,-9790000,,,,90300000,1524813000,1217055000,950088000,-9798000,,207660000,185985000,58816,HEI
2020-12-31,,,-16924000,,-42718000,87195000,169124000,4836000,4836000,11621000,-6841000,,,,-2804000,838561000,833725000,669437000,-21760000,-28598000,-14120000,-42718000,58817,CVLG
2019-12-31,,,11941000,,8477000,78158000,186095000,16034000,16034000,13024000,-11110000,,,,3464000,894528000,878494000,708433000,-4093000,-28598000,8477000,8477000,58817,CVLG
2018-12-31,,,58010000,,42503000,66560000,213533000,58986000,58986000,11831000,-8708000,,,,15507000,885455000,826469000,671922000,-976000,-28598000,42503000,42503000,58817,CVLG
2017-12-31,,,23297000,,55439000,47938000,162418000,28155000,28155000,9878000,-8258000,,,,-32142000,705007000,676852000,542589000,-5758000,-28598000,55439000,55439000,58817,CVLG
2019-12-31,,,-13000000,3746000,-10872000,46010000,208593000,24799000,24799000,,-63987000,,,,0,345435000,320636000,136842000,-37799000,,-13000000,-39130000,58820,PEI
2018-12-31,,,-126503000,105770000,-110329000,38342000,231132000,60474000,60474000,-800000.0,-61355000,,,,0,373057000,312583000,141925000,-186977000,,-126503000,-138246000,58820,PEI
2017-12-31,,,-32848000,129131000,-25953000,36736000,238732000,74974000,74974000,-1800000.0,-58430000,,,,0,379805000,304831000,141073000,-107822000,,-32848000,-58273000,58820,PEI
2016-12-31,,,-12713000,147152000,-9663000,35269000,254047000,98369000,98369000,-6260000.0,-70724000,,,,0,411965000,313596000,157918000,-111082000,,-12713000,-25833000,58820,PEI
2020-12-31,,,681000000,,585000000,525000000,2458000000,1265000000,1265000000,,-275000000,,,,99000000,11781000000,10516000000,9323000000,-584000000,,582000000,585000000,58822,BLL
2019-12-31,,,607000000,70000000.0,566000000,417000000,2271000000,1176000000,1176000000,,-317000000,,,,71000000,11474000000,10298000000,9203000000,-569000000,,536000000,566000000,58822,BLL
2018-12-31,,,638000000,104000000.0,454000000,478000000,2306000000,1126000000,1126000000,,-301000000,,,,185000000,11635000000,10509000000,9329000000,-488000000,,453000000,454000000,58822,BLL
2017-12-31,,,545000000,105000000.0,374000000,514000000,2266000000,1058000000,1058000000,,-285000000,,,,165000000,10983000000,9925000000,8717000000,-513000000,,380000000,374000000,58822,BLL
2019-12-31,,,48761000,94284000,17691000,579419000,635646000,56227000,56227000,,-45782000,,,,16658000,869366000,813139000,233720000,-7466000,,32103000,17691000,58823,BVH
2018-12-31,,,87432000,90567000,35102000,534162000,650917000,116755000,116755000,,-42075000,,,,31639000,878801000,762046000,227884000,-29323000,,55793000,35102000,58823,BVH
2017-12-31,,,92601000,84819000,83925000,529098000,632651000,103553000,103553000,,-35205000,,,,-9702000,814679000,711126000,182028000,-10952000,,102303000,83925000,58823,BVH
2016-12-31,,,78986000,40850000,29430000,515481000,619550000,104069000,104069000,,-36037000,,,,36390000,769383000,665314000,149833000,-25083000,,42596000,29430000,58823,BVH
2020-11-30,,,-10253000000,,-10236000000,1885000000,834000000,-4917000000,-4917000000,1625000000,-895000000,,,,-17000000,5594000000,10511000000,4760000000,-5336000000,,-10236000000,-10236000000,58825,CUK
2019-11-30,,,3061000000,,2990000000,2486000000,11110000000,3297000000,3297000000,3167000000,-206000000,,,,71000000,20825000000,17528000000,9715000000,-236000000,,2990000000,2990000000,58825,CUK
2018-11-30,,,3206000000,,3152000000,2459000000,10777000000,3389000000,3389000000,2912000000,-194000000,,,,54000000,18880000000,15491000000,8103000000,-183000000,,3152000000,3152000000,58825,CUK
2017-11-30,,,2666000000,,2606000000,2265000000,7313000000,3237000000,3237000000,-35000000,-198000000,,,,60000000,17510000000,14273000000,10197000000,-571000000,,2606000000,2606000000,58825,CUK
2019-12-31,52553000,,77178000,,72921000,162402000,320805000,105850000,105850000,,-14790000,,,,4257000,534890000,429040000,214085000,-28672000,,72921000,72921000,58827,QDEL
2018-12-31,51649000,,63384000,,74183000,152824000,319363000,114890000,114890000,,-24283000,,,,-10799000,522285000,407395000,202922000,-51506000,,74183000,74183000,58827,QDEL
2017-12-31,33644000,,-8036000,,-8165000,96440000,167011000,36927000,36927000,,-17588000,,,,129000,277743000,240816000,110732000,-44963000,,-8165000,-8165000,58827,QDEL
2016-12-31,38672000,,-16199000,,-13808000,76787000,111246000,-4213000,-4213000,,-12181000,,,,-2391000,191603000,195816000,80357000,-11986000,,-13808000,-13808000,58827,QDEL
2019-12-31,30557000,,30902000,,31057000,138637000,211122000,32443000,32443000,489000,-2036000,,,,-155000,321500000,289057000,110378000,-1541000,,31057000,31057000,58831,VERX
2018-12-31,23755000,,-4427000,,-6106000,115845000,176705000,29980000,29980000,-812000,-2120000,,,,1679000,272403000,242423000,95698000,-34407000,,-6106000,-6106000,58831,VERX
2019-12-31,,,-8841000,,-4753000,29592000,63914000,18163000,18163000,,-6728000,,,,-4088000,519704000,501541000,455790000,-27004000,,-4753000,-4753000,58832,MEC
2018-12-31,,,17476000,,17935000,22386000,53213000,22731000,22731000,,-3879000,,,,-459000,354526000,331795000,301313000,-5255000,,17935000,17935000,58832,MEC
2017-12-31,,,5246000,,5246000,19411000,36593000,9426000,9426000,,-4180000,,,,0,313331000,303905000,276738000,-4180000,,5246000,5246000,58832,MEC
2020-12-31,,,274464000,,166296000,428015000,844843000,0,263039000,,,,,,56074000,892343000,629304000,47500000,11425000,,218390000,166296000,58833,TW
2019-12-31,,,225326000,1214157000.0,126121000,405932000,736281000,0,189819000,1200000.0,,,,,52302000,775566000,585747000,39285000,35507000,,173024000,83769000,58833,TW
2018-12-31,,,174782000,1214157000.0,159467000,366976000,647903000,0,199099000,1200000.0,,,,,15315000,684408000,485309000,36505000,-24317000,,159467000,159467000,58833,TW
2017-12-31,,,89777000,1214157000.0,83648000,316728000,532955000,0,147612000,1200000.0,,,,,6129000,562968000,415356000,30013000,-57835000,,83648000,83648000,58833,TW
2020-12-31,,,-6097000000,,-4319000000,9981000000,14107000000,-5639000000,-5639000000,53000000,-982000000,,,,-1778000000,24662000000,30301000000,10555000000,-458000000,,-4319000000,-4319000000,58834,SU
2019-12-31,,,2533000000,,2899000000,11303000000,24333000000,2087000000,2087000000,115000000,-930000000,,,,-366000000,38344000000,36257000000,14011000000,446000000,,2899000000,2899000000,58834,SU
2018-12-31,,,4983000000,,3293000000,10629000000,23103000000,6603000000,6603000000,11000000,-797000000,,,,1690000000,38542000000,31939000000,15439000000,-1620000000,,3293000000,3293000000,58834,SU
2017-12-31,,,5916000000,,4458000000,9246000000,19797000000,4525000000,4525000000,321000000,-221000000,,,,1458000000,31954000000,27429000000,12157000000,1391000000,,4458000000,4458000000,58834,SU
2020-01-31,,,20116000000,6883000000,14881000000,107891000000,129359000000,21468000000,21468000000,,-2599000000,,,,4915000000,523964000000,502496000000,394605000000,-1352000000,,15201000000,14881000000,58837,WMT
2019-01-31,,,11460000000,7138000000,6670000000,106987000000,129104000000,22117000000,22117000000,,-2346000000,,,,4281000000,514405000000,492288000000,385301000000,-10657000000,,7179000000,6670000000,58837,WMT
2018-01-31,,,15123000000,2953000000,9862000000,106010000000,126947000000,20937000000,20937000000,,-2330000000,,,,4600000000,500343000000,479406000000,373396000000,-5814000000,,10523000000,9862000000,58837,WMT
2017-01-31,,,20497000000,2737000000,13643000000,101853000000,124617000000,22764000000,22764000000,,-2367000000,,,,6204000000,485873000000,463109000000,361256000000,-2267000000,,14293000000,13643000000,58837,WMT
2019-12-31,32100000,,33968000,1604000,31622000,227449000,404331000,118082000,118082000,,-18767000,,,,2084000,1133503000,1015421000,729172000,-84114000,,31884000,31532000,58839,KWR
2018-12-31,24500000,,84861000,1317000,59473000,178357000,312314000,102157000,102157000,,-6228000,,,,25050000,867520000,765363000,555206000,-17296000,,59811000,59220000,58839,KWR
2017-12-31,23900000,,63953000,1946000,20278000,171461000,291495000,88734000,88734000,,-4133000,,,,41653000,820082000,731348000,528587000,-24781000,,22300000,20141000,58839,KWR
2016-12-31,23900000,,86265000,9846000,61403000,195967000,280110000,84143000,84143000,,-2889000,,,,23226000,746665000,662522000,466555000,2122000,,63039000,60888000,58839,KWR
2020-12-31,713700000,,-405400000,,-429400000,819500000,1163000000,-370200000,-370200000,,-30300000,,,,24000000,1974800000,2345000000,811800000,-35200000,,-429400000,-429400000,58840,ZNGA
2019-12-31,304289000,,47335000,,41925000,566981000,797570000,-73700000,-73700000,,-16971000,,,,5410000,1321659000,1395359000,524089000,121035000,,41925000,41925000,58840,ZNGA
2018-12-31,264823000,,26463000,,15457000,323765000,602550000,13962000,13962000,,-255000,,,,11006000,907208000,893246000,304658000,12501000,,15457000,15457000,58840,ZNGA
2017-12-31,256012000,,37583000,,26639000,320683000,602419000,25724000,25724000,,-22000,,,,10944000,861390000,835666000,258971000,-2325000,,26639000,26628000,58840,ZNGA
2019-12-31,11052903,,-21493852,,-16433074,9865005,-89968,-21007876,-21007876,,-787488,,,,-5060778,283266,21291142,373234,-485976,,-16433074,-43535672,58842,CRMD
2018-12-31,18822488,,-26829630,,-26829630,8074719,33011,-26864196,-26864196,,-1873,,,,0,429797,27293993,396786,34566,,-26829630,-26829630,58842,CRMD
2017-12-31,24486122,,-33009914,,-33009914,8652351,214363,-32924110,-32924110,,-5619,,,,0,329327,33253437,114964,-85804,,-33009914,-33009914,58842,CRMD
2016-12-31,15735300,,-24643627,,-24643627,8883050,-142568,-24760918,-24760918,,-1311,,,,0,224105,24985023,366673,117291,,-24643627,-24643627,58842,CRMD
2020-12-31,,,-1464000000,1321000000,-931000000,3983000000,3810000000,-173000000,-173000000,,-515000000,,,,-173000000,12549000000,12722000000,8739000000,-1291000000,,-1291000000,-931000000,58844,L
2019-12-31,,,1119000000,2811000000,932000000,4851000000,6634000000,1783000000,1783000000,,-591000000,,,,248000000,14905000000,13122000000,8271000000,-664000000,,871000000,932000000,58844,L
2018-12-31,,,834000000,2868000000,636000000,4806000000,6236000000,1430000000,1430000000,,-574000000,,,,128000000,14066000000,12636000000,7830000000,-596000000,,706000000,636000000,58844,L
2017-12-31,,,1582000000,5362000000,1164000000,4665000000,6893000000,2228000000,2228000000,,-646000000,,,,170000000,13735000000,11507000000,6842000000,-646000000,,1412000000,1164000000,58844,L
2020-12-31,,,59742000,,45270000,91283000,170829000,0,66155000,13391000,,,,,14472000,170829000,104674000,0,-6413000,,45270000,45270000,58845,FMBH
2019-12-31,,,63266000,,47943000,88557000,175258000,0,69776000,16925000,,,,,15323000,175258000,105482000,0,-6510000,,47943000,47943000,58845,FMBH
2018-12-31,,,48505000,,36600000,69336000,138485000,0,53061000,16088000,,,,,11905000,138485000,85424000,0,-4556000,,36600000,36600000,58845,FMBH
2017-12-31,,,41726000,,26684000,58319000,115436000,0,44833000,12284000,,,,,15042000,115436000,70603000,0,-3107000,,26684000,26684000,58845,FMBH
2019-12-31,,,4725000,,3607000,18801000,24575000,0,4791000,,,,,,1118000,28583000,23792000,4008000,-66000,,3607000,3607000,58846,SIEB
2018-12-31,,,7360000,,11962000,18672000,26176000,0,7360000,,,,,,-4602000,30036000,22676000,3860000,0,,11962000,11962000,58846,SIEB
2017-12-31,,,2310000,,2157000,9244000,11669000,0,2310000,,,,,,153000,13110000,10800000,1441000,0,,2157000,2157000,58846,SIEB
2016-12-31,,,-5578000,,-5578000,11032000,8484000,0,-2548000,,,,,,0,9812000,12360000,1328000,-3030000,,-5578000,-5578000,58846,SIEB
2020-12-31,17244000,,7282000,,5725000,10274000,35423000,7905000,7905000,,,,,,1557000,107398000,99493000,71975000,-623000,,5725000,5725000,58847,SILC
2019-12-31,15075000,,11859000,,10236000,10806000,36094000,10213000,10213000,,,,,,1623000,105240000,95027000,69146000,1646000,,10236000,10236000,58847,SILC
2018-12-31,14820000,,17574000,,14637000,10585000,45256000,19851000,19851000,,,,,,2937000,133753000,113902000,88497000,-2277000,,14637000,14637000,58847,SILC
2017-12-31,13915000,,25582000,,21714000,11229000,45928000,20784000,20784000,,,,,,3868000,125690000,104906000,79762000,4798000,,21714000,21714000,58847,SILC
2020-04-30,,,-5687495,,-5249350,4409123,0,-5687495,-5687495,,,,,,-438145,0,5687495,0,0,,-5249350,-7335562,58848,USAU
2019-04-30,,,-7611205,,-8046550,5026788,0,-7611205,-7611205,,,,,,435345,0,7611205,0,0,,-8046550,-8046550,58848,USAU
2018-04-30,,,-8262685,,-13658495,5786280,0,-8262569,-8262569,,-116.0,,,,-435345,0,8262569,0,-116,-5831155.0,-7827340,-15235097,58848,USAU
2017-04-30,,,-4148461,,-4148461,2777223,0,-4145267,-4145267,,-4242.0,,,,0,0,4145267,0,-3194,-5831155.0,-4148461,-4148461,58848,USAU
2019-12-31,7718000,,-291225000,,-291306000,99772000,43916000,-79348000,-79348000,,-9408000,,,,81000,191675000,271023000,147759000,-211877000,,-291306000,-289409000,58849,WTRH
2018-12-31,3913000,,-34738000,,-34311000,46843000,17845000,-34134000,-34134000,,-1822000,,,,-427000,69273000,103407000,51428000,-604000,,-34311000,-34311000,58849,WTRH
2017-12-31,1586000,,-26901000,,-26907000,15098000,1941000,-15466000,-15466000,,-283000,,,,6000,22911000,38377000,20970000,-11435000,,-26907000,-26907000,58849,WTRH
2016-12-31,395000,,-8717000,,-8722000,5510000,865000,-5307000,-5307000,,-4467000,,,,5000,5650000,10957000,4785000,-3410000,,-8722000,-8722000,58849,WTRH
2020-07-31,,,800839000,,699907000,191703000,1007802000,816099000,816099000,,-20230000,,,,100932000,2205583000,1389484000,1197781000,-15260000,,699907000,699907000,58850,CPRT
2019-07-31,,,704951000,,591693000,181867000,898342000,716475000,716475000,,-19810000,,,,113258000,2041957000,1325482000,1143615000,-11524000,,591693000,591693000,58850,CPRT
2018-07-31,,,562511000,,417867000,176890000,762366000,585476000,585476000,,-20368000,,,,144504000,1805695000,1220219000,1043329000,-22965000,,418007000,417867000,58850,CPRT
2017-07-31,,,440100000,534000.0,394227000,181064000,661728000,480664000,480664000,,-23779000,,,,45839000,1447981000,967317000,786253000,-40564000,,394261000,394227000,58850,CPRT
2020-11-30,,,27948984,,27948984,2785209,20241779,17456570,17456570,,-1142485,,,,0,20241779,2785209,0,10492414,,27948984,27948984,58851,MCR
2019-11-30,,,53441726,,53441726,2796205,22118659,19322454,19322454,,-2832409,,,,0,22118659,2796205,0,34119272,,53441726,53441726,58851,MCR
2018-11-30,,,-7334882,,-7334882,2983595,22459726,19476131,19476131,,-2411143,,,,0,22459726,2983595,0,-26811013,,-7334882,-7334882,58851,MCR
2017-11-30,,,35972086,,35972086,3318609,24448048,21129439,21129439,,-1617398,,,,0,24448048,3318609,0,14842647,,35972086,35972086,58851,MCR
2020-12-31,19575000,,23399000,,21778000,31032000,73231000,22624000,22624000,,,,,,1621000,155859000,133235000,82628000,775000,,21778000,21778000,58852,CAMT
2019-12-31,16331000,,22773000,,21986000,26481000,64784000,21972000,21972000,,,,,,1950000,134019000,112047000,69235000,801000,1163000.0,20823000,21986000,58852,CAMT
2018-12-31,14581000,,20761000,,18731000,26182000,60796000,20033000,20033000,,,,,,2030000,123174000,103141000,62378000,523000,1163000.0,18731000,18731000,58852,CAMT
2017-12-31,13534000,,-3187000,,13962000,22022000,45519000,9963000,9963000,,-13000.0,,,,-4875000,93485000,83522000,47966000,-13150000,12274000.0,1688000,13962000,58852,CAMT
2020-11-30,,,364043000,,296243000,464079000,848463000,384384000,384384000,,,,,,67800000,4183174000,3798790000,3334711000,-20341000,,296243000,294717000,58853,KBH
2019-11-30,,,348175000,,268775000,497350000,869007000,371657000,371657000,,,,,,79400000,4552747000,4181090000,3683740000,-23482000,,268775000,267147000,58853,KBH
2018-11-30,,,367965000,,170365000,444154000,835533000,391379000,391379000,,,,,,197600000,4547002000,4155623000,3711469000,-23414000,,170365000,169387000,58853,KBH
2017-11-30,,,289995000,,180595000,438294000,748097000,309803000,309803000,,-622000.0,,,,109400000,4368529000,4058726000,3620432000,-19808000,,180595000,179418000,58853,KBH
2019-12-31,,,-3804494,2654085,-3015718,1351180,3922120,-264465,-264465,,-2472628,,,,0,8268768,8533233,4346648,-3540029,,-3804494,-3015718,58856,MDRRP
2018-12-31,,,-2938002,3568601,-2743323,1044330,3004658,-873335,-873335,,-1917183,,,,53151,6589951,7463286,3585293,-2064667,,-2991153,-2743323,58856,MDRRP
2017-12-31,,,-968548,3293936,-847919,307241,765260,-285127,-285127,307241.0,-766857,,,,0,1724657,2009784,959397,-683421,,-968548,-847919,58856,MDRRP
2016-12-31,,,-46247,3293936,-46247,44429,0,-44429,-44429,307241.0,-1818,,,,0,0,44429,0,-1818,,-46247,-46247,58856,MDRRP
2020-12-31,,,338100000,,254400000,780600000,1223400000,395100000,395100000,9200000,-74400000,,,,83700000,7131800000,6736700000,5908400000,-57000000,,254400000,254400000,58858,ABG
2019-12-31,,,243900000,,184400000,799800000,1168900000,334700000,334700000,-1800000,-92800000,,,,59500000,7210300000,6875600000,6041400000,-90800000,,184400000,184400000,58858,ABG
2018-12-31,,,224800000,,168000000,755800000,1103000000,314800000,314800000,-1300000,-86100000,,,,56800000,6874400000,6559600000,5771400000,-90000000,,168000000,168000000,58858,ABG
2017-12-31,,,209100000,,139100000,729700000,1055900000,297100000,297100000,-3000000,-78600000,,,,70000000,6456500000,6159400000,5400600000,-88000000,,139100000,139100000,58858,ABG
2019-12-31,,,22369000,,15189000,72367000,89213000,16846000,16846000,,-6058000,,,,7180000,583290000,566444000,494077000,5523000,,15189000,15189000,58861,GPX
2018-12-31,,,14763000,,9836000,59646000,77743000,18097000,18097000,,-4045000,,,,4927000,515160000,497063000,437417000,-3334000,,9836000,9836000,58861,GPX
2017-12-31,,,19689000,,12891000,57419000,82027000,24608000,24608000,,-3132000,,,,6798000,509208000,484600000,427181000,-4919000,,12891000,12891000,58861,GPX
2016-12-31,,,30034000,,20247000,48597000,80157000,31560000,31560000,,-1568000,,,,9787000,490559000,458999000,410402000,-1526000,,20247000,20247000,58861,GPX
2019-12-31,,,-12060000,-109714000,-3379000,12586000,21474000,8888000,8888000,,-11497000,,,,4710000,48841000,39953000,27367000,-20948000,,-16770000,-3529000,58863,MDLY
2018-12-31,,,-21268000,-75403000,-2432000,15566000,27573000,12007000,12007000,,-10806000,,,,258000,56509000,44502000,28936000,-33275000,,-21526000,-3629000,58863,MDLY
2017-12-31,,,19265000,-15362000,927000,13045000,39659000,26614000,26614000,,-11855000,,,,1956000,65033000,38419000,25374000,-7349000,,17309000,376000,58863,MDLY
2016-12-31,,,11015000,-15004000,997000,28540000,48678000,20138000,20138000,,-9226000,,,,1063000,75941000,55803000,27263000,-9123000,,9952000,105000,58863,MDLY
2019-12-31,88517000,,198246000,46359000,153250000,180743000,465807000,176779000,176779000,1727000,-7893000,,,,44131000,1249130000,1072351000,783323000,21467000,,154115000,153250000,58867,DIOD
2018-12-31,86286000,,149962000,45969000,104021000,176197000,435276000,154442000,154442000,1727000,-9901000,,,,44556000,1213989000,1059547000,778713000,-4480000,,105406000,104021000,58867,DIOD
2017-12-31,77877000,,62591000,42414000,-1805000,168590000,352276000,87012000,87012000,-1000,-13448000,,,,62325000,1054204000,967192000,701928000,-24421000,,266000,-1805000,58867,DIOD
2016-12-31,69937000,,25035000,44448000,15935000,158321000,286923000,38117000,38117000,70000,-13257000,,,,6558000,942162000,904045000,655239000,-13082000,,18477000,15935000,58867,DIOD
2020-03-31,35677000,,-52625000,,-52625000,17437000,0,-53114000,-53114000,,-1919000,,,,0,0,53114000,0,489000,,-52625000,-52625000,58868,REPL
2019-03-31,19645000,,-30834000,,-30834000,8773000,0,-28418000,-28418000,,-1919000,,,,0,0,28418000,0,-2416000,,-30834000,-30834000,58868,REPL
2018-03-31,11249000,,-19702000,,-19702000,5713000,0,-16962000,-16962000,,-1919000,,,,0,0,16962000,0,-2740000,,-19702000,-19702000,58868,REPL
2017-03-31,5494000,,-7704000,,-7704000,2711000,0,-8205000,-8205000,,-1919000,,,,0,0,8205000,0,501000,,-7704000,-7704000,58868,REPL
2020-12-31,,,23011000,,16175000,37454000,64710000,0,23011000,4245000,,,,,6836000,64710000,41699000,0,0,,16175000,16175000,58870,PCB
2019-12-31,,,34351000,,24108000,38080000,76666000,0,34351000,4235000,,,,,10243000,76666000,42315000,0,0,,24108000,24108000,58870,PCB
2018-12-31,,,34745000,,24301000,35813000,74971000,0,34745000,4413000,,,,,10444000,74971000,40226000,0,0,,24301000,24301000,58870,PCB
2017-12-31,,,31342000,,16403000,32575000,67237000,0,31342000,3320000,,,,,14939000,67237000,35895000,0,0,,16403000,16403000,58870,PCB
2019-12-31,,,-167928000,,-167928000,10328000,0,-10328000,-10328000,,-12000,,,,0,0,10328000,0,-157600000,,-167928000,-167928000,58871,GAU
2018-12-31,,,-128704000,,-141372000,11660000,74814000,18448000,18448000,429000.0,-9987000,,,,12509000,161918000,143470000,87104000,-147152000,,-141213000,-141372000,58871,GAU
2017-12-31,,,30388000,740000.0,5776000,12590000,126765000,47322000,47322000,650000.0,-17160000,,,,24075000,256203000,208881000,129438000,-16934000,,6313000,5776000,58871,GAU
2016-12-31,,,-1778000,740000.0,-13216000,10953000,87221000,14364000,14364000,398000.0,-13451000,,,,11438000,175909000,161545000,88688000,-16142000,,-13216000,-13216000,58871,GAU
2019-12-31,41073000,,44004000,37985000,51305000,151104000,429454000,101106000,101106000,,-75782000,,,,-11813000,1804436000,1703330000,1374982000,-57102000,,55817000,50906000,58875,KRA
2018-12-31,41296000,,74095000,32461000,67015000,155985000,580606000,241915000,241915000,,-93772000,,,,3574000,2011675000,1769760000,1431069000,-167820000,,70521000,66043000,58875,KRA
2017-12-31,40283000,,34762000,30038000,97549000,162652000,544703000,204606000,204606000,,-132459000,,,,-57884000,1960362000,1755756000,1415659000,-169844000,,92646000,95717000,58875,KRA
2016-12-31,39129000,,12686000,32336000,107308000,177853000,506281000,163641000,163641000,,-138952000,,,,-91954000,1744104000,1580463000,1237823000,-150955000,,104640000,105001000,58875,KRA
2020-07-31,,,409099,,409099,1019201,872385,-146816,-146816,,,,,,0,872385,1019201,0,555915,,409099,409099,58876,MXE
2019-07-31,,,-14879380,,-14879380,1528849,2105089,576240,576240,,,,,,0,2105089,1528849,0,-15455620,,-14879380,-14879380,58876,MXE
2018-07-31,,,-3075815,,-3075815,1582945,1889207,306262,306262,,,,,,0,1889207,1582945,0,-3382077,,-3075815,-3075815,58876,MXE
2017-07-31,,,10058473,,10058473,1507114,2144348,637234,637234,,,,,,0,2144348,1507114,0,9421239,,10058473,10058473,58876,MXE
2020-12-31,,,923270000,,696429000,1941477000,4322740000,1035672000,1035672000,1196612000,-57467000,,,,222774000,7086667000,6050995000,2763927000,-112402000,,700496000,696429000,58877,FAF
2019-12-31,,,905018000,4518000.0,707410000,1926068000,3881755000,952819000,952819000,873847000,-47801000,,,,195170000,6202061000,5249242000,2320306000,-47801000,,709848000,707410000,58877,FAF
2018-12-31,,,609538000,3507000.0,474496000,1748949000,3495375000,650516000,650516000,969983000,-40978000,,,,133640000,5747844000,5097328000,2252469000,-40978000,,475898000,474496000,58877,FAF
2017-12-31,,,445331000,3070000.0,423049000,1723539000,3458597000,486618000,486618000,1125687000,-35987000,,,,23468000,5772363000,5285745000,2313766000,-41287000,,421863000,423049000,58877,FAF
2019-12-31,,,-364639000,93827000,-114659000,782248000,509714000,-272534000,-272534000,,-80606000,,,,0,3939896000,4212430000,3430182000,-92105000,,-364639000,-114659000,58878,CVNA
2018-12-31,,,-254745000,147742000,-55476000,421840000,201109000,-220731000,-220731000,,-25018000,,,,0,1955467000,2176198000,1754358000,-34014000,,-254745000,-61062000,58878,CVNA
2017-12-31,,,-164316000,153808000,-62841000,226200000,70891000,-155309000,-155309000,,-7659000,,,,0,858870000,1014179000,787979000,-9007000,,-164316000,-64491000,58878,CVNA
2016-12-31,,,-93112000,153808000,-93112000,110576000,21097000,-89479000,-89479000,,-3587000,,,,0,365148000,454627000,344051000,-3633000,,-93112000,-93112000,58878,CVNA
2019-12-31,,,-117796000,,-117796000,19527000,-38331000,-57858000,-57858000,,,,,,0,0,57858000,38331000,-59938000,,-117796000,-117796000,58879,ZIOP
2018-12-31,,,-53117000,,-53117000,19918000,-33988000,-53906000,-53906000,,,,,,0,146000,54052000,34134000,789000,,-53117000,137246000,58879,ZIOP
2017-12-31,,,-54323000,,-54323000,14798000,-38695000,-53493000,-53493000,,,,,,0,6389000,59882000,45084000,-830000,,-54323000,-73261000,58879,ZIOP
2016-12-31,,,-165297000,,-165297000,14377000,-150930000,-165307000,-165307000,,,,,,0,6861000,172168000,157791000,10000,,-165297000,-172420000,58879,ZIOP
2019-12-31,,,-801801000,205975000,-791150000,257423000,-202034000,-474581000,-474581000,,-16346000,,,,4872000,1167358000,1641939000,1369392000,-327220000,,-806673000,-791150000,58880,UK
2018-12-31,,,-443068000,198357000,-429592000,163581000,-215101000,-398847000,-398847000,,-9902000,,,,2087000,448508000,847355000,663609000,-44221000,,-445155000,-429592000,58880,UK
2017-12-31,,,-372815000,1359000,-355753000,117846000,-143028000,-284933000,-284933000,,-78000,,,,61000,167394000,452327000,310422000,-87882000,,-372876000,-355753000,58880,UK
2019-12-31,,,-622000000,132000000,-456000000,2601000000,4559000000,1352000000,1352000000,,-374000000,,,,-217000000,13458000000,12106000000,8899000000,-1974000000,,-405000000,-456000000,58883,QRTEA
2018-12-31,,,883000000,120000000,916000000,2795000000,4861000000,1429000000,1429000000,,-381000000,,,,60000000,14070000000,12641000000,9209000000,-546000000,141000000.0,823000000,674000000,58883,QRTEA
2017-12-31,,,1050000000,99000000,2441000000,1788000000,3615000000,1102000000,1102000000,,-355000000,,,,-985000000,10404000000,9302000000,6789000000,-52000000,452000000.0,2035000000,1208000000,58883,QRTEA
2016-12-31,,,1091000000,89000000,1235000000,1897000000,3739000000,968000000,968000000,,-363000000,,,,316000000,10647000000,9679000000,6908000000,123000000,499000000.0,775000000,473000000,58883,QRTEA
2019-12-31,,,-68898,,-68898,68898,0,-68898,-68898,,,,,,0,0,68898,0,0,,-68898,-68898,58884,CCAC
2019-12-31,2386000000,,2859000000,,2166000000,342000000,5366000000,2638000000,2638000000,,-7000000,,,,693000000,5366000000,2728000000,0,221000000,,2166000000,2166000000,58887,GMAB
2018-12-31,1431000000,,1612000000,,1472000000,214000000,3025000000,1380000000,1380000000,,-7000000,,,,140000000,3025000000,1645000000,0,232000000,,1472000000,1472000000,58887,GMAB
2017-12-31,852057000,,1063720000,,1103551000,146987000,2365436000,1366392000,1366392000,,-2802000,,,,-39831000,2365436000,999044000,0,-302672000,,1103551000,1103551000,58887,GMAB
2016-12-31,660876000,,1130217000,,1187075000,102413000,1816122000,1052833000,1052833000,,-213000,,,,-56858000,1816122000,763289000,0,77384000,,1187075000,1187075000,58887,GMAB
2020-09-30,,,-2594000,,8008000,186442000,182571000,-3871000,-3871000,,-10000,,,,-10602000,300761000,304632000,118190000,1277000,,8008000,1609000,58888,UTI
2019-09-30,,,-7665000,,-7868000,191372000,188970000,-2402000,-2402000,,-3220000,,,,203000,331504000,333906000,142534000,-5263000,,-7868000,-13118000,58888,UTI
2018-09-30,,,-35697000,,-32682000,168487000,134376000,-34111000,-34111000,,-3310000,,,,-3015000,316965000,351076000,182589000,-1586000,,-32682000,-37932000,58888,UTI
2017-09-30,,,-2731000,,-8128000,180753000,178929000,-1824000,-1824000,,-3381000,,,,5397000,324263000,326087000,145334000,-907000,,-8128000,-13378000,58888,UTI
2020-09-30,256575000,,134706000,,130695000,587175000,1124144000,251681000,251681000,,-76428000,,,,4011000,1458415000,1206734000,334271000,-116975000,,130695000,130695000,58889,PTC
2019-09-30,246888000,,20300000,,-27460000,542094000,930253000,117430000,117430000,,-43047000,,,,47760000,1255631000,1138201000,325378000,-97130000,,-27460000,-27460000,58889,PTC
2018-09-30,249786000,,28656000,,51987000,556686000,915322000,77500000,77500000,,-41673000,,,,-23331000,1241824000,1164324000,326502000,-48844000,,51987000,51987000,58889,PTC
2017-09-30,236028000,,-1406000,,6239000,516993000,835537000,50408000,50408000,,-42400000,,,,-7645000,1164039000,1113631000,328502000,-51814000,,6239000,6239000,58889,PTC
2020-12-31,30880000,,9615000,,10225000,54904000,107960000,12253000,12253000,,-2638000,,,,-610000,328063000,315810000,220103000,-2638000,,10225000,10225000,58892,PERI
2019-12-31,22585000,,14538000,,12893000,49735000,100039000,18008000,18008000,,-1954000,,,,1645000,261450000,243442000,161411000,-3470000,,12893000,12893000,58892,PERI
2018-12-31,18884000,,10897000,,8121000,55368000,100737000,16766000,16766000,,-6425000,,,,2776000,252845000,236079000,152108000,-5869000,,8121000,8121000,58892,PERI
2017-12-31,17189000,,-81580000,,-72754000,74653000,118442000,10009000,10009000,,-2421000,,,,-8826000,273986000,263977000,155544000,-91589000,,-72754000,-72754000,58892,PERI
2020-12-31,,,253965000,,228860000,197766000,537430000,0,319478000,20186000,,,,,25105000,537430000,217952000,0,-65513000,,228860000,228860000,58893,CATY
2019-12-31,,,349369000,,279135000,206319000,620921000,0,394783000,19819000,,,,,70234000,620921000,226138000,0,-45414000,,279135000,279135000,58893,CATY
2018-12-31,,,337687000,,271885000,199654000,604553000,0,390911000,13988000,,,,,65802000,604553000,213642000,0,-53224000,,271885000,271885000,58893,CATY
2017-12-31,,,298307000,,176042000,178562000,528878000,0,333926000,16390000,,,,,122265000,528878000,194952000,0,-35619000,,176042000,176042000,58893,CATY
2020-05-31,,,1437100000,,1098100000,1299200000,2759700000,1460500000,1460500000,,-38800000,,,,339000000,4040500000,2580000000,1280800000,-23400000,,1098100000,1098100000,58894,PAYX
2019-05-31,,,1368000000,,1034400000,1218100000,2594700000,1376600000,1376600000,,-17600000,,,,333600000,3772500000,2395900000,1177800000,-8600000,,1034400000,1034400000,58894,PAYX
2018-05-31,,,1300100000,,994100000,1068000000,2359500000,1291500000,1291500000,,-3900000,,,,306000000,3377700000,2086200000,1018200000,8600000,,994100000,994100000,58894,PAYX
2017-05-31,,,1259100000,,826300000,979700000,2233600000,1253900000,1253900000,,-2500000,,,,432800000,3153000000,1899100000,919400000,5200000,,826300000,826300000,58894,PAYX
2020-12-31,3975000,,510045000,,434374000,67913000,660497000,588609000,588609000,,-98074000,,,,75671000,1224361000,635752000,563864000,-78564000,,434374000,434374000,58899,EAF
2019-12-31,2684000,,842827000,,744602000,67774000,1040403000,969945000,969945000,,-127331000,,,,98225000,1790793000,820848000,750390000,-127118000,,744602000,744602000,58899,EAF
2018-12-31,2129000,,902808000,,854219000,63932000,1190212000,1124151000,1124151000,,-135061000,,,,48920000,1895910000,771759000,705698000,-221343000,331000.0,853888000,854219000,58899,EAF
2017-12-31,3456000,,3431000,,7983000,52506000,87717000,31755000,31755000,,-30823000,,,,-10781000,550771000,519016000,463054000,-29210000,-6229000.0,14212000,7983000,58899,EAF
2019-12-31,48059000,,-33295000,,-34099000,8774000,21381000,-35452000,-35452000,,,,,,804000,21381000,56833000,0,2157000,,-34099000,-42567000,58900,CCCC
2018-12-31,28592000,,-15711000,,-15711000,7161000,19364000,-16389000,-16389000,,,,,,0,19364000,35753000,0,678000,,-15711000,-24107000,58900,CCCC
2019-12-31,724983000,,-622929000,,-626695000,568816000,757042000,-536757000,-536757000,,-8719000,,,,3766000,3599436000,4136193000,2842394000,-86172000,,-626695000,-1268869000,58901,DUO
2018-12-31,202877000,,-139727000,,-144160000,204376000,476628000,69375000,69375000,,-1118000,,,,4433000,2282216000,2212841000,1805588000,-209102000,,-144160000,-144160000,58901,DUO
2017-12-31,191662000,,-225453000,,-227819000,194790000,381588000,-4864000,-4864000,,-13034000,,,,2366000,1798521000,1803385000,1416933000,-220589000,,-227819000,-227819000,58901,DUO
2016-12-31,182625000,,-535304000,,-536421000,409630000,228402000,-363853000,-363853000,,-13034000,,,,1117000,1475758000,1839611000,1247356000,-171451000,,-536421000,-536421000,58901,DUO
2020-02-29,,,1676286,,1676286,183138,742737,559599,559599,,-8296,,,,0,742737,183138,0,1116687,,1676286,1676286,58904,NPN
2019-02-28,,,700256,,700256,176709,797156,620447,620447,,-7056,,,,0,797156,176709,0,79809,,700256,700256,58904,NPN
2018-02-28,,,479577,,479577,184556,860401,675845,675845,,-4500,,,,0,860401,184556,0,-196268,,479577,479577,58904,NPN
2017-02-28,,,-318983,,-318983,181091,930158,749068,749068,,-1780,,,,0,930158,181091,0,-1068051,,-318983,-318983,58904,NPN
2019-12-31,,,158514000,135798000,87777000,107465000,737841000,235480000,235480000,44356000,-73873000,,,,35532000,962904000,727424000,225063000,-76966000,,122982000,87777000,58905,MTDR
2018-12-31,,,292073000,90777000,274207000,69308000,629343000,363271000,363271000,-68378000,-41327000,,,,-7691000,771691000,408420000,142348000,-71198000,,299764000,274207000,58905,MTDR
2017-12-31,,,129850000,100990000,125867000,66016000,400255000,160841000,160841000,-4104000,-34565000,,,,-8157000,538882000,378041000,138627000,-30991000,,138007000,125867000,58905,MTDR
2016-12-31,,,-98093000,1320000,-97421000,55089000,191737000,-18534000,-18534000,33134000,-28199000,,,,-1036000,279774000,298308000,88037000,-79559000,,-97057000,-97421000,58905,MTDR
2020-12-31,,,1797000000,,1427000000,3536000000,6515000000,0,1797000000,1182000000,,,,,370000000,6515000000,4718000000,0,0,,1427000000,1317000000,58906,FITBI
2019-12-31,,,3202000000,,2512000000,3412000000,7893000000,0,3457000000,1024000000,,,,,690000000,7893000000,4436000000,0,-255000000,,2512000000,2398000000,58906,FITBI
2018-12-31,,,2765000000,,2193000000,3031000000,6772000000,0,2841000000,900000000,,,,,572000000,6772000000,3931000000,0,-76000000,,2193000000,2095000000,58906,FITBI
2017-12-31,,,2979000000,20000000.0,2180000000,2847000000,6820000000,0,3052000000,921000000,,,,,799000000,6820000000,3768000000,0,-73000000,,2180000000,2082000000,58906,FITBI
2020-12-31,,,-11453000000,,-8885000000,513000000,-5540000000,-11387000000,-11387000000,2969000000,-1227000000,,,,-2568000000,17337000000,28724000000,22877000000,-66000000,,-8885000000,-8885000000,58907,AAL
2019-12-31,,,2256000000,,1686000000,1602000000,12560000000,3889000000,3889000000,5087000000,-1095000000,,,,570000000,45768000000,41879000000,33208000000,-1633000000,,1686000000,1686000000,58907,AAL
2018-12-31,,,1884000000,,1412000000,1520000000,12204000000,3757000000,3757000000,5088000000,-1056000000,,,,472000000,44541000000,40784000000,32337000000,-1873000000,,1412000000,1412000000,58907,AAL
2017-12-31,,,3395000000,,1282000000,1477000000,13192000000,5103000000,5103000000,4910000000,-1053000000,,,,2113000000,42622000000,37519000000,29430000000,-1708000000,,1282000000,1282000000,58907,AAL
2019-12-31,74000000,,-128000000,,-129000000,1528000000,1458000000,-144000000,-144000000,,,,,,1000000,1901000000,2045000000,443000000,16000000,,-129000000,-136000000,58908,WISH
2018-12-31,45000000,,-208000000,,-208000000,1628000000,1450000000,-223000000,-223000000,,,,,,0,1728000000,1951000000,278000000,15000000,,-208000000,-208000000,58908,WISH
2017-12-31,28000000,,-207000000,,-207000000,1015000000,896000000,-147000000,-147000000,,,,,,0,1101000000,1248000000,205000000,-60000000,,-207000000,-247000000,58908,WISH
2018-12-31,,,2910551,,2910551,1037869,0,-1037869,-1037869,,,,,,0,0,1037869,0,3948420,,2910551,2910551,58909,NFH
2020-12-31,,,2159000,,1668000,10162000,13855000,0,2345000,1348000,,,,,491000,13855000,11510000,0,-186000,,1668000,1668000,58910,GLBZ
2019-12-31,,,2051000,,1599000,10193000,13997000,0,2182000,1622000,,,,,452000,13997000,11815000,0,-131000,,1599000,1599000,58910,GLBZ
2018-12-31,,,1713000,,1583000,9651000,12944000,0,1719000,1574000,,,,,130000,12944000,11225000,0,-6000,,1583000,1583000,58910,GLBZ
2017-12-31,,,1824000,,911000,9137000,12619000,0,2075000,1407000,,,,,913000,12619000,10544000,0,-251000,,911000,911000,58910,GLBZ
2019-12-31,193382000,,-197965000,,-197614000,46480000,-166704000,-213184000,-213184000,,,,,,-351000,26678000,239862000,193382000,15219000,,-197614000,-197614000,58911,DNLI
2018-12-31,193382000,,-36240000,,-36240000,32349000,-14023000,-46372000,-46372000,,,,,,0,129160000,175532000,143183000,10132000,,-36240000,-36240000,58911,DNLI
2017-12-31,193382000,,-88185000,,-88185000,15680000,-74460000,-90140000,-90140000,,,,,,0,0,90140000,74460000,1955000,,-88185000,-88185000,58911,DNLI
2016-12-31,193382000,,-86652000,,-86652000,11731000,-75702000,-87433000,-87433000,,,,,,0,0,87433000,75702000,781000,,-86652000,-86652000,58911,DNLI
2020-08-31,44052000,,-28370000,,-29932000,96175000,114497000,-25730000,-25730000,,-356000,,,,1562000,211672000,237402000,97175000,-2640000,,-29932000,-24334000,58915,DCT
2019-08-31,35936000,,-15746000,,-16896000,76682000,99095000,-13523000,-13523000,,-1030000,,,,1150000,171273000,184796000,72178000,-2223000,,-16896000,-16896000,58915,DCT
2018-08-31,36056000,,-7448000,,-7802000,64828000,95337000,-5547000,-5547000,,-567000,,,,354000,159669000,165216000,64332000,-1901000,,-7802000,-7802000,58915,DCT
2017-08-31,42815000,,-23782000,,-24790000,69987000,93321000,-19481000,-19481000,,-330000,,,,1008000,156721000,176202000,63400000,-4301000,,-24790000,-24790000,58915,DCT
2020-12-31,,,52646000,,45234000,100043000,175749000,0,64270000,11436000,,,,,7412000,175749000,111479000,0,-11624000,,45234000,37361000,58917,TSCAP
2019-12-31,,,68658000,,60193000,89670000,180807000,0,77116000,14021000,,,,,8465000,180807000,103691000,0,-8458000,,60193000,54440000,58917,TSCAP
2018-12-31,,,60369000,,54424000,81491000,161526000,0,67701000,12334000,,,,,5945000,161526000,93825000,0,-7332000,,54424000,52304000,58917,TSCAP
2017-12-31,,,47470000,,37988000,72946000,138942000,0,54616000,11380000,,,,,9482000,138942000,84326000,0,-7146000,,37988000,37988000,58917,TSCAP
2020-12-31,,,727000000,14000000,482000000,3021000000,6310000000,1832000000,1832000000,171000000,-446000000,,,,245000000,20580000000,18748000000,14270000000,-1105000000,,482000000,482000000,58918,IP
2019-12-31,,,1854000000,5000000,1225000000,3243000000,7108000000,2389000000,2389000000,170000000,-706000000,,,,634000000,22376000000,19987000000,15268000000,-535000000,,1220000000,1225000000,58918,IP
2018-12-31,,,2117000000,21000000,2012000000,3784000000,7751000000,2468000000,2468000000,171000000,-734000000,,,,445000000,23306000000,20838000000,15555000000,-351000000,345000000.0,1672000000,2012000000,58918,IP
2017-12-31,,,1025000000,19000000,2144000000,3585000000,6941000000,1844000000,1844000000,169000000,-758000000,,,,-1085000000,21743000000,19899000000,14802000000,-819000000,34000000.0,2110000000,2144000000,58918,IP
2019-12-31,,,338185,,-104405,4572649,5881771,340713,340713,968409,-67203,,,,442590,16465562,16124849,10583791,-2528,,-104405,-104405,58920,KBSF
2018-12-31,,,-23390717,,-17968598,7577975,-2436525,-10055740,-10055740,41240,-96444,,,,-5422119,18535115,28590855,20971640,-13334977,,-17968598,-17968598,58920,KBSF
2017-12-31,,,-19413657,,-14815596,8144777,-11455758,-19398912,-19398912,-201623,-96385,,,,-4598061,23762536,43161448,35218294,-14745,,-14815596,-14815596,58920,KBSF
2016-12-31,,,-15628820,,-11902687,7150003,2409645,-15656523,-15656523,10916165,-71783,,,,-3726133,41200205,56856728,38790560,27703,,-11902687,-11902687,58920,KBSF
2019-12-31,,,-21577000,,-4357000,129738000,264320000,31233000,31233000,,-44087000,,,,-17220000,630065000,598832000,365745000,-52810000,,-4357000,-4357000,58921,PLYA
2018-12-31,,,31176000,,18977000,117252000,281124000,90273000,90273000,,-62243000,,,,12199000,616035000,525762000,334911000,-59097000,,18977000,18977000,58921,PLYA
2017-12-31,,,8810000,,-241000,108408000,249497000,87958000,87958000,,-53661000,,,,9051000,559545000,471587000,310048000,-79148000,,-241000,-9042000,58921,PLYA
2016-12-31,,,24448000,,20216000,100698000,238154000,84712000,84712000,,-54793000,,,,4232000,521491000,436779000,283337000,-60264000,,20216000,-23460000,58921,PLYA
2020-03-28,,,9730000,,8067000,31628000,42478000,10850000,10850000,,-934000,,,,1663000,173099000,162249000,130621000,-1120000,,8067000,8067000,58922,TRNS
2019-03-30,,,9235000,,7145000,29114000,39343000,10229000,10229000,,-903000,,,,2090000,160898000,150669000,121555000,-994000,,7145000,7145000,58922,TRNS
2018-03-31,,,7948000,,5922000,28415000,37441000,9026000,9026000,,-1018000,,,,2026000,155141000,146115000,117700000,-1078000,,5922000,5922000,58922,TRNS
2017-03-25,,,7164000,,4522000,26936000,34970000,8034000,8034000,,-719000,,,,2642000,143898000,135864000,108928000,-870000,,4522000,4522000,58922,TRNS
2019-12-31,,,65556000,3455000,57919000,69841000,137838000,67997000,67997000,,-10940000,,,,7859000,751909000,683912000,614071000,-2441000,,57697000,57289000,58930,HLX
2018-12-31,,,30998000,3455000,28598000,70287000,121684000,51397000,51397000,,-16988000,,,,2400000,739818000,688421000,618134000,-20399000,,28598000,28325000,58930,HLX
2017-12-31,,,-20372000,3455000,30052000,63257000,62166000,-1091000,-1091000,,-21368000,,,,-50424000,581383000,582474000,519217000,-19281000,,30052000,29696000,58930,HLX
2016-12-31,,,-93915000,3455000,-81445000,65934000,46516000,-19418000,-19418000,,-33325000,,,,-12470000,487582000,507000000,441066000,-74497000,,-81445000,-81445000,58930,HLX
2020-07-31,,,-37950356,,-37950356,6727532,52502674,45775142,45775142,,-8862362,,,,0,52502674,6727532,0,-83725498,,-37950356,-37950356,58933,HPS
2019-07-31,,,43629199,,43629199,7124429,54621111,47496682,47496682,,-12602619,,,,0,54621111,7124429,0,-3867483,,43629199,43629199,58933,HPS
2018-07-31,,,24474663,,24474663,7276156,56550001,49273845,49273845,,-4855924,,,,0,56550001,7276156,0,-24799182,,24474663,24474663,58933,HPS
2017-07-31,,,29471913,,29471913,7468713,57359475,49890762,49890762,,-4638129,,,,0,57359475,7468713,0,-20418849,,29471913,29471913,58933,HPS
2019-12-31,,,742000000,2571000000,790000000,8354000000,12184000000,2417001000,2417001000,,-1250000000,,,,254000000,56635000000,54217999000,44451000000,-1675001000,348000000,488000000,790000000,58934,CBD
2018-12-31,,,1569000000,2925000000,1149000000,7602000000,11609000000,2805005000,2805005000,215000000.0,-977000000,,,,413000000,49388000000,46582995000,37779000000,-1236005000,128000000,1156000000,1149000000,58934,CBD
2017-12-31,,,752000000,2853000000,580000000,8059000000,10988000000,2150000000,2150000000,215000000.0,-498000000,,,,297000000,44634000000,42484000000,33646000000,-1398000000,125000000,455000000,580000000,58934,CBD
2016-12-31,,,-47000000,2737000000,-482000000,7451000000,9521000000,1363000000,1363000000,215000000.0,-705000000,,,,24000000,41454000000,40091000000,31933000000,-1410000000,-411000000,-71000000,-482000000,58934,CBD
2019-12-31,,,-77200000,,-66600000,365600000,752100000,81600000,81600000,,-139600000,,,,-10600000,1536700000,1455100000,784600000,-158800000,,-66600000,-77000000,58937,CBB
2018-12-31,,,-60400000,,-69800000,325900000,679500000,101600000,101600000,,-131500000,,,,9400000,1378200000,1276600000,698700000,-162000000,,-69800000,-80200000,58937,CBB
2017-12-31,,,66700000,,40000000,251700000,534700000,90000000,90000000,4000000.0,-85200000,,,,26700000,1065700000,975700000,531000000,-23300000,,40000000,29600000,58937,CBB
2016-12-31,,,164400000,,103000000,220600000,510300000,107500000,107500000,4000000.0,-75700000,,,,61700000,1017600000,910100000,507300000,56900000,300000.0,102700000,92600000,58937,CBB
2020-06-30,1178685,,-2927206,,-2927206,4041629,1829730,-2916910,-2916910,-473674,-21631,,,,0,2518566,5435476,688836,-10296,,-2927206,-2927206,58940,IMRN
2019-06-30,1044528,,-4656421,,-4656421,5902450,1706661,-4708267,-4708267,-532050,-21631,,,,0,2387426,7095693,680765,51846,,-4656421,-4656421,58940,IMRN
2018-06-30,2257224,,-3010929,,-3010929,4099290,1260616,-3246735,-3246735,-1849163,-24199,,,,0,1842909,5089644,582293,235806,,-3010929,-3010929,58940,IMRN
2017-06-30,4630674,,-6804154,,-6804154,4680605,922157,-8394044,-8394044,-1849163,-24483,,,,0,1396197,9790241,474040,1589890,,-6804154,-6804154,58940,IMRN
2019-12-31,,,13684000,,13631000,24105000,45288000,18670000,18670000,2513000,-3031000,,,,53000,171398000,152728000,126110000,-4986000,,13631000,13631000,58941,IPI
2018-12-31,,,11891000,,11783000,20968000,39982000,17205000,17205000,1809000,-3855000,,,,108000,161937000,144732000,121955000,-5314000,,11783000,11783000,58941,IPI
2017-12-31,,,-25350000,,-22567000,20602000,18267000,-5116000,-5116000,2781000,-11692000,,,,-2783000,136229000,141345000,117962000,-20234000,,-22567000,-22567000,58941,IPI
2016-12-31,,,-65545000,,-64183000,22637000,-4716000,-27455000,-27455000,102000,-11622000,,,,-1362000,165029000,192484000,169745000,-38090000,,-64183000,-64183000,58941,IPI
2019-12-31,3168000,,-3198000,,-1657000,13594000,18900000,1059000,1059000,,-5000,,,,-1541000,27371000,26312000,8471000,-4257000,,-1657000,-1657000,58942,BLFS
2018-12-31,1298000,,-25005000,,-25005000,8565000,13525000,3662000,3662000,,-5000,,,,0,19742000,16080000,6217000,-28667000,,-25005000,-25344000,58942,BLFS
2017-12-31,1193000,,-2515000,,-2515000,6609000,6746000,-1056000,-1056000,,-346000,,,,0,11022000,12078000,4276000,-1459000,,-2515000,-2728000,58942,BLFS
2016-12-31,2028465,,-8041372,,-6875446,7601772,4778698,-4851539,-4851539,,-405130,,,,0,8226992,13078531,3448294,-3189833,,-8041372,-6875446,58942,BLFS
2020-03-31,,,1019716000,,705377000,4513646000,8587240000,1890130000,1890130000,-107313000,-935842000,,,,314339000,22952067000,21061937000,14364827000,-870414000,,705377000,705377000,58943,SIFY
2019-03-31,,,1071315000,,1068703000,4874620000,7944661000,1746127000,1746127000,-209998000,-630587000,,,,2612000,21546885000,19800758000,13602224000,-674812000,,1068703000,1068703000,58943,SIFY
2018-03-31,,,923595000,,923401000,4394814000,7250663000,1288497000,1288497000,-187185000,-404448000,,,,194000,20685613000,19397116000,13434950000,-364902000,,923401000,923401000,58943,SIFY
2017-03-31,,,643097000,,642399000,3991273000,6561799000,956541000,956541000,-144791000,-343411000,,,,698000,18432020000,17475479000,11870221000,-313444000,,642399000,642399000,58943,SIFY
2019-12-31,12272000,,-52407000,,-52415000,63220000,47427000,-28065000,-28065000,,-4952000,,,,8000,63354000,91419000,15927000,-24342000,,-52415000,-52415000,58944,SILK
2018-12-31,10258000,,-37616000,,-37629000,34820000,23683000,-21395000,-21395000,,-4361000,,,,14000,34557000,55952000,10874000,-16221000,,-37630000,-37629000,58944,SILK
2017-12-31,7242000,,-19356000,,-19356000,20261000,9129000,-18374000,-18374000,,-3943000,,,,0,14258000,32632000,5129000,-982000,,-19356000,-19356000,58944,SILK
2019-12-31,38386000,,-46363000,6821000,-46378000,8459000,0,-46845000,-46845000,,,,,,15000,0,46845000,0,482000,,-46378000,-46378000,58946,ZNTL
2018-12-31,18921000,,-23428000,7536000,-23432000,4876000,14000,-23783000,-23783000,,,,,,4000,14000,23797000,0,355000,,-23432000,-23432000,58946,ZNTL
2020-12-31,,,2519200000,,2030400000,5477900000,8682600000,2854200000,2854200000,37100000,-340400000,,,,488800000,18361700000,15507500000,9679100000,-335000000,,2030400000,2030400000,58947,SHW
2019-12-31,,,1981800000,,1541300000,5366100000,8036100000,2385000000,2385000000,-27800000,-349300000,,,,440500000,17900800000,15515800000,9864700000,-403200000,,1541300000,1541300000,58947,SHW
2018-12-31,,,1359700000,,1108700000,5060600000,7418600000,1863600000,1863600000,176300000,-366700000,,,,251000000,17534500000,15670900000,10115900000,-503900000,,1108700000,1108700000,58947,SHW
2017-12-31,,,1469300000,,1727900000,4781900000,6718800000,1714700000,1714700000,15400000,-263500000,,,,-300200000,14983800000,13269100000,8265000000,-245400000,-41600000.0,1769500000,1727900000,58947,SHW
2020-12-31,,,-15587000000,,-12385000000,582000000,-4129000000,-4240000000,-4240000000,-2783000000,-929000000,,,,-3202000000,17095000000,21335000000,21224000000,-11347000000,,-12385000000,-12385000000,58948,DAL
2019-12-31,,,6198000000,,4767000000,1993000000,12916000000,6650000000,6650000000,1771000000,-301000000,,,,1431000000,47007000000,40357000000,34091000000,-452000000,,4767000000,4767000000,58948,DAL
2018-12-31,,,5151000000,,3935000000,1941000000,11452000000,5459000000,5459000000,1723000000,-311000000,,,,1216000000,44438000000,38979000000,32986000000,-308000000,,3935000000,3935000000,58948,DAL
2017-12-31,,,5500000000,,3205000000,1827000000,11833000000,6175000000,6175000000,1609000000,-396000000,,,,2295000000,41138000000,34963000000,29305000000,-675000000,,3205000000,3205000000,58948,DAL
2020-10-03,6400000,,13704000,,12185000,61921000,96200000,27179000,27179000,,-12652000,,,,1519000,879221000,852042000,783021000,-13475000,,12185000,12185000,58951,BLBD
2019-09-28,11500000,,31873000,,24300000,67688000,133474000,53586000,53586000,,-13279000,,,,7573000,1018874000,965288000,885400000,-21713000,,24300000,24300000,58951,BLBD
2018-09-29,8500000,,28200000,,30820000,74002000,121988000,39486000,39486000,,-6661000,,,,-2620000,1024976000,985490000,902988000,-11286000,,30820000,28924000,58951,BLBD
2017-09-30,7400000,,40657000,,28801000,63673000,127368000,56295000,56295000,,-7251000,,,,11856000,990602000,934307000,863234000,-15638000,41000.0,28801000,18449000,58951,BLBD
2020-03-31,,,-1456511,-547777,-1416717,1159124,11252,-2119030,-2119030,3956,-3,,,,27413,11252,2130282,0,662519,,-1483924,-1416717,58953,LYL
2019-03-31,,,-1459770,-489765,-1056360,4815219,2757229,-2160142,-2160142,223,-133,,,,0,2757229,4917371,0,700372,,-1459770,-1056360,58953,LYL
2018-03-31,,,758918,-78790,193131,3864346,4278729,384041,384041,10168,-133,,,,633614,4278729,3894688,0,374877,,125304,193131,58953,LYL
2017-03-31,,,2178298,-78790,1713971,1390294,3590217,2163755,2163755,14873,-133,,,,464327,3590217,1426462,0,14543,,1713971,1713971,58953,LYL
2019-12-31,3795000,,-11164000,,-11164000,4275000,439000,-7631000,-7631000,,-10000,,,,0,2318000,9949000,1879000,-3533000,,-11164000,-11164000,58955,CLGN
2018-12-31,3546000,,-6249000,,-6249000,4054000,3355000,-4245000,-4245000,,-9000,,,,0,5014000,9259000,1659000,-2004000,,-6249000,-6249000,58955,CLGN
2017-12-31,3610000,,-6051000,,-6051000,2762000,415000,-5957000,-5957000,,-21000,,,,0,463000,6420000,48000,-94000,,-6051000,-6051000,58955,CLGN
2016-12-31,16789000,,-27893000,,-27893000,11048000,292000,-27545000,-27545000,,-129000,,,,0,292000,27837000,0,-348000,,-27893000,-27893000,58955,CLGN
2020-01-31,231683000,,53303000,13069000,28684000,478802000,863852000,97925000,97925000,,-40426000,,,,17620000,1303634000,1205709000,439782000,-44622000,,35683000,28684000,58959,VRNT
2019-01-31,209106000,,77762000,11568000,65991000,422044000,805937000,118374000,118374000,,-36724000,,,,7542000,1229747000,1111373000,423810000,-40612000,,70220000,65991000,58959,VRNT
2018-01-31,190643000,,18900000,11744000,-6627000,406760000,726658000,56830000,56830000,,-33430000,,,,22354000,1135229000,1078399000,408571000,-37930000,,-3454000,-6627000,58959,VRNT
2017-01-31,171070000,,-23474000,8460000,-29380000,397052000,676849000,27266000,27266000,,-34962000,,,,2772000,1062106000,1034840000,385257000,-50740000,,-26246000,-29380000,58959,VRNT
2019-12-29,,,-508000,,-1018000,11472000,18394000,6703000,6703000,219000,-8658000,,,,510000,22505000,15802000,4111000,-7211000,,-1018000,-1018000,58960,FAT
2018-12-30,,,-2073000,,-1798000,10349000,14652000,4236000,4236000,67000,-5895000,,,,-275000,17834000,13598000,3182000,-6309000,,-1798000,-1798000,58960,FAT
2017-12-31,,,1126000,,241500,2658000,4311000,1630000,1630000,67000,-405000,,,,884500,4311000,2681000,0,-504000,,241500,241500,58960,FAT
2016-12-25,,,6502000,,4204000,3595000,10061000,6466000,6466000,67000,-405000,,,,2298000,10061000,3595000,0,36000,,4204000,4204000,58960,FAT
2019-12-31,,,17048868,72825710,11657958,17378681,68502308,32594151,32594151,,-9278025,,,,0,412197819,379603668,343695511,-15545283,,17048868,11657958,58961,PANL
2018-12-31,,,23981646,71678946,17757020,16483991,71035880,36931164,36931164,,-8897229,,,,0,372970373,336039209,301934493,-12949518,,23981646,17757020,58961,PANL
2017-12-31,,,9100655,65304320,7812794,15163352,56079077,25301154,25301154,,-8270376,,,,0,385945564,360644410,329866487,-16200499,,9100655,7812794,58961,PANL
2016-12-31,,,9158811,60405671,7456955,12773781,39773440,12891837,12891837,,-5737982,,,,0,238016498,225124661,198243058,-3733026,,9158811,7456955,58961,PANL
2020-03-31,,,146937000,3537000,137116000,530258000,781720000,251462000,251462000,,-43673000,,,,9821000,3087868000,2836406000,2306148000,-104525000,,137116000,137116000,58962,ENS
2019-03-31,,,182211000,3730000,160239000,442917000,703405000,260488000,260488000,,-30868000,,,,21584000,2808017000,2547529000,2104612000,-78277000,,160627000,160239000,58962,ENS
2018-03-31,,,238326000,5436000,119594000,383541000,661861000,278320000,278320000,,-25001000,,,,118493000,2581891000,2303571000,1920030000,-39994000,,119833000,119594000,58962,ENS
2017-03-31,,,212695000,4913000,160214000,364815000,654034000,289219000,289219000,,-22197000,,,,54472000,2367149000,2077930000,1713115000,-76524000,,158223000,160214000,58962,ENS
2020-12-31,,,-587000000,,-582000000,115000000,-363000000,0,-587000000,109000000,,,,,-5000000,-352000000,235000000,11000000,0,,-582000000,-582000000,58963,RWT
2019-12-31,,,176623000,,169183000,117662000,326965000,0,180850000,28453000,,,,,7440000,326965000,146115000,0,-4227000,,169183000,164386000,58963,RWT
2018-12-31,,,130688000,,119600000,82782000,215784000,0,130688000,2314000,,,,,11088000,215784000,85096000,0,0,,119600000,115846000,58963,RWT
2017-12-31,,,152158000,,140406000,77156000,239178000,0,152158000,9864000,,,,,11752000,239178000,87020000,0,0,,140406000,136774000,58963,RWT
2019-12-31,24254000,,70820000,58176000,44929000,121468000,213584000,68856000,68856000,-688000,-650000,,,,5605000,246053000,177197000,32469000,1964000,,65215000,39801000,58964,SVA
2018-12-31,21910000,,46583000,38495000,21782000,137003000,204927000,45391000,45391000,-197000,-1070000,,,,10472000,229650000,184259000,24723000,1192000,,36111000,21782000,58964,SVA
2017-12-31,20489000,,45044000,25988000,25807000,87365000,154106000,45459000,45459000,-141000,-1869000,,,,8339000,174346000,128887000,20240000,-415000,,36705000,25807000,58964,SVA
2016-12-31,12648000,,-394000,13899000,-596000,41980000,50038000,982000,982000,-6984000,-1766000,,,,2664000,72431000,71449000,22393000,-1376000,2338000.0,-3058000,-596000,58964,SVA
2020-09-30,,,31377000,5441000,23662000,10961000,18517000,7519000,7519000,,-5981000,,,,7663000,92507000,84988000,73990000,23858000,,23714000,23662000,58966,ALCO
2019-09-30,,,50233000,5095000,37833000,11871000,60026000,48122000,48122000,,-7180000,,,,12783000,122251000,74129000,62225000,2111000,,37450000,37833000,58966,ALCO
2018-09-30,,,13190000,5478000,13050000,15058000,16314000,1256000,1256000,,-8561000,,,,390000,81281000,80025000,64967000,11934000,,12800000,13050000,58966,ALCO
2017-09-30,,,-13342000,4728000,-9451000,15024000,8930000,-6094000,-6094000,,-9141000,,,,-3846000,129829000,135923000,120899000,-7248000,,-9496000,-9451000,58966,ALCO
2020-12-31,,,41467000,,37260000,34441000,84090000,42144000,42144000,,-1813000,,,,4207000,133277000,91133000,49187000,-677000,,37260000,37260000,58967,NRC
2019-12-31,,,40519000,,32406000,32951000,81547000,43057000,43057000,,-2091000,,,,8113000,127982000,84925000,46435000,-2538000,,32406000,32297000,58967,NRC
2018-12-31,,,34709000,,30047000,31320000,72109000,35326000,35326000,,-1513000,,,,4662000,119686000,84360000,47577000,-617000,,30047000,29947000,58967,NRC
2017-12-31,,,34283000,,22943000,29686000,68491000,34219000,34219000,,-82000,,,,11340000,117559000,83340000,49068000,64000,,22943000,22768000,58967,NRC
2019-12-31,12608000,,-43133000,,-43133000,9241000,-22649000,-44498000,-44498000,,,,,,0,0,44498000,22649000,1365000,,-43133000,-43133000,58968,IGMS
2018-12-31,6209000,,-22711000,,-22711000,3829000,-12753000,-22791000,-22791000,,,,,,0,0,22791000,12753000,80000,,-22711000,-22711000,58968,IGMS
2017-12-31,4242000,,-11054000,,-11054000,2508000,-4397000,-11147000,-11147000,,,,,,0,0,11147000,4397000,93000,,-11054000,-11054000,58968,IGMS
2020-03-31,3303135,,-57278276,-205795,-57716069,36924084,494622,-42490022,-42490022,,-1851527,,,,0,494622,42984644,0,-14788254,-857554,-57278276,-57716069,58969,EQOS
2019-03-31,3303135,,-40266233,-61954,16810157,16923789,950064,-17935837,-17935837,,-878748,,,,0,950064,18885901,0,-22330396,56986946,-40266233,16810157,58969,EQOS
2018-03-31,3303135,,-1505369,-61954,-342092,1471064,0,-1479128,-1479128,,-878748,,,,33216,0,1479128,0,-26241,1196492,-1538585,-342092,58969,EQOS
2020-12-31,,,297537000,71476000,299915000,62404000,720410000,284492000,284492000,20501000,-93442000,,,,-5112000,1004320000,719828000,283910000,13045000,111000,302649000,298468000,58972,DRE
2019-12-31,,,440885000,62145000,428972000,60889000,667795000,261963000,261963000,17720000,-89756000,,,,8686000,984465000,722502000,316670000,178922000,445000,432199000,427485000,58972,DRE
2018-12-31,,,392196000,55042000,383729000,56218000,604900000,231234000,231234000,5231000,-85006000,,,,8828000,955514000,724280000,350614000,160962000,3900000,383368000,382054000,58972,DRE
2017-12-31,,,290235000,41534000,1634431000,54944000,528999000,196282000,196282000,4212000,-87003000,,,,-357000,790344000,594062000,261345000,93953000,1363749000,290592000,1630450000,58972,DRE
2019-12-31,18180000,,-20461000,,-20461000,4196000,0,-22376000,-22376000,,,,,,0,0,22376000,0,1915000,,-20461000,-20461000,58973,GLMD
2018-12-31,8313000,,-9781000,,-9856000,4440000,2038000,-10715000,-10715000,,,,,,75000,2038000,12753000,0,934000,,-9856000,-9856000,58973,GLMD
2017-12-31,9650000,,-12299000,,-12299000,3799000,1085000,-12364000,-12364000,,,,,,0,1085000,13449000,0,65000,,-12299000,-12299000,58973,GLMD
2016-12-31,14271000,,-16847000,,-16953000,3078000,467000,-16882000,-16882000,,,,,,106000,467000,17349000,0,35000,,-16953000,-16953000,58973,GLMD
2020-07-31,,,-24756928,,-24756928,24786866,175683697,150896831,150896831,,-84329584,,,,0,175683697,24786866,0,-175653759,,-24756928,-24756928,58975,JPS
2019-07-31,,,158768884,,158768884,25007459,191958060,166950601,166950601,,-76904694,,,,0,191958060,25007459,0,-8181717,,158768884,158768884,58975,JPS
2018-07-31,,,13448344,,13448344,26116062,191029841,164913779,164913779,,2380419,,,,0,191029841,26116062,0,-151465435,,13448344,13448344,58975,JPS
2017-07-31,,,299358861,,299358861,25197193,184347442,159150249,159150249,,-2983720,,,,0,184347442,25197193,0,140208612,,299358861,299358861,58975,JPS
2019-12-31,,,-42416000,,-43328000,10233000,-36755000,-46988000,-46988000,,-34000,,,,912000,16977000,63965000,53732000,4572000,,-43328000,-43328000,58976,MORF
2018-12-31,,,-23831000,,-23831000,5355000,-19273000,-24628000,-24628000,,-29000,,,,0,3358000,27986000,22631000,797000,,-23831000,-23831000,58976,MORF
2017-12-31,,,-16920000,,-16920000,2826000,-14103000,-16929000,-16929000,,-29000,,,,0,0,16929000,14103000,9000,,-16920000,-16920000,58976,MORF
2020-04-30,,,150962000,2310000,104946000,256303000,541715000,230101000,230101000,,-16524000,,,,43945000,1932732000,1702631000,1391017000,-79139000,,107017000,103806000,58977,KFY
2019-04-30,,,134340000,2731000,102651000,245436000,534111000,242186000,242186000,,-11604000,,,,29544000,1926033000,1683847000,1391922000,-107846000,,104796000,101585000,58977,KFY
2018-04-30,,,206030000,3008000,133779000,237390000,489940000,203962000,203962000,,-9676000,,,,70133000,1767217000,1563255000,1277277000,2068000,,135897000,132353000,58977,KFY
2017-04-30,,,116342000,3609000,84181000,226232000,422532000,149040000,149040000,,-10251000,,,,29104000,1565521000,1416481000,1142989000,-32698000,,87238000,83416000,58977,KFY
2020-03-31,,,33893000,,25851000,48012000,81246000,30977000,30977000,,,,,,8042000,284125000,253148000,202879000,2916000,,25851000,25851000,58980,PETS
2019-03-31,,,49121000,,37740000,46915000,95314000,46174000,46174000,,,,,,11381000,283419000,237245000,188105000,2947000,,37740000,37740000,58980,PETS
2018-03-31,,,53789000,,37283000,43545000,97807000,52136000,52136000,,,,,,16506000,273800000,221664000,175993000,1653000,,37283000,37283000,58980,PETS
2017-03-31,,,37924000,,23819000,40462000,79314000,37483000,37483000,,,,,,14105000,249176000,211693000,169862000,441000,,23819000,23819000,58980,PETS
2020-12-31,61833000,,55886000,,49982000,78710000,198584000,58041000,58041000,,-5211000,,,,5904000,474560000,416519000,275976000,-2155000,,49982000,49982000,58981,ACLS
2019-12-31,53618000,,20922000,,17034000,66329000,144152000,24205000,24205000,,-5155000,,,,3888000,342958000,318753000,198806000,-3283000,,17034000,17034000,58981,ACLS
2018-12-31,51876000,,54705000,,45885000,67801000,179636000,59959000,59959000,,-5110000,,,,8820000,442575000,382616000,262939000,-5254000,,45885000,45885000,58981,ACLS
2017-12-31,43071000,,43831000,,126959000,59334000,150247000,47842000,47842000,,-5121000,,,,-83128000,410561000,362719000,260314000,-4011000,,126959000,126959000,58981,ACLS
2020-10-02,464100000,,891700000,,814800000,231400000,1636300000,929000000,929000000,,,,,,76900000,3355700000,2426700000,1719400000,-37300000,,814800000,814800000,58982,SWKS
2019-09-27,424100000,,961000000,,853600000,198300000,1669900000,1024900000,1024900000,,,,,,107400000,3376800000,2351900000,1706900000,-63900000,,853600000,853600000,58982,SWKS
2018-09-28,404500000,,1332100000,,918400000,207800000,1950700000,1320100000,1320100000,,,,,,413700000,3868000000,2547900000,1917300000,12000000,,918400000,918400000,58982,SWKS
2017-09-29,355200000,,1257000000,,1010200000,205900000,1841800000,1253100000,1253100000,,,,,,246800000,3651400000,2398300000,1809600000,3900000,,1010200000,1010200000,58982,SWKS
2019-12-31,61858000,,-85372000,,-85372000,29560000,0,-91418000,-91418000,,,,,,0,0,91418000,0,6046000,,-85372000,-85372000,58983,ALLK
2018-12-31,33287000,,-43538000,,-43538000,12434000,0,-45721000,-45721000,,,,,,0,0,45721000,0,2183000,,-43538000,-43538000,58983,ALLK
2017-12-31,18506000,,-23843000,,-23552000,3748000,0,-22254000,-22254000,,-1302000.0,,,,-291000,0,22254000,0,-1589000,,-23552000,-23552000,58983,ALLK
2016-12-31,14672000,,-17100000,,-17100000,2388000,0,-17060000,-17060000,,-51000.0,,,,0,0,17060000,0,-40000,,-17100000,-17100000,58983,ALLK
2020-12-31,,,78369000,,68499000,102844000,209546000,0,79960000,26742000,,,,,9870000,209546000,129586000,0,-1591000,,68499000,68499000,58984,HBNC
2019-12-31,,,79841000,,66538000,95941000,201485000,0,79705000,25839000,,,,,13303000,201485000,121780000,0,136000,,66538000,66538000,58984,HBNC
2018-12-31,,,63560000,,53117000,81118000,165862000,0,64790000,19954000,,,,,10443000,165862000,101072000,0,-1230000,,53117000,53117000,58984,HBNC
2017-12-31,,,47953000,,33117000,76332000,142846000,0,49079000,17435000,,,,,14836000,142846000,93767000,0,-1126000,,33117000,33117000,58984,HBNC
2020-06-30,2477578,,-6098930,,-6098930,4658477,-241647,-7377702,-7377702,,-52198,,,,0,9864,7387566,251511,1278772,,-6098930,-6098930,58986,GENE
2019-06-30,2360762,,-6425604,,-6425604,4406275,-250823,-7017860,-7017860,,-20031,,,,0,25444,7043304,276267,592256,,-6425604,-6425604,58986,GENE
2018-06-30,2210498,,-5463872,,-5463872,4082222,-110834,-6403554,-6403554,,-28843,,,,0,189254,6592808,300088,939682,,-5463872,-5463872,58986,GENE
2017-06-30,2366334,,-8403826,,-8403826,5831004,26089,-8171249,-8171249,,-31995,,,,0,518506,8689755,492417,-232577,,-8403826,-8403826,58986,GENE
2020-12-31,,,89012000,,88854000,70157000,692621000,0,622464000,,,,,,158000,730085000,107621000,37464000,-533452000,,88854000,15104000,58988,CIM
2019-12-31,,,413744000,,413551000,75435000,850515000,0,775080000,,,,,,193000,886805000,111725000,36290000,-361336000,,413551000,340847000,58988,CIM
2018-12-31,,,411728000,,411637000,57778000,452740000,0,394962000,,,,,,91000,493513000,98551000,40773000,16766000,,411637000,368440000,58988,CIM
2017-12-31,,,524776000,,524668000,47862000,645328000,0,597466000,,,,,,108000,687018000,89552000,41690000,-72690000,,524668000,491184000,58988,CIM
2019-12-31,,,48769109000,1346000,40799776000,26751796000,93961698000,0,47756119000,19453783000,,,,,7968699000,95388964000,47632845000,1427266000,1012990000,,40800410000,40799776000,58992,BMA
2018-12-31,,,22694533000,973000,15729243000,16060781000,49102269000,0,21893002000,11148486000,,,,,6964755000,50011912000,28118910000,909643000,801531000,,15729778000,15729243000,58992,BMA
2017-12-31,,,14428414000,309995000,5938807000,17663393000,54969181000,0,14191708000,23114080000,,,,,8408808000,55937465000,41745757000,968284000,236706000,,6019606000,5938807000,58992,BMA
2016-12-31,,,10072801000,182799000,6540832000,7844575000,20167713000,0,10253417000,2069721000,,,,,3477377000,20167713000,9914296000,0,-180616000,,6595424000,6540832000,58992,BMA
2020-12-31,,,34536000,,26438000,85859000,127612000,0,34536000,7217000,,,,,8098000,127612000,93076000,0,0,,26438000,26438000,58993,MRBK
2019-12-31,,,13514000,,10481000,47310000,68533000,0,14304000,6919000,,,,,3033000,68533000,54229000,0,-790000,,10481000,10481000,58993,MRBK
2018-12-31,,,10490000,,8163000,46344000,63435000,0,10490000,6601000,,,,,2327000,63435000,52945000,0,0,,8163000,8163000,58993,MRBK
2017-12-31,,,5786000,,3032000,50365000,63477000,0,5900000,7212000,,,,,2754000,63477000,57577000,0,-114000,,3032000,1865000,58993,MRBK
2019-12-31,,,65246000,,51511000,76557000,123853000,47296000,47296000,,,,,,13735000,395637000,348341000,271784000,17950000,,51511000,51511000,58995,WILC
2018-12-31,,,32817000,,24967000,60509000,98213000,37704000,37704000,,,,,,7850000,338245000,300541000,240032000,-4887000,,24967000,24967000,58995,WILC
2017-12-31,,,30933000,,25023000,57929000,74333000,16404000,16404000,,,,,,5910000,311978000,295574000,237645000,14529000,,25023000,25023000,58995,WILC
2016-12-31,,,16179000,,10852000,53982000,76617000,22635000,22635000,,-172000.0,,,,5327000,294202000,271567000,217585000,-6456000,,10852000,10852000,58995,WILC
2020-03-31,,,-34011807,,-34011807,3093781,24560561,21466780,21466780,,-2452272,,,,0,24560561,3093781,0,-55478587,,-34011807,-34011807,58997,DHF
2019-03-31,,,12799509,,12799509,3077591,25920672,22843081,22843081,,-3800913,,,,0,25920672,3077591,0,-10043572,,12799509,12799509,58997,DHF
2018-03-31,,,11547698,,11547698,3299543,25601361,22301818,22301818,,-2760238,,,,0,25601361,3299543,0,-10754120,,11547698,11547698,58997,DHF
2017-03-31,,,45027990,,45027990,3212008,26089948,22877940,22877940,,-2088618,,,,0,26089948,3212008,0,22150050,,45027990,45027990,58997,DHF
2020-07-31,,,-15593000,,-15593000,3606000,34980000,31374000,31374000,,-803000,,,,0,34980000,3606000,0,-46967000,,-15593000,-16719000,59001,PFL
2019-07-31,,,24839000,,24839000,3376000,28578000,25202000,25202000,,608000,,,,0,28578000,3376000,0,-363000,,24839000,23026000,59001,PFL
2018-07-31,,,17029000,,17029000,3378000,26435000,23057000,23057000,,-2251000,,,,0,26435000,3378000,0,-6028000,,17029000,15620000,59001,PFL
2017-07-31,,,55619000,,55619000,3250000,26065000,22815000,22815000,,1974000,,,,0,26065000,3250000,0,32804000,,55619000,54601000,59001,PFL
2019-12-31,6939051,,-20116938,-1509456,-18686762,10779130,-259379,-18198451,-18198451,220891,-3699672,,,,0,535166,18733617,794545,-1918487,,-20116938,-18686762,59002,APM
2018-12-31,3101432,,-15134485,-368533,-14831723,6731396,65439,-10328098,-10328098,560709,-4458191,,,,0,383450,10711548,318011,-4806387,,-15134485,-14831723,59002,APM
2017-12-31,2560323,,-3187591,-14045,-3173546,3100703,0,-5920110,-5920110,259084,-4458191,,,,0,0,5920110,0,2732519,,-3187591,-2547462,59002,APM
2016-12-31,2560323,,-2134515,-14045,-2134515,827588,0,-878234,-878234,50646,-4458191,,,,0,0,878234,0,-1256281,,-2134515,-2134515,59002,APM
2020-12-31,,,133087000,,104388000,243492000,410820000,0,142465000,24863000,,,,,28699000,410820000,268355000,0,-9378000,,104388000,104388000,59003,NBTB
2019-12-31,,,155432000,,121021000,239911000,430166000,0,168915000,21340000,,,,,34411000,430166000,261251000,0,-13483000,,121021000,121021000,59003,NBTB
2018-12-31,,,137002000,,112566000,232054000,401563000,0,149912000,19597000,,,,,24436000,401563000,251651000,0,-12910000,,112566000,112566000,59003,NBTB
2017-12-31,,,128161000,,82151000,211850000,373809000,0,141651000,20308000,,,,,46010000,373809000,232158000,0,-13490000,,82151000,82151000,59003,NBTB
2019-12-31,,,18880000,12647000,18703000,48763000,150332000,48623000,48623000,1441000,-28247000,,,,0,314614000,265991000,164282000,-29743000,,18880000,18406000,59004,CLDT
2018-12-31,,,30842000,9952000,30641000,49034000,156689000,55680000,55680000,3806000,-26878000,,,,-28000,316015000,260335000,159326000,-24838000,,30870000,30331000,59004,CLDT
2017-12-31,,,30076000,6618000,29478000,44719000,151242000,59708000,59708000,523000,-27901000,,,,396000,295943000,236235000,144701000,-29632000,,29680000,29243000,59004,CLDT
2016-12-31,,,31394000,4848000,31483000,41611000,149950000,59054000,59054000,510000,-28297000,,,,-301000,289799000,230745000,139849000,-27660000,,31695000,31294000,59004,CLDT
2020-12-31,1348000000,,4495000000,11000000,3646000000,6896000000,12475000000,4231000000,4231000000,,-275000000,,,,849000000,22284000000,18053000000,9809000000,264000000,,3646000000,3510000000,59005,DHR
2019-12-31,1126000000,,3305300000,11300000,3008200000,5576300000,9983700000,3281400000,3281400000,,-108600000,,,,873000000,17911100000,14629700000,7927400000,23900000,575900000.0,2432300000,2939800000,59005,DHR
2018-12-31,1059200000,,2961900000,12300000,2650900000,5356500000,9505300000,3089600000,3089600000,,-136900000,,,,555600000,17048500000,13958900000,7543200000,-127700000,244600000.0,2406300000,2650900000,59005,DHR
2017-12-31,956400000,,2543200000,9600000,2492100000,5011900000,8571300000,2603000000,2603000000,,-140100000,,,,371000000,15518800000,12915800000,6947500000,-59800000,319900000.0,2172200000,2492100000,59005,DHR
2020-12-31,,,2096000000,,1392000000,3100000000,6046000000,2394000000,2394000000,,-24000000,,,,704000000,16652000000,14258000000,10606000000,-298000000,,1392000000,1392000000,59006,CTSH
2019-12-31,,,2485000000,,1842000000,2855000000,6149000000,2787000000,2787000000,,-26000000,,,,643000000,16783000000,13996000000,10634000000,-302000000,,1842000000,1842000000,59006,CTSH
2018-12-31,,,2799000000,,2101000000,3007000000,6287000000,2820000000,2820000000,,-27000000,,,,698000000,16125000000,13305000000,9838000000,-21000000,,2101000000,2101000000,59006,CTSH
2017-12-31,,,2657000000,,1504000000,2697000000,5658000000,2553000000,2553000000,,-23000000,,,,1153000000,14810000000,12257000000,9152000000,104000000,,1504000000,1504000000,59006,CTSH
2019-12-31,,,-216960,,-216960,-2000,0,-1780,-1780,3780,,,,,0,0,1780,0,-215180,,-216960,-216960,59007,DCRB
2018-12-31,,,-462,,-462,-2000,0,-462,-462,462,,,,,0,0,462,0,0,,-462,-462,59007,DCRB
2019-12-31,242757000,,744243000,213264000,727829000,887571000,762760000,-367568000,-367568000,,-5089000,,,,20241000,1531062000,1898630000,768302000,1111811000,,724002000,727829000,59011,FENG
2018-12-31,204723000,,-45507000,310634000,-63222000,700130000,780831000,-124022000,-124022000,,-13544000,,,,20105000,1377379000,1501401000,596548000,78515000,,-65612000,-63222000,59011,FENG
2017-12-31,192325000,,49207000,-6388000,37472000,640587000,981050000,14983000,14983000,133155000.0,-22221000,,,,14783000,1575092000,1560109000,594042000,34224000,,34424000,37472000,59011,FENG
2016-12-31,161880000,,92309000,-3340000,80611000,497048000,837867000,59172000,59172000,119767000.0,-7061000,,,,14089000,1444907000,1385735000,607040000,33137000,,78220000,80611000,59011,FENG
2018-12-31,,,64155000,46001000,42410000,272776000,389192000,116416000,116416000,,-14571000,,,,10414000,3318414000,3201998000,2929222000,-52261000,,53741000,42410000,59014,GVA
2017-12-31,,,104463000,47697000,69098000,220400000,314933000,94533000,94533000,,-11000000,,,,28662000,2989713000,2895180000,2674780000,9930000,,75801000,69098000,59014,GVA
2016-12-31,,,96362000,36603000,57122000,217374000,301370000,83996000,83996000,,-12466000,,,,30162000,2514617000,2430621000,2213247000,12366000,,66200000,57122000,59014,GVA
2015-12-31,,,103427000,30884000,60485000,203817000,299836000,96019000,96019000,,-12757000,,,,35179000,2371029000,2275010000,2071193000,7408000,,68248000,60485000,59014,GVA
2020-04-30,,,-4846667,,-4846667,2937988,20129239,17191251,17191251,,-4344412,,,,0,20129239,2937988,0,-22037918,,-4846667,-4846667,59016,MQT
2019-04-30,,,22265395,,22265395,2873134,21263490,18390356,18390356,,-4920054,,,,0,21263490,2873134,0,3875039,,22265395,22265395,59016,MQT
2018-04-30,,,8548180,,8548180,2870565,21337566,18467001,18467001,,-3666587,,,,0,21337566,2870565,0,-9918821,,8548180,8548180,59016,MQT
2017-04-30,,,-443320,,-443320,2869716,22080964,19211248,19211248,,-2832690,,,,0,22080964,2869716,0,-19654568,,-443320,-443320,59016,MQT
2019-12-31,,,44031000,267291000,33564000,132231000,489958000,185552000,185552000,965000,-132291000,,,,402000,626733000,441181000,136775000,-141521000,,43629000,33564000,59018,MSC
2018-12-31,,,-20201000,252929000,-21598000,135935000,447404000,140062000,140062000,2264000,-160508000,,,,544000,571213000,431151000,123809000,-160263000,,-20745000,-21598000,59018,MSC
2017-12-31,,,-76676000,252929000,-76437000,133788000,409567000,100095000,100095000,2565000,-159918000,,,,-239000,539814000,439719000,130247000,-176771000,,-76437000,-76437000,59018,MSC
2016-12-31,,,-242315000,252929000,-242789000,138394000,258036000,-54766000,-54766000,1825000,-159236000,,,,474000,424531000,479297000,166495000,-187549000,,-242789000,-242789000,59018,MSC
2019-12-31,,,683314,,538314,5252946,5744530,491584,491584,,,,,,145000,32873002,32381418,27128472,191730,,538314,538314,59019,CVR
2018-12-31,,,2556185,,2001185,5503111,7905759,2402648,2402648,,,,,,555000,37174249,34771601,29268490,153537,,2001185,2001185,59019,CVR
2017-12-31,,,2466082,,2079082,5548541,7913722,2365181,2365181,,,,,,387000,35764714,33399533,27850992,100901,,2079082,2079082,59019,CVR
2016-12-31,,,3547980,,2356980,5559436,9042161,3482725,3482725,,,,,,1191000,37022378,33539653,27980217,65255,,2356980,2356980,59019,CVR
2019-12-31,,,-53802,,-53802,53802,0,-53802,-53802,,,,,,0,0,53802,0,0,,-53802,-53802,59021,VINC
2019-12-31,431425,,-2470882,,-2470882,8456535,6481438,-2406522,-2406522,,-69322,,,,0,13641315,16047837,7159877,-64360,,-2470882,-2470882,59023,DUOT
2018-12-31,488694,,-1580887,,-1580887,6285433,5204223,-1569904,-1569904,,-17180,,,,0,12048619,13618523,6844396,-10983,,-1580887,-1580887,59023,DUOT
2017-12-31,310099,,-5152477,,-5152477,4723430,1590036,-3443493,-3443493,,-4519035,,,,0,3884588,7328081,2294552,-1708984,,-5152477,-5170237,59023,DUOT
2016-12-31,271950,,-2561613,,-2561613,4844598,3372442,-1744106,-1744106,,-561174,,,,0,6104893,7848999,2732451,-817507,,-2561613,-2567533,59023,DUOT
2019-12-31,9271000,,-13508000,,-13551000,21077000,24624000,-6397000,-6397000,,-784000,,,,43000,31340000,37737000,6716000,-7111000,,-13551000,-13551000,59024,ICAD
2018-12-31,9445000,,-8975000,,-9017000,16410000,19833000,-6730000,-6730000,,-504000,,,,42000,25621000,32351000,5788000,-2245000,,-9017000,-9017000,59024,ICAD
2017-12-31,9327000,,-14274000,,-14256000,18380000,20213000,-8983000,-8983000,,-124000,,,,-18000,28102000,37085000,7889000,-5291000,,-14256000,-14256000,59024,ICAD
2016-12-31,9518000,,-10023000,,-10099000,17854000,19707000,-9970000,-9970000,,-63000,,,,76000,26338000,36308000,6631000,-53000,,-10099000,-10099000,59024,ICAD
2020-02-29,,,-81612000,,-452174000,4481694000,4726758000,245064000,245064000,,-229657000,,,,387607000,21928393000,21683329000,17201635000,-326676000,17045000,-469219000,-452174000,59026,RAD
2019-03-02,,,-589477000,,-422213000,4587671000,4676352000,88681000,88681000,,-227728000,,,,77477000,21639557000,21550876000,16963205000,-678158000,244741000,-666954000,-422213000,59026,RAD
2018-03-03,,,-43545000,,943470000,4651262000,4780105000,128843000,128843000,,-202768000,,,,305987000,21528968000,21400125000,16748863000,-172388000,1293002000,-349532000,943470000,59026,RAD
2017-03-04,,,48518000,,4053000,4776995000,5064707000,287712000,287712000,,-200065000,,,,44438000,22927540000,22639828000,17862833000,-239194000,-27000,4080000,4053000,59026,RAD
2020-12-31,,,-74570000,,-74970000,83998000,132275000,0,36663000,11614000,,,,,400000,132275000,95612000,0,-111233000,,-74970000,-74970000,59027,EQBK
2019-12-31,,,32857000,,25579000,82156000,132511000,0,38875000,11480000,,,,,7278000,132511000,93636000,0,-6018000,,25579000,25579000,59027,EQBK
2018-12-31,,,46175000,,35825000,73600000,140744000,0,57545000,9599000,,,,,10350000,140744000,83199000,0,-11370000,,35825000,35825000,59027,EQBK
2017-12-31,,,31026000,,20649000,51786000,98494000,0,38871000,7837000,,,,,10377000,98494000,59623000,0,-7845000,,20649000,20649000,59027,EQBK
2019-12-31,4182000,,-2580000,,-2580000,4016000,6155000,-2043000,-2043000,,-220000,,,,0,10086000,12129000,3931000,-537000,,-2580000,-2580000,59029,MOSY
2018-12-31,4129000,,-11396000,,-11409000,4095000,10254000,2030000,2030000,,-582000,,,,13000,16600000,14570000,6346000,-13426000,,-11409000,-11409000,59029,MOSY
2017-12-31,8158000,,-10901000,,-10668000,4702000,4148000,-8712000,-8712000,,-927000,,,,-233000,8842000,17554000,4694000,-2189000,,-10668000,-10668000,59029,MOSY
2016-12-31,18086000,,-32003000,,-32048000,5693000,2949000,-20830000,-20830000,,-687000,,,,45000,6024000,26854000,3075000,-11173000,,-32048000,-32048000,59029,MOSY
2020-06-30,,,12515000000,65528000000,14249000000,23898000000,42766000000,18572000000,18572000000,296000000,-20346000000,,,,6869000000,104310000000,85738000000,61544000000,-6057000000,18085000000,5646000000,14249000000,59031,IRS
2019-06-30,,,-49762000000,76813000000,-36610000000,22222000000,26346000000,2024000000,2024000000,2100000000,-19509000000,,,,-4251000000,84981000000,82957000000,58635000000,-51786000000,7140000000,-45511000000,-36610000000,59031,IRS
2018-06-30,,,-14365000000,58181000000,21047000000,20552000000,26043000000,3887000000,3887000000,1604000000,-18159000000,,,,-11135000000,74465000000,70578000000,48422000000,-18252000000,36441000000,-3230000000,21047000000,59031,IRS
2017-06-30,,,-4296000000,21472000000,-1120000000,15874000000,23542000000,6608000000,6608000000,1060000000,-13185000000,,,,1491000000,58912000000,52304000000,35370000000,-10904000000,8835000000,-5787000000,-1120000000,59031,IRS
2019-12-31,,,-55903880,,-55903880,1718246,-8131186,-20765271,-20765271,,-22690892,,,,0,7861331,28626602,15992517,-35138609,,-55903880,-55903880,59034,HOFV
2018-12-31,,,-33625624,,-33625624,1611266,-4547571,-17043894,-17043894,,-16262703,,,,0,6889148,23933042,11436719,-16581730,,-33625624,-33625624,59034,HOFV
2017-12-31,,,-9794625,,-9794625,1309031,2699981,-3167353,-3167353,,-6627272,,,,0,5734630,8901983,3034649,-6627272,,-9794625,-9794625,59034,HOFV
2020-12-31,,,3202000000,,2444000000,,4432000000,3653000000,3653000000,,-458000000,,,,758000000,7710000000,4057000000,3278000000,-451000000,,2444000000,2444000000,59038,CP
2019-12-31,,,3146000000,,2440000000,,4344000000,3505000000,3505000000,133000000.0,-454000000,,,,706000000,7792000000,4287000000,3448000000,-359000000,,2440000000,2440000000,59038,CP
2018-12-31,,,2588000000,,1951000000,,4035000000,3215000000,3215000000,124000000.0,-455000000,,,,637000000,7316000000,4101000000,3281000000,-627000000,,1951000000,1951000000,59038,CP
2017-12-31,,,2498000000,,2405000000,,3524000000,2742000000,2742000000,121000000.0,-475000000,,,,93000000,6554000000,3812000000,3030000000,-244000000,,2405000000,2405000000,59038,CP
