endDate,researchDevelopment,effectOfAccountingCharges,incomeBeforeTax,minorityInterest,netIncome,sellingGeneralAdministrative,grossProfit,ebit,operatingIncome,otherOperatingExpenses,interestExpense,extraordinaryItems,nonRecurring,otherItems,incomeTaxExpense,totalRevenue,totalOperatingExpenses,costOfRevenue,totalOtherIncomeExpenseNet,discontinuedOperations,netIncomeFromContinuingOps,netIncomeApplicableToCommonShares,stockId,ticker,type
2020-12-31,75700000,,432100000,,358600000,515300000,1066200000,475200000,475200000,,-23900000,,,,75000000,3017800000,2542600000,1951600000,-43100000,1500000,357100000,358600000,11,PNR,yearly
2019-12-31,78900000,,407500000,,355700000,525400000,1051500000,447200000,447200000,,-30100000,,,,45800000,2957200000,2510000000,1905700000,-39700000,-6000000,361700000,355700000,11,PNR,yearly
2018-12-31,76700000,,379800000,,347400000,502800000,1047700000,468200000,468200000,,-32600000,,,,58100000,2965100000,2496900000,1917400000,-88400000,25700000,321700000,347400000,11,PNR,yearly
2017-12-31,73200000,,172800000,,666500000,512900000,987500000,401400000,401400000,,-87300000,,,,58700000,2845700000,2444300000,1858200000,-228600000,552400000,114100000,666500000,11,PNR,yearly
2020-12-31,,,365400000,3200000,314300000,610800000,1184000000,573200000,573200000,,-51100000,,,,50900000,2719900000,2146700000,1535900000,-207800000,,314500000,314300000,37,ALLE,yearly
2019-12-31,,,475200000,3000000,401800000,677900000,1260600000,582700000,582700000,,-56000000,,,,73100000,2854000000,2271300000,1593400000,-107500000,,402100000,401800000,37,ALLE,yearly
2018-12-31,,,475200000,3000000,434900000,631500000,1175000000,543500000,543500000,,-54000000,,,,39800000,2731700000,2188200000,1556700000,-68300000,,435400000,434900000,37,ALLE,yearly
2017-12-31,,,395700000,3900000,273300000,580000000,1072900000,492900000,492900000,,-105700000,,,,119000000,2408200000,1915300000,1335300000,-97200000,,276700000,273300000,37,ALLE,yearly
2020-12-31,,,2704000000,1000000,2109000000,2150000000,5199000000,2895000000,2895000000,,-206000000,,,,595000000,12574000000,9679000000,7375000000,-191000000,,2109000000,2109000000,45,ITW,yearly
2019-12-31,,,3288000000,4000000,2521000000,2337000000,5922000000,3426000000,3426000000,,-221000000,,,,767000000,14109000000,10683000000,8187000000,-138000000,,2521000000,2521000000,45,ITW,yearly
2018-12-31,,,3394000000,4000000,2563000000,2371000000,6164000000,3604000000,3604000000,,-257000000,,,,831000000,14768000000,11164000000,8604000000,-210000000,,2563000000,2563000000,45,ITW,yearly
2017-12-31,,,3270000000,4000000,1687000000,2403000000,6008000000,3399000000,3399000000,,-260000000,,,,1583000000,14314000000,10915000000,8306000000,-129000000,,1687000000,1687000000,45,ITW,yearly
2020-10-25,2234000000,,4166000000,,3619000000,1013000000,7715000000,4468000000,4468000000,,-240000000,,,,547000000,17202000000,12734000000,9487000000,-302000000,,3619000000,3619000000,48,AMAT,yearly
2019-10-27,2054000000,,3269000000,,2706000000,960000000,6386000000,3372000000,3372000000,,-237000000,,,,563000000,14608000000,11236000000,8222000000,-103000000,,2706000000,2706000000,48,AMAT,yearly
2018-10-28,2022000000,,4396000000,,3038000000,999000000,7517000000,4496000000,4496000000,,-234000000,,,,1358000000,16705000000,12209000000,9188000000,32000000,,3038000000,3038000000,48,AMAT,yearly
2017-10-29,1781000000,,3816000000,,3519000000,895000000,6612000000,3936000000,3936000000,,-198000000,,,,297000000,14698000000,10762000000,8086000000,-120000000,,3519000000,3519000000,48,AMAT,yearly
2020-12-31,144000000,,-1006000000,26000000,-770000000,2026000000,3083000000,913000000,913000000,,-274000000,,,,-236000000,9385000000,8472000000,6302000000,-1919000000,,-770000000,-770000000,52,NWL,yearly
2019-12-31,149000000,,-852000000,33000000,107000000,2263000000,3235000000,823000000,823000000,,-303000000,,,,-1038000000,9715000000,8892000000,6480000000,-1675000000,-79000000.0,186000000,107000000,52,NWL,yearly
2018-12-31,151000000,,-7992000000,34800000,-6942000000,2486000000,3518000000,881000000,881000000,,-446000000,,,,-1359000000,10154000000,9273000000,6636000000,-8873000000,-309000000.0,-6633000000,-6942000000,52,NWL,yearly
2017-12-31,175000000,,919300000,36600000,2748800000,2749100000,3810500000,886400000,886400000,,-475800000,,,,-1515000000,11170400000,10284000000,7359900000,32900000,314500000.0,2434300000,2748800000,52,NWL,yearly
2020-12-31,,,267342000,216775000,254962000,46858000,985213000,427513000,427513000,,-167562000,,,,3327000,1677984000,1250471000,692771000,-160171000,,264015000,250936000,54,MAA,yearly
2019-12-31,,,370314000,220894000,353811000,43845000,973161000,432473000,432473000,,-179847000,,,,3696000,1641017000,1208544000,667856000,-62159000,,366618000,349604000,54,MAA,yearly
2018-12-31,,,233633000,222349000,222899000,38855000,929125000,400511000,400511000,,-173594000,,,,2611000,1571346000,1170835000,642221000,-166878000,,231022000,218920000,54,MAA,yearly
2017-12-31,,,343155000,233982000,328379000,40194000,908668000,374766000,374766000,,-154751000,,,,2619000,1528987000,1154221000,620319000,-31611000,,340536000,324156000,54,MAA,yearly
2020-12-31,,,963353000,576786000,913636000,48305000,1655320000,786183000,786183000,,-374012000,,,,852000,2571705000,1785522000,916385000,177170000,,962501000,910546000,80,EQR,yearly
2019-12-31,,,1007427000,692420000,970377000,52757000,1792363000,908523000,908523000,,-401746000,,,,-2281000,2700691000,1792168000,908328000,98904000,,1009708000,967287000,80,EQR,yearly
2018-12-31,,,686070000,605551000,657535000,53813000,1698047000,858509000,858509000,,-424670000,,,,878000,2577681000,1719172000,879634000,-172439000,,685192000,654445000,80,EQR,yearly
2017-12-31,,,628859000,598354000,603454000,52224000,1645137000,849164000,849164000,,-392416000,,,,478000,2471406000,1622242000,826269000,-220305000,,628381000,600363000,80,EQR,yearly
2020-06-30,,,1046000000,27000000,684000000,8651000000,10752000000,2101000000,2101000000,,-161000000,,,,350000000,14294000000,12193000000,3542000000,-1055000000,,696000000,684000000,97,EL,yearly
2019-06-30,,,2307000000,25000000,1785000000,8896000000,11498000000,2602000000,2602000000,,-133000000,,,,513000000,14863000000,12261000000,3365000000,-295000000,,1794000000,1785000000,97,EL,yearly
2018-06-30,,,1980000000,22000000,1108000000,8599000000,10857000000,2258000000,2258000000,,-128000000,,,,863000000,13683000000,11425000000,2826000000,-278000000,,1117000000,1108000000,97,EL,yearly
2017-06-30,,,1617000000,18000000,1249000000,7529000000,9405000000,1876000000,1876000000,,-103000000,,,,361000000,11824000000,9948000000,2419000000,-259000000,,1256000000,1249000000,97,EL,yearly
2020-12-31,551000000,,1746000000,43000000,1410000000,3113000000,5450000000,1786000000,1786000000,,-221000000,,,,331000000,17858000000,16072000000,12408000000,-40000000,,1415000000,1410000000,119,ETN,yearly
2019-12-31,606000000,,2591000000,51000000,2211000000,3589000000,7052000000,2857000000,2857000000,,-272000000,,,,378000000,21390000000,18533000000,14338000000,-266000000,,2213000000,2211000000,119,ETN,yearly
2018-12-31,584000000,,2424000000,35000000,2145000000,3542000000,7098000000,2972000000,2972000000,,-258000000,,,,278000000,21609000000,18637000000,14511000000,-548000000,,2146000000,2145000000,119,ETN,yearly
2017-12-31,584000000,,3368000000,37000000,2985000000,3560000000,6648000000,2504000000,2504000000,,-246000000,,,,382000000,20404000000,17900000000,13756000000,864000000,,2986000000,2985000000,119,ETN,yearly
2020-12-31,,,18995000000,,17894000000,48483000000,74208000000,0,19818000000,5907000000,,,,,1101000000,74208000000,54390000000,0,-823000000,,17894000000,16473000000,134,BAC,yearly
2019-12-31,,,32754000000,,27430000000,46742000000,85582000000,0,33435000000,5405000000,,,,,5324000000,85582000000,52147000000,0,-681000000,,27430000000,25998000000,134,BAC,yearly
2018-12-31,,,34584000000,,28147000000,46188000000,87738000000,0,34584000000,6966000000,,,,,6437000000,87738000000,53154000000,0,0,,28147000000,26696000000,134,BAC,yearly
2017-12-31,,,29213000000,,18232000000,46359000000,83730000000,0,29213000000,8158000000,,,,,10981000000,83730000000,54517000000,0,0,,18232000000,16618000000,134,BAC,yearly
2020-03-28,853589000,,833984000,,792721000,428108000,2137432000,824450000,824450000,,-39820000,,,,41263000,3162666000,2338216000,1025234000,9534000,,792721000,792721000,137,XLNX,yearly
2019-03-30,743027000,,968332000,,889750000,398416000,2103172000,956799000,956799000,,-52883000,,,,78582000,3059040000,2102241000,955868000,11533000,,889750000,889750000,137,XLNX,yearly
2018-03-31,639750000,,691379000,,463981000,362329000,1723604000,719373000,719373000,,-45837000,,,,227398000,2467023000,1747650000,743419000,-27994000,,463981000,463981000,137,XLNX,yearly
2017-04-01,601443000,,698076000,,628133000,335150000,1648110000,706390000,706390000,,-53953000,,,,69943000,2356742000,1650352000,708632000,-8314000,,628133000,628133000,137,XLNX,yearly
2020-12-31,495000000,,1292000000,37000000,1102000000,2360000000,4733000000,1878000000,1878000000,,-153000000,,,,182000000,11673000000,9795000000,6940000000,-586000000,,1110000000,1102000000,144,BAX,yearly
2019-12-31,542000000,,970000000,30000000,1001000000,2384000000,4916000000,1990000000,1990000000,,-111000000,,,,-41000000,11362000000,9372000000,6446000000,-1020000000,,1011000000,1001000000,144,BAX,yearly
2018-12-31,618000000,,1617000000,22000000,1546000000,2401000000,4811000000,1801000000,1801000000,-9000000.0,-93000000,,,,65000000,11099000000,9298000000,6288000000,-184000000,-6000000.0,1552000000,1546000000,144,BAX,yearly
2017-12-31,615000000,,1100000000,-8000000,602000000,2516000000,4585000000,1510000000,1510000000,-56000000.0,-85000000,,,,491000000,10584000000,9074000000,5999000000,-410000000,-7000000.0,609000000,602000000,144,BAX,yearly
2020-12-31,,,682253000,154674000,584520000,2667778000,3881231000,1213453000,1213453000,,-326800000,,,,77153000,7423558000,6210105000,3542327000,-531200000,,605100000,584520000,149,GPN,yearly
2019-12-31,,,531466000,199242000,430613000,1847772000,2894789000,1047017000,1047017000,,-301200000,,,,62190000,4911892000,3864875000,2017103000,-515551000,,469276000,430613000,149,GPN,yearly
2018-12-31,,,562155000,194936000,452053000,1478197000,2271352000,793155000,793155000,,-195500000,,,,77488000,3366366000,2573211000,1095014000,-231000000,,484667000,452053000,149,GPN,yearly
2017-12-31,,,392683000,170704000,468425000,1488258000,2047126000,558868000,558868000,,-174300000,,,,-101387000,3975163000,3416295000,1928037000,-166185000,,494070000,468425000,149,GPN,yearly
2020-12-31,,,1693500000,314000000,1395800000,4646500000,6340000000,1693500000,1693500000,,,,,,265000000,14741700000,13048200000,8401700000,0,,1428500000,1395800000,150,PFG,yearly
2019-12-31,,,1693300000,332700000,1394200000,4503900000,6197200000,1693300000,1693300000,,,,,,249200000,16222100000,14528800000,10024900000,0,,1444100000,1394200000,150,PFG,yearly
2018-12-31,,,1784400000,457200000,1546500000,4136700000,5921100000,1784400000,1784400000,,,,,,230700000,14237200000,12452800000,8316100000,0,,1553700000,1546500000,150,PFG,yearly
2017-12-31,,,2252200000,173900000,2310400000,3893800000,6146000000,2252200000,2252200000,,,,,,-72300000,14093200000,11841000000,7947200000,0,,2324500000,2310400000,150,PFG,yearly
2020-12-31,,,-466000000,,-267000000,1038000000,1442000000,467000000,467000000,-293000000,-445000000,,,,-199000000,2119000000,1652000000,677000000,-933000000,,-267000000,-267000000,151,MAR,yearly
2019-12-31,,,1599000000,,1273000000,1789000000,4057000000,2037000000,2037000000,-11000000,-394000000,,,,326000000,5373000000,3336000000,1316000000,-438000000,,1273000000,1273000000,151,MAR,yearly
2018-12-31,,,2345000000,,1907000000,1587000000,3909000000,2521000000,2521000000,-425000000,-340000000,,,,438000000,5215000000,2694000000,1306000000,-176000000,,1907000000,1907000000,151,MAR,yearly
2017-12-31,,,2982000000,,1459000000,1483000000,3586000000,2663000000,2663000000,-789000000,-288000000,,,,1523000000,4997000000,2334000000,1411000000,319000000,,1459000000,1459000000,151,MAR,yearly
2020-12-31,,,-4256000000,,-3074000000,168000000,-1875000000,-5041000000,-5041000000,1743000000,-342000000,,,,-1182000000,9048000000,14089000000,10923000000,785000000,,-3074000000,-3074000000,185,LUV,yearly
2019-12-31,,,2957000000,,2300000000,225000000,7020000000,2948000000,2948000000,2628000000,-82000000,,,,657000000,22428000000,19480000000,15408000000,9000000,,2300000000,2300000000,185,LUV,yearly
2018-12-31,,,3164000000,,2465000000,227000000,7245000000,3180000000,3180000000,2637000000,-93000000,,,,699000000,21965000000,18785000000,14720000000,-16000000,,2465000000,2465000000,185,LUV,yearly
2017-12-31,,,3265000000,,3357000000,238000000,7316000000,3354000000,3354000000,2527000000,-65000000,,,,-92000000,21146000000,17792000000,13830000000,-89000000,,3357000000,3357000000,185,LUV,yearly
2020-12-31,126898000,,205692000,1292000,159572000,180588000,538996000,231510000,231510000,,,,,,45354000,1200724000,969214000,661728000,-25818000,,160338000,159572000,187,IPGP,yearly
2019-12-31,129997000,,248376000,717000,180234000,185342000,606209000,290870000,290870000,,,,,,68115000,1314581000,1023711000,708372000,-42494000,,180261000,180234000,187,IPGP,yearly
2018-12-31,122769000,,534395000,687000,404027000,160244000,800268000,517255000,517255000,,,,,,130226000,1459874000,942619000,659606000,16584000,,404169000,404027000,187,IPGP,yearly
2017-12-31,100870000,,551871000,687000,347614000,130469000,796911000,565572000,565572000,,,,,,204283000,1408889000,843317000,611978000,-13701000,,347588000,347614000,187,IPGP,yearly
2020-12-31,686000000,,1174000000,17000000,949000000,1212000000,3637000000,1524000000,1524000000,,-233000000,,,,221000000,7414000000,5890000000,3777000000,-350000000,,953000000,949000000,200,MSI,yearly
2019-12-31,687000000,,1001000000,17000000,868000000,1325000000,3948000000,1728000000,1728000000,,-237000000,,,,130000000,7887000000,6159000000,3939000000,-727000000,,871000000,868000000,200,MSI,yearly
2018-12-31,637000000,,1102000000,17000000,966000000,1179000000,3539000000,1535000000,1535000000,,-240000000,,,,133000000,7343000000,5808000000,3804000000,-433000000,,969000000,966000000,200,MSI,yearly
2017-12-31,568000000,,1076000000,15000000,-155000000,979000000,3033000000,1335000000,1335000000,,-215000000,,,,1227000000,6380000000,5045000000,3347000000,-259000000,,-151000000,-155000000,200,MSI,yearly
2019-12-31,187400000,,171000000,300000,146100000,1148500000,1773300000,444200000,444200000,-6800000,-128400000,,,,24900000,4837400000,4393200000,3064100000,-273200000,,146100000,146100000,219,PRGO,yearly
2018-12-31,218600000,,290600000,100000,131000000,1123800000,1831500000,483900000,483900000,5200000,-122100000,,,,159600000,4731700000,4247800000,2900200000,-193300000,,131000000,131000000,219,PRGO,yearly
2017-12-31,167700000,,280100000,100000,119600000,1145700000,1979500000,692500000,692500000,-26400000,-166100000,,,,160500000,4946200000,4253700000,2966700000,-412400000,,119600000,119600000,219,PRGO,yearly
2016-12-31,184000000,,-4848300000,-500000,-4012800000,1205900000,2051800000,661900000,661900000,-26400000,-212800000,,,,-835500000,5280600000,4618700000,3228800000,-5510200000,,-4012800000,-4012800000,219,PRGO,yearly
2020-12-31,,,1626157000,,1409594000,1090527000,2723880000,1633353000,1633353000,,-6996000,,,,216563000,4598638000,2965285000,1874758000,-7196000,,1409594000,1409594000,257,MNST,yearly
2019-12-31,,,1415962000,,1107835000,668346000,2518585000,1414239000,1414239000,,-56000,,,,308127000,4200819000,2786580000,1682234000,1723000,,1107835000,1107835000,257,MNST,yearly
2018-12-31,,,1293272000,,993004000,985156000,2295375000,1310219000,1310219000,,-60000,,,,300268000,3807183000,2496964000,1511808000,-16947000,,993004000,993004000,257,MNST,yearly
2017-12-31,,,1201623000,,820678000,903503000,2137690000,1234187000,1234187000,,-80000,,,,380945000,3369045000,2134858000,1231355000,-32564000,,820678000,820678000,257,MNST,yearly
2020-12-31,453000000,,560000000,,504000000,787000000,2003000000,685000000,685000000,,-76000000,,,,56000000,4448000000,3763000000,2445000000,-125000000,,504000000,504000000,276,ZBRA,yearly
2019-12-31,447000000,,598000000,,544000000,826000000,2100000000,724000000,724000000,,-86000000,,,,54000000,4485000000,3761000000,2385000000,-126000000,,544000000,544000000,276,ZBRA,yearly
2018-12-31,444000000,,524000000,,421000000,798000000,1981000000,642000000,642000000,,-90000000,,,,103000000,4218000000,3576000000,2237000000,-118000000,,421000000,421000000,276,ZBRA,yearly
2017-12-31,389000000,,88000000,,17000000,749000000,1710000000,388000000,388000000,,-162000000,,,,71000000,3722000000,3334000000,2012000000,-300000000,,17000000,17000000,276,ZBRA,yearly
2020-12-31,59214000,,501040000,200367000,375764000,386500000,995553000,549839000,549839000,,-73116000,,,,54425000,3128909000,2579070000,2133356000,-48799000,,446615000,375764000,321,ALB,yearly
2019-12-31,58287000,,692518000,161330000,533228000,438562000,1259478000,762629000,762629000,,-52866000,,,,88161000,3589427000,2826798000,2329949000,-70111000,,604357000,533228000,321,ALB,yearly
2018-12-31,70054000,,883965000,173787000,693562000,409736000,1234756000,754966000,754966000,,-52405000,,,,144826000,3374950000,2619984000,2140194000,128999000,,739139000,693562000,321,ALB,yearly
2017-12-31,78630000,,531285000,143147000,54850000,420022000,1145271000,646619000,646619000,,-62549000,,,,431817000,3071976000,2425357000,1926705000,-115334000,,99468000,54850000,321,ALB,yearly
2020-12-31,,,1161400000,35000000,-1205100000,3309100000,4932600000,1623500000,1623500000,,-206400000,,,,176600000,11790200000,10166700000,6857600000,-462100000,-2172500000,984800000,-1205100000,323,ECL,yearly
2019-12-31,,,1898900000,40500000,1558900000,3873700000,6221400000,2347700000,2347700000,,-215100000,,,,322700000,14906300000,12558600000,8684900000,-448800000,-2172500000,1576200000,1558900000,323,ECL,yearly
2018-12-31,,,1804600000,50400000,1429100000,3890100000,6051600000,2161500000,2161500000,,-236900000,,,,364300000,14668200000,12506700000,8616600000,-356900000,-2172500000,1440300000,1429100000,323,ECL,yearly
2017-12-31,,,1762400000,70200000,1504600000,3758000000,5815700000,2057700000,2057700000,,-252700000,,,,243800000,13835900000,11778200000,8020200000,-295300000,-2172500000,1518600000,1504600000,323,ECL,yearly
2020-12-31,,,10868000000,65000000,8458000000,13475000000,24356000000,8899000000,8899000000,,-1400000000,,,,2379000000,160550000000,151651000000,136194000000,1969000000,,8489000000,8458000000,344,CI,yearly
2019-12-31,,,6570000000,41000000,5104000000,13261000000,25256000000,9046000000,9046000000,,-1600000000,,,,1450000000,153743000000,144697000000,128487000000,-2476000000,,5120000000,5104000000,344,CI,yearly
2018-12-31,,,3581000000,44000000,2637000000,11141000000,16248000000,4872000000,4872000000,,-507000000,,,,935000000,48569000000,43697000000,32321000000,-1291000000,,2646000000,2637000000,344,CI,yearly
2017-12-31,,,3606000000,49000000,2237000000,9830000000,14324000000,4379000000,4379000000,9214000000.0,-243000000,,,,1374000000,42043000000,37664000000,27719000000,-773000000,,2232000000,2237000000,344,CI,yearly
2020-12-31,,,4300000000,,3299000000,5596000000,11338000000,0,4723000000,415000000,,,,,1001000000,11691000000,6968000000,353000000,-423000000,,3299000000,3043000000,350,SCHW,yearly
2019-12-31,,,4848000000,,3704000000,4922000000,10468000000,0,4936000000,261000000,,,,,1144000000,10721000000,5785000000,253000000,-88000000,,3704000000,3526000000,350,SCHW,yearly
2018-12-31,,,4562000000,,3507000000,4709000000,9890000000,0,4562000000,313000000,,,,,1055000000,10132000000,5570000000,242000000,0,,3507000000,3329000000,350,SCHW,yearly
2017-12-31,,,3650000000,,2354000000,4200000000,8387000000,0,3650000000,268000000,,,,,1296000000,8618000000,4968000000,231000000,0,,2354000000,2180000000,350,SCHW,yearly
2020-12-31,320700000,,1507700000,8500000,1613300000,1748400000,2608500000,539400000,539400000,,-148500000,,,,55500000,4634400000,4095000000,2025900000,968300000,161100000,1452200000,1544300000,361,FTV,yearly
2019-12-31,456700000,,874500000,13200000,738900000,2079600000,3696100000,1159800000,1159800000,,-164200000,,,,149100000,7320000000,6160200000,3623900000,-285300000,13500000,725400000,669900000,361,FTV,yearly
2018-12-31,414300000,,1078400000,17400000,2913800000,1701900000,3323300000,1207100000,1207100000,,-97000000,,,,160100000,6452700000,5245600000,3129400000,-128700000,1995500000,918300000,2878900000,361,FTV,yearly
2017-12-31,369300000,,1073600000,17900000,1044500000,1377800000,2923400000,1176300000,1176300000,,-88700000,,,,189300000,5756100000,4579800000,2832700000,-102700000,160200000,884300000,1044500000,361,FTV,yearly
2020-12-31,,,2773000000,189000000,1808000000,10763000000,17912000000,4110000000,4110000000,2320000000,-728000000,,,,979000000,104176000000,100066000000,86264000000,-1337000000,,1794000000,1808000000,375,CNC,yearly
2019-12-31,,,1782000000,141000000,1321000000,6448000000,11945000000,2580000000,2580000000,2659000000,-412000000,,,,473000000,70807000000,68227000000,58862000000,-798000000,,1309000000,1321000000,375,CNC,yearly
2018-12-31,,,1368000000,106000000,900000000,6331000000,10631000000,2132000000,2132000000,1957000000,-343000000,,,,474000000,56688000000,54556000000,46057000000,-764000000,,894000000,900000000,375,CNC,yearly
2017-12-31,,,1134000000,26000000,828000000,4370000000,7959000000,1465000000,1465000000,1968000000,-255000000,,,,326000000,45810000000,44345000000,37851000000,-328000000,,808000000,828000000,375,CNC,yearly
2020-03-28,,,727208000,,679449000,4529120000,5817436000,1288316000,1288316000,,-92042000,,,,98062000,10488556000,9200240000,4671120000,-561108000,50303000,629146000,679449000,470,VFC,yearly
2019-03-30,,,1038313000,,1259792000,4302258000,5625161000,1322903000,1322903000,,-107738000,,,,167887000,10266887000,8943984000,4641726000,-284590000,389366000,870426000,1259792000,470,VFC,yearly
2018-03-31,,,1278414000,,658553000,4508093000,5886506000,1378413000,1378413000,,-102384000,,,,641506000,11492383000,10113970000,5605877000,-99999000,21645000,636908000,658553000,470,VFC,yearly
2017-12-30,,,787879000,,614923000,3626301000,4550036000,923735000,923735000,,-101974000,,,,519809000,8394684000,7470949000,3844648000,-135856000,346853000,268070000,614923000,470,VFC,yearly
2020-12-31,,,1883000000,96000000,1772000000,2591000000,4453000000,1806000000,1806000000,9000000,-339000000,,,,101000000,64355000000,62549000000,59902000000,77000000,,1782000000,1772000000,488,ADM,yearly
2019-12-31,,,1588000000,75000000,1379000000,2519000000,4147000000,1587000000,1587000000,18000000,-402000000,,,,209000000,64656000000,63069000000,60509000000,1000000,,1379000000,1379000000,488,ADM,yearly
2018-12-31,,,2060000000,64000000,1810000000,2213000000,4181000000,1924000000,1924000000,18000000,-364000000,,,,245000000,64341000000,62417000000,60160000000,136000000,,1815000000,1810000000,488,ADM,yearly
2017-12-31,,,1609000000,62000000,1595000000,1984000000,3518000000,1524000000,1524000000,10000000,-330000000,,,,7000000,60828000000,59304000000,57310000000,85000000,,1602000000,1595000000,488,ADM,yearly
2020-06-30,,,15834000000,357000000,13027000000,20142000000,36314000000,16172000000,16172000000,,-465000000,,,,2731000000,70950000000,54778000000,34636000000,-338000000,,13103000000,12764000000,541,PG,yearly
2019-06-30,,,6069000000,385000000,3897000000,19083000000,33437000000,14354000000,14354000000,,-509000000,,,,2103000000,67684000000,53330000000,34247000000,-8285000000,,3966000000,3634000000,541,PG,yearly
2018-06-30,,,13326000000,590000000,9750000000,19037000000,32400000000,13363000000,13363000000,,-506000000,,,,3465000000,66832000000,53469000000,34432000000,-37000000,,9861000000,9485000000,541,PG,yearly
2017-06-30,,,13257000000,594000000,15326000000,18654000000,32420000000,13766000000,13766000000,,-465000000,,,,3063000000,65058000000,51292000000,32638000000,-509000000,5217000000.0,10194000000,15079000000,541,PG,yearly
2020-12-31,141249000,,661985000,707000,581776000,735267000,1571040000,694524000,694524000,,-33125000,,,,79854000,2706655000,2012131000,1135615000,-32539000,,582131000,581776000,543,IDXX,yearly
2019-12-31,133193000,,522218000,352000,427720000,666110000,1365549000,566246000,566246000,,-31055000,,,,94426000,2406908000,1840662000,1041359000,-44028000,,427792000,427720000,543,IDXX,yearly
2018-12-31,117863000,,457742000,280000,377031000,632344000,1241542000,491335000,491335000,,-34744000,,,,80695000,2213242000,1721907000,971700000,-36222000,,377047000,377031000,543,IDXX,yearly
2017-12-31,109182000,,381057000,264000,263144000,575172000,1097382000,413028000,413028000,,-37225000,,,,117788000,1969058000,1556030000,871676000,-31971000,,263269000,263144000,543,IDXX,yearly
2020-12-31,,,924000000,,709000000,-49000000,2155000000,1297000000,1297000000,303000000,-395000000,,,,215000000,3777000000,2480000000,1622000000,-373000000,,709000000,709000000,562,AWK,yearly
2019-12-31,,,833000000,,621000000,-16000000,2066000000,1220000000,1220000000,280000000,-382000000,,,,212000000,3610000000,2390000000,1544000000,-387000000,,621000000,621000000,562,AWK,yearly
2018-12-31,,,787000000,,567000000,-20000000,1961000000,1159000000,1159000000,277000000,-350000000,,,,222000000,3440000000,2281000000,1479000000,-372000000,,565000000,567000000,562,AWK,yearly
2017-12-31,,,912000000,,426000000,9000000,1988000000,1228000000,1228000000,259000000,-356000000,,,,486000000,3357000000,2129000000,1369000000,-316000000,,426000000,426000000,562,AWK,yearly
2020-12-31,1530000000,,6017000000,,5595000000,1616000000,9269000000,5925000000,5925000000,,-190000000,,,,422000000,14461000000,8536000000,5192000000,92000000,,5595000000,5568000000,579,TXN,yearly
2019-12-31,1544000000,,5728000000,,5017000000,1650000000,9164000000,5682000000,5682000000,,-170000000,,,,711000000,14383000000,8701000000,5219000000,46000000,,5017000000,4985000000,579,TXN,yearly
2018-12-31,1559000000,,6686000000,,5580000000,1716000000,10277000000,6684000000,6684000000,,-125000000,,,,1106000000,15784000000,9100000000,5507000000,2000000,,5580000000,5537000000,579,TXN,yearly
2017-12-31,1508000000,,6080000000,,3682000000,1754000000,9614000000,6034000000,6034000000,,-78000000,,,,2398000000,14961000000,8927000000,5347000000,46000000,,3682000000,3648000000,579,TXN,yearly
2020-12-31,,,6927000000,259000000,5407000000,,20077000000,7838000000,7838000000,12239000000,-913000000,,,,1509000000,67842000000,60004000000,47765000000,-911000000,,5418000000,5191000000,619,MET,yearly
2019-12-31,,,6795000000,238000000,5899000000,,20484000000,7856000000,7856000000,12628000000,-955000000,,,,886000000,69620000000,61764000000,49136000000,-1061000000,,5909000000,5721000000,619,MET,yearly
2018-12-31,,,6307000000,217000000,5123000000,,20021000000,7490000000,7490000000,12531000000,-1122000000,,,,1179000000,67941000000,60451000000,47920000000,-1183000000,,5128000000,4982000000,619,MET,yearly
2017-12-31,,,3536000000,194000000,4010000000,,17157000000,4838000000,4838000000,12319000000,-1129000000,,,,-1470000000,62308000000,57470000000,45151000000,-1302000000,-986000000.0,5006000000,3907000000,619,MET,yearly
2020-10-02,,,441203000,39955000,491845000,1719484000,2588981000,869497000,869497000,,-62206000,,,,55320000,13566975000,12697478000,10977994000,-428294000,137984000,385883000,491745000,623,J,yearly
2019-09-27,,,350959000,53967000,847979000,1720092000,2481963000,761871000,761871000,,-83847000,,,,36954000,12737868000,11975997000,10255905000,-410912000,557019000,314005000,846769000,623,J,yearly
2018-09-28,,,330981000,90009000,163431000,1523567000,2162437000,638870000,638870000,,-76760000,,,,325632000,10579773000,9940903000,8417336000,-307889000,167616000,5349000,162623000,623,J,yearly
2017-09-29,,,243154000,58999000,293727000,912774000,1260035000,347261000,347261000,,-12035000,,,,73103000,6330126000,5982865000,5070091000,-104107000,123560000,170051000,290650000,623,J,yearly
2020-12-31,,,810000000,,696000000,785000000,1670000000,886000000,886000000,-1000000,-114000000,,,,114000000,9361000000,8475000000,7691000000,-76000000,,696000000,696000000,680,HII,yearly
2019-12-31,,,683000000,,549000000,776000000,1531000000,755000000,755000000,-1000000,-70000000,,,,134000000,8899000000,8144000000,7368000000,-72000000,,549000000,549000000,680,HII,yearly
2018-12-31,,,971000000,,836000000,797000000,1791000000,1008000000,1008000000,-14000000,-58000000,,,,135000000,8176000000,7168000000,6385000000,-37000000,,836000000,836000000,680,HII,yearly
2017-12-31,,,772000000,,479000000,775000000,1628000000,853000000,853000000,-14000000,-94000000,,,,293000000,7441000000,6588000000,5813000000,-81000000,,479000000,479000000,680,HII,yearly
2020-12-31,,,870900000,46500000,818800000,878300000,2510500000,1121500000,1121500000,,-196400000,,,,12800000,6781800000,5660300000,4271300000,-250600000,,858100000,818800000,690,AJG,yearly
2019-12-31,,,626100000,60000000,668800000,1031500000,2272200000,766400000,766400000,,-179800000,,,,-89700000,6894200000,6127800000,4622000000,-143200000,,715800000,668800000,690,AJG,yearly
2018-12-31,,,479400000,70800000,633500000,903700000,1868900000,556800000,556800000,,-138400000,,,,-196500000,6711200000,6154400000,4842300000,-77400000,,675900000,633500000,690,AJG,yearly
2017-12-31,,,359800000,64100000,481300000,790400000,1706600000,536600000,536600000,,-124100000,,,,-157100000,6050900000,5514300000,4344300000,-176800000,,516900000,481300000,690,AJG,yearly
2020-12-31,,,632700000,,461000000,537300000,1390400000,848000000,848000000,5100000,-93500000,,,,171700000,6658200000,5810200000,5267800000,-215300000,,461000000,457400000,691,PKG,yearly
2019-12-31,,,917000000,,696400000,565500000,1644000000,1071800000,1071800000,6700000,-110600000,,,,220600000,6964300000,5892500000,5320300000,-154800000,,696400000,691200000,691,PKG,yearly
2018-12-31,,,970500000,,738000000,538500000,1645300000,1100100000,1100100000,6700000,-89800000,,,,232500000,7014600000,5914500000,5369300000,-129600000,,738000000,732300000,691,PKG,yearly
2017-12-31,,,828600000,,668600000,521200000,1470800000,945700000,945700000,3900000,-96900000,,,,160000000,6444900000,5499200000,4974100000,-117100000,,668600000,663000000,691,PKG,yearly
2020-12-31,260700000,,1526600000,67000000,1203400000,760300000,2664100000,1643100000,1643100000,,-115400000,,,,313300000,8598900000,6955800000,5934800000,-116500000,,1213300000,1203400000,704,APH,yearly
2019-12-31,234200000,,1495900000,65900000,1155000000,742100000,2616000000,1639700000,1639700000,,-117600000,,,,331900000,8225400000,6585700000,5609400000,-143800000,,1164000000,1155000000,704,APH,yearly
2018-12-31,220900000,,1588400000,47200000,1205000000,746000000,2654900000,1688000000,1688000000,,-101700000,,,,371500000,8202000000,6514000000,5547100000,-99600000,,1216900000,1205000000,704,APH,yearly
2017-12-31,193700000,,1352400000,53600000,650500000,699500000,2309900000,1416700000,1416700000,,-92300000,,,,691700000,7011300000,5594600000,4701400000,-64300000,,660700000,650500000,704,APH,yearly
2020-12-31,88363000,,175042000,,194820000,259561000,542512000,172926000,172926000,,-610000,,,,-19778000,1116663000,943737000,574151000,2116000,,194820000,194820000,732,TYL,yearly
2019-12-31,81342000,,159838000,,146527000,256646000,516900000,157467000,157467000,,-1750000,,,,13311000,1086427000,928960000,569527000,2371000,,146527000,146527000,732,TYL,yearly
2018-12-31,63264000,,155870000,,147462000,207605000,439578000,152492000,152492000,,-770000,,,,8408000,935282000,782790000,495704000,3378000,,147462000,147462000,732,TYL,yearly
2017-12-31,47324000,,163456000,,169571000,175914000,399377000,162758000,162758000,,-804000,,,,-6115000,840899000,678141000,441522000,698000,,169571000,169571000,732,TYL,yearly
2020-09-30,1096000000,,985000000,,874000000,4318000000,7919000000,2520000000,2520000000,-15000000,-528000000,,,,111000000,17117000000,14597000000,9198000000,-1535000000,,874000000,767000000,770,BDX,yearly
2019-09-30,1032000000,,1176000000,,1233000000,4334000000,8288000000,2921000000,2921000000,1000000,-639000000,,,,-57000000,17290000000,14369000000,9002000000,-1745000000,,1233000000,1081000000,770,BDX,yearly
2018-09-30,1004000000,,1173000000,,311000000,4029000000,7805000000,2772000000,2772000000,1000000,-706000000,,,,862000000,15983000000,13211000000,8178000000,-1599000000,,311000000,159000000,770,BDX,yearly
2017-09-30,770000000,,976000000,,1100000000,2953000000,5965000000,2243000000,2243000000,-1000000,-521000000,,,,-124000000,12093000000,9850000000,6128000000,-1267000000,,1100000000,1030000000,770,BDX,yearly
2020-12-31,36100000,,186812000,30330000,116326000,773173000,1179066000,369793000,369793000,,-57386000,,,,60031000,3728134000,3358341000,2549068000,-182981000,,126781000,116326000,794,FLS,yearly
2019-12-31,42000000,,322433000,25602000,238828000,832496000,1306580000,432084000,432084000,,-54980000,,,,75493000,3939697000,3507613000,2633117000,-109651000,,246940000,238828000,794,FLS,yearly
2018-12-31,39600000,,156437000,18465000,104508000,891283000,1190869000,259986000,259986000,,-58160000,,,,46550000,3835699000,3575713000,2644830000,-103549000,,109887000,104508000,794,FLS,yearly
2017-12-31,38600000,,263007000,16367000,2652000,842840000,1088953000,207513000,207513000,,-59730000,,,,258679000,3660831000,3453318000,2571878000,55494000,,4328000,2652000,794,FLS,yearly
2020-12-31,,,3647000000,358000000,2695000000,6096000000,10021000000,3789000000,3789000000,136000000,-183000000,,,,787000000,16471000000,12682000000,6450000000,-142000000,,2860000000,2695000000,795,CL,yearly
2019-12-31,,,3301000000,441000000,2367000000,5616000000,9336000000,3614000000,3614000000,106000000,-192000000,,,,774000000,15693000000,12079000000,6357000000,-313000000,,2527000000,2367000000,795,CL,yearly
2018-12-31,,,3464000000,299000000,2400000000,5434000000,9262000000,3759000000,3759000000,69000000,-193000000,,,,906000000,15544000000,11785000000,6282000000,-295000000,,2558000000,2400000000,795,CL,yearly
2017-12-31,,,3487000000,303000000,2024000000,5412000000,9355000000,3925000000,3925000000,18000000,-153000000,,,,1313000000,15454000000,11529000000,6099000000,-438000000,,2174000000,2024000000,795,CL,yearly
2020-12-31,,,855100000,,744300000,1021000000,2013000000,992000000,992000000,,-118500000,,,,110800000,4835000000,3843000000,2822000000,-136900000,,744300000,744300000,805,WU,yearly
2019-12-31,,,1321400000,,1058300000,1206700000,2245400000,1038700000,1038700000,,-152000000,,,,263100000,5292100000,4253400000,3046700000,282700000,,1058300000,1058300000,805,WU,yearly
2018-12-31,,,991400000,,851900000,1178700000,2289100000,1110400000,1110400000,,-149600000,,,,139500000,5589900000,4479500000,3300800000,-119000000,,851900000,851900000,805,WU,yearly
2017-12-31,,,347500000,,-557100000,1184100000,2207000000,1022900000,1022900000,,-142100000,,,,904600000,5524300000,4501400000,3317300000,-675400000,,-557100000,-557100000,805,WU,yearly
2020-12-31,538080000,,554880000,,504446000,1576486000,2770936000,620789000,620789000,,-64687000,,,,50434000,3236700000,2615911000,465764000,-65909000,,504446000,504446000,812,CTXS,yearly
2019-12-31,518877000,,509500000,,681813000,1453385000,2597857000,571565000,571565000,,-45974000,,,,-172313000,3010564000,2438999000,412707000,-62065000,,681813000,681813000,812,CTXS,yearly
2018-12-31,439984000,,629455000,,575667000,1389577000,2587159000,694685000,694685000,,-80162000,,,,53788000,2973903000,2279218000,386744000,-65230000,,575667000,575667000,812,CTXS,yearly
2017-12-31,415801000,,550346000,,-20719000,1308177000,2450728000,643872000,643872000,,-51609000,,,,528361000,2824686000,2180814000,373958000,-93526000,-42704000.0,21985000,-20719000,812,CTXS,yearly
2020-06-30,,,3182600000,,2466500000,2856000000,6511600000,3288700000,3288700000,,-107100000,,,,716100000,14589800000,11301100000,8078200000,-106100000,,2466500000,2466500000,875,ADP,yearly
2019-06-30,,,3005600000,,2292800000,2871000000,6393000000,3217600000,3217600000,,-129900000,,,,712800000,14110200000,10892600000,7717200000,-212000000,,2292800000,2292800000,875,ADP,yearly
2018-06-30,,,2282600000,,1884900000,2893600000,5791300000,2623200000,2623200000,,-102700000,,,,397700000,13274200000,10651000000,7482900000,-340600000,,1884900000,1884900000,875,ADP,yearly
2017-06-30,,,2616900000,,1787800000,2630800000,5353700000,2496700000,2496700000,,-80000000,,,,829100000,12372000000,9875300000,7018300000,120200000,,1787800000,1787800000,875,ADP,yearly
2020-12-31,,,1333965000,,1064151000,2123413000,3759694000,0,1378078000,258203000,,,,,269814000,3759694000,2381616000,0,-44113000,,1064151000,1005426000,967,FRC,yearly
2019-12-31,,,1133236000,,930329000,1845601000,3279697000,0,1171995000,262101000,,,,,202907000,3279697000,2107702000,0,-38759000,,930329000,881259000,967,FRC,yearly
2018-12-31,,,1051742000,,853828000,1623759000,2968461000,0,1109864000,234838000,,,,,197914000,2968461000,1858597000,0,-58122000,,853828000,796103000,967,FRC,yearly
2017-12-31,,,912202000,,757660000,1381627000,2551743000,0,967994000,202122000,,,,,154542000,2551743000,1583749000,0,-55792000,,757660000,699620000,967,FRC,yearly
2020-12-31,,,516225000,130000,369777000,1809337000,2888768000,1079431000,1079431000,,-406466000,,,,146151000,5963108000,4883677000,3074340000,-563206000,,370074000,369777000,981,EQIX,yearly
2019-12-31,,,692597000,-224000,507450000,1586064000,2672992000,1086928000,1086928000,,-479684000,,,,185352000,5483176000,4396248000,2810184000,-394331000,,507245000,507450000,981,EQIX,yearly
2018-12-31,,,433038000,-224000,365359000,1460396000,2496782000,1036386000,1036386000,,-521494000,,,,67679000,5102257000,4065871000,2605475000,-603348000,,365359000,365359000,981,EQIX,yearly
2017-12-31,,,286832000,-224000,232982000,1327630000,2154434000,826804000,826804000,,-478698000,,,,53850000,4347583000,3520779000,2193149000,-539972000,,232982000,232982000,981,EQIX,yearly
2020-12-31,,,-4000047000,,-4012514000,745345000,-413153000,-1850798000,-1850798000,,-454518000,,,,12467000,1279908000,3130706000,1693061000,-2149249000,,-4012514000,-4012514000,986,NCLH,yearly
2019-12-31,,,911365000,,930228000,968714000,2799115000,1184213000,1184213000,,-256191000,,,,-18863000,6462376000,5278163000,3663261000,-272848000,,930228000,930228000,986,NCLH,yearly
2018-12-31,,,969310000,,954843000,898355000,2678050000,1218635000,1218635000,,-264058000,,,,14467000,6055126000,4836491000,3377076000,-249325000,,954843000,954843000,986,NCLH,yearly
2017-12-31,,,770614000,,759872000,773755000,2332531000,1048819000,1048819000,,-243904000,,,,10742000,5396175000,4347356000,3063644000,-278205000,,759872000,759872000,986,NCLH,yearly
2020-12-31,,,531392000,388345000,481779000,96594000,991464000,670426000,670426000,,-172301000,,,,13810000,1378573000,708147000,387109000,-139034000,,517582000,481779000,1005,EXR,yearly
2019-12-31,,,462431000,381733000,419967000,114524000,979408000,645027000,645027000,,-191268000,,,,11308000,1319728000,674701000,340320000,-182596000,,451123000,419287000,1005,EXR,yearly
2018-12-31,,,456324000,371698000,415289000,97409000,909807000,603348000,603348000,,-183123000,,,,9244000,1211056000,607708000,301249000,-147024000,,447080000,414566000,1005,EXR,yearly
2017-12-31,,,517847000,373056000,479013000,93371000,843603000,556936000,556936000,,-158614000,,,,3625000,1120340000,563404000,276737000,-39089000,,514222000,478038000,1005,EXR,yearly
2020-12-31,,,1298000000,,1057000000,3672000000,5289000000,0,1298000000,319000000,,,,,241000000,5289000000,3991000000,0,0,,1057000000,950000000,1010,CFG,yearly
2019-12-31,,,2251000000,,1791000000,3483000000,6098000000,0,2251000000,364000000,,,,,460000000,6098000000,3847000000,0,0,,1791000000,1718000000,1010,CFG,yearly
2018-12-31,,,2183000000,,1721000000,3253000000,5802000000,0,2183000000,366000000,,,,,462000000,5802000000,3619000000,0,-54000000,,1721000000,1692000000,1010,CFG,yearly
2017-12-31,,,1912000000,,1652000000,3037000000,5386000000,0,1912000000,437000000,,,,,260000000,5386000000,3474000000,0,2000000,,1652000000,1638000000,1010,CFG,yearly
2020-12-31,,,1131000000,226000000,1224000000,1327000000,2587000000,1260000000,1260000000,,-144000000,,,,269000000,7188000000,5928000000,4601000000,-129000000,414000000,862000000,1215000000,1018,MAS,yearly
2019-12-31,,,914000000,179000000,935000000,1295000000,2371000000,1076000000,1076000000,,-159000000,,,,230000000,6707000000,5631000000,4336000000,-162000000,296000000,684000000,929000000,1018,MAS,yearly
2018-12-31,,,907000000,180000000,734000000,1264000000,2367000000,1103000000,1103000000,,-156000000,,,,221000000,6654000000,5551000000,4287000000,-196000000,98000000,686000000,727000000,1018,MAS,yearly
2017-12-31,,,718000000,236000000,533000000,1217000000,2220000000,1003000000,1003000000,,-279000000,,,,245000000,6014000000,5011000000,3794000000,-285000000,107000000,473000000,528000000,1018,MAS,yearly
2020-12-31,2363000000,,4968000000,219000000,4495000000,9563000000,19611000000,5553000000,5553000000,,-546000000,,,,497000000,34608000000,29055000000,14997000000,-585000000,24000000,4471000000,4473000000,1092,ABT,yearly
2019-12-31,2412000000,,4077000000,213000000,3687000000,9518000000,18689000000,4823000000,4823000000,,-670000000,,,,390000000,31904000000,27081000000,13215000000,-746000000,24000000,3687000000,3666000000,1092,ABT,yearly
2018-12-31,2298000000,,2873000000,198000000,2368000000,9568000000,17882000000,3838000000,3838000000,,-826000000,,,,539000000,30578000000,26740000000,12696000000,-965000000,34000000,2334000000,2353000000,1092,ABT,yearly
2017-12-31,2183000000,,2231000000,201000000,477000000,8804000000,15900000000,2938000000,2938000000,,-904000000,,,,1878000000,27390000000,24452000000,11490000000,-707000000,124000000,353000000,468000000,1092,ABT,yearly
2020-12-31,,,1728694000,,1406839000,1001142000,2786067000,1775020000,1775020000,9905000,-4248000,,,,321855000,11036082000,9261062000,8250015000,-46326000,,1406839000,1394385000,1120,PHM,yearly
2019-12-31,,,1339576000,,1016700000,1044337000,2411374000,1354702000,1354702000,12335000,-584000,,,,322876000,10212957000,8858255000,7801583000,-15126000,,1016700000,1006329000,1120,PHM,yearly
2018-12-31,,,1347540000,,1022023000,1012023000,2455866000,1437397000,1437397000,6446000,-618000,,,,325517000,10188331000,8750934000,7732465000,-89857000,,1022023000,1010831000,1120,PHM,yearly
2017-12-31,,,938828000,,447221000,891581000,2035324000,1122674000,1122674000,21069000,-503000,,,,491607000,8577686000,7455012000,6542362000,-183846000,,447221000,442649000,1120,PHM,yearly
2020-12-31,,,1171000000,999000000,958000000,5652000000,7040000000,1388000000,1388000000,,-709000000,,,,196000000,14852000000,13464000000,7812000000,-217000000,,975000000,958000000,1125,FISV,yearly
2019-12-31,,,1112000000,1878000000,893000000,3042000000,4878000000,1836000000,1836000000,,-507000000,,,,198000000,10187000000,8351000000,5309000000,-724000000,,914000000,893000000,1125,FISV,yearly
2018-12-31,,,1565000000,1878000000,1187000000,1228000000,2754000000,1526000000,1526000000,,-193000000,,,,378000000,5823000000,4297000000,3069000000,39000000,,1187000000,1187000000,1125,FISV,yearly
2017-12-31,,,1390000000,1878000000,1246000000,1150000000,2672000000,1522000000,1522000000,,-176000000,,,,158000000,5696000000,4174000000,3024000000,-132000000,14000000.0,1232000000,1246000000,1125,FISV,yearly
2020-02-01,,,4190000000,,3281000000,16163000000,23248000000,4728000000,4728000000,,-467000000,,,,921000000,78112000000,73384000000,54864000000,-538000000,12000000,3269000000,3281000000,1145,TGT,yearly
2019-02-02,,,3676000000,,2937000000,15606000000,22057000000,4227000000,4227000000,,-461000000,,,,746000000,75356000000,71129000000,53299000000,-551000000,7000000,2930000000,2937000000,1145,TGT,yearly
2018-02-03,,,3630000000,,2914000000,14990000000,21589000000,4374000000,4374000000,,-530000000,,,,722000000,72714000000,68340000000,51125000000,-744000000,6000000,2908000000,2914000000,1145,TGT,yearly
2017-01-28,,,3961000000,,2734000000,14086000000,21126000000,4995000000,4995000000,,-569000000,,,,1295000000,70271000000,65276000000,49145000000,-1034000000,68000000,2666000000,2734000000,1145,TGT,yearly
2020-12-31,187000000,,285000000,8000000,254000000,1143000000,1830000000,500000000,500000000,,-77000000,,,,31000000,4876000000,4376000000,3046000000,-215000000,,254000000,254000000,1157,XYL,yearly
2019-12-31,191000000,,416000000,10000000,401000000,1165000000,2051000000,695000000,695000000,,-67000000,,,,15000000,5249000000,4554000000,3198000000,-279000000,,401000000,401000000,1157,XYL,yearly
2018-12-31,189000000,,585000000,14000000,549000000,1150000000,2031000000,692000000,692000000,,-82000000,,,,36000000,5207000000,4515000000,3176000000,-107000000,,549000000,549000000,1157,XYL,yearly
2017-12-31,181000000,,466000000,16000000,331000000,1086000000,1847000000,580000000,580000000,,-82000000,,,,136000000,4707000000,4127000000,2860000000,-114000000,,330000000,331000000,1157,XYL,yearly
2020-12-31,,,-232218000,,-295697000,517872000,276631000,-241241000,-241241000,,-2174000,,,,63479000,2666702000,2907943000,2390071000,9023000,,-295697000,-295697000,1185,INCY,yearly
2019-12-31,,,486791000,,446906000,469276000,890399000,421123000,421123000,,-1855000,,,,39885000,2158759000,1737636000,1268360000,65668000,,446906000,446906000,1185,INCY,yearly
2018-12-31,,,115347000,,109493000,434934000,589803000,154869000,154869000,,-1543000,,,,5854000,1881883000,1727014000,1292080000,-39522000,,109493000,109493000,1185,INCY,yearly
2017-12-31,,,-312290000,,-313142000,366633000,142603000,-224030000,-224030000,,-6900000,,,,852000,1536216000,1760246000,1393613000,-88260000,,-313142000,-313142000,1185,INCY,yearly
2020-12-31,,,567000000,,59000000,3814000000,4852000000,580000000,580000000,,-356000000,,,,508000000,6796000000,6216000000,1944000000,-13000000,,59000000,59000000,1196,BKNG,yearly
2019-12-31,,,5958000000,,4865000000,7004000000,12818000000,5345000000,5345000000,,-266000000,,,,1093000000,15066000000,9721000000,2248000000,613000000,,4865000000,4865000000,1196,BKNG,yearly
2018-12-31,,,4835000000,,3998000000,6718000000,12485000000,5341000000,5341000000,,-269000000,,,,837000000,14527000000,9186000000,2042000000,-506000000,,3998000000,3998000000,1196,BKNG,yearly
2017-12-31,,,4399000000,,2341000000,7533000000,12439000000,4543000000,4543000000,,-254000000,,,,2058000000,12681000000,8138000000,242000000,-144000000,,2341000000,2341000000,1196,BKNG,yearly
2020-10-03,,,-1743000000,13929000000,-2864000000,11799000000,21508000000,4364000000,4364000000,,-2217000000,,,,699000000,65388000000,61024000000,43880000000,-6107000000,-32000000,-2442000000,-2864000000,1226,DIS,yearly
2019-09-28,,,13923000000,13975000000,11054000000,10588000000,27546000000,12791000000,12791000000,,-1907000000,,,,3026000000,69607000000,56816000000,42061000000,1132000000,629000000,10897000000,11054000000,1226,DIS,yearly
2018-09-29,,,14729000000,5182000000,12598000000,8281000000,26708000000,15416000000,15416000000,,-1261000000,,,,1663000000,59434000000,44018000000,32726000000,-687000000,629000000,13066000000,12598000000,1226,DIS,yearly
2017-09-30,,,13788000000,4837000000,8980000000,8176000000,24831000000,13873000000,13873000000,,-507000000,,,,4422000000,55137000000,41264000000,30306000000,-85000000,629000000,9366000000,8980000000,1226,DIS,yearly
2020-12-31,,,2229000000,194000000,1778000000,1235000000,3896000000,2441000000,2441000000,,-163000000,,,,452000000,5371000000,2930000000,1475000000,-212000000,,1777000000,1778000000,1231,MCO,yearly
2019-12-31,,,1810000000,225000000,1422000000,1171000000,3442000000,2071000000,2071000000,,-175000000,,,,381000000,4829000000,2758000000,1387000000,-261000000,,1429000000,1422000000,1231,MCO,yearly
2018-12-31,,,1672000000,197000000,1310000000,1089000000,3197000000,1916000000,1916000000,,-196000000,,,,352000000,4443000000,2527000000,1246000000,-244000000,,1320000000,1310000000,1231,MCO,yearly
2017-12-31,,,1787000000,212800000,1001000000,998000000,2988000000,1832000000,1832000000,,-189000000,,,,779000000,4204000000,2372000000,1216000000,-45000000,,1008000000,1001000000,1231,MCO,yearly
2020-10-31,1874000000,,-442000000,47000000,-322000000,4483000000,8496000000,1659000000,1659000000,101000000,-332000000,,,,-120000000,26982000000,25323000000,18486000000,-2101000000,,-322000000,-322000000,1244,HPE,yearly
2019-10-31,1842000000,,1553000000,51000000,1049000000,4837000000,9493000000,2924000000,2924000000,-377000000,-311000000,,,,504000000,29135000000,26211000000,19642000000,-1371000000,,1049000000,1049000000,1244,HPE,yearly
2018-10-31,1667000000,,268000000,35000000,1908000000,4783000000,9231000000,1133000000,1133000000,1354000000,-353000000,,,,-1744000000,30852000000,29719000000,21621000000,-865000000,-104000000.0,2012000000,1908000000,1244,HPE,yearly
2017-10-31,1490000000,,272000000,39000000,344000000,4951000000,8669000000,1904000000,1904000000,3000000,-334000000,,,,-164000000,28871000000,26967000000,20202000000,-1632000000,-92000000.0,436000000,344000000,1244,HPE,yearly
2020-12-31,90244000,,185936000,,143453000,413916000,743656000,186123000,186123000,,-1399000,,,,42483000,841434000,655311000,97778000,-187000,,143453000,143453000,1274,PAYC,yearly
2019-12-31,73080000,,226087000,,180576000,306820000,648335000,226224000,226224000,,-2315000,,,,45511000,737671000,511447000,89336000,-137000,,180576000,180495000,1274,PAYC,yearly
2018-12-31,46247000,,174711000,,137065000,240486000,490105000,173715000,173715000,,-766000,,,,37646000,566336000,392621000,76231000,996000,,137065000,136906000,1274,PAYC,yearly
2017-12-31,30430000,,127732000,,123486000,191074000,370609000,129710000,129710000,,-911000,,,,4246000,433047000,303337000,62438000,-1978000,,123486000,123171000,1274,PAYC,yearly
2020-06-30,,,-1524000000,807000000,-1269000000,3065000000,4081000000,372000000,372000000,,-25000000,,,,21000000,9008000000,8636000000,4927000000,-1896000000,,-1545000000,-1269000000,1275,NWSA,yearly
2019-06-30,,,354000000,1167000000,155000000,3177000000,4435000000,599000000,599000000,,-59000000,,,,126000000,10074000000,9475000000,5639000000,-245000000,,228000000,155000000,1275,NWSA,yearly
2018-06-30,,,-1089000000,1186000000,-1514000000,3081000000,4120000000,567000000,567000000,,-7000000,,,,355000000,9024000000,8457000000,4904000000,-1656000000,,-1444000000,-1516000000,1275,NWSA,yearly
2017-06-30,,,-615000000,284000000,-738000000,2710000000,3610000000,451000000,451000000,,-7000000,,,,28000000,8139000000,7688000000,4529000000,-1066000000,,-643000000,-740000000,1275,NWSA,yearly
2020-06-27,,,293384000,34265000,215475000,8238103000,9901664000,1625276000,1625276000,,-408220000,,,,77909000,52893310000,51268034000,42991646000,-1331892000,,215475000,215475000,1282,SYY,yearly
2019-06-29,,,2005836000,35426000,1674271000,8779693000,11408987000,2629294000,2629294000,,-360423000,,,,331565000,60113922000,57484628000,48704935000,-623458000,,1674271000,1674271000,1282,SYY,yearly
2018-06-30,,,1956224000,37649000,1430766000,8735275000,11085391000,2350116000,2350116000,,-395483000,,,,525458000,58727324000,56377208000,47641933000,-393892000,,1430766000,1430766000,1282,SYY,yearly
2017-07-01,,,1766230000,82839000,1142503000,8504291000,10557507000,2053216000,2053216000,,-302878000,,,,623727000,55371139000,53317923000,44813632000,-286986000,,1142503000,1142503000,1282,SYY,yearly
2020-12-31,,,3228000000,2843000000,2339000000,1277000000,5350000000,3867000000,3867000000,,-141000000,,,,694000000,7442000000,3575000000,2092000000,-639000000,,2534000000,2339000000,1312,SPGI,yearly
2019-12-31,,,2930000000,2325000000,2123000000,1360000000,4723000000,3159000000,3159000000,,-141000000,,,,627000000,6699000000,3540000000,1976000000,-229000000,,2303000000,2123000000,1312,SPGI,yearly
2018-12-31,,,2681000000,1676000000,1958000000,1253000000,4420000000,2961000000,2961000000,,-134000000,,,,560000000,6258000000,3297000000,1838000000,-250000000,,2121000000,1958000000,1312,SPGI,yearly
2017-12-31,,,2461000000,1409000000,1496000000,1438000000,4369000000,2751000000,2751000000,,-149000000,,,,823000000,6063000000,3312000000,1694000000,-290000000,,1638000000,1496000000,1312,SPGI,yearly
2020-12-31,,,3429000000,31000000,7517000000,7911000000,13726000000,0,3429000000,2386000000,,,,,426000000,13726000000,10297000000,0,0,4555000000,3003000000,7249000000,1323,PNC,yearly
2019-12-31,,,6480000000,29000000,5369000000,7992000000,17054000000,0,6480000000,2582000000,,,,,1062000000,17054000000,10574000000,0,0,4555000000,5418000000,5108000000,1323,PNC,yearly
2018-12-31,,,6428000000,42000000,5301000000,7677000000,16724000000,0,6428000000,2619000000,,,,,1082000000,16724000000,10296000000,0,0,4555000000,5346000000,5040000000,1323,PNC,yearly
2017-12-31,,,5490000000,72000000,5338000000,7445000000,15888000000,0,5490000000,2953000000,,,,,102000000,15888000000,10398000000,0,0,4555000000,5388000000,5053000000,1323,PNC,yearly
2020-12-31,,,1318262000,1513214000,773642000,1212584000,3561991000,1718972000,1718972000,,-297030000,,,,313932000,11550604000,9831632000,7988613000,-400710000,-9653000,1004330000,773642000,1333,DVA,yearly
2019-12-31,,,1195439000,1366209000,810981000,1103312000,3473994000,1755530000,1755530000,,-435233000,,,,279628000,11388479000,9632949000,7914485000,-560091000,105483000,915811000,810981000,1333,DVA,yearly
2018-12-31,,,1048478000,1329597000,159394000,1135454000,3216638000,1490149000,1490149000,,-478969000,,,,258400000,11412151000,9922002000,8195513000,-441671000,-457038000,790078000,159394000,1333,DVA,yearly
2017-12-31,,,1399786000,1207397000,663618000,1052076000,3243662000,1631675000,1631675000,,-422356000,,,,323859000,10883667000,9251992000,7640005000,-231889000,-245372000,1075927000,663618000,1333,DVA,yearly
2020-12-31,,,74000000,192000000,-6000000,1872000000,3530000000,794000000,794000000,,-371000000,,,,67000000,6290000000,5496000000,2760000000,-720000000,,7000000,-6000000,1350,NLSN,yearly
2019-12-31,,,-663000000,193000000,-415000000,2083000000,3676000000,837000000,837000000,,-397000000,,,,-260000000,6498000000,5661000000,2822000000,-1500000000,,-403000000,-415000000,1350,NLSN,yearly
2018-12-31,,,-882000000,196000000,-712000000,1951000000,3710000000,1084000000,1084000000,,-394000000,,,,-182000000,6515000000,5431000000,2805000000,-1966000000,,-700000000,-712000000,1350,NLSN,yearly
2017-12-31,,,828000000,198000000,429000000,1862000000,3807000000,1305000000,1305000000,,-374000000,,,,388000000,6572000000,5267000000,2765000000,-477000000,,440000000,429000000,1350,NLSN,yearly
2020-06-30,19269000000,,53036000000,,44281000000,24709000000,96937000000,52959000000,52959000000,,-2591000000,,,,8755000000,143015000000,90056000000,46078000000,77000000,,44281000000,44281000000,1358,MSFT,yearly
2019-06-30,16876000000,,43688000000,,39240000000,23098000000,82933000000,42959000000,42959000000,,-2686000000,,,,4448000000,125843000000,82884000000,42910000000,729000000,,39240000000,39240000000,1358,MSFT,yearly
2018-06-30,14726000000,,36474000000,,16571000000,22223000000,72007000000,35058000000,35058000000,,-2733000000,,,,19903000000,110360000000,75302000000,38353000000,1416000000,,16571000000,16571000000,1358,MSFT,yearly
2017-06-30,13037000000,,29901000000,,25489000000,19942000000,62310000000,29331000000,29331000000,,-2222000000,,,,4412000000,96571000000,67240000000,34261000000,570000000,,25489000000,25489000000,1358,MSFT,yearly
2020-12-31,,,-3220000000,9000000,-2945000000,182000000,1545000000,577000000,577000000,786000000,-543000000,,,,-278000000,14445000000,13868000000,12900000000,-3797000000,,-2942000000,-2945000000,1368,HAL,yearly
2019-12-31,,,-1122000000,13000000,-1131000000,227000000,2285000000,1481000000,1481000000,577000000,-592000000,,,,7000000,22408000000,20927000000,20123000000,-2603000000,,-1129000000,-1131000000,1368,HAL,yearly
2018-12-31,,,1814000000,22000000,1656000000,254000000,2986000000,2732000000,2732000000,577000000,-598000000,,,,157000000,23995000000,21263000000,21009000000,-918000000,,1657000000,1656000000,1368,HAL,yearly
2017-12-31,,,682000000,27000000,-463000000,256000000,2277000000,2021000000,2021000000,577000000,-705000000,,,,1131000000,20620000000,18599000000,18343000000,-1339000000,-19000000.0,-449000000,-463000000,1368,HAL,yearly
2020-12-26,,,968147000,,748958000,2356446000,3761549000,1187979000,1187979000,,-28781000,,,,219189000,10620352000,9432373000,6858803000,-219832000,,748958000,748958000,1369,TSCO,yearly
2019-12-28,,,723377000,,562354000,1932572000,2871770000,743220000,743220000,,-19843000,,,,161023000,8351931000,7608711000,5480161000,-19843000,,562354000,562354000,1369,TSCO,yearly
2018-12-29,,,683385000,,532357000,1823440000,2702528000,701737000,701737000,,-18352000,,,,151028000,7911046000,7209309000,5208518000,-18352000,,532357000,532357000,1369,TSCO,yearly
2017-12-30,,,672523000,,422599000,1639749000,2491965000,686382000,686382000,,-13859000,,,,249924000,7256382000,6570000000,4764417000,-13859000,,422599000,422599000,1369,TSCO,yearly
2020-06-30,,,1464000000,322000000,999000000,1741000000,4496000000,2497000000,2497000000,,-369000000,,,,402000000,12303000000,9806000000,7807000000,-1033000000,,1062000000,999000000,1370,FOX,yearly
2019-06-30,,,2224000000,200000000,1595000000,1419000000,4062000000,2431000000,2431000000,,-203000000,,,,581000000,11389000000,8958000000,7327000000,-207000000,,1643000000,1595000000,1370,FOX,yearly
2018-06-30,,,2170000000,275000000,2187000000,1262000000,3648000000,2215000000,2215000000,,-43000000,,,,-58000000,10153000000,7938000000,6505000000,-45000000,,2228000000,2187000000,1370,FOX,yearly
2017-06-30,,,2241000000,154000000,1372000000,1117000000,3821000000,2535000000,2535000000,,-23000000,,,,832000000,9921000000,7386000000,6100000000,-294000000,,1409000000,1372000000,1370,FOX,yearly
2020-12-31,10307000000,,8791000000,,7067000000,9486000000,34562000000,14769000000,14769000000,,,,,,1709000000,47994000000,33225000000,13432000000,-5978000000,,7082000000,7067000000,1381,MRK,yearly
2019-12-31,8742000000,,11464000000,94000000.0,9843000000,9863000000,33684000000,15079000000,15079000000,,-893000000.0,,,,1687000000,46840000000,31761000000,13156000000,-3615000000,,9777000000,9843000000,1381,MRK,yearly
2018-12-31,9308000000,,8701000000,181000000.0,6220000000,9555000000,28806000000,9943000000,9943000000,,-772000000.0,,,,2508000000,42294000000,32351000000,13488000000,-1242000000,,6193000000,6220000000,1381,MRK,yearly
2017-12-31,9845000000,,6521000000,233000000.0,2394000000,9560000000,27406000000,8001000000,8001000000,,-754000000.0,,,,4103000000,40122000000,32121000000,12716000000,-1480000000,,2418000000,2394000000,1381,MRK,yearly
2020-12-31,,,1728000000,1919000000,1219000000,2722000000,6859000000,2778000000,2778000000,,-691000000,,,,373000000,10671000000,7893000000,3812000000,-1050000000,,1355000000,1091000000,1401,DISCK,yearly
2019-12-31,,,2294000000,2075000000,2069000000,2817000000,7392000000,3228000000,3228000000,,-720000000,,,,81000000,11144000000,7916000000,3752000000,-934000000,,2213000000,1845000000,1401,DISCK,yearly
2018-12-31,,,1022000000,2131000000,594000000,2620000000,6643000000,2625000000,2625000000,,-743000000,,,,341000000,10553000000,7928000000,3910000000,-1603000000,,681000000,529000000,1401,DISCK,yearly
2017-12-31,,,-137000000,413000000,-337000000,1689000000,4249000000,2230000000,2230000000,7000000.0,-458000000,,,,176000000,6873000000,4643000000,2624000000,-2367000000,,-313000000,-296000000,1401,DISCK,yearly
2020-12-31,,,-1856665000,610469000,-1724535000,1626442000,458778000,-1652689000,-1652689000,,-226832000,,,,-28875000,1861178000,3513867000,1402400000,-203976000,,-1827790000,-1723355000,1411,LYV,yearly
2019-12-31,,,185104000,767632000,69889000,2307627000,3080787000,355920000,355920000,,-157521000,,,,66892000,11547969000,11192049000,8467182000,-170816000,,118212000,-4882000,1411,LYV,yearly
2018-12-31,,,131105000,573117000,60249000,2136309000,2819868000,307530000,307530000,,-140976000,,,,40765000,10787800000,10480270000,7967932000,-176425000,,90340000,-17651000,1411,LYV,yearly
2017-12-31,,,-9380000,481675000,-6015000,1914684000,2505324000,238439000,238439000,,-107770000,,,,-17154000,9687222000,9448783000,7181898000,-247819000,,7774000,-97646000,1411,LYV,yearly
2020-12-31,,,372705000,59800000,342693000,947615000,2397528000,797844000,797844000,,-418535000,,,,29609000,4147270000,3349426000,1749742000,-425139000,,343096000,342693000,1421,IRM,yearly
2019-12-31,,,328142000,67947000,267377000,991664000,2429269000,779404000,779404000,,-425857000,,,,59931000,4262584000,3483180000,1833315000,-451262000,104000.0,268211000,267377000,1421,IRM,yearly
2018-12-31,,,410311000,71941000,353933000,1006983000,2431807000,785310000,785310000,,-416201000,,,,42753000,4225761000,3440451000,1793954000,-374999000,-12427000.0,367558000,353933000,1421,IRM,yearly
2017-12-31,,,200977000,92822000,170113000,937180000,2180753000,721197000,721197000,,-361304000,,,,22962000,3845578000,3124381000,1664825000,-520220000,-6291000.0,178015000,170113000,1421,IRM,yearly
2020-09-30,,,1052000000,62000000,818000000,5915000000,7263000000,0,1125000000,223000000,,,,,234000000,7757000000,6632000000,494000000,-73000000,,818000000,817000000,1467,RJF,yearly
2019-09-30,,,1375000000,62000000,1034000000,5584000000,7226000000,0,1365000000,277000000,,,,,341000000,7693000000,6328000000,467000000,10000000,,1034000000,1032000000,1467,RJF,yearly
2018-09-30,,,1311000000,84000000,857000000,5252000000,6792000000,0,1297000000,243000000,,,,,454000000,7236000000,5939000000,444000000,14000000,,857000000,856000000,1467,RJF,yearly
2017-09-30,,,925000000,111638000,636000000,4629000000,6002000000,0,1009000000,364000000,,,,,289000000,6378000000,5369000000,376000000,-84000000,,636000000,635000000,1467,RJF,yearly
2020-12-31,,,-31300000,85600000,-17600000,11000000,2044900000,1008800000,1008800000,299200000,-378000000,,,,-17100000,4681700000,3672900000,2636800000,-1040100000,,-14200000,-72700000,1509,NI,yearly
2019-12-31,,,506600000,85600000,383100000,35400000,2338300000,1288700000,1288700000,296800000,-386800000,,,,123500000,5208900000,3920200000,2870600000,-782100000,,383100000,328000000,1509,NI,yearly
2018-12-31,,,-230600000,85600000,-50600000,-18000000,1000300000,143900000,143900000,274800000,-335500000,,,,-180000000,5114500000,4970600000,4114200000,-374500000,,-50600000,-65600000,1509,NI,yearly
2017-12-31,,,443000000,85600000,128500000,60100000,1803700000,916100000,916100000,257200000,-376900000,,,,314500000,4874600000,3958500000,3070900000,-473100000,,128500000,128500000,1509,NI,yearly
2020-10-31,715000000,,761000000,,627000000,1053000000,2533000000,777000000,777000000,-12000000,-78000000,,,,134000000,4221000000,3444000000,1688000000,-16000000,,627000000,627000000,1512,KEYS,yearly
2019-10-31,688000000,,715000000,,621000000,1092000000,2534000000,773000000,773000000,-19000000,-80000000,,,,94000000,4303000000,3530000000,1769000000,-58000000,,621000000,621000000,1512,KEYS,yearly
2018-10-31,624000000,,-411000000,,165000000,1065000000,2111000000,435000000,435000000,-13000000,-83000000,,,,-576000000,3878000000,3443000000,1767000000,-846000000,,165000000,165000000,1512,KEYS,yearly
2017-10-31,507000000,,179000000,,102000000,932000000,1697000000,198000000,198000000,60000000,-80000000,,,,77000000,3189000000,2991000000,1492000000,-19000000,,102000000,102000000,1512,KEYS,yearly
2021-01-01,475900000,,395000000,1700000,389900000,767900000,1850100000,448500000,448500000,,-77600000,,,,4400000,3147700000,2699200000,1297600000,-53500000,,390600000,389900000,1543,TRMB,yearly
2020-01-03,469700000,,344800000,1400000,514300000,814300000,1876100000,424300000,424300000,,-82400000,,,,-169700000,3264300000,2840000000,1388200000,-79500000,,514500000,514300000,1543,TRMB,yearly
2018-12-28,446100000,,278000000,400000,282800000,792700000,1786900000,368500000,368500000,,-73200000,,,,-5300000,3108400000,2739900000,1321500000,-90500000,,283300000,282800000,1543,TRMB,yearly
2017-12-29,370200000,,248200000,400000,118400000,694400000,1469800000,256400000,256400000,,-25200000,,,,129700000,2646500000,2390100000,1176700000,-8200000,,118500000,118400000,1543,TRMB,yearly
2020-12-31,27573000000,,48082000000,,40269000000,28998000000,97795000000,41224000000,41224000000,,-135000000,,,,7813000000,182527000000,141303000000,84732000000,6858000000,,40269000000,40269000000,1547,GOOG,yearly
2019-12-31,26018000000,,39625000000,,34343000000,27461000000,89961000000,36482000000,36482000000,,-100000000,,,,5282000000,161857000000,125375000000,71896000000,3143000000,,34343000000,34343000000,1547,GOOG,yearly
2018-12-31,21419000000,,34913000000,,30736000000,23256000000,77270000000,32595000000,32595000000,,-114000000,,,,4177000000,136819000000,104224000000,59549000000,2318000000,,30736000000,30736000000,1547,GOOG,yearly
2017-12-31,16625000000,,27193000000,,12662000000,19733000000,65272000000,28914000000,28914000000,,-109000000,,,,14531000000,110855000000,81941000000,45583000000,-1721000000,,12662000000,12662000000,1547,GOOG,yearly
2020-12-31,,,8235000000,23000000,6833000000,-241000000,8681000000,8877000000,8877000000,45000000,-591000000,,,,1347000000,65398000000,56521000000,56717000000,-642000000,-55000000,6888000000,6833000000,1557,LMT,yearly
2019-12-31,,,7241000000,44000000,6230000000,608000000,8367000000,7698000000,7698000000,61000000,-653000000,,,,1011000000,59812000000,52114000000,51445000000,-457000000,-55000000,6230000000,6230000000,1557,LMT,yearly
2018-12-31,,,5838000000,55000000,5046000000,777000000,7370000000,6644000000,6644000000,-51000000,-668000000,,,,792000000,53762000000,47118000000,46392000000,-806000000,-55000000,5046000000,5046000000,1557,LMT,yearly
2017-12-31,,,5246000000,74000000,1963000000,746000000,6371000000,5593000000,5593000000,32000000,-651000000,,,,3356000000,49960000000,44367000000,43589000000,-347000000,73000000,1890000000,1963000000,1557,LMT,yearly
2020-12-31,311000000,,256000000,4000000,192000000,1851000000,2626000000,408000000,408000000,,,,,,64000000,7022000000,6614000000,4396000000,-152000000,,192000000,178000000,1568,XRX,yearly
2019-12-31,373000000,,830000000,7000000,1353000000,2103000000,3650000000,1129000000,1129000000,,-105000000.0,,,,179000000,9066000000,7937000000,5416000000,-299000000,705000000.0,651000000,1339000000,1568,XRX,yearly
2018-12-31,397000000,,557000000,34000000,361000000,2485000000,3869000000,939000000,939000000,,-114000000.0,,,,247000000,9662000000,8723000000,5793000000,-382000000,55000000.0,310000000,347000000,1568,XRX,yearly
2017-12-31,424000000,,538000000,37000000,195000000,2702000000,4071000000,892000000,892000000,,-119000000.0,,,,468000000,9991000000,9099000000,5920000000,-354000000,129000000.0,70000000,181000000,1568,XRX,yearly
2020-12-31,,,685200000,41900000,520100000,1322500000,2390100000,676800000,676800000,,-141600000,,,,159000000,4127500000,3450700000,1737400000,8400000,,526200000,520100000,1597,EFX,yearly
2019-12-31,,,-433000000,44300000,-398800000,1185900000,1985900000,468900000,468900000,,-111700000,,,,-40200000,3507600000,3038700000,1521700000,-901900000,,-392800000,-398800000,1597,EFX,yearly
2018-12-31,,,356300000,47900000,299800000,1232900000,1971700000,428400000,428400000,,-103500000,,,,50000000,3412100000,2983700000,1440400000,-72100000,,306300000,299800000,1597,EFX,yearly
2017-12-31,,,746600000,64600000,587300000,1089200000,2151500000,774500000,774500000,,-92800000,,,,148600000,3362200000,2587700000,1210700000,-27900000,,598000000,587300000,1597,EFX,yearly
2020-12-31,,,-15587000000,,-12385000000,582000000,-5165000000,-9200000000,-9200000000,1163000000,-929000000,,,,-3202000000,17095000000,26295000000,22260000000,-6387000000,,-12385000000,-12385000000,1633,DAL,yearly
2019-12-31,,,6198000000,,4767000000,1993000000,12916000000,6571000000,6571000000,1771000000,-301000000,,,,1431000000,47007000000,40436000000,34091000000,-373000000,,4767000000,4767000000,1633,DAL,yearly
2018-12-31,,,5151000000,,3935000000,1941000000,11452000000,5459000000,5459000000,1723000000,-311000000,,,,1216000000,44438000000,38979000000,32986000000,-308000000,,3935000000,3935000000,1633,DAL,yearly
2017-12-31,,,5500000000,,3205000000,1827000000,11833000000,6175000000,6175000000,1609000000,-396000000,,,,2295000000,41138000000,34963000000,29305000000,-675000000,,3205000000,3205000000,1633,DAL,yearly
2020-06-30,,,579500000,,462500000,639000000,1263900000,624900000,624900000,,-62500000,,,,117000000,4529000000,3904100000,3265100000,-45400000,,462500000,462500000,1636,BR,yearly
2019-06-30,,,607300000,,482100000,577500000,1230300000,652800000,652800000,,-45900000,,,,125200000,4362200000,3709400000,3131900000,-45500000,,482100000,482100000,1636,BR,yearly
2018-06-30,,,561000000,,427900000,564500000,1162500000,598000000,598000000,,-42400000,,,,133100000,4329900000,3731900000,3167400000,-37000000,,427900000,427900000,1636,BR,yearly
2017-06-30,,,488200000,,326800000,500700000,1034700000,534000000,534000000,,-44700000,,,,161400000,4142600000,3608600000,3107900000,-45800000,,326800000,326800000,1636,BR,yearly
2020-12-31,,,1821100000,687000000,1690600000,778700000,5814300000,3110500000,3110500000,42800000,-793500000,,,,129600000,8041500000,4931000000,2227200000,-1289400000,,1691500000,1690600000,1641,AMT,yearly
2019-12-31,,,1916400000,1531500000,1887800000,730400000,5363500000,2864400000,2864400000,-9700000,-814200000,,,,-200000,7580300000,4715900000,2216800000,-948000000,,1916600000,1887800000,1641,AMT,yearly
2018-12-31,,,1154600000,1568300000,1236400000,733200000,5262300000,2742300000,2742300000,3500000,-825600000,,,,-110100000,7440100000,4697800000,2177800000,-1587700000,,1264700000,1227000000,1641,AMT,yearly
2017-12-31,,,1256100000,1712800000,1238900000,637000000,4607300000,2248200000,2248200000,6200000,-749600000,,,,30700000,6663900000,4415700000,2056600000,-992100000,,1225400000,1151500000,1641,AMT,yearly
2021-01-31,931500000,,546700000,,1208200000,1841300000,3484900000,643700000,643700000,,-40700000,,,,-661500000,3790400000,3146700000,305500000,-97000000,,1208200000,1208200000,1642,ADSK,yearly
2020-01-31,820000000,,294800000,,214500000,1716100000,2984400000,374900000,374900000,,-54000000,,,,80300000,3274300000,2899400000,289900000,-80100000,,214500000,214500000,1642,ADSK,yearly
2019-01-31,725000000,,-42700000,,-80800000,1508200000,2299400000,32700000,32700000,,-52100000,,,,38100000,2569800000,2537100000,270400000,-75400000,,-80800000,-80800000,1642,ADSK,yearly
2018-01-31,755500000,,-557300000,,-566900000,1371100000,1769600000,-393600000,-393600000,,-34500000,,,,9600000,2056600000,2450200000,287000000,-163700000,,-566900000,-566900000,1642,ADSK,yearly
2020-12-31,,,46962000,73235000,44889000,75001000,734854000,300956000,300956000,12997000,-158278000,,,,-355000,1047931000,746975000,313077000,-253994000,,47317000,44889000,1651,REG,yearly
2019-12-31,,,244015000,76613000,239430000,74984000,858527000,402203000,402203000,7057000,-152333000,,,,757000,1164672000,762469000,306145000,-158188000,,243258000,239430000,1651,REG,yearly
2018-12-31,,,253031000,52198000,249127000,65491000,854451000,420241000,420241000,9031000,-148456000,,,,706000,1160341000,740100000,305890000,-163819000,,252325000,249127000,1651,REG,yearly
2017-12-31,,,169243000,41002000,176077000,67624000,767363000,357013000,357013000,8525000,-132629000,,,,-9737000,1021076000,664063000,253713000,-184249000,,178980000,159949000,1651,REG,yearly
2020-12-31,,,-261000000,,-200000000,244000000,2467000000,-52000000,-52000000,589000000,-129000000,,,,-61000000,7024000000,7076000000,4557000000,-209000000,,-200000000,-200000000,1670,PXD,yearly
2019-12-31,,,987000000,,756000000,324000000,4031000000,1806000000,1806000000,132000000,-121000000,,,,231000000,9676000000,7870000000,5645000000,-819000000,,756000000,753000000,1670,PXD,yearly
2018-12-31,,,1251000000,,978000000,381000000,4315000000,1756000000,1756000000,530000000,-126000000,,,,276000000,9384000000,7628000000,5069000000,-505000000,,975000000,973000000,1670,PXD,yearly
2017-12-31,,,309000000,5000000.0,833000000,326000000,2681000000,502000000,502000000,347000000,-154000000,,,,-524000000,5294000000,4792000000,2613000000,-193000000,,833000000,827000000,1670,PXD,yearly
2020-12-31,,,964000000,296000000,500000000,944000000,1910000000,969000000,969000000,-3000000,-73000000,,,,397000000,10165000000,9196000000,8255000000,-5000000,,567000000,500000000,1690,BWA,yearly
2019-12-31,,,1265000000,138000000,746000000,900000000,2101000000,1203000000,1203000000,-2000000,-55000000,,,,468000000,10168000000,8965000000,8067000000,62000000,,797000000,746000000,1690,BWA,yearly
2018-12-31,,,1196000000,119000000,931000000,936000000,2230000000,1298000000,1298000000,-4000000,-59000000,,,,211000000,10530000000,9232000000,8300000000,-102000000,,985000000,931000000,1690,BWA,yearly
2017-12-31,408000000.0,,1063000000,109100000,440000000,485000000,2115000000,1222000000,1222000000,-4000000,-71000000,,,,580000000,9799000000,8577000000,7684000000,-159000000,,483000000,440000000,1690,BWA,yearly
2020-12-31,,,-19400000,69800000,-33300000,894800000,1613400000,105600000,105600000,217200000,-111100000,,,,13000000,4910200000,4804600000,3296800000,-125000000,,-32400000,-33300000,1703,IR,yearly
2019-12-31,,,190900000,69800000,159100000,436400000,911700000,349100000,349100000,1900000,-88900000,,,,31800000,2451900000,2102800000,1540200000,-158200000,,159100000,159100000,1703,IR,yearly
2018-12-31,,,349500000,69800000,269400000,442800000,1012500000,444800000,444800000,-900000,-99600000,,,,80100000,2689800000,2245000000,1677300000,-95300000,,269400000,269400000,1703,IR,yearly
2017-12-31,,,-112700000,69800000,18400000,446200000,897900000,129500000,129500000,28300000,-140700000,,,,-131200000,2375400000,2245900000,1477500000,-242200000,,18500000,18400000,1703,IR,yearly
2020-12-31,,,839000000,1220000000,1377000000,,11471000000,5429000000,5429000000,1337000000,-2162000000,,,,-236000000,23868000000,18439000000,12397000000,-4590000000,7000000,1075000000,1270000000,1716,DUK,yearly
2019-12-31,,,4097000000,1129000000,3748000000,,11560000000,5705000000,5705000000,1307000000,-2204000000,,,,519000000,24658000000,18953000000,13098000000,-1608000000,-7000000,3578000000,3687000000,1716,DUK,yearly
2018-12-31,,,3073000000,17000000,2666000000,,10717000000,5362000000,5362000000,1281000000,-2094000000,,,,448000000,24116000000,18754000000,13399000000,-2289000000,19000000,2625000000,2661000000,1716,DUK,yearly
2017-12-31,,,4266000000,-2000000,3059000000,241000000.0,10703000000,5938000000,5938000000,1238000000,-1986000000,,,,1196000000,23189000000,17251000000,12486000000,-1672000000,-6000000,3070000000,3053000000,1716,DUK,yearly
2020-12-31,,,14065000000,2695000000,10534000000,39850000000,70443000000,17493000000,17493000000,,-4588000000,,,,3364000000,103564000000,86071000000,33121000000,-3428000000,,10701000000,10534000000,1743,CMCSA,yearly
2019-12-31,,,16996000000,2520000000,13057000000,40424000000,74502000000,21125000000,21125000000,,-4567000000,,,,3673000000,108942000000,87817000000,34440000000,-4129000000,,13323000000,13057000000,1743,CMCSA,yearly
2018-12-31,,,15242000000,2205000000,11731000000,34791000000,64815000000,19148000000,19148000000,-141000000.0,-3542000000,,,,3380000000,94507000000,75359000000,29692000000,-3906000000,,11862000000,11731000000,1743,CMCSA,yearly
2017-12-31,,,15353000000,2200000000,22735000000,31968000000,59674000000,17576000000,17576000000,-141000000.0,-3086000000,,,,-7569000000,85029000000,67453000000,25355000000,-2223000000,,22922000000,22735000000,1743,CMCSA,yearly
2020-12-31,,,1499000000,,1216000000,,1658000000,1553000000,1553000000,105000000,-54000000,,,,283000000,7536000000,5983000000,5878000000,-54000000,,1216000000,1216000000,1761,CINF,yearly
2019-12-31,,,2472000000,,1997000000,,2634000000,2525000000,2525000000,109000000,-53000000,,,,475000000,7924000000,5399000000,5290000000,-53000000,,1997000000,1997000000,1761,CINF,yearly
2018-12-31,,,251000000,,287000000,,395000000,304000000,304000000,91000000,-53000000,,,,-36000000,5407000000,5103000000,5012000000,-53000000,,287000000,287000000,1761,CINF,yearly
2017-12-31,,,730000000,,1045000000,,875000000,783000000,783000000,92000000,-53000000,,,,-315000000,5732000000,4949000000,4857000000,-53000000,,1045000000,1045000000,1761,CINF,yearly
2020-12-31,,,-5776000000,1010000000,-4517000000,88000000,1941000000,464000000,464000000,85000000,-197000000,,,,-1104000000,2806000000,2342000000,865000000,-6240000000,,-4672000000,-4517000000,1764,FANG,yearly
2019-12-31,,,362000000,1657000000,240000000,104000000,3098000000,1377000000,1377000000,170000000,-173000000,,,,47000000,3767000000,2390000000,669000000,-1015000000,,315000000,240000000,1764,FANG,yearly
2018-12-31,,,1113000000,467000000,846000000,65000000,1757000000,1148000000,1148000000,-79000000,-88000000,,,,168000000,2060000000,912000000,303000000,-35000000,,945000000,846000000,1764,FANG,yearly
2017-12-31,,,497000000,326877000,482000000,48000000,969000000,527000000,527000000,67000000,-41000000,,,,-20000000,1193000000,666000000,224000000,-30000000,,517000000,482000000,1764,FANG,yearly
2020-10-31,1478000000,,3231000000,,2844000000,4925000000,10437000000,3921000000,3921000000,,-239000000,,,,387000000,56639000000,52718000000,46202000000,-690000000,,2844000000,2844000000,1784,HPQ,yearly
2019-10-31,1499000000,,2523000000,,3152000000,5290000000,11170000000,4265000000,4265000000,,-242000000,,,,-629000000,58756000000,54491000000,47586000000,-1742000000,,3152000000,3152000000,1784,HPQ,yearly
2018-10-31,1404000000,,3013000000,,5327000000,4866000000,10669000000,4319000000,4319000000,,-312000000,,,,-2314000000,58472000000,54153000000,47803000000,-1306000000,,5327000000,5327000000,1784,HPQ,yearly
2017-10-31,1190000000,,3276000000,,2526000000,4382000000,9578000000,4005000000,4005000000,,-309000000,,,,750000000,52056000000,48051000000,42478000000,-729000000,,2526000000,2526000000,1784,HPQ,yearly
2020-12-31,,,1809000000,8494000000,599000000,375000000,4273000000,2333000000,2333000000,27000000,-563000000,,,,944000000,14198000000,11865000000,9925000000,-524000000,,865000000,596000000,1790,FCX,yearly
2019-12-31,,,318000000,8150000000,-239000000,447000000,2695000000,627000000,627000000,105000000,-542000000,,,,510000000,14402000000,13775000000,11707000000,-309000000,3000000.0,-192000000,-242000000,1790,FCX,yearly
2018-12-31,,,3900000000,8094000000,2602000000,454000000,6930000000,4528000000,4528000000,89000000,-575000000,,,,991000000,18628000000,14100000000,11698000000,-628000000,-15000000.0,2909000000,2598000000,1790,FCX,yearly
2017-12-31,,,2912000000,3319000000,1817000000,480000000,6464000000,3933000000,3933000000,244000000,-656000000,,,,883000000,16403000000,12470000000,9939000000,-1021000000,62000000.0,2029000000,1813000000,1790,FCX,yearly
2020-07-03,2261000000,,-46000000,,-250000000,1152000000,3781000000,368000000,368000000,,-413000000,,,,204000000,16736000000,16368000000,12955000000,-414000000,,-250000000,-250000000,1795,WDC,yearly
2019-06-28,2182000000,,-287000000,,-754000000,1348000000,3752000000,222000000,222000000,,-469000000,,,,467000000,16569000000,16347000000,12817000000,-509000000,,-754000000,-754000000,1795,WDC,yearly
2018-06-29,2400000000,,2085000000,,675000000,1475000000,7705000000,3830000000,3830000000,,-676000000,,,,1410000000,20647000000,16817000000,12942000000,-1745000000,,675000000,675000000,1795,WDC,yearly
2017-06-30,2441000000,,769000000,,397000000,1445000000,6072000000,2186000000,2186000000,,-847000000,,,,372000000,19093000000,16907000000,13021000000,-1417000000,,397000000,397000000,1795,WDC,yearly
2020-12-31,,,599332000,215021000,568870000,65388000,1084458000,493573000,493573000,,-220633000,,,,0,1556922000,1063349000,472464000,105759000,,599332000,568870000,1815,ESS,yearly
2019-12-31,,,464448000,220487000,439286000,54262000,1153013000,615001000,615001000,,-217339000,,,,0,1583775000,968774000,430762000,-150553000,,464448000,439286000,1815,ESS,yearly
2018-12-31,,,413599000,162246000,390153000,53451000,1068933000,535598000,535598000,,-220492000,,,,0,1485523000,949925000,416590000,-121999000,,413599000,390153000,1815,ESS,yearly
2017-12-31,,,458043000,158625000,433059000,41385000,1043233000,532967000,532967000,,-222894000,,,,0,1450344000,917377000,407111000,-74924000,,458043000,433059000,1815,ESS,yearly
2020-12-31,,,701600000,,572600000,1023400000,1912700000,0,775100000,114200000,,,,,129000000,1912700000,1137600000,0,-73500000,,572600000,558500000,1867,PBCT,yearly
2019-12-31,,,652400000,,520400000,959200000,1812900000,0,765300000,88400000,,,,,132000000,1812900000,1047600000,0,-112900000,,520400000,506100000,1867,PBCT,yearly
2018-12-31,,,576300000,,468100000,851100000,1571400000,0,645700000,74600000,,,,,108200000,1571400000,925700000,0,-69400000,,468100000,453800000,1867,PBCT,yearly
2017-12-31,,,467100000,,337200000,792400000,1426500000,0,567700000,66400000,,,,,129900000,1426500000,858800000,0,-100600000,,337200000,322600000,1867,PBCT,yearly
2020-12-31,595100000,,1207000000,27600000,1060600000,1217500000,2861200000,1048600000,1048600000,,,,,,140200000,4358400000,3309800000,1497200000,158400000,,1066800000,1060600000,1870,ISRG,yearly
2019-12-31,557300000,,1502200000,20900000,1379300000,1177900000,3110200000,1375000000,1375000000,,,,,,120400000,4478500000,3103500000,1368300000,127200000,,1381800000,1379300000,1870,ISRG,yearly
2018-12-31,418100000,,1279500000,8700000,1127900000,941400000,2604100000,1244600000,1244600000,,,,,,154500000,3724200000,2479600000,1120100000,34900000,,1125000000,1127900000,1870,ISRG,yearly
2017-12-31,328600000,,1104800000,1600000,670900000,810500000,2202000000,1062900000,1062900000,,,,,,433900000,3138200000,2075300000,936200000,41900000,,670900000,670900000,1870,ISRG,yearly
2020-12-31,,,2572211000,351138000,1762673000,1806122000,5459707000,2939033000,2939033000,,-12974000,,,,698275000,15493435000,12554402000,10033728000,-366822000,,1873936000,1762673000,1909,DISH,yearly
2019-12-31,,,1943927000,551626000,1399512000,1728069000,4237522000,1878876000,1878876000,,-23687000,,,,451358000,12807684000,10928808000,8570162000,65051000,,1492569000,1399512000,1909,DISH,yearly
2018-12-31,,,2189175000,458569000,1575091000,1437281000,4296926000,2147621000,2147621000,,-15006000,,,,533684000,13621302000,11473681000,9324376000,41554000,,1655491000,1575091000,1909,DISH,yearly
2017-12-31,,,1650087000,383882000,2098689000,1817170000,4644112000,2009378000,2009378000,,-63172000,,,,-515320000,14391375000,12381997000,9747263000,-359291000,,2165407000,2098689000,1909,DISH,yearly
2020-08-30,,,5367000000,421000000,4002000000,15852000000,21930000000,6023000000,6023000000,,-160000000,,,,1308000000,166761000000,160738000000,144831000000,-656000000,,4059000000,4002000000,1962,COST,yearly
2019-09-01,,,4765000000,341000000,3659000000,14994000000,19817000000,4737000000,4737000000,,-150000000,,,,1061000000,152703000000,147966000000,132886000000,28000000,,3704000000,3659000000,1962,COST,yearly
2018-09-02,,,4442000000,304000000,3134000000,13876000000,18424000000,4480000000,4480000000,,-159000000,,,,1263000000,141576000000,137096000000,123152000000,-38000000,,3179000000,3134000000,1962,COST,yearly
2017-09-03,,,4039000000,301000000,2679000000,12950000000,17143000000,4111000000,4111000000,,-134000000,,,,1325000000,129025000000,124914000000,111882000000,-72000000,,2714000000,2679000000,1962,COST,yearly
2020-12-31,,,5430000000,2320000000,3754000000,923000000,19230000000,7202000000,7202000000,8384000000,-1584000000,,,,1043000000,51533000000,44331000000,32303000000,-1772000000,,4387000000,3754000000,2015,HCA,yearly
2019-12-31,,,5244000000,2243000000,3505000000,855000000,19295000000,7218000000,7218000000,8626000000,-1824000000,,,,1099000000,51336000000,44118000000,32041000000,-1974000000,,4145000000,3505000000,2015,HCA,yearly
2018-12-31,,,5335000000,2032000000,3787000000,855000000,17528000000,6642000000,6642000000,8608000000,-1755000000,,,,946000000,46677000000,40035000000,29149000000,-1307000000,,4389000000,3787000000,2015,HCA,yearly
2017-12-31,,,4381000000,1811000000,2216000000,855000000,16239000000,6055000000,6055000000,8053000000,-1690000000,,,,1638000000,43614000000,37559000000,27375000000,-1674000000,,2743000000,2216000000,2015,HCA,yearly
2020-12-26,719000000,,9069000000,98000000,7120000000,27117000000,38637000000,10807000000,10807000000,-6000000,-1128000000,,,,1894000000,70372000000,59565000000,31735000000,-1738000000,,7175000000,7120000000,2027,PEP,yearly
2019-12-28,711000000,,9312000000,82000000,7314000000,25795000000,37178000000,10671000000,10671000000,1000000,-935000000,,,,1959000000,67161000000,56490000000,29983000000,-1359000000,,7353000000,7314000000,2027,PEP,yearly
2018-12-29,680000000,,9189000000,84000000,12515000000,24327000000,35280000000,10276000000,10276000000,-3000000,-1219000000,,,,-3370000000,64661000000,54385000000,29381000000,-1087000000,,12559000000,12513000000,2027,PEP,yearly
2017-12-30,737000000,,9602000000,92000000,4857000000,23366000000,34729000000,10627000000,10627000000,-1000000,-1151000000,,,,4694000000,63525000000,52898000000,28796000000,-1025000000,,4908000000,4853000000,2027,PEP,yearly
2020-12-31,356863000,,441371000,109434000,363228000,798803000,2087062000,738789000,738789000,,-131802000,,,,73999000,5084239000,4345450000,2997177000,-297418000,,367372000,364031000,2036,IFF,yearly
2019-12-31,346128000,,557452000,111287000,455873000,791175000,2120242000,789842000,789842000,,-138221000,,,,97184000,5140084000,4350242000,3019842000,-232390000,,460268000,452776000,2036,IFF,yearly
2018-12-31,311583000,,447757000,92229000,337302000,678371000,1682707000,616874000,616874000,,-132558000,,,,107976000,3977539000,3360665000,2294832000,-169117000,,339781000,333454000,2036,IFF,yearly
2017-12-31,295469000,,537045000,5092000,295665000,533702000,1501165000,637301000,637301000,,-65363000,,,,241380000,3398719000,2761418000,1897554000,-100256000,,295665000,294665000,2036,IFF,yearly
2020-12-31,,,-15705000000,,-14831000000,864000000,9341000000,-8357000000,-8357000000,1506000000,-1847000000,,,,-2172000000,17809000000,26166000000,8468000000,-7348000000,-1298000000,-13533000000,-15675000000,2062,OXY,yearly
2019-12-31,,,186000000,,-667000000,882000000,12056000000,2579000000,2579000000,2083000000,-769000000,,,,693000000,20393000000,17814000000,8337000000,-2393000000,-15000000,-507000000,-985000000,2062,OXY,yearly
2018-12-31,,,5608000000,,4131000000,585000000,11256000000,4701000000,4701000000,1467000000,-356000000,,,,1477000000,17824000000,13123000000,6568000000,907000000,-15000000,4131000000,4114000000,2062,OXY,yearly
2017-12-31,,,1328000000,,1311000000,546000000,6914000000,694000000,694000000,1189000000,-324000000,,,,17000000,12508000000,11814000000,5594000000,634000000,-15000000,1311000000,1305000000,2062,OXY,yearly
2020-12-31,,,2219100000,20700000,1556100000,1729300000,4952800000,2948100000,2948100000,,-207400000,,,,662100000,13978500000,11030400000,9025700000,-729000000,,1557000000,1556100000,2070,LH,yearly
2019-12-31,,,1104900000,20100000,823800000,1544100000,3252500000,1465200000,1465200000,,-240700000,,,,280000000,11554800000,10089600000,8302300000,-360300000,,824900000,823800000,2070,LH,yearly
2018-12-31,,,1268300000,19100000,883700000,1485400000,3176400000,1461600000,1461600000,,-244200000,,,,384400000,11333400000,9871800000,8157000000,-193300000,,883900000,883700000,2070,LH,yearly
2017-12-31,,,1077500000,20800000,1227100000,1499200000,3091800000,1376100000,1376100000,6100000.0,-235100000,,,,-155400000,10308000000,8931900000,7216200000,-298600000,,1232900000,1227100000,2070,LH,yearly
2020-12-31,,,2327000000,2283000000,1963000000,-53000000,10033000000,4313000000,4313000000,1714000000,-1635000000,,,,373000000,33039000000,28726000000,23006000000,-1986000000,,1954000000,1963000000,2078,EXC,yearly
2019-12-31,,,3802000000,2349000000,2936000000,-13000000,10247000000,4505000000,4505000000,1732000000,-1616000000,,,,774000000,34438000000,29933000000,24191000000,-703000000,,3028000000,2936000000,2078,EXC,yearly
2018-12-31,,,2197000000,2306000000,2005000000,47000000,10003000000,4416000000,4416000000,1783000000,-1554000000,,,,118000000,35978000000,31562000000,25975000000,-2219000000,,2079000000,2005000000,2078,EXC,yearly
2017-12-31,,,3743000000,2291000000,3779000000,109000000,10117000000,4711000000,4711000000,1731000000,-1560000000,,,,-126000000,33558000000,28847000000,23441000000,-968000000,,3869000000,3779000000,2078,EXC,yearly
2020-06-30,863864000,,1316711000,15586000,1216785000,735977000,3356863000,1757022000,1757022000,,-160274000,,,,101686000,5806424000,4049402000,2449561000,-440311000,,1215025000,1216785000,2081,KLAC,yearly
2019-06-30,711030000,,1296231000,18585000,1175617000,600848000,2699527000,1387649000,1387649000,,-124604000,,,,121214000,4568904000,3181255000,1869377000,-91418000,,1175017000,1175617000,2081,KLAC,yearly
2018-06-30,608531000,,1455931000,18585000,802265000,444935000,2590660000,1537194000,1537194000,,-114376000,,,,653666000,4036701000,2499507000,1446041000,-81263000,,802265000,802265000,2081,KLAC,yearly
2017-06-30,526688000,,1173246000,18585000,926076000,390849000,2193799000,1276262000,1276262000,,-122476000,,,,247170000,3480014000,2203752000,1286215000,-103016000,,926076000,926076000,2081,KLAC,yearly
2020-12-31,,,4468000000,319000000,3617000000,9425000000,15472000000,0,4572000000,1475000000,,,,,842000000,15472000000,10900000000,0,-104000000,,3626000000,3417000000,2095,BK,yearly
2019-12-31,,,5587000000,245000000,4441000000,9407000000,16487000000,0,5704000000,1376000000,,,,,1120000000,16487000000,10783000000,0,-117000000,,4467000000,4254000000,2095,BK,yearly
2018-12-31,,,5192000000,230000000,4266000000,9399000000,16403000000,0,5372000000,1632000000,,,,,938000000,16403000000,11031000000,0,-180000000,,4254000000,4070000000,2095,BK,yearly
2017-12-31,,,4610000000,495000000,4090000000,9093000000,15567000000,0,4819000000,1655000000,,,,,496000000,15567000000,10748000000,0,-209000000,,4114000000,3872000000,2095,BK,yearly
2020-12-31,,,835538000,443196000,721470000,615041000,2227950000,1585909000,1585909000,,-153198000,,,,-490000,20139658000,18553749000,17911708000,-750371000,,836028000,721470000,2121,NUE,yearly
2019-12-31,,,1782807000,433310000,1271143000,732523000,2700360000,1932837000,1932837000,,-157358000,,,,411897000,22588858000,20656021000,19888498000,-150030000,,1370910000,1264108000,2121,NUE,yearly
2018-12-31,,,3229391000,409890000,2360767000,881222000,4295408000,3304186000,3304186000,,-161256000,,,,748307000,25067279000,21763093000,20771871000,-74795000,,2481084000,2351423000,2121,NUE,yearly
2017-12-31,,,1749957000,345752000,1318688000,687531000,2569407000,1881876000,1881876000,,-187282000,,,,369386000,20252393000,18370517000,17682986000,-164219000,,1380571000,1314139000,2121,NUE,yearly
2020-12-31,,,451969000,,366738000,659931000,1130902000,470971000,470971000,,-12353000,,,,85231000,3936623000,3465652000,2805721000,-19002000,,366738000,366738000,2126,POOL,yearly
2019-12-31,,,317736000,,261575000,583679000,924925000,341246000,341246000,,-22472000,,,,56161000,3199517000,2858271000,2274592000,-23510000,,261575000,261575000,2126,POOL,yearly
2018-12-31,,,293235000,,234461000,556284000,870173000,313889000,313889000,,-20296000,,,,58774000,2998097000,2684208000,2127924000,-20654000,,234461000,234461000,2126,POOL,yearly
2017-12-31,,,269321000,,191633000,520918000,805289000,284371000,284371000,,-15389000,,,,77982000,2788188000,2503817000,1982899000,-15050000,,191339000,191633000,2126,POOL,yearly
2020-12-31,74671000,,750244000,,814888000,186003000,1084875000,824201000,824201000,,-90144000,,,,-64644000,1265052000,440851000,180177000,-73957000,,814888000,814888000,2128,VRSN,yearly
2019-12-31,60805000,,758776000,,612299000,184262000,1051194000,806127000,806127000,,-90611000,,,,146477000,1231661000,425534000,180467000,-47351000,,612299000,612299000,2128,VRSN,yearly
2018-12-31,57884000,,729516000,,582489000,197559000,1022835000,767392000,767392000,,-114845000,,,,147027000,1214969000,447577000,192134000,-37876000,,582489000,582489000,2128,VRSN,yearly
2017-12-31,52342000,,599012000,,457248000,211705000,971769000,707722000,707722000,,-136336000,,,,141764000,1165095000,457373000,193326000,-108710000,,457248000,457248000,2128,VRSN,yearly
2020-12-31,,,8095000000,4647000000,6427000000,5943000000,14502000000,8559000000,8559000000,,-1098000000,,,,1774000000,122485000000,113926000000,107983000000,-464000000,,6321000000,6247000000,2140,GM,yearly
2019-12-31,,,7436000000,4165000000,6732000000,7559000000,14478000000,6919000000,6919000000,,-782000000,,,,769000000,137237000000,130318000000,122759000000,517000000,,6667000000,6581000000,2140,GM,yearly
2018-12-31,,,8549000000,3917000000,8014000000,7985000000,14278000000,6293000000,6293000000,,-655000000,,,,474000000,147049000000,140756000000,132771000000,2256000000,-70000000.0,8075000000,7916000000,2140,GM,yearly
2017-12-31,,,11863000000,1199000000,-3864000000,8254000000,18404000000,10150000000,10150000000,,-575000000,,,,11533000000,145588000000,135438000000,127184000000,1713000000,-4212000000.0,330000000,-3880000000,2140,GM,yearly
2020-12-31,906000000,,2338000000,927000000,1789000000,2060000000,4894000000,1912000000,1912000000,16000000,-100000000,,,,527000000,19811000000,17899000000,14917000000,426000000,,1811000000,1789000000,2206,CMI,yearly
2019-12-31,1001000000,,2834000000,958000000,2260000000,2383000000,5980000000,2584000000,2584000000,12000000,-109000000,,,,566000000,23571000000,20987000000,17591000000,250000000,,2268000000,2260000000,2206,CMI,yearly
2018-12-31,902000000,,2753000000,911000000,2141000000,2437000000,5737000000,2392000000,2392000000,6000000,-114000000,,,,566000000,23771000000,21379000000,18034000000,361000000,,2187000000,2141000000,2206,CMI,yearly
2017-12-31,754000000,,2365000000,905000000,999000000,2429000000,5100000000,1977000000,1977000000,-60000000,-81000000,,,,1371000000,20428000000,18451000000,15328000000,388000000,,994000000,999000000,2206,CMI,yearly
2020-12-31,,,585349000,,514151000,41118000,656303000,615185000,615185000,,-36323000,,,,71198000,9591627000,8976442000,8935324000,-29836000,,514151000,514151000,2231,RE,yearly
2019-12-31,,,1098987000,,1009461000,32966000,1175445000,1142479000,1142479000,,-31693000,,,,89526000,8242968000,7100489000,7067523000,-43492000,,1009461000,998182000,2231,RE,yearly
2018-12-31,,,-242182000,,89041000,30672000,-160403000,-191075000,-191075000,,-31031000,,,,-331223000,7381571000,7572646000,7541974000,-51107000,,89041000,88239000,2231,RE,yearly
2017-12-31,,,419411000,,482751000,25923000,491800000,465877000,465877000,,-31603000,,,,-63340000,6637161000,6171284000,6145361000,-46466000,,482751000,477771000,2231,RE,yearly
2020-12-31,,,443900000,,344900000,666800000,1108200000,441400000,441400000,,-7300000,,,,99000000,2895300000,2453900000,1787100000,2500000,,344900000,344900000,2265,AOS,yearly
2019-12-31,,,472100000,,370000000,721000000,1180700000,459700000,459700000,,-11000000,,,,102100000,2992700000,2533000000,1812000000,12400000,,370000000,370000000,2265,AOS,yearly
2018-12-31,,,557800000,,444200000,755200000,1305500000,550300000,550300000,,-8400000,,,,113600000,3187900000,2637600000,1882400000,7500000,,444200000,444200000,2265,AOS,yearly
2017-12-31,,,520800000,,296500000,723700000,1232400000,508700000,508700000,,-10100000,,,,224300000,2996700000,2488000000,1764300000,12100000,,296500000,296500000,2265,AOS,yearly
2021-01-03,609000000,,856000000,,656000000,949000000,2231000000,645000000,645000000,,-49000000,,,,200000000,3239000000,2594000000,1008000000,211000000,,656000000,656000000,2273,ILMN,yearly
2019-12-29,575000000,,1118000000,,1002000000,864000000,2501000000,1028000000,1028000000,,-52000000,,,,128000000,3543000000,2515000000,1042000000,90000000,,990000000,1002000000,2273,ILMN,yearly
2018-12-30,568000000,,894000000,148000000.0,826000000,849000000,2335000000,883000000,883000000,,-57000000,,,,112000000,3333000000,2450000000,998000000,11000000,,782000000,826000000,2273,ILMN,yearly
2017-12-31,500000000,,1043000000,220000000.0,726000000,720000000,1883000000,624000000,624000000,,-37000000,,,,365000000,2752000000,2128000000,869000000,419000000,,678000000,725000000,2273,ILMN,yearly
2020-05-31,,,1043100000,74600000,840100000,1288400000,3102800000,1814400000,1814400000,,-490200000,,,,201300000,11054400000,9240000000,7951600000,-771300000,,841800000,840100000,2276,CAG,yearly
2019-05-26,,,899100000,79100000,678300000,1083700000,2706000000,1622300000,1622300000,,-386300000,,,,218800000,9538400000,7916100000,6832400000,-723200000,-1900000.0,680300000,678300000,2276,CAG,yearly
2018-05-27,,,972100000,80400000,808400000,1082000000,2351500000,1269500000,1269500000,,-162500000,,,,174600000,7938300000,6668800000,5586800000,-297400000,14300000.0,797500000,808400000,2276,CAG,yearly
2017-05-28,,,800700000,87000000,639300000,1046300000,2361000000,1314700000,1314700000,,-199200000,,,,254700000,7826900000,6512200000,5465900000,-514000000,102000000.0,546000000,638500000,2276,CAG,yearly
2020-12-31,,,-1511479000,4741724000,-1032724000,2582481000,1709371000,-2083750000,-2083750000,,-676380000,,,,-191572000,4917133000,7000883000,3207762000,572271000,,-1319907000,-1032724000,2290,MGM,yearly
2019-12-31,,,2846725000,5040700000,2049146000,2565859000,5296183000,1418500000,1418500000,,-847932000,,,,632345000,12462785000,11044285000,7166602000,1428225000,,2214380000,2046433000,2290,MGM,yearly
2018-12-31,,,634006000,4059758000,466772000,2183842000,4844221000,1330943000,1330943000,,-769513000,,,,50112000,11337604000,10006661000,6493383000,-696937000,,583894000,445446000,2290,MGM,yearly
2017-12-31,,,960790000,4113841000,1952052000,1988447000,4604357000,1575955000,1575955000,-72000000.0,-668745000,,,,-1127394000,10395437000,8819482000,5791080000,-615165000,,2088184000,1933689000,2290,MGM,yearly
2020-09-30,,,746796000,,601443000,3189000,1532682000,820910000,820910000,278755000,-84474000,,,,145353000,2821137000,2000227000,1288455000,-74114000,,601443000,600999000,2299,ATO,yearly
2019-09-30,,,650309000,,511406000,-3016000,1412703000,749074000,749074000,275189000,-103153000,,,,138903000,2901848000,2152774000,1489145000,-98765000,,511406000,510990000,2299,ATO,yearly
2018-09-30,,,611144000,,603064000,5770000,1352903000,722164000,722164000,263886000,-106646000,,,,8080000,3115546000,2393382000,1762643000,-111020000,,603064000,602484000,2299,ATO,yearly
2017-09-30,,,604094000,,396421000,8469000,1295483000,727159000,727159000,240407000,-120182000,,,,221383000,2759735000,2032576000,1464252000,-123065000,13710000.0,382711000,395934000,2299,ATO,yearly
2020-12-31,,,1082309000,,872439000,538109000,1587214000,1049105000,1049105000,,-86062000,,,,209870000,4540029000,3490924000,2952815000,33204000,,872439000,872439000,2302,AME,yearly
2019-12-31,,,1069748000,,861297000,643680000,1787660000,1143980000,1143980000,,-88481000,,,,208451000,5158557000,4014577000,3370897000,-74232000,,861297000,861297000,2302,AME,yearly
2018-12-31,,,987745000,,777933000,597433000,1659562000,1062129000,1062129000,,-82180000,,,,209812000,4845872000,3783743000,3186310000,-74384000,,777933000,777933000,2302,AME,yearly
2017-12-31,,,796729000,,681470000,553853000,1438800000,884947000,884947000,,-98029000,,,,115259000,4300170000,3415223000,2861370000,-88218000,,681470000,681470000,2302,AME,yearly
2020-09-26,222500000,,1001900000,2100000,1115200000,843500000,2513300000,1157300000,1157300000,-2900000,-116500000,,,,-108600000,3776400000,2619100000,1263100000,-155400000,,1110500000,1115200000,2317,HOLX,yearly
2019-09-28,232200000,,-257700000,2100000,-203600000,886700000,2075200000,585800000,585800000,-2900000,-140800000,,,,-54100000,3367300000,2781500000,1292100000,-843500000,,-203600000,-203600000,2317,HOLX,yearly
2018-09-29,218700000,,-418600000,2100000,-111300000,914700000,2016100000,508000000,508000000,-4000000,-148700000,,,,-307300000,3217900000,2709900000,1201800000,-926600000,,-111300000,-111300000,2317,HOLX,yearly
2017-09-30,232800000,,1230500000,2100000,755500000,818700000,1957400000,546300000,546300000,-4000000,-153200000,,,,475000000,3058800000,2512500000,1101400000,684200000,,755500000,755500000,2317,HOLX,yearly
2020-12-31,,,2096000000,,1392000000,3077000000,6060000000,2431000000,2431000000,,-24000000,,,,704000000,16652000000,14221000000,10592000000,-335000000,,1392000000,1392000000,2349,CTSH,yearly
2019-12-31,,,2485000000,,1842000000,2851000000,6174000000,2816000000,2816000000,,-26000000,,,,643000000,16783000000,13967000000,10609000000,-331000000,,1842000000,1842000000,2349,CTSH,yearly
2018-12-31,,,2799000000,,2101000000,3007000000,6287000000,2820000000,2820000000,,-27000000,,,,698000000,16125000000,13305000000,9838000000,-21000000,,2101000000,2101000000,2349,CTSH,yearly
2017-12-31,,,2657000000,,1504000000,2697000000,5658000000,2553000000,2553000000,,-23000000,,,,1153000000,14810000000,12257000000,9152000000,104000000,,1504000000,1504000000,2349,CTSH,yearly
2020-12-31,,,2413000000,8416000000,2919000000,-200000000,10707000000,5146000000,5146000000,1709000000,-1950000000,,,,44000000,17997000000,12851000000,7290000000,-2733000000,,2369000000,2919000000,2359,NEE,yearly
2019-12-31,,,3836000000,4842000000,3769000000,-185000000,11201000000,5366000000,5366000000,1804000000,-2249000000,,,,448000000,19204000000,13838000000,8003000000,-1530000000,,3388000000,3769000000,2359,NEE,yearly
2018-12-31,,,7352000000,3737000000,6638000000,-168000000,9665000000,4371000000,4371000000,1551000000,-1498000000,,,,1576000000,16727000000,12356000000,7062000000,2981000000,,5776000000,6638000000,2359,NEE,yearly
2017-12-31,,,4663000000,1295000000,5380000000,-151000000,9644000000,5983000000,5983000000,1455000000,-1558000000,,,,-660000000,17173000000,11190000000,7529000000,-1320000000,,5323000000,5380000000,2359,NEE,yearly
2020-12-31,,,628331000,,506421000,496122000,1169390000,673268000,673268000,,-49100000,,,,121910000,16207106000,15533838000,15037716000,-44937000,,506421000,506421000,2366,CHRW,yearly
2019-12-31,,,742257000,,576968000,497806000,1287782000,789976000,789976000,,-43519000,,,,165289000,15309508000,14519532000,14021726000,-47719000,,576968000,576968000,2366,CHRW,yearly
2018-12-31,,,880273000,,664505000,449610000,1361693000,912083000,912083000,,-31810000,,,,215768000,16631172000,15719089000,15269479000,-31810000,,664505000,664505000,2366,CHRW,yearly
2017-12-31,,,728463000,,504893000,413404000,1188523000,775119000,775119000,,-37256000,,,,223570000,14869380000,14094261000,13680857000,-46656000,,504893000,504893000,2366,CHRW,yearly
2020-07-31,,,800839000,,699907000,191703000,1007802000,816099000,816099000,,-20230000,,,,100932000,2205583000,1389484000,1197781000,-15260000,,699907000,699907000,2391,CPRT,yearly
2019-07-31,,,704951000,,591693000,181867000,898342000,716475000,716475000,,-19810000,,,,113258000,2041957000,1325482000,1143615000,-11524000,,591693000,591693000,2391,CPRT,yearly
2018-07-31,,,562511000,,417867000,176890000,762366000,585476000,585476000,,-20368000,,,,144504000,1805695000,1220219000,1043329000,-22965000,,418007000,417867000,2391,CPRT,yearly
2017-07-31,,,440100000,534000.0,394227000,181064000,661728000,480664000,480664000,,-23779000,,,,45839000,1447981000,967317000,786253000,-40564000,,394261000,394227000,2391,CPRT,yearly
2020-09-30,,,1017900000,1401200000,798900000,773800000,2240100000,1412300000,1412300000,,-33400000,,,,230800000,5566500000,4154200000,3326400000,-394400000,,787100000,783600000,2409,BEN,yearly
2019-09-30,,,1647800000,1464400000,1195700000,746900000,2384300000,1622700000,1622700000,,-22400000,,,,442300000,5669400000,4046700000,3285100000,25100000,,1205500000,1184800000,2409,BEN,yearly
2018-09-30,,,2215200000,1352300000,764400000,717200000,2782100000,2063100000,2063100000,,-46300000,,,,1472500000,6204500000,4141400000,3422400000,152100000,,742700000,746800000,2409,BEN,yearly
2017-09-30,,,2549100000,2257700000,1696700000,653700000,2927600000,2273900000,2273900000,,-51500000,,,,759400000,6392200000,4118300000,3464600000,275200000,,1789700000,1684300000,2409,BEN,yearly
2020-12-31,446100000,,1209300000,,949700000,1665800000,3543000000,1431100000,1431100000,,-218900000,,,,259600000,5527100000,4096000000,1984100000,-221800000,,949700000,949700000,2437,ROP,yearly
2019-12-31,403500000,,2227400000,,1767900000,1511600000,3427100000,1512000000,1512000000,,-186600000,,,,459500000,5366800000,3854800000,1939700000,715400000,,1767900000,1767900000,2437,ROP,yearly
2018-12-31,376900000,,1198400000,,944400000,1506200000,3279500000,1396400000,1396400000,,-182100000,,,,254000000,5191200000,3794800000,1911700000,-198000000,,944400000,944400000,2437,ROP,yearly
2017-12-31,376900000,,1034700000,,971800000,1654600000,2864800000,1210200000,1210200000,,-180600000,,,,62900000,4607500000,3397300000,1742700000,-175500000,,971800000,971800000,2437,ROP,yearly
2020-06-30,,,-3772000000,3000000,-3696000000,4572000000,6868000000,1779000000,1779000000,,-238000000,,,,-79000000,152922000000,151143000000,146054000000,-5551000000,,-3693000000,-3696000000,2448,CAH,yearly
2019-06-30,,,1751000000,2000000,1363000000,4480000000,6834000000,1808000000,1808000000,,-294000000,,,,386000000,145534000000,143726000000,138700000000,-57000000,,1365000000,1363000000,2448,CAH,yearly
2018-06-30,,,-228000000,12000000,256000000,4596000000,7181000000,1985000000,1985000000,,-329000000,,,,-487000000,136809000000,134824000000,129628000000,-2213000000,,259000000,256000000,2448,CAH,yearly
2017-06-30,,,1924000000,138000000,1288000000,3775000000,6544000000,2291000000,2291000000,,-201000000,,,,630000000,129976000000,127685000000,123432000000,-367000000,,1294000000,1288000000,2448,CAH,yearly
2020-10-03,,,2664000000,132000000,2061000000,2167000000,5901000000,3734000000,3734000000,,-485000000,,,,593000000,43185000000,39451000000,37284000000,-1070000000,,2071000000,2061000000,2473,TSN,yearly
2019-09-28,,,2374000000,144000000,1980000000,2222000000,5094000000,2872000000,2872000000,,-462000000,,,,381000000,42405000000,39533000000,37311000000,-498000000,,1993000000,1980000000,2473,TSN,yearly
2018-09-29,,,2682000000,8000000,2970000000,2045000000,5197000000,3152000000,3152000000,,-350000000,,,,-291000000,40052000000,36900000000,34855000000,-470000000,,2973000000,2970000000,2473,TSN,yearly
2017-09-30,,,2628000000,18000000,1774000000,2008000000,5141000000,3133000000,3133000000,,-279000000,,,,850000000,38260000000,35127000000,33119000000,-505000000,,1778000000,1774000000,2473,TSN,yearly
2021-01-03,,,555130000,,491296000,406613000,1132255000,725642000,725642000,,-172166000,,,,63834000,4117411000,3391769000,2985156000,-170512000,,491296000,491296000,2496,DPZ,yearly
2019-12-29,,,482637000,,400709000,380793000,1011700000,630907000,630907000,,-150818000,,,,81928000,3618774000,2987867000,2607074000,-148270000,,400709000,400709000,2496,DPZ,yearly
2018-12-30,,,428678000,,361972000,371964000,944153000,572189000,572189000,,-146345000,,,,66706000,3432867000,2860678000,2488714000,-143511000,,361972000,361972000,2496,DPZ,yearly
2017-12-31,,,400153000,,277905000,344159000,865991000,521832000,521832000,,-122541000,,,,122248000,2787979000,2266147000,1921988000,-121679000,,277905000,277905000,2496,DPZ,yearly
2021-01-30,,,2377000000,,1798000000,7928000000,10596000000,2668000000,2668000000,,-52000000,,,,579000000,47262000000,44594000000,36666000000,-291000000,,1798000000,1798000000,2507,BBY,yearly
2020-02-01,,,1993000000,,1541000000,7923000000,10048000000,2053000000,2053000000,,-64000000,,,,452000000,43638000000,41585000000,33590000000,-60000000,,1541000000,1541000000,2507,BBY,yearly
2019-02-02,,,1888000000,,1464000000,7979000000,9961000000,1959000000,1959000000,,-73000000,,,,424000000,42879000000,40920000000,32918000000,-67000000,,1464000000,1464000000,2507,BBY,yearly
2018-02-03,,,1817000000,,1000000000,8023000000,9876000000,1853000000,1853000000,,-75000000,,,,818000000,42151000000,40298000000,32275000000,-39000000,1000000.0,999000000,1000000000,2507,BBY,yearly
2020-12-31,,,3738000000,,3167000000,2113000000,6325000000,4212000000,4212000000,,-489000000,,,,571000000,37925000000,33713000000,31600000000,-474000000,,3167000000,3167000000,2538,GD,yearly
2019-12-31,,,4202000000,,3484000000,2430000000,6987000000,4557000000,4557000000,,-472000000,,,,718000000,39350000000,34793000000,32363000000,-355000000,,3484000000,3484000000,2538,GD,yearly
2018-12-31,,,4085000000,,3345000000,2253000000,6657000000,4404000000,4404000000,,-374000000,,,,727000000,36193000000,31789000000,29536000000,-319000000,-13000000.0,3358000000,3345000000,2538,GD,yearly
2017-12-31,,,4077000000,,2912000000,2065000000,6242000000,4177000000,4177000000,,-117000000,,,,1165000000,30973000000,26796000000,24731000000,-100000000,-13000000.0,2912000000,2912000000,2538,GD,yearly
2021-01-30,,,1092318000,,844450000,2939932000,4880451000,1940519000,1940519000,,-438462000,,,,247868000,11846891000,9906372000,6966440000,-848201000,,844450000,844450000,2566,LB,yearly
2020-02-01,,,-181000000,4000000.0,-366000000,4306000000,5547000000,1241000000,1241000000,,-378000000,,,,185000000,12914000000,11673000000,7367000000,-1422000000,,-366000000,-366000000,2566,LB,yearly
2019-02-02,,,857000000,4000000.0,644000000,4289000000,5749000000,1460000000,1460000000,,-385000000,,,,213000000,13237000000,11777000000,7488000000,-603000000,,644000000,644000000,2566,LB,yearly
2018-02-03,,,1312000000,2000000.0,983000000,3940000000,5668000000,1728000000,1728000000,,-406000000,,,,329000000,12632000000,10904000000,6964000000,-416000000,,983000000,983000000,2566,LB,yearly
2020-12-31,,,-924000000,4000000,-715000000,323000000,980000000,46000000,46000000,280000000,-429000000,,,,-204000000,1600000000,1554000000,620000000,-970000000,,-720000000,-715000000,2632,HLT,yearly
2019-12-31,,,1244000000,10000000,881000000,452000000,2512000000,1565000000,1565000000,149000000,-414000000,,,,358000000,3766000000,2201000000,1254000000,-321000000,,886000000,881000000,2632,HLT,yearly
2018-12-31,,,1078000000,7000000,764000000,454000000,2336000000,1421000000,1421000000,136000000,-371000000,,,,309000000,3668000000,2247000000,1332000000,-343000000,,769000000,764000000,2632,HLT,yearly
2017-12-31,,,753000000,3000000,1084000000,449000000,2135000000,1122000000,1122000000,228000000,-351000000,,,,-336000000,3404000000,2282000000,1269000000,-369000000,,1089000000,1084000000,2632,HLT,yearly
2020-12-31,,,1844000000,12000000,1343000000,,11490000000,1410000000,1410000000,7382000000,-701000000,,,,501000000,84628000000,83218000000,73138000000,434000000,,1343000000,1343000000,2653,UPS,yearly
2019-12-31,,,5652000000,16000000,4440000000,,13637000000,5536000000,5536000000,5744000000,-653000000,,,,1212000000,74094000000,68558000000,60457000000,116000000,,4440000000,4440000000,2653,UPS,yearly
2018-12-31,,,6019000000,16000000,4791000000,1362000000.0,13130000000,5458000000,5458000000,5465000000,-605000000,,,,1228000000,71861000000,66403000000,58731000000,561000000,,4791000000,4791000000,2653,UPS,yearly
2017-12-31,,,7137000000,30000000,4905000000,1362000000.0,13866000000,6529000000,6529000000,5055000000,-453000000,,,,2232000000,66585000000,60056000000,52719000000,608000000,,4905000000,4905000000,2653,UPS,yearly
2020-09-30,,,-5293831000,179288000,-3408716000,2729432000,5188229000,2067735000,2067735000,,-158522000,,,,-1894273000,189893926000,187826191000,184705697000,-7361566000,,-3399558000,-3408716000,2669,ABC,yearly
2019-09-30,,,967106000,114289000,855365000,2663508000,4992440000,1866525000,1866525000,,-195474000,,,,112971000,179589121000,177722596000,174596681000,-899419000,,854135000,855365000,2669,ABC,yearly
2018-09-30,,,1177423000,117137000,1658405000,2460301000,4576379000,1650951000,1650951000,,-189640000,,,,-438469000,167939635000,166288684000,163363256000,-473528000,,1615892000,1658405000,2669,ABC,yearly
2017-09-30,,,917887000,117137000,364484000,2128730000,4544607000,2018274000,2018274000,,-149042000,,,,553403000,153143826000,151125552000,148599219000,-1100387000,,364484000,364484000,2669,ABC,yearly
2020-12-31,152000000,,1511000000,631000000,906000000,1769000000,3779000000,1865000000,1865000000,-7000000,-129000000,,,,455000000,12756000000,10891000000,8977000000,-354000000,,1056000000,906000000,2673,OTIS,yearly
2019-12-31,163000000,,1861000000,626000000,1116000000,1699000000,3826000000,1953000000,1953000000,11000000,-129000000,,,,594000000,13118000000,11165000000,9292000000,-92000000,,1267000000,1116000000,2673,OTIS,yearly
2018-12-31,181000000,,1893000000,646000000,1049000000,1645000000,3726000000,1925000000,1925000000,-25000000,-129000000,,,,683000000,12915000000,10990000000,9189000000,-32000000,,1210000000,1049000000,2673,OTIS,yearly
2017-12-31,175000000,,1957000000,698000000,636000000,1597000000,3702000000,1967000000,1967000000,-37000000,-40000000,,,,1148000000,12323000000,10356000000,8621000000,-10000000,,809000000,636000000,2673,OTIS,yearly
2020-12-31,,,297537000,71476000,299915000,57904000,720410000,288992000,288992000,20501000,-93442000,,,,-5112000,1004320000,715328000,283910000,8545000,111000,302649000,298468000,2676,DRE,yearly
2019-12-31,,,440885000,62145000,428972000,60889000,667256000,261424000,261424000,17720000,-89756000,,,,8686000,983926000,722502000,316670000,179461000,445000,432199000,427485000,2676,DRE,yearly
2018-12-31,,,392196000,55042000,383729000,56218000,606606000,232940000,232940000,5231000,-85006000,,,,8828000,957220000,724280000,350614000,159256000,3900000,383368000,382054000,2676,DRE,yearly
2017-12-31,,,290235000,41534000,1634431000,54944000,528999000,196282000,196282000,4212000,-87003000,,,,-357000,790344000,594062000,261345000,93953000,1363749000,290592000,1630450000,2676,DRE,yearly
2020-12-31,,,3072000000,243000000,2352000000,3512000000,7105000000,3599000000,3599000000,-6000000,-252000000,,,,676000000,19140000000,15541000000,12035000000,-527000000,,2396000000,2352000000,2683,KMB,yearly
2019-12-31,,,2773000000,227000000,2157000000,3199000000,6451000000,3254000000,3254000000,-2000000,-261000000,,,,576000000,18450000000,15196000000,11999000000,-481000000,,2197000000,2157000000,2683,KMB,yearly
2018-12-31,,,1916000000,241000000,1410000000,3151000000,6138000000,3026000000,3026000000,-39000000,-263000000,,,,471000000,18486000000,15460000000,12348000000,-1110000000,,1445000000,1410000000,2683,KMB,yearly
2017-12-31,,,3095000000,253000000,2278000000,3261000000,6587000000,3286000000,3286000000,40000000,-318000000,,,,776000000,18348000000,15062000000,11761000000,-191000000,,2319000000,2278000000,2683,KMB,yearly
2020-12-31,379000000,,1362000000,126000000,1059000000,3423000000,6091000000,1672000000,1672000000,108000000,-138000000,,,,291000000,13834000000,12162000000,7743000000,-310000000,3000000,1071000000,1059000000,2684,PPG,yearly
2019-12-31,432000000,,1661000000,119000000,1243000000,3638000000,6527000000,1854000000,1854000000,92000000,-132000000,,,,392000000,15146000000,13292000000,8619000000,-193000000,3000000,1269000000,1243000000,2684,PPG,yearly
2018-12-31,441000000,,1693000000,102000000,1341000000,3573000000,6373000000,1762000000,1762000000,100000000,-118000000,,,,353000000,15374000000,13612000000,9001000000,-69000000,18000000,1340000000,1341000000,2684,PPG,yearly
2017-12-31,451000000,,2005000000,115000000,1594000000,3554000000,6539000000,1986000000,1986000000,88000000,-105000000,,,,615000000,14748000000,12762000000,8209000000,19000000,225000000,1390000000,1594000000,2684,PPG,yearly
2020-12-31,,,885000000,581000000,755000000,-118000000,2769000000,1480000000,1480000000,359000000,-563000000,,,,133000000,6680000000,5200000000,3911000000,-595000000,,752000000,755000000,2689,CMS,yearly
2019-12-31,,,829000000,37000000,680000000,-91000000,2564000000,1330000000,1330000000,333000000,-523000000,,,,147000000,6845000000,5515000000,4281000000,-501000000,,682000000,680000000,2689,CMS,yearly
2018-12-31,,,774000000,37000000,657000000,-90000000,2398000000,1252000000,1252000000,303000000,-461000000,,,,115000000,6873000000,5621000000,4475000000,-478000000,,659000000,657000000,2689,CMS,yearly
2017-12-31,,,886000000,37000000,460000000,-24000000,2503000000,1362000000,1362000000,284000000,-440000000,,,,424000000,6583000000,5221000000,4080000000,-476000000,,462000000,460000000,2689,CMS,yearly
2020-12-31,226000000,,530000000,85000000,478000000,773000000,1983000000,984000000,984000000,,-214000000,,,,41000000,8473000000,7489000000,6490000000,-454000000,,489000000,478000000,2698,EMN,yearly
2019-12-31,234000000,,902000000,74000000,759000000,751000000,2234000000,1249000000,1249000000,,-221000000,,,,140000000,9273000000,8024000000,7039000000,-347000000,,762000000,759000000,2698,EMN,yearly
2018-12-31,235000000,,1310000000,75000000,1080000000,693000000,2479000000,1551000000,1551000000,,-238000000,,,,226000000,10151000000,8600000000,7672000000,-241000000,,1084000000,1080000000,2698,EMN,yearly
2017-12-31,227000000,,1289000000,77000000,1384000000,594000000,2475000000,1654000000,1654000000,,-244000000,,,,-99000000,9549000000,7895000000,7074000000,-365000000,,1388000000,1384000000,2698,EMN,yearly
2020-12-31,162100000,,557200000,30400000,414400000,867100000,2181100000,869500000,869500000,,-198900000,,,,144900000,7556100000,6686600000,5375000000,-312300000,,412300000,413200000,2716,WAB,yearly
2019-12-31,209900000,,446800000,37100000,326700000,964700000,2501000000,1088000000,1088000000,,-219100000,,,,120300000,8200000000,7112000000,5699000000,-641200000,,326500000,325300000,2716,WAB,yearly
2018-12-31,87500000,,367600000,3900000,294900000,624200000,1233900000,482400000,482400000,,-112200000,,,,75900000,4363500000,3881100000,3129600000,-114800000,,291700000,294200000,2716,WAB,yearly
2017-12-31,95200000,,352100000,19664000,262300000,472700000,1077300000,472900000,472900000,,-79900000,,,,89800000,3881700000,3408800000,2804400000,-120800000,,262300000,261600000,2716,WAB,yearly
2020-12-31,,,2301000000,,1905000000,-249000000,3432000000,2396000000,2396000000,,-600000000,,,,396000000,9603000000,7207000000,6171000000,-95000000,,1905000000,1905000000,2718,PEG,yearly
2019-12-31,,,1950000000,,1693000000,-177000000,3609000000,2538000000,2538000000,,-569000000,,,,257000000,10076000000,7538000000,6467000000,-588000000,,1693000000,1693000000,2718,PEG,yearly
2018-12-31,,,1855000000,,1438000000,-76000000,3402000000,2320000000,2320000000,,-476000000,,,,417000000,9696000000,7376000000,6294000000,-465000000,,1438000000,1438000000,2718,PEG,yearly
2017-12-31,,,1268000000,,1574000000,-76000000,3415000000,2393000000,2393000000,,-391000000,,,,-306000000,9094000000,6701000000,5679000000,-1125000000,,1574000000,1574000000,2718,PEG,yearly
2020-12-31,,,890007000,39659000,638423000,3266065000,4600492000,1062135000,1062135000,,-103784000,,,,249498000,11628830000,10566695000,7028338000,-172128000,-198000,640509000,638423000,2723,LKQ,yearly
2019-12-31,,,758745000,63781000,541260000,3581258000,4872794000,1000766000,1000766000,,-138504000,,,,215330000,12506109000,11505343000,7633315000,-242021000,645000,543415000,541260000,2723,LKQ,yearly
2018-12-31,,,678960000,56454000,480118000,3353278000,4574857000,947366000,947366000,,-146377000,,,,191395000,11876674000,10929308000,7301817000,-268406000,-4397000,487565000,480118000,2723,LKQ,yearly
2017-12-31,,,772534000,8484000,533744000,2713087000,3799623000,866990000,866990000,,-101640000,,,,235560000,9736909000,8869919000,5937286000,-94456000,-6746000,536974000,533744000,2723,LKQ,yearly
2020-12-31,,,889300000,2600000,721000000,297500000,1256500000,945200000,945200000,13800000,-118100000,,,,168200000,4432100000,3486900000,3175600000,-55900000,,721100000,720400000,2726,MLM,yearly
2019-12-31,,,748300000,2500000,611900000,308400000,1183200000,879700000,879700000,-4900000,-129300000,,,,136300000,4422300000,3542600000,3239100000,-131400000,,612000000,611000000,2726,MLM,yearly
2018-12-31,,,576100000,3000000,470000000,283600000,970600000,687000000,687000000,-4900000,-137100000,,,,105700000,3980400000,3293400000,3009800000,-110900000,,470400000,469200000,2726,MLM,yearly
2017-12-31,,,618900000,2877000,713300000,271400000,974000000,693000000,693000000,9600000,-91500000,,,,-94500000,3723500000,3030500000,2749500000,-74100000,,713400000,711300000,2726,MLM,yearly
2020-12-31,,,704802000,14995000,530670000,44291000,3245731000,864142000,864142000,2337298000,-150537000,,,,171817000,8098925000,7234783000,4853194000,-159340000,,532985000,530670000,2807,WRB,yearly
2019-12-31,,,852920000,43403000,681944000,44107000,3368411000,975614000,975614000,2348690000,-153409000,,,,168935000,7902196000,6926582000,4533785000,-122694000,,683985000,681944000,2807,WRB,yearly
2018-12-31,,,812094000,41947000,640749000,45778000,3352500000,942212000,942212000,2364510000,-157185000,,,,163028000,7691651000,6749439000,4339151000,-130118000,,649066000,640749000,2807,WRB,yearly
2017-12-31,,,772770000,39819000,549094000,52925000,3356999000,935334000,935334000,2368740000,-147297000,,,,219433000,7684764000,6749430000,4327765000,-162564000,,553337000,549094000,2807,WRB,yearly
2020-06-28,1252412000,,2574978000,,2251753000,682479000,4608693000,2673802000,2673802000,,-177440000,,,,323225000,10044736000,7370934000,5436043000,-98824000,,2251753000,2251753000,2817,LRCX,yearly
2019-06-30,1191320000,,2446571000,,2191430000,702407000,4358459000,2464732000,2464732000,,-117263000,,,,255141000,9653559000,7188827000,5295100000,-18161000,,2191430000,2191430000,2817,LRCX,yearly
2018-06-24,1189514000,,3151789000,,2380681000,762219000,5165032000,3213299000,3213299000,,-97387000,,,,771108000,11076998000,7863699000,5911966000,-61510000,,2380681000,2380681000,2817,LRCX,yearly
2017-06-25,1033742000,,1811673000,,1697763000,657685000,3603359000,1911932000,1911932000,,-117734000,,,,113910000,8013620000,6101688000,4410261000,-100259000,,1697763000,1697763000,2817,LRCX,yearly
2020-09-30,,,1136100000,319000000,1023400000,1515800000,2595200000,1079400000,1079400000,,-103500000,,,,112900000,6329800000,5250400000,3734600000,56700000,,1023200000,1022400000,2861,ROK,yearly
2019-09-30,,,901000000,319000000,695800000,1528800000,2900100000,1371300000,1371300000,,-98200000,,,,205200000,6694800000,5323500000,3794700000,-470300000,,695800000,695100000,2861,ROK,yearly
2018-09-30,,,1330800000,319000000,535500000,1612900000,2884900000,1272000000,1272000000,-16300000.0,-73000000,,,,795300000,6666000000,5394000000,3781100000,58800000,,535500000,535000000,2861,ROK,yearly
2017-09-30,,,1037400000,319000000,825700000,1634700000,2667900000,1033200000,1033200000,-9100000.0,-76200000,,,,211700000,6311300000,5278100000,3643400000,4200000,,825700000,824800000,2861,ROK,yearly
2021-01-03,205389000,,906364000,,727887000,910852000,2117814000,1001573000,1001573000,,-49712000,,,,178266000,3782745000,2781172000,1664931000,-95209000,-211000,728098000,727887000,2880,PKI,yearly
2019-12-29,189336000,,237142000,,227558000,827837000,1417645000,400472000,400472000,,-63627000,,,,9389000,2883673000,2483201000,1466028000,-163330000,-195000,227753000,227558000,2880,PKI,yearly
2018-12-30,193998000,,257683000,,237927000,787474000,1360211000,378739000,378739000,,-66976000,,,,20208000,2777996000,2399257000,1417785000,-121056000,452000,237475000,237927000,2880,PKI,yearly
2017-12-31,139464000,,296718000,,292633000,614656000,1073754000,319634000,319634000,,-43940000,,,,139828000,2256982000,1937348000,1183228000,-22916000,135743000,156890000,292633000,2880,PKI,yearly
2020-08-29,,,2216514000,,1732972000,4269174000,6770753000,2501579000,2501579000,,-206854000,,,,483542000,12631967000,10130388000,5861214000,-285065000,,1732972000,1732972000,2892,AZO,yearly
2019-08-31,,,2031333000,,1617221000,4155664000,6365001000,2209337000,2209337000,,-192200000,,,,414112000,11863743000,9654406000,5498742000,-178004000,,1617221000,1617221000,2892,AZO,yearly
2018-08-25,,,1636329000,,1337536000,3839428000,5973746000,2134318000,2134318000,,-180163000,,,,298793000,11221077000,9086759000,5247331000,-497989000,,1337536000,1337536000,2892,AZO,yearly
2017-08-26,,,1925489000,,1280869000,3659551000,5739620000,2080069000,2080069000,,-158082000,,,,644620000,10888676000,8808607000,5149056000,-154580000,,1280869000,1280869000,2892,AZO,yearly
2020-04-30,,,1026700000,,779500000,1474300000,3002000000,1292000000,1292000000,-600000,-189200000,,,,247200000,7801000000,6509000000,4799000000,-265300000,,779500000,779500000,2919,SJM,yearly
2019-04-30,,,701600000,,514400000,1508600000,2915700000,1170100000,1170100000,-3300000,-207900000,,,,187200000,7838000000,6667900000,4922300000,-468500000,,514400000,514400000,2919,SJM,yearly
2018-04-30,,,861000000,,1338600000,1362900000,2840000000,1270200000,1270200000,100000,-174100000,,,,-477600000,7357100000,6086900000,4517100000,-409200000,,1338600000,1338600000,2919,SJM,yearly
2017-04-30,,,878400000,,592300000,1340000000,2841000000,1298000000,1298000000,-4300000,-163100000,,,,286100000,7392300000,6094300000,4551300000,-419600000,,592300000,592300000,2919,SJM,yearly
2020-12-31,,,2266405000,,1752302000,3666356000,6085692000,2419336000,2419336000,,-161126000,,,,514103000,11604493000,9185157000,5518801000,-152931000,,1752302000,1752302000,2920,ORLY,yearly
2019-12-31,,,1790329000,,1391042000,3204765000,5394691000,1922626000,1922626000,,-139975000,,,,399287000,10149985000,8227359000,4755294000,-132297000,,1391042000,1391042000,2920,ORLY,yearly
2018-12-31,,,1694087000,,1324487000,2967382000,5039966000,1826584000,1826584000,,-122129000,,,,369600000,9536428000,7709844000,4496462000,-132497000,,1324487000,1324487000,2920,ORLY,yearly
2017-12-31,,,1637804000,,1133804000,2762583000,4720683000,1725400000,1725400000,,-91349000,,,,504000000,8977726000,7252326000,4257043000,-83996000,,1133804000,1133804000,2920,ORLY,yearly
2020-12-31,1024327000,,149185000,,118503000,2309181000,3532371000,198863000,198863000,,-32746000,,,,30682000,4519484000,4320621000,987113000,-49678000,,118503000,118503000,2965,NOW,yearly
2019-12-31,748369000,,67185000,,626698000,1873300000,2663792000,42123000,42123000,,-33283000,,,,-559513000,3460437000,3418314000,796645000,25062000,,626698000,626698000,2965,NOW,yearly
2018-12-31,529501000,,-39024000,,-26704000,1499083000,1986158000,-42426000,-42426000,,-52733000,,,,-12320000,2608816000,2651242000,622658000,3402000,,-26704000,-26704000,2965,NOW,yearly
2017-12-31,377518000,,-113406000,,-116846000,1105510000,1418632000,-64396000,-64396000,,-53394000,,,,3440000,1918494000,1982890000,499862000,-49010000,,-116846000,-116846000,2965,NOW,yearly
2020-02-01,,,906150000,,705945000,2078777000,2999125000,901094000,901094000,,,,,,200205000,7398068000,6496974000,4398943000,5056000,,705945000,705945000,3010,ULTA,yearly
2019-02-02,,,859141000,,658559000,1535464000,2409311000,854080000,854080000,,,,,,200582000,6716615000,5862535000,4307304000,5061000,,658559000,658559000,3010,ULTA,yearly
2018-02-03,,,786859000,,555234000,1287232000,2096809000,785291000,785291000,,,,,,231625000,5884506000,5099215000,3787697000,1568000,,555234000,555234000,3010,ULTA,yearly
2017-01-28,,,655714000,,409760000,1073834000,1747229000,654824000,654824000,,,,,,245954000,4854737000,4199913000,3107508000,890000,,409760000,409760000,3010,ULTA,yearly
2020-10-31,1279022000,,638159000,4963000,664347000,916540000,2943043000,656200000,656200000,,-5140000,,,,-25288000,3685281000,3029081000,742238000,-18041000,,663447000,664347000,3036,SNPS,yearly
2019-10-31,1136932000,,545506000,5863000,532367000,880408000,2667371000,549117000,549117000,,-11659000,,,,13139000,3360694000,2811577000,693323000,-3611000,,532367000,532367000,3036,SNPS,yearly
2018-10-31,1084822000,,363543000,5863000,432518000,859538000,2469194000,399170000,399170000,,-15607000,,,,-68975000,3121058000,2721888000,651864000,-35627000,,432518000,432518000,3036,SNPS,yearly
2017-10-31,908841000,,383098000,4104000,136563000,738492000,2146805000,391749000,391749000,,-7303000,,,,246535000,2724880000,2333131000,578075000,-8651000,,136563000,136563000,3036,SNPS,yearly
2021-01-29,,,7739000000,,5835000000,18526000000,29572000000,9647000000,9647000000,,-848000000,,,,1904000000,89597000000,79950000000,60025000000,-1908000000,,5835000000,5811000000,3060,LOW,yearly
2020-01-31,,,5623000000,,4281000000,15282000000,23100000000,6579000000,6579000000,,-718000000,,,,1342000000,72148000000,65569000000,49048000000,-956000000,,4281000000,4268000000,3060,LOW,yearly
2019-02-01,,,3394000000,,2314000000,16431000000,22908000000,5153000000,5153000000,,-652000000,,,,1080000000,71309000000,66156000000,48401000000,-1759000000,,2314000000,2307000000,3060,LOW,yearly
2018-02-02,,,5489000000,,3447000000,14444000000,22434000000,6586000000,6586000000,,-652000000,,,,2042000000,68619000000,62033000000,46185000000,-1097000000,,3447000000,3436000000,3060,LOW,yearly
2020-12-31,,,6890000000,40000000,4467000000,1902000000,13488000000,11514000000,11514000000,,-1205000000,,,,2436000000,20841000000,9327000000,7353000000,-4624000000,,4454000000,4467000000,3130,MO,yearly
2019-12-31,,,766000000,135000000,-1293000000,1903000000,12713000000,10810000000,10810000000,,-1317000000,,,,2064000000,19796000000,8986000000,7083000000,-10044000000,,-1298000000,-1300000000,3130,MO,yearly
2018-12-31,,,9341000000,41000000,6963000000,2342000000,12176000000,9834000000,9834000000,,-679000000,,,,2374000000,19627000000,9793000000,7451000000,-493000000,,6967000000,6955000000,3130,MO,yearly
2017-12-31,,,9828000000,41000000,10222000000,2042000000,12003000000,9961000000,9961000000,,-728000000,,,,-399000000,19494000000,9533000000,7491000000,-133000000,,10227000000,10208000000,3130,MO,yearly
2020-12-26,1983000000,,1280000000,,2490000000,995000000,4347000000,1369000000,1369000000,,-47000000,,,,-1210000000,9763000000,8394000000,5416000000,-89000000,,2490000000,2490000000,3152,AMD,yearly
2019-12-28,1547000000,,372000000,,341000000,750000000,2868000000,631000000,631000000,-60000000.0,-94000000,,,,31000000,6731000000,6100000000,3863000000,-259000000,,341000000,341000000,3152,AMD,yearly
2018-12-29,1434000000,,328000000,,337000000,562000000,2447000000,451000000,451000000,-60000000.0,-121000000,,,,-9000000,6475000000,6024000000,4028000000,-123000000,,337000000,337000000,3152,AMD,yearly
2017-12-30,1196000000,,-15000000,,-33000000,516000000,1787000000,127000000,127000000,-52000000.0,-126000000,,,,18000000,5253000000,5126000000,3466000000,-142000000,,-33000000,-33000000,3152,AMD,yearly
2020-12-31,101053000,,686225000,,601822000,332158000,1403686000,883350000,883350000,,-156324000,,,,84403000,1695390000,812040000,291704000,-197125000,,601822000,601822000,3156,MSCI,yearly
2019-12-31,98334000,,603318000,,563648000,322131000,1269835000,754961000,754961000,15000000.0,-148041000,,,,39670000,1557796000,802835000,287961000,-151643000,,563648000,563648000,3156,MSCI,yearly
2018-12-31,81411000,,629896000,,507885000,292859000,1146649000,694744000,694744000,15000000.0,-133114000,,,,122011000,1433984000,739240000,287335000,-64848000,,507885000,507885000,3156,MSCI,yearly
2017-12-31,75849000,,466899000,,303972000,264885000,1000491000,579770000,579770000,15000000.0,-116098000,,,,162927000,1274172000,694402000,273681000,-112071000,,303972000,303972000,3156,MSCI,yearly
2020-05-31,,,2691300000,835600000,2181200000,3038800000,6157200000,3118400000,3118400000,,-472500000,,,,480500000,17626600000,14508200000,11469400000,-427100000,,2210800000,2181200000,3160,GIS,yearly
2019-05-26,,,2154000000,864900000,1752700000,2822300000,5821000000,2998700000,2998700000,,-527400000,,,,367800000,16865200000,13866500000,11044200000,-844700000,,1786200000,1752700000,3160,GIS,yearly
2018-05-27,,,2220300000,1127500000,2131000000,2760700000,5460900000,2700200000,2700200000,,-385400000,,,,57300000,15740400000,13040200000,10279500000,-479900000,,2163000000,2131000000,3160,GIS,yearly
2017-05-28,,,2356300000,1268500000,1657500000,2814500000,5653200000,2838700000,2838700000,,-302100000,,,,655200000,15619800000,12781100000,9966600000,-482400000,,1701100000,1657500000,3160,GIS,yearly
2019-12-31,,,102696000000,3772000000,81417000000,,105481000000,105481000000,105481000000,,-3961000000,,,,20904000000,256100000000,150619000000,150619000000,-2785000000,,81792000000,81417000000,3164,BRK-B,yearly
2018-12-31,,,4001000000,3797000000,4021000000,,10021000000,10021000000,10021000000,,-3853000000,,,,-321000000,247537000000,237516000000,237516000000,-6020000000,,4322000000,4021000000,3164,BRK-B,yearly
2017-12-31,,,23838000000,3658000000,44940000000,,25210000000,25210000000,25210000000,,-4386000000,,,,-21515000000,240651000000,215441000000,215441000000,-1372000000,,45353000000,44940000000,3164,BRK-B,yearly
2016-12-31,,,33667000000,3358000000,24074000000,,36299000000,36299000000,36299000000,,-3741000000,,,,9240000000,215865000000,179566000000,179566000000,-2632000000,,24427000000,24074000000,3164,BRK-B,yearly
2019-12-28,935938000,,478968000,,988979000,619179000,2069962000,502717000,502717000,,-18829000,,,,-510011000,2336319000,1833602000,266357000,-23749000,,988979000,988979000,3208,CDNS,yearly
2018-12-29,884816000,,376390000,,345777000,572475000,1879275000,407898000,407898000,,-23139000,,,,30613000,2138022000,1730124000,258747000,-31508000,,345777000,345777000,3208,CDNS,yearly
2017-12-30,804223000,,315046000,,204101000,552242000,1705642000,334461000,334461000,,-25664000,,,,110945000,1943032000,1608571000,237390000,-19415000,,204101000,204101000,3208,CDNS,yearly
2016-12-31,735340000,,237153000,,203086000,519200000,1559591000,286956000,286956000,,-23670000,,,,34067000,1816083000,1529127000,256492000,-49803000,,203086000,203086000,3208,CDNS,yearly
2020-12-31,372000000,,-274400000,5200000,-138900000,2995700000,4896200000,930900000,930900000,,-212000000,,,,-137000000,7024500000,6093600000,2128300000,-1205300000,,-137400000,-138900000,3210,ZBH,yearly
2019-12-31,449300000,,905800000,4700000,1131600000,3289800000,5729600000,1406200000,1406200000,,-226900000,,,,-225700000,7982200000,6576000000,2252600000,-500400000,,1131500000,1131600000,3210,ZBH,yearly
2018-12-31,391700000,,-271100000,4800000,-379200000,3372400000,5661000000,1301000000,1301000000,,-289300000,,,,108200000,7932900000,6631900000,2271900000,-1572100000,,-379300000,-379200000,3210,ZBH,yearly
2017-12-31,369900000,,464600000,-300000,1813800000,3095800000,5703200000,1633600000,1633600000,,-325300000,,,,-1348800000,7803300000,6169700000,2100100000,-1169000000,,1813400000,1813800000,3210,ZBH,yearly
2020-12-31,,,591000000,,474000000,1655000000,2375000000,0,641000000,79000000,,,,,117000000,2375000000,1734000000,0,-50000000,,474000000,459000000,3214,CMA,yearly
2019-12-31,,,1532000000,,1198000000,1639000000,3275000000,0,1570000000,66000000,,,,,334000000,3275000000,1705000000,0,-38000000,,1198000000,1191000000,3214,CMA,yearly
2018-12-31,,,1535000000,,1235000000,1619000000,3329000000,0,1647000000,63000000,,,,,300000000,3329000000,1682000000,0,-112000000,,1235000000,1227000000,3214,CMA,yearly
2017-12-31,,,1234000000,,743000000,1680000000,3094000000,0,1345000000,69000000,,,,,491000000,3094000000,1749000000,0,-111000000,,743000000,738000000,3214,CMA,yearly
2020-12-31,55921000,,119410000,,133995000,103621000,345981000,186439000,186439000,,-21001000,,,,-14585000,774425000,587986000,428444000,-67029000,,133995000,133995000,3221,ENPH,yearly
2019-12-31,40381000,,90114000,,161148000,75536000,221245000,105328000,105328000,,-9691000,,,,-71034000,624333000,519005000,403088000,-15214000,,161148000,161148000,3221,ENPH,yearly
2018-12-31,32587000,,-10229000,,-11627000,55333000,94445000,6525000,6525000,,-10693000,,,,1398000,316159000,309634000,221714000,-16754000,,-11627000,-11627000,3221,ENPH,yearly
2017-12-31,33157000,,-45341000,,-45192000,45347000,56043000,-22461000,-22461000,1468000.0,-8212000,,,,-149000,286166000,308627000,230123000,-22880000,,-45192000,-45192000,3221,ENPH,yearly
2020-12-31,,,723200000,,553100000,1278900000,2174800000,853900000,853900000,,-83900000,,,,168800000,6090300000,5236400000,3915500000,-130700000,,554400000,553100000,3232,FBHS,yearly
2019-12-31,,,575300000,1200000.0,431900000,1284800000,2058200000,732000000,732000000,,-94200000,,,,144000000,5764600000,5032600000,3706400000,-156700000,,431300000,431900000,3232,FBHS,yearly
2018-12-31,,,537000000,1800000.0,389600000,1235700000,1971500000,699700000,699700000,,-74500000,,,,147000000,5485100000,4785400000,3513600000,-162700000,-200000.0,390000000,389600000,3232,FBHS,yearly
2017-12-31,,,634800000,1600000.0,472600000,1179200000,1932200000,721300000,721300000,,-49400000,,,,159500000,5283300000,4562000000,3351100000,-86500000,-2600000.0,475300000,472600000,3232,FBHS,yearly
2020-12-31,419000000,,2855000000,326000000,1982000000,2731000000,5129000000,1953000000,1953000000,26000000,-298000000,,,,849000000,17456000000,15503000000,12327000000,902000000,,2006000000,1982000000,3253,CARR,yearly
2019-12-31,401000000,,2672000000,333000000,2116000000,2464000000,5455000000,2696000000,2696000000,-106000000,-75000000,,,,517000000,18608000000,15912000000,13153000000,-24000000,,2155000000,2116000000,3253,CARR,yearly
2018-12-31,400000000,,3842000000,352000000,2734000000,2477000000,5605000000,2866000000,2866000000,-138000000,-84000000,,,,1073000000,18914000000,16048000000,13309000000,976000000,,2769000000,2734000000,3253,CARR,yearly
2017-12-31,364000000,,3054000000,352000000,1227000000,2382000000,5233000000,2644000000,2644000000,-157000000,-219000000,,,,1787000000,17814000000,15170000000,12581000000,410000000,,1267000000,1227000000,3253,CARR,yearly
2020-12-31,,,470340000,123000,377778000,494454000,1031531000,537077000,537077000,,-44746000,,,,92562000,2351646000,1814569000,1320115000,-66737000,,377778000,377778000,3276,IEX,yearly
2019-12-31,,,532903000,123000,425521000,526858000,1128374000,601516000,601516000,,-44341000,,,,107382000,2494573000,1893057000,1366199000,-68613000,,425521000,425521000,3276,IEX,yearly
2018-12-31,,,528939000,123000,410573000,534462000,1117895000,581233000,581233000,2200000.0,-44134000,,,,118366000,2483666000,1902433000,1365771000,-52294000,,410573000,410573000,3276,IEX,yearly
2017-12-31,,,455273000,123000,337257000,527454000,1026678000,499224000,499224000,2200000.0,-44889000,,,,118016000,2287312000,1788088000,1260634000,-43951000,,337257000,337257000,3276,IEX,yearly
2020-12-31,137598000,,169342000,,164375000,157077000,465954000,171279000,171279000,,,,,,4967000,844452000,673173000,378498000,-1937000,,164375000,164375000,3315,MPWR,yearly
2019-12-31,107757000,,113120000,,108839000,133542000,346325000,105026000,105026000,,,,,,4281000,627921000,522895000,281596000,8094000,,108839000,108839000,3315,MPWR,yearly
2018-12-31,93455000,,118482000,,105268000,113803000,322668000,115410000,115410000,,4994000.0,,,,13214000,582382000,466972000,259714000,3072000,,105268000,105268000,3315,MPWR,yearly
2017-12-31,82359000,,82944000,,65203000,97257000,258283000,78667000,78667000,,4994000.0,,,,17741000,470929000,392262000,212646000,4277000,,65203000,65203000,3315,MPWR,yearly
2020-06-30,,,1512627000,14546000,1206341000,1548339000,3538002000,1989663000,1989663000,,-308161000,,,,305924000,13695520000,11705857000,10157518000,-477036000,,1206703000,1206341000,3316,PH,yearly
2019-06-30,,,1933425000,6183000,1512364000,1553759000,3631490000,2077731000,2077731000,,-190138000,,,,420494000,14320324000,12242593000,10688834000,-144306000,,1512931000,1512364000,3316,PH,yearly
2018-06-30,,,1702277000,5627000,1060801000,1643000000,3609596000,1966596000,1966596000,,-213873000,,,,640962000,14302392000,12335796000,10692796000,-264319000,,1061315000,1060801000,3316,PH,yearly
2017-06-30,,,1328641000,5697000,983412000,1504657000,2946215000,1441558000,1441558000,,-162436000,,,,344797000,12029312000,10587754000,9083097000,-112917000,,983844000,983412000,3316,PH,yearly
2020-12-31,,,-747046000,553842000,-601448000,307456000,649862000,-178506000,-178506000,,-126527000,,,,-232147000,11183643000,11362149000,10533781000,-568540000,,-514899000,-603259000,3351,HFC,yearly
2019-12-31,,,1171504000,531233000,772388000,326664000,2293917000,1457328000,1457328000,,-143321000,,,,299152000,17486578000,16029250000,15192661000,-285824000,,872352000,771354000,3351,HFC,yearly
2018-12-31,,,1524467000,540488000,1097960000,283066000,2351741000,1631351000,1631351000,,-131363000,,,,347243000,17714666000,16083315000,15362925000,-106884000,,1177224000,1094246000,3351,HFC,yearly
2017-12-31,,,868863000,526111000,805395000,235327000,1595442000,950178000,950178000,,-117597000,,,,-12379000,14251299000,13301121000,12655857000,-81315000,,881242000,800348000,3351,HFC,yearly
2020-12-31,,,463000000,2681000000,317000000,206000000,827000000,621000000,621000000,,-179000000,,,,31000000,4124000000,3503000000,3297000000,-158000000,,432000000,317000000,3354,CF,yearly
2019-12-31,,,772000000,2740000000,493000000,239000000,1174000000,930000000,930000000,5000000.0,-237000000,,,,126000000,4590000000,3660000000,3416000000,-158000000,,646000000,493000000,3354,CF,yearly
2018-12-31,,,547000000,2773000000,290000000,214000000,917000000,721000000,721000000,-18000000.0,-241000000,,,,119000000,4429000000,3708000000,3512000000,-174000000,,428000000,290000000,3354,CF,yearly
2017-12-31,,,-125000000,3105000000,358000000,195000000,434000000,226000000,226000000,13000000.0,-315000000,,,,-575000000,4130000000,3904000000,3696000000,-351000000,,450000000,358000000,3354,CF,yearly
2020-12-31,1087000000,,3420000000,,5667000000,3636000000,7798000000,2717000000,2717000000,331000000,-305000000,,,,878000000,10271000000,7554000000,2473000000,703000000,3125000000,2542000000,5667000000,3376,EBAY,yearly
2019-12-31,976000000,,1749000000,,1786000000,3309000000,6500000000,1925000000,1925000000,262000000,-311000000,,,,233000000,8636000000,6711000000,2136000000,-176000000,270000000,1516000000,1786000000,3376,EBAY,yearly
2018-12-31,1051000000,,2249000000,,2530000000,3486000000,6627000000,1821000000,1821000000,247000000,-326000000,,,,121000000,8650000000,6829000000,2023000000,428000000,402000000,2128000000,2530000000,3376,EBAY,yearly
2017-12-31,1224000000,,2275000000,,-1017000000,3908000000,7706000000,2264000000,2264000000,272000000,-292000000,,,,3288000000,9927000000,7663000000,2221000000,11000000,-4000000,-1013000000,-1017000000,3376,EBAY,yearly
2020-09-25,613000000,,524000000,112000000,-241000000,1377000000,3735000000,1745000000,1745000000,,-48000000,,,,783000000,12172000000,10427000000,8437000000,-1221000000,18000000,-259000000,-241000000,3389,TEL,yearly
2019-09-27,644000000,,1931000000,112000000,1844000000,1489000000,4394000000,2261000000,2261000000,,-68000000,,,,-15000000,13448000000,11187000000,9054000000,-330000000,-102000000,1946000000,1844000000,3389,TEL,yearly
2018-09-28,680000000,,2240000000,112000000,2565000000,1591000000,4745000000,2486000000,2486000000,-12000000.0,-107000000,,,,-344000000,13988000000,11502000000,9243000000,-246000000,-19000000,2584000000,2565000000,3389,TEL,yearly
2017-09-29,611000000,,1720000000,112000000,1683000000,1577000000,4183000000,1994000000,1994000000,1000000.0,-130000000,,,,180000000,12185000000,10191000000,8002000000,-274000000,143000000,1540000000,1683000000,3389,TEL,yearly
2020-12-31,760700000,,916700000,,823400000,1228800000,3305700000,1316200000,1316200000,,-15800000,,,,93300000,4386300000,3070100000,1080600000,-399500000,,823400000,823400000,3413,EW,yearly
2019-12-31,752700000,,1166500000,,1046900000,1240400000,3233600000,1240500000,1240500000,,-20700000,,,,119600000,4348000000,3107500000,1114400000,-74000000,,1046900000,1046900000,3413,EW,yearly
2018-12-31,622200000,,761400000,,722200000,1088400000,2783400000,1072800000,1072800000,,-29900000,,,,39200000,3722800000,2650000000,939400000,-311400000,,722200000,722200000,3413,EW,yearly
2017-12-31,552600000,,1034900000,,583600000,984300000,2560000000,1022400000,1022400000,700000.0,-23200000,,,,451300000,3435300000,2412900000,875300000,12500000,,583600000,583600000,3413,EW,yearly
2020-12-31,,,320900000,500000,247600000,423300000,895600000,407100000,407100000,,-82700000,,,,73200000,4280200000,3873100000,3384600000,-86200000,,247700000,247600000,3428,LEG,yearly
2019-12-31,,,430100000,500000,333800000,471500000,1050100000,515300000,515300000,,-90700000,,,,96200000,4752500000,4237200000,3702400000,-85200000,,333900000,333800000,3428,LEG,yearly
2018-12-31,,,384400000,600000,305900000,423800000,893300000,449000000,449000000,,-60900000,,,,78300000,4269500000,3820500000,3376200000,-64600000,,306100000,305900000,3428,LEG,yearly
2017-12-31,,,432000000,600000,292600000,417900000,882900000,444300000,444300000,,-43500000,,,,138400000,3943800000,3499500000,3060900000,-12300000,-900000.0,293600000,292600000,3428,LEG,yearly
2020-12-31,,,-7453000000,1038000000,-5543000000,24557000000,43983000000,-3319000000,-3319000000,4492000000,-697000000,,,,-1892000000,94471000000,97790000000,50488000000,-4134000000,,-5561000000,-5543000000,3433,CVX,yearly
2019-12-31,,,5536000000,995000000,2924000000,25945000000,59752000000,10478000000,10478000000,4138000000,-798000000,,,,2691000000,139865000000,129387000000,80113000000,-4942000000,,2845000000,2924000000,3433,CVX,yearly
2018-12-31,,,20575000000,1088000000,14824000000,24942000000,64324000000,14624000000,14624000000,4864000000,-748000000,,,,5715000000,158902000000,144278000000,94578000000,5951000000,,14860000000,14824000000,3433,CVX,yearly
2017-12-31,,,9221000000,1195000000,9195000000,23885000000,58909000000,3499000000,3499000000,12333000000,-307000000,,,,-48000000,127485000000,123986000000,68576000000,5722000000,,9269000000,9195000000,3433,CVX,yearly
2020-12-31,,,7760000000,126000000,6411000000,6559000000,15301000000,8162000000,8162000000,,-380000000,,,,1349000000,15301000000,7139000000,0,-402000000,,6411000000,6411000000,3440,MA,yearly
2019-12-31,,,9731000000,98000000,8118000000,6694000000,16883000000,9667000000,9667000000,,-224000000,,,,1613000000,16883000000,7216000000,0,64000000,,8118000000,8118000000,3440,MA,yearly
2018-12-31,,,7204000000,94000000,5859000000,6073000000,14950000000,8418000000,8418000000,,-186000000,,,,1345000000,14950000000,6532000000,0,-1214000000,,5859000000,5859000000,3440,MA,yearly
2017-12-31,,,6522000000,100000000,3915000000,5252000000,12497000000,6809000000,6809000000,,-154000000,,,,2607000000,12497000000,5688000000,0,-287000000,,3915000000,3915000000,3440,MA,yearly
2020-12-31,,,666025000,,506035000,314565000,1621690000,725419000,725419000,54331000,-47580000,,,,159990000,9636573000,8911154000,8014883000,-59394000,,506035000,506035000,3449,JBHT,yearly
2019-12-31,,,680895000,,516320000,325784000,1637490000,757225000,757225000,55336000,-54684000,,,,164575000,9165258000,8408033000,7527768000,-76330000,,516320000,516320000,3449,JBHT,yearly
2018-12-31,,,640818000,,489585000,292676000,1460670000,681021000,681021000,51080000,-40427000,,,,151233000,8614874000,7933853000,7154204000,-40203000,,489585000,489585000,3449,JBHT,yearly
2017-12-31,,,595239000,,686263000,249457000,1301589000,623789000,623789000,44825000,-28785000,,,,-91024000,7189568000,6565779000,5887979000,-28550000,,686263000,686263000,3449,JBHT,yearly
2020-12-31,,,6524000000,,4932000000,2442000000,8266000000,5718000000,5718000000,,-205000000,,,,1238000000,16205000000,10487000000,7939000000,806000000,,5286000000,4932000000,3475,BLK,yearly
2019-12-31,,,5787000000,1382000000.0,4476000000,1705000000,7406000000,5604000000,5604000000,,-203000000,,,,1261000000,14539000000,8935000000,7133000000,183000000,,4526000000,4476000000,3475,BLK,yearly
2018-12-31,,,5378000000,1166000000.0,4305000000,1573000000,7205000000,5582000000,5582000000,,-184000000,,,,1076000000,14198000000,8616000000,6993000000,-204000000,,4302000000,4305000000,3475,BLK,yearly
2017-12-31,,,5259000000,466000000.0,4952000000,1438000000,6789000000,5262000000,5262000000,,-205000000,,,,270000000,13600000000,8338000000,6811000000,-3000000,,4989000000,4952000000,3475,BLK,yearly
2020-12-31,,,1728000000,1919000000,1219000000,2722000000,6859000000,2778000000,2778000000,,-691000000,,,,373000000,10671000000,7893000000,3812000000,-1050000000,,1355000000,1091000000,3488,DISCA,yearly
2019-12-31,,,2294000000,2075000000,2069000000,2817000000,7392000000,3228000000,3228000000,,-720000000,,,,81000000,11144000000,7916000000,3752000000,-934000000,,2213000000,1845000000,3488,DISCA,yearly
2018-12-31,,,1022000000,2131000000,594000000,2620000000,6643000000,2625000000,2625000000,,-743000000,,,,341000000,10553000000,7928000000,3910000000,-1603000000,,681000000,529000000,3488,DISCA,yearly
2017-12-31,,,-137000000,413000000,-337000000,1689000000,4249000000,2230000000,2230000000,7000000.0,-458000000,,,,176000000,6873000000,4643000000,2624000000,-2367000000,,-313000000,-296000000,3488,DISCA,yearly
2020-12-31,,,4162000000,,3533000000,3078000000,7110000000,3659000000,3659000000,83000000,-516000000,,,,629000000,36052000000,32393000000,28942000000,503000000,,3533000000,3533000000,3490,CB,yearly
2019-12-31,,,5249000000,,4454000000,3139000000,8716000000,5207000000,5207000000,65000000,-552000000,,,,795000000,34230000000,29023000000,25514000000,42000000,,4454000000,4454000000,3490,CB,yearly
2018-12-31,,,4657000000,,3962000000,3000000000,8224000000,4843000000,4843000000,42000000,-641000000,,,,695000000,32679000000,27836000000,24455000000,-186000000,,3962000000,3962000000,3490,CB,yearly
2017-12-31,,,3722000000,,3861000000,2949000000,7545000000,4271000000,4271000000,65000000,-607000000,,,,-139000000,32340000000,28069000000,24795000000,-549000000,,3861000000,3861000000,3490,CB,yearly
2021-01-02,,,651015000,,493021000,3657523000,4484775000,799915000,799915000,,-46886000,,,,157994000,10106321000,9306406000,5621546000,-148900000,,493021000,493021000,3553,AAP,yearly
2019-12-28,,,637746000,,486896000,3476108000,4271101000,767493000,767493000,,-39898000,,,,150850000,9709003000,8941510000,5437902000,-129747000,,486896000,486896000,3553,AAP,yearly
2018-12-29,,,555264000,,423847000,3601738000,4219413000,617675000,617675000,,-56588000,,,,131417000,9580554000,8962879000,5361141000,-62411000,,423847000,423847000,3553,AAP,yearly
2017-12-30,,,520259000,,475505000,3501537000,4085049000,583512000,583512000,,-58801000,,,,44754000,9373784000,8790272000,5288735000,-63253000,,475505000,475505000,3553,AAP,yearly
2020-12-31,,,379368000,13207000,-29102000,4356665000,5654841000,1001757000,1001757000,,-93713000,,,,215973000,16537433000,15535676000,10882592000,-622389000,-192497000,163395000,-29102000,3561,GPC,yearly
2019-12-31,,,859283000,20793000,621085000,4520593000,5859683000,1067951000,1067951000,,-95583000,,,,212808000,17522234000,16454283000,11662551000,-208668000,-25390000,646475000,621085000,3561,GPC,yearly
2018-12-31,,,994638000,21540000,810474000,4215018000,5519755000,1061224000,1061224000,,-101796000,,,,245104000,16831605000,15770381000,11311850000,-66586000,60940000,749534000,810474000,3561,GPC,yearly
2017-12-31,,,1009268000,52004000,616757000,3705136000,4906398000,1019639000,1019639000,,-41486000,,,,392511000,16308801000,15289162000,11402403000,-10371000,60940000,616757000,616757000,3561,GPC,yearly
2020-12-31,,,1627600000,,1209300000,4008200000,5975800000,0,1680100000,287500000,,,,,418300000,5975800000,4295700000,0,-52500000,,1209300000,1141000000,3584,NTRS,yearly
2019-12-31,,,1944100000,,1492200000,3917900000,6087600000,0,1944100000,225600000,,,,,451900000,6087600000,4143500000,0,0,,1492200000,1428900000,3584,NTRS,yearly
2018-12-31,,,1957800000,,1556400000,3784600000,5974700000,0,1957800000,232300000,,,,,401400000,5974700000,4016900000,0,0,,1556400000,1489900000,3584,NTRS,yearly
2017-12-31,,,1633900000,,1199000000,3533200000,5403300000,0,1633900000,236200000,,,,,434900000,5403300000,3769400000,0,0,,1199000000,1130400000,3584,NTRS,yearly
2020-12-31,,,-1818000000,,-1307000000,101000000,-784000000,-1712000000,-1712000000,407000000,-87000000,,,,-511000000,3566000000,5278000000,4350000000,-106000000,,-1307000000,-1307000000,3596,ALK,yearly
2019-12-31,,,1016000000,,769000000,313000000,2491000000,1071000000,1071000000,684000000,-63000000,,,,247000000,8781000000,7710000000,6290000000,-55000000,,769000000,769000000,3596,ALK,yearly
2018-12-31,,,585000000,,437000000,326000000,2202000000,793000000,793000000,685000000,-73000000,,,,148000000,8264000000,7471000000,6062000000,-208000000,,437000000,437000000,3596,ALK,yearly
2017-12-31,,,1159000000,,960000000,368000000,2626000000,1324000000,1324000000,562000000,-86000000,,,,199000000,7894000000,6570000000,5268000000,-165000000,,960000000,960000000,3596,ALK,yearly
2020-11-30,,,3123788000,104545000,2465036000,2055513000,5171203000,3098710000,3098710000,16980000,-22401000,,,,656235000,22488854000,19390144000,17317651000,25078000,,2467553000,2436647000,3614,LEN,yearly
2019-11-30,,,2434292000,84313000,1849052000,2056299000,4517480000,2438519000,2438519000,22662000,-17620000,,,,592173000,22259561000,19821042000,17742081000,-4227000,,1842119000,1832910000,3614,LEN,yearly
2018-11-30,,,2262684000,101422000,1695831000,343934000,2334185000,2178381000,2178381000,-188130000,-11258000,,,,545171000,20571631000,18393250000,18237446000,84303000,,1717513000,1680964000,3614,LEN,yearly
2017-11-30,,,1189611000,113815000,810480000,285889000,1624884000,1350871000,1350871000,-11876000,-7164000,,,,417857000,12646365000,11295494000,11021481000,-161260000,,771754000,802656000,3614,LEN,yearly
2020-12-31,,,-15202000000,,-9940000000,2404000000,3199000000,795000000,795000000,,-264000000,,,,559000000,20705000000,19910000000,17506000000,-15997000000,,-15761000000,-9940000000,3642,BKR,yearly
2019-12-31,,,753000000,12570000000.0,128000000,2821000000,4432000000,1611000000,1611000000,,-237000000,,,,482000000,23838000000,22227000000,19406000000,-858000000,,271000000,128000000,3642,BKR,yearly
2018-12-31,,,541000000,17548000000.0,195000000,2654000000,3986000000,1321000000,1321000000,11000000.0,-223000000,,,,258000000,22877000000,21556000000,18891000000,-780000000,,283000000,195000000,3642,BKR,yearly
2017-12-31,,,-388000000,24133000000.0,-103000000,2475000000,3123000000,633000000,633000000,15000000.0,-131000000,,,,45000000,17179000000,16546000000,14056000000,-1021000000,,-433000000,-103000000,3642,BKR,yearly
2020-12-31,,,515300000,3400000,441800000,,1021700000,784400000,784400000,177300000,-104500000,,,,72600000,10088900000,9304500000,9067200000,-269100000,,442700000,423100000,3673,AIZ,yearly
2019-12-31,,,554500000,29300000,382600000,,989600000,740300000,740300000,194000000,-110600000,,,,167700000,9923800000,9183500000,8934200000,-185800000,,386800000,363900000,3673,AIZ,yearly
2018-12-31,,,333500000,21900000,251000000,,824600000,515000000,515000000,270600000,-100300000,,,,80900000,8057600000,7542600000,7233000000,-181500000,,252600000,236800000,3673,AIZ,yearly
2017-12-31,,,444500000,10900000,519600000,,707500000,494000000,494000000,213500000,-49500000,,,,-75100000,6415000000,5921000000,5707500000,-49500000,,519600000,519600000,3673,AIZ,yearly
2020-12-31,,,354720000,,260824000,656207000,1112628000,368092000,368092000,,-5082000,,,,93896000,2161220000,1793128000,1048592000,-13372000,,260824000,260824000,3681,ROL,yearly
2019-12-31,,,261160000,,203347000,623379000,1021884000,317394000,317394000,,-6917000,,,,57813000,2015477000,1698083000,993593000,-56234000,,203347000,203347000,3681,ROL,yearly
2018-12-31,,,310733000,,231663000,550698000,927128000,309638000,309638000,,-6917000,,,,79070000,1821565000,1511927000,894437000,1095000,,231663000,231663000,3681,ROL,yearly
2017-12-31,,,294502000,,179124000,503433000,854014000,294001000,294001000,,-6917000,,,,115378000,1673957000,1379956000,819943000,501000,,179124000,179124000,3681,ROL,yearly
2020-06-30,109988000,,381076000,,296668000,197988000,688603000,380627000,380627000,,-688000,,,,84408000,1697067000,1316440000,1008464000,449000,,296668000,296668000,3684,JKHY,yearly
2019-06-30,96378000,,347235000,,271885000,185939000,629661000,347344000,347344000,,-926000,,,,75350000,1552691000,1205347000,923030000,-109000,,271885000,271885000,3684,JKHY,yearly
2018-06-30,90340000,,356158000,,365034000,171710000,617659000,355609000,355609000,,-1920000,,,,-8876000,1470797000,1115188000,853138000,549000,,365034000,365034000,3684,JKHY,yearly
2017-06-30,84753000,,340969000,,229561000,159235000,582435000,338447000,338447000,,-996000,,,,111408000,1388290000,1049843000,805855000,2522000,,229561000,229561000,3684,JKHY,yearly
2020-12-31,463000000,,1996000000,4000000,1638000000,1713000000,4637000000,2301000000,2301000000,,-231000000,,,,360000000,6675000000,4374000000,2038000000,-305000000,,1636000000,1638000000,3687,ZTS,yearly
2019-12-31,457000000,,1801000000,4000000,1500000000,1636000000,4345000000,2097000000,2097000000,,-223000000,,,,301000000,6260000000,4163000000,1915000000,-296000000,,1500000000,1500000000,3687,ZTS,yearly
2018-12-31,432000000,,1690000000,4000000,1428000000,1482000000,3922000000,1891000000,1891000000,,-206000000,,,,266000000,5825000000,3934000000,1903000000,-201000000,,1424000000,1428000000,3687,ZTS,yearly
2017-12-31,382000000,,1525000000,16000000,864000000,1325000000,3546000000,1748000000,1748000000,,-175000000,,,,663000000,5307000000,3559000000,1761000000,-223000000,,862000000,864000000,3687,ZTS,yearly
2020-12-31,,,344651000,333514000,439149000,130158000,1836296000,596375000,596375000,,-469541000,,,,-96534000,3800292000,3203917000,1963996000,-251724000,,441185000,439149000,3705,VTR,yearly
2019-12-31,,,382987000,373238000,433016000,158726000,2048785000,844439000,844439000,,-451662000,,,,-56310000,3859312000,3014873000,1810527000,-461452000,,439297000,433016000,3705,VTR,yearly
2018-12-31,,,376038000,243878000,409467000,145978000,2010286000,944669000,944669000,,-442497000,,,,-39953000,3701584000,2756915000,1691298000,-568631000,-10000.0,415991000,409467000,3705,VTR,yearly
2017-12-31,,,1301423000,224449000,1356470000,135490000,2081091000,1057653000,1057653000,,-448196000,,,,-59799000,3567554000,2509901000,1486463000,243770000,-110000.0,1361222000,1356470000,3705,VTR,yearly
2020-12-31,,,661000000,1130000000,119000000,648000000,6680000000,3492000000,3492000000,376000000,-1595000000,,,,481000000,11700000000,8208000000,5020000000,-2831000000,,180000000,106000000,3727,KMI,yearly
2019-12-31,,,3165000000,1147000000,2190000000,590000000,7355000000,3857000000,3857000000,423000000,-1801000000,,,,926000000,13209000000,9352000000,5854000000,-692000000,,2239000000,2178000000,3727,KMI,yearly
2018-12-31,,,2506000000,1519000000,1609000000,601000000,7201000000,3882000000,3882000000,342000000,-1917000000,,,,587000000,14144000000,10262000000,6943000000,-1376000000,,1919000000,1473000000,3727,KMI,yearly
2017-12-31,,,2161000000,1488000000,183000000,673000000,6891000000,3560000000,3560000000,397000000,-1832000000,,,,1938000000,13705000000,10145000000,6814000000,-1399000000,,223000000,22000000,3727,KMI,yearly
2020-12-31,1491000000,,1154000000,1454000000,721000000,3188000000,6630000000,1951000000,1951000000,,-784000000,,,,292000000,31536000000,29585000000,24906000000,-797000000,,862000000,690000000,3747,TSLA,yearly
2019-12-31,1343000000,,-665000000,1492000000,-862000000,2646000000,4069000000,80000000,80000000,,-725000000,,,,110000000,24578000000,24498000000,20509000000,-745000000,,-775000000,-870000000,3747,TSLA,yearly
2018-12-31,1460000000,,-1005000000,1390000000,-976000000,2835000000,4042000000,-253000000,-253000000,,-653000000,,,,58000000,21461000000,21714000000,17419000000,-752000000,,-1063000000,-976000000,3747,TSLA,yearly
2017-12-31,1378000000,,-2209000000,1395080000,-1962000000,2477000000,2223000000,-1632000000,-1632000000,,-477000000,,,,32000000,11759000000,13391000000,9536000000,-577000000,,-2241000000,-1962000000,3747,TSLA,yearly
2020-12-31,,,-4840000000,1602000000,-4860000000,290000000,2741000000,-50000000,-50000000,455000000,-427000000,,,,64000000,4499000000,4549000000,1758000000,-4790000000,,-4904000000,-4860000000,3795,APA,yearly
2019-12-31,,,-3008000000,1765000000,-3553000000,406000000,4630000000,-1243000000,-1243000000,349000000,-400000000,,,,674000000,6213000000,7456000000,1583000000,-1765000000,,-3682000000,-3553000000,3795,APA,yearly
2018-12-31,,,958000000,1682000000,40000000,431000000,5628000000,1611000000,1611000000,340000000,-406000000,,,,672000000,7216000000,5605000000,1588000000,-653000000,,286000000,40000000,3795,APA,yearly
2017-12-31,,,918000000,1375000000,1304000000,395000000,4363000000,715000000,715000000,424000000,-415000000,,,,-585000000,5792000000,5077000000,1429000000,203000000,,1503000000,1304000000,3795,APA,yearly
2020-02-29,,,-945200000,342500000,-11800000,1585800000,4285500000,2716600000,2716600000,-16900000,-428700000,,,,-966600000,8343500000,5626900000,4058000000,-3661800000,,21400000,-11800000,3803,STZ,yearly
2019-02-28,,,4145000000,286200000,3435900000,1482100000,4103400000,2623300000,2623300000,-2000000,-367100000,,,,685900000,8116000000,5492700000,4012600000,1521700000,,3459100000,3435900000,3803,STZ,yearly
2018-02-28,,,2338000000,16600000,2303400000,1370800000,3850300000,2490000000,2490000000,-10500000,-332000000,,,,22700000,7580300000,5090300000,3730000000,-152000000,,2315300000,2303400000,3803,STZ,yearly
2017-02-28,,,2083000000,-6400000,1528600000,1284800000,3539100000,2254300000,2254300000,-10500000,-333300000,,,,550300000,7321100000,5066800000,3782000000,-171300000,,1532700000,1528600000,3803,STZ,yearly
2020-12-31,,,-4964000000,2539000000,-3975000000,6107000000,6464000000,-1514000000,-1514000000,476000000,-499000000,,,,-1250000000,64171000000,65685000000,57707000000,-3450000000,,-3714000000,-3983000000,3817,PSX,yearly
2019-12-31,,,4178000000,2259000000,3076000000,6755000000,11807000000,3312000000,3312000000,399000000,-458000000,,,,801000000,107336000000,104024000000,95529000000,866000000,,3377000000,3070000000,3817,PSX,yearly
2018-12-31,,,7445000000,2500000000,5595000000,6557000000,13562000000,5186000000,5186000000,463000000,-504000000,,,,1572000000,111492000000,106306000000,97930000000,2259000000,,5873000000,5589000000,3817,PSX,yearly
2017-12-31,,,3555000000,2343000000,5106000000,6394000000,22945000000,1776000000,1776000000,13457000000,-438000000,,,,-1693000000,89300000000,87524000000,66355000000,1779000000,,5248000000,5100000000,3817,PSX,yearly
2020-12-31,4207000000,,8133000000,,7264000000,5730000000,19265000000,9328000000,9328000000,,-1038000000,,,,869000000,25424000000,16096000000,6159000000,-1195000000,,7264000000,7264000000,3871,AMGN,yearly
2019-12-31,4116000000,,9138000000,,7842000000,5150000000,19006000000,9721000000,9721000000,19000000.0,-1289000000,,,,1296000000,23362000000,13641000000,4356000000,-583000000,,7842000000,7842000000,3871,AMGN,yearly
2018-12-31,3737000000,,9545000000,,8394000000,5332000000,19646000000,10551000000,10551000000,26000000.0,-1392000000,,,,1151000000,23747000000,13196000000,4101000000,-1006000000,,8394000000,8394000000,3871,AMGN,yearly
2017-12-31,3562000000,,9597000000,,1979000000,4870000000,18780000000,10340000000,10340000000,8000000.0,-1303000000,,,,7618000000,22849000000,12509000000,4069000000,-743000000,,1979000000,1979000000,3871,AMGN,yearly
2020-12-31,,,1831000000,,1534000000,3120000000,5816000000,2696000000,2696000000,,-865000000,,,,297000000,11958000000,9262000000,6142000000,-865000000,,1534000000,1534000000,3875,AMP,yearly
2019-12-31,,,2232000000,,1893000000,3287000000,6318000000,3031000000,3031000000,,-1019000000,,,,339000000,12883000000,9852000000,6565000000,-799000000,,1893000000,1893000000,3875,AMP,yearly
2018-12-31,,,2484000000,,2098000000,3171000000,6663000000,3492000000,3492000000,,-1008000000,,,,386000000,12924000000,9432000000,6261000000,-1008000000,,2098000000,2098000000,3875,AMP,yearly
2017-12-31,,,2214000000,,1480000000,3158000000,6283000000,3125000000,3125000000,,-911000000,,,,734000000,12180000000,9055000000,5897000000,-911000000,,1480000000,1480000000,3875,AMP,yearly
2020-09-27,,,1164400000,5700000,928300000,1679600000,5141100000,1599900000,1599900000,430300000,-437000000,,,,239700000,23518000000,21918100000,18376900000,-435500000,,924700000,928300000,3909,SBUX,yearly
2019-09-29,,,4466200000,1200000,3599200000,1824100000,7488100000,3915700000,3915700000,371000000,-331000000,,,,871600000,26508600000,22592900000,19020500000,550500000,,3594600000,3599200000,3909,SBUX,yearly
2018-09-30,,,5780000000,6300000,4518300000,1704600000,7316600000,3810100000,3810100000,554900000,-170300000,,,,1262000000,24719500000,20909400000,17402900000,1969900000,,4518000000,4518300000,3909,SBUX,yearly
2017-10-01,,,4317500000,6900000,2884700000,1408400000,6834600000,3896800000,3896800000,518000000,-92500000,,,,1432600000,22386800000,18490000000,15552200000,420700000,,2884900000,2884700000,3909,SBUX,yearly
2020-12-31,126200000,,460300000,3900000,342000000,503700000,1188300000,558400000,558400000,,-10000000,,,,118300000,2704600000,2146200000,1516300000,-98100000,,342000000,342000000,3987,VNT,yearly
2019-12-31,136400000,,565800000,4900000,436500000,487100000,1192800000,569300000,569300000,,-10000000,,,,129300000,2772100000,2202800000,1579300000,-3500000,,436500000,436500000,3987,VNT,yearly
2018-12-31,136200000,,507300000,3100000,385500000,497200000,1135500000,502100000,502100000,,-10000000,,,,121800000,2665900000,2163800000,1530400000,5200000,,385500000,385500000,3987,VNT,yearly
2017-12-31,126200000,,523900000,3900000,373300000,440300000,1073100000,506600000,506600000,,-10000000,,,,150600000,2498200000,1991600000,1425100000,17300000,,373300000,373300000,3987,VNT,yearly
2020-12-31,,,-2010000000,841000000,-1421000000,724000000,1266000000,-1517000000,-1517000000,-262000000,-563000000,,,,-903000000,60115000000,61632000000,58849000000,-493000000,,-1107000000,-1426000000,3991,VLO,yearly
2019-12-31,,,3486000000,733000000,2422000000,819000000,6531000000,3885000000,3885000000,-428000000,-454000000,,,,702000000,102729000000,98844000000,96198000000,-399000000,,2784000000,2415000000,3991,VLO,yearly
2018-12-31,,,4232000000,1064000000,3122000000,904000000,7611000000,4593000000,4593000000,45000000,-470000000,,,,879000000,111407000000,106814000000,103796000000,-361000000,,3353000000,3113000000,3991,VLO,yearly
2017-12-31,,,3207000000,909000000,4065000000,793000000,6439000000,3599000000,3599000000,61000000,-468000000,,,,-949000000,88407000000,84808000000,81968000000,-453000000,,4156000000,4051000000,3991,VLO,yearly
2020-12-31,,,423000000,,499000000,2565000000,3812000000,795000000,795000000,415000000,-284000000,,,,-76000000,17439000000,16644000000,13627000000,-372000000,,499000000,499000000,3996,LNC,yearly
2019-12-31,,,919000000,,886000000,2691000000,4589000000,1441000000,1441000000,431000000,-326000000,,,,33000000,17258000000,15817000000,12669000000,-522000000,,886000000,886000000,3996,LNC,yearly
2018-12-31,,,1885000000,,1641000000,2418000000,5167000000,2343000000,2343000000,397000000,-297000000,,,,244000000,16424000000,14081000000,11257000000,-458000000,,1641000000,1641000000,3996,LNC,yearly
2017-12-31,,,1130000000,,2079000000,2204000000,4871000000,2331000000,2331000000,332000000,-253000000,,,,-949000000,14257000000,11926000000,9386000000,-1201000000,,2079000000,2079000000,3996,LNC,yearly
2020-11-27,2188000000,,4176000000,,5260000000,4559000000,11146000000,4237000000,4237000000,,-116000000,,,,-1084000000,12868000000,8631000000,1722000000,-61000000,,5260000000,5260000000,4005,ADBE,yearly
2019-11-29,1930000000,,3205000000,,2951000000,4125000000,9498000000,3268000000,3268000000,,-157000000,,,,254000000,11171000000,7903000000,1673000000,-63000000,,2951000000,2951000000,4005,ADBE,yearly
2018-11-30,1538000000,,2794000000,,2591000000,3366000000,7835000000,2840000000,2840000000,,-89000000,,,,203000000,9030000000,6190000000,1195000000,-46000000,,2591000000,2591000000,4005,ADBE,yearly
2017-12-01,1224059000,,2137641000,,1693954000,2822298000,6291014000,2168095000,2168095000,,-74402000,,,,443687000,7301505000,5133410000,1010491000,-30454000,,1693954000,1693954000,4005,ADBE,yearly
2020-12-31,1010000000,,-3151000000,1494000000,-2612000000,3143000000,3519000000,-1527000000,-1527000000,,-360000000,,,,-423000000,5199000000,6726000000,1680000000,-1624000000,,-2728000000,-2687000000,4012,EXPE,yearly
2019-12-31,1226000000,,775000000,1569000000,565000000,6893000000,9990000000,961000000,961000000,,-173000000,,,,203000000,12067000000,11106000000,2077000000,-186000000,,572000000,565000000,4012,EXPE,yearly
2018-12-31,1122000000,,485000000,1577000000,406000000,6495000000,9359000000,783000000,783000000,-59000000.0,-190000000,,,,87000000,11223000000,10440000000,1864000000,-298000000,,398000000,406000000,4012,EXPE,yearly
2017-12-31,1387000000,,417000000,1628000000,378000000,6015000000,8303000000,626000000,626000000,-59000000.0,-182000000,,,,45000000,10060000000,9434000000,1757000000,-209000000,,372000000,378000000,4012,EXPE,yearly
2020-06-30,201946000,,733088000,,621674000,676689000,1767389000,809059000,809059000,,-40377000,,,,111414000,2957013000,2147954000,1189624000,-75971000,,621674000,621674000,4028,RMD,yearly
2019-06-30,180651000,,518847000,,404592000,645010000,1536585000,635986000,635986000,,-36156000,,,,114255000,2606572000,1970586000,1069987000,-117139000,,404592000,404592000,4028,RMD,yearly
2018-06-30,155149000,,521312000,,315588000,600369000,1362164000,560263000,560263000,,-28355000,,,,205724000,2340196000,1779933000,978032000,-38951000,,315588000,315588000,4028,RMD,yearly
2017-06-30,144467000,,418743000,,342284000,553968000,1201745000,456732000,456732000,,-28236000,,,,76459000,2066737000,1610005000,864992000,-37989000,,342284000,342284000,4028,RMD,yearly
2020-12-31,,,6238000000,,4572000000,25202000000,33823000000,8260000000,8260000000,,-785000000,,,,1666000000,121868000000,113608000000,88045000000,-2022000000,,4572000000,4572000000,4031,ANTM,yearly
2019-12-31,,,5985000000,,4807000000,15356000000,22426000000,6732000000,6732000000,,-745000000,,,,1178000000,104212000000,97480000000,81786000000,-747000000,,4807000000,4807000000,4031,ANTM,yearly
2018-12-31,,,5068000000,,3750000000,14020000000,20196000000,5818000000,5818000000,,-739000000,,,,1318000000,92091000000,86273000000,71895000000,-750000000,,3750000000,3750000000,4031,ANTM,yearly
2017-12-31,,,3964000000,,3843000000,12650000000,17813000000,4994000000,4994000000,,-748000000,,,,121000000,90049000000,85055000000,72236000000,-1030000000,,3843000000,3843000000,4031,ANTM,yearly
2020-11-30,,,-10253000000,,-10236000000,1885000000,834000000,-4917000000,-4917000000,1625000000,-895000000,,,,-17000000,5594000000,10511000000,4760000000,-5336000000,,-10236000000,-10236000000,4039,CCL,yearly
2019-11-30,,,3061000000,,2990000000,2486000000,11110000000,3297000000,3297000000,3167000000,-206000000,,,,71000000,20825000000,17528000000,9715000000,-236000000,,2990000000,2990000000,4039,CCL,yearly
2018-11-30,,,3206000000,,3152000000,2459000000,10777000000,3389000000,3389000000,2912000000,-194000000,,,,54000000,18880000000,15491000000,8103000000,-183000000,,3152000000,3152000000,4039,CCL,yearly
2017-11-30,,,2666000000,,2606000000,2265000000,7313000000,3237000000,3237000000,-35000000,-198000000,,,,60000000,17510000000,14273000000,10197000000,-571000000,,2606000000,2606000000,4039,CCL,yearly
2020-12-31,,,2120000000,,1737000000,4417000000,6983000000,2463000000,2463000000,31000000,-207000000,,,,383000000,20494000000,18031000000,13511000000,-343000000,,1737000000,1716000000,4042,HIG,yearly
2019-12-31,,,2560000000,,2085000000,4472000000,7642000000,3013000000,3013000000,91000000,-255000000,,,,475000000,20736000000,17723000000,13094000000,-453000000,,2085000000,2064000000,4042,HIG,yearly
2018-12-31,,,1753000000,,1807000000,4234000000,6376000000,2074000000,2074000000,91000000,-268000000,,,,268000000,18925000000,16851000000,12549000000,-321000000,322000000.0,1485000000,1801000000,4042,HIG,yearly
2017-12-31,,,723000000,,-3131000000,4546000000,5579000000,1019000000,1019000000,91000000,-279000000,,,,985000000,17125000000,16106000000,11546000000,-296000000,-2869000000.0,-262000000,-3131000000,4042,HIG,yearly
2020-12-31,142101000,,841734000,,683451000,1366960000,2492914000,983853000,983853000,,-111937000,,,,158283000,6683760000,5699907000,4190846000,-142119000,,683451000,683451000,4106,DOV,yearly
2019-12-31,140957000,,843009000,,677918000,1431176000,2629848000,1057715000,1057715000,,-125818000,,,,165091000,7136397000,6078682000,4506549000,-214706000,,677918000,677918000,4106,DOV,yearly
2018-12-31,143033000,,725378000,,570267000,1531829000,2576477000,901615000,901615000,,-130972000,,,,134233000,6992118000,6090503000,4415641000,-176237000,-20878000.0,591145000,570267000,4106,DOV,yearly
2017-12-31,143033000,,875815000,,811665000,1682590000,2545705000,863115000,863115000,,-144948000,,,,129152000,6820886000,5957771000,4275181000,12700000,65002000.0,746663000,811665000,4106,DOV,yearly
2020-12-31,,,7173200000,,5704600000,,8673100000,7390200000,7390200000,205500000,-217000000,,,,1468600000,42638100000,35247900000,33965000000,-217000000,,5704600000,5677700000,4124,PGR,yearly
2019-12-31,,,5160300000,225600000.0,3970300000,,5528900000,5350000000,5350000000,178900000,-189700000,,,,1180300000,38997700000,33647700000,33468800000,-189700000,,3980000000,3943400000,4124,PGR,yearly
2018-12-31,,,3163600000,214500000.0,2615300000,,3464200000,3330100000,3330100000,134100000,-166500000,,,,542600000,31954700000,28624600000,28490500000,-166500000,,2621000000,2593900000,4124,PGR,yearly
2017-12-31,,,2138900000,503700000.0,1592200000,,2402500000,2293000000,2293000000,109500000,-153100000,,,,540800000,26816100000,24523100000,24413600000,-154100000,,1598100000,1592200000,4124,PGR,yearly
2020-12-31,,,2722100000,31600000,2105200000,1491200000,4883600000,2637400000,2637400000,290600000,-166200000,,,,615700000,4883600000,2246200000,0,84700000,,2106400000,2105200000,4129,CME,yearly
2019-12-31,,,2689600000,30400000,2116500000,1525000000,4857800000,2656100000,2656100000,203400000,-178000000,,,,573800000,4857800000,2201700000,0,33500000,,2115800000,2116500000,4129,CME,yearly
2018-12-31,,,2777800000,46800000,1962200000,1126100000,4309400000,2681200000,2681200000,253400000,-157700000,,,,814100000,4309400000,1628200000,0,34300000,,1963700000,1962200000,4129,CME,yearly
2017-12-31,,,2526300000,46800000,4063400000,929400000,3644700000,2301200000,2301200000,205600000,-117000000,,,,-1537100000,3644700000,1343500000,0,225100000,,4063400000,4063400000,4129,CME,yearly
2020-12-31,,,1747088000,4353033000,1481814000,274845000,3566001000,1699177000,1699177000,30010000,-314507000,,,,130458000,4736105000,3036928000,1170104000,47911000,,1616630000,1473122000,4156,PLD,yearly
2019-12-31,,,1776363000,3418657000,1572959000,266718000,2611872000,1192126000,1192126000,13149000,-239953000,,,,74517000,3530799000,2338673000,918927000,584237000,,1701846000,1566950000,4156,PLD,yearly
2018-12-31,,,1886290000,3502795000,1649361000,238985000,2345021000,1145262000,1145262000,13560000,-229141000,,,,63330000,3102709000,1957447000,757688000,741028000,,1822960000,1643426000,4156,PLD,yearly
2017-12-31,,,1815568000,3074583000,1652325000,231059000,2142037000,1019633000,1019633000,12205000,-274486000,,,,54609000,2866701000,1847068000,724664000,795935000,,1760959000,1641931000,4156,PLD,yearly
2020-12-31,,,3481000000,,3119000000,,9897000000,4820000000,4820000000,1559000000,-1836000000,,,,393000000,20375000000,15555000000,10478000000,-1339000000,,3088000000,3119000000,4188,SO,yearly
2019-12-31,,,6527000000,4545000000.0,4739000000,-267000000.0,9627000000,5602000000,5602000000,1254000000,-1751000000,,,,1798000000,21419000000,15817000000,11792000000,925000000,,4729000000,4739000000,4188,SO,yearly
2018-12-31,,,2733000000,4607000000.0,2226000000,-235000000.0,9664000000,4356000000,4356000000,2412000000,-1858000000,,,,449000000,23495000000,19139000000,13831000000,-1623000000,,2284000000,2226000000,4188,SO,yearly
2017-12-31,,,1030000000,1685000000.0,842000000,-235000000.0,9915000000,2528000000,2528000000,4612000000,-1732000000,,,,142000000,23031000000,20503000000,13116000000,-1498000000,,888000000,842000000,4188,SO,yearly
2021-01-02,44710000,,-183122000,,-75579000,1687276000,2557215000,791308000,791308000,,-174128000,,,,-107543000,6664350000,5873042000,4107135000,-974430000,,-75579000,-75579000,4198,HBI,yearly
2019-12-28,51520000,,679727000,,600720000,1783251000,2777597000,934168000,934168000,,-182192000,,,,79007000,6966923000,6032755000,4189326000,-254441000,,600720000,600720000,4198,HBI,yearly
2018-12-29,59313000,,643581000,,539666000,1692018000,2691574000,924430000,924430000,,-194675000,,,,103915000,6803955000,5879525000,4112381000,-280849000,,539666000,539666000,4198,HBI,yearly
2017-12-30,65457000,,529095000,,73881000,1564419000,2544421000,907903000,907903000,,-174435000,,,,453117000,6471410000,5563507000,3926989000,-378808000,-2097000.0,75978000,73881000,4198,HBI,yearly
2020-12-31,,,681000000,62000000,585000000,525000000,2458000000,1265000000,1265000000,,-275000000,,,,99000000,11781000000,10516000000,9323000000,-584000000,,582000000,585000000,4206,BLL,yearly
2019-12-31,,,607000000,70000000,566000000,417000000,2271000000,1176000000,1176000000,,-317000000,,,,71000000,11474000000,10298000000,9203000000,-569000000,,536000000,566000000,4206,BLL,yearly
2018-12-31,,,638000000,104000000,454000000,478000000,2306000000,1126000000,1126000000,,-301000000,,,,185000000,11635000000,10509000000,9329000000,-488000000,,453000000,454000000,4206,BLL,yearly
2017-12-31,,,545000000,105000000,374000000,514000000,2266000000,1058000000,1058000000,,-285000000,,,,165000000,10983000000,9925000000,8717000000,-513000000,,380000000,374000000,4206,BLL,yearly
2020-12-31,,,-1465000000,,-1451000000,258000000,1971000000,-868000000,-868000000,84000000,-291000000,,,,-14000000,3122000000,3990000000,1151000000,-597000000,,-1451000000,-1451000000,4208,MRO,yearly
2019-12-31,,,392000000,,480000000,353000000,3808000000,526000000,526000000,383000000,-280000000,,,,-88000000,5125000000,4599000000,1317000000,-134000000,,480000000,480000000,4208,MRO,yearly
2018-12-31,,,1427000000,,1096000000,408000000,4635000000,1184000000,1184000000,313000000,-280000000,,,,331000000,6052000000,4868000000,1417000000,243000000,,1096000000,1096000000,4208,MRO,yearly
2017-12-31,,,-454000000,,-5723000000,390000000,3172000000,-447000000,-447000000,219000000,-324000000,,,,376000000,4487000000,4934000000,1315000000,-7000000,-4893000000.0,-830000000,-5723000000,4208,MRO,yearly
2020-12-31,,,2530000000,,2013000000,,4632000000,3478000000,3478000000,,-625000000,,,,517000000,9789000000,6311000000,5157000000,-948000000,,2013000000,2010000000,4234,NSC,yearly
2019-12-31,,,3491000000,,2722000000,,5159000000,4052000000,4052000000,-31000000.0,-604000000,,,,769000000,11296000000,7244000000,6137000000,-561000000,,2722000000,2717000000,4234,NSC,yearly
2018-12-31,,,3469000000,,2666000000,,5122000000,4020000000,4020000000,-31000000.0,-557000000,,,,803000000,11458000000,7438000000,6336000000,-551000000,,2666000000,2660000000,4234,NSC,yearly
2017-12-31,,,3128000000,,5404000000,,4641000000,3586000000,3586000000,-31000000.0,-550000000,,,,-2276000000,10551000000,6965000000,5910000000,-458000000,,5404000000,5400000000,4234,NSC,yearly
2020-12-31,2582000000,,-2353000000,1721000000,-3519000000,4592000000,8531000000,2242000000,2242000000,-885000000,-1366000000,,,,575000000,56587000000,54345000000,48056000000,-4595000000,-410000000,-2928000000,-3519000000,4246,RTX,yearly
2019-12-31,3015000000,,8243000000,2552000000,5537000000,7399000000,20212000000,10273000000,10273000000,-475000000,-1773000000,,,,2295000000,77046000000,66773000000,56834000000,-2030000000,-410000000,5948000000,5537000000,4246,RTX,yearly
2018-12-31,2462000000,,8280000000,2273000000,5269000000,6189000000,16516000000,8516000000,8516000000,-651000000,-1225000000,,,,2626000000,66501000000,57985000000,49985000000,-236000000,-410000000,5654000000,5269000000,4246,RTX,yearly
2017-12-31,2427000000,,7763000000,1942000000,4552000000,5856000000,15636000000,8145000000,8145000000,-792000000,-1017000000,,,,2843000000,59837000000,51692000000,44201000000,-382000000,-410000000,4920000000,4552000000,4246,RTX,yearly
2020-02-01,,,1981000000,-29000000,1659000000,22577000000,27846000000,2620000000,2620000000,,-603000000,,,,469000000,122286000000,119666000000,94440000000,-639000000,,1512000000,1640000000,4272,KR,yearly
2019-02-02,,,3978000000,-51000000,3110000000,22359000000,27501000000,2677000000,2677000000,,-620000000,,,,900000000,121852000000,119175000000,94351000000,1301000000,,3078000000,3076000000,4272,KR,yearly
2018-02-03,,,1484000000,-26000000,1907000000,23290000000,28176000000,2450000000,2450000000,,-601000000,,,,-405000000,123280000000,120830000000,95104000000,-966000000,,1889000000,1890000000,4272,KR,yearly
2017-01-28,,,2914000000,12000000,1975000000,20750000000,26552000000,3462000000,3462000000,,-522000000,,,,957000000,115337000000,111875000000,88785000000,-548000000,,1957000000,1959000000,4272,KR,yearly
2020-12-31,,,260000000,187000000,158000000,2658000000,4204000000,1546000000,1546000000,,-339000000,,,,96000000,12552000000,11006000000,8348000000,-1286000000,,164000000,158000000,4279,FIS,yearly
2019-12-31,,,403000000,16000000,298000000,1963000000,3723000000,1760000000,1760000000,,-389000000,,,,100000000,10333000000,8573000000,6610000000,-1357000000,,303000000,298000000,4279,FIS,yearly
2018-12-31,,,1089000000,7000000,846000000,1301000000,2854000000,1553000000,1553000000,,-314000000,,,,208000000,8423000000,6870000000,5569000000,-464000000,,881000000,846000000,4279,FIS,yearly
2017-12-31,,,973000000,109000000,1261000000,1442000000,2874000000,1432000000,1432000000,,-359000000,,,,-321000000,8668000000,7236000000,5794000000,-459000000,,1294000000,1261000000,4279,FIS,yearly
2020-09-30,,,13790000000,,10866000000,6227000000,21119000000,14125000000,14125000000,,-516000000,,,,2924000000,21846000000,7721000000,727000000,-335000000,,10866000000,10475000000,4282,V,yearly
2019-09-30,,,14884000000,,12080000000,6162000000,22256000000,15438000000,15438000000,,-533000000,,,,2804000000,22977000000,7539000000,721000000,-554000000,,12080000000,11650000000,4282,V,yearly
2018-09-30,,,12806000000,,10301000000,5706000000,19923000000,13604000000,13604000000,,-612000000,,,,2505000000,20609000000,7005000000,686000000,-798000000,,10301000000,9942000000,4282,V,yearly
2017-09-30,,,11694000000,,6699000000,4820000000,17738000000,12362000000,12362000000,,-563000000,,,,4995000000,18358000000,5996000000,620000000,-668000000,,6699000000,6467000000,4282,V,yearly
2020-12-31,,,20742000000,2211000000,15403000000,41704000000,67000000000,22405000000,22405000000,,-1663000000,,,,4973000000,257141000000,234736000000,190141000000,-1663000000,,15769000000,15403000000,4288,UNH,yearly
2019-12-31,,,17981000000,4546000000,13839000000,35193000000,57598000000,19685000000,19685000000,,-1704000000,,,,3742000000,242155000000,222470000000,184557000000,-1704000000,,14239000000,13839000000,4288,UNH,yearly
2018-12-31,,,15944000000,4531000000,11986000000,34074000000,53846000000,17344000000,17344000000,,-1400000000,,,,3562000000,226247000000,208903000000,172401000000,-1400000000,,12382000000,11986000000,4288,UNH,yearly
2017-12-31,,,14023000000,4246000000,10558000000,29557000000,47011000000,15209000000,15209000000,,-1186000000,,,,3200000000,201159000000,185950000000,154148000000,-1186000000,,10823000000,10558000000,4288,UNH,yearly
2020-12-31,,,5473000000,105000000,4482000000,12179000000,20370000000,0,7378000000,813000000,,,,,981000000,20370000000,12992000000,0,-1905000000,,4492000000,4184000000,4300,TFC,yearly
2019-12-31,,,4019000000,174000000,3224000000,6664000000,11953000000,0,4624000000,665000000,,,,,782000000,11953000000,7329000000,0,-605000000,,3237000000,3028000000,4300,TFC,yearly
2018-12-31,,,4060000000,56000000,3237000000,5930000000,10992000000,0,4471000000,591000000,,,,,803000000,10992000000,6521000000,0,-411000000,,3257000000,3063000000,4300,TFC,yearly
2017-12-31,,,3326000000,47000000,2394000000,5835000000,10770000000,0,4128000000,807000000,,,,,911000000,10770000000,6642000000,0,-802000000,,2415000000,2220000000,4300,TFC,yearly
2020-12-31,,,1003855000,77994000,1000833000,84517000,714924000,341452000,341452000,,-186904000,,,,978000,1057893000,716441000,342969000,662403000,,1002877000,971230000,4306,KIM,yearly
2019-12-31,,,410244000,81958000,410605000,94342000,821933000,449712000,449712000,,-177395000,,,,-3317000,1158884000,709172000,336951000,-39468000,,413561000,337389000,4306,KIM,yearly
2018-12-31,,,500063000,100931000,497795000,83997000,836203000,435573000,435573000,,-183339000,,,,1600000,1164762000,729189000,328559000,64490000,,498463000,429708000,4306,KIM,yearly
2017-12-31,,,438791000,144046000,426075000,86190000,862941000,410310000,410310000,,-191956000,,,,-880000,1200834000,790524000,337893000,28481000,,439671000,370329000,4306,KIM,yearly
2020-03-28,484414000,,395089000,,334325000,343569000,1360389000,526142000,526142000,6264000,-60392000,,,,60764000,3239141000,2712999000,1878752000,-131053000,,334325000,334325000,4328,QRVO,yearly
2019-03-30,450482000,,91792000,,133125000,476074000,1216529000,285212000,285212000,4761000,-43963000,,,,-41333000,3090325000,2805113000,1873796000,-193420000,,133125000,133125000,4328,QRVO,yearly
2018-03-31,445103000,,17145000,,-40288000,527751000,1146966000,144182000,144182000,29930000,-59548000,,,,57433000,2973536000,2829354000,1826570000,-127037000,,-40288000,-40288000,4328,QRVO,yearly
2017-04-01,470836000,,27305000,,-16558000,545588000,1135512000,107059000,107059000,12029000,-58879000,,,,43863000,3032574000,2925515000,1897062000,-79754000,,-16558000,-16558000,4328,QRVO,yearly
2020-12-31,152000000,,3469000000,2265000000,2501000000,3016000000,11860000000,4005000000,4005000000,61000000,-115000000,,,,847000000,27243000000,23238000000,15383000000,-536000000,4000000,2622000000,2501000000,4375,LIN,yearly
2019-12-31,184000000,,3041000000,2561000000,2285000000,3425000000,11596000000,3380000000,3380000000,-68000000,-246000000,,,,769000000,28228000000,24848000000,16632000000,-339000000,102000000,2272000000,2285000000,4375,LIN,yearly
2018-12-31,113000000,,5105000000,5500000000,4381000000,1625000000,6184000000,2583000000,2583000000,33000000,-277000000,,,,817000000,14836000000,12253000000,8652000000,2522000000,108000000,4288000000,4381000000,4375,LIN,yearly
2017-12-31,93000000,,2334000000,504000000,1247000000,1203000000,4976000000,2499000000,2499000000,-3000000,-202000000,,,,1026000000,11358000000,8859000000,6382000000,-165000000,108000000,1308000000,1247000000,4375,LIN,yearly
2020-12-31,,,4674000000,,3367000000,10052000000,15527000000,4986000000,4986000000,,-283000000,,,,1307000000,77155000000,72169000000,61628000000,-312000000,,3367000000,3367000000,4408,HUM,yearly
2019-12-31,,,3470000000,,2707000000,7334000000,11031000000,3239000000,3239000000,,-242000000,,,,763000000,64888000000,61649000000,53857000000,231000000,,2707000000,2707000000,4408,HUM,yearly
2018-12-31,,,2074000000,,1683000000,7525000000,11030000000,3112000000,3112000000,,-218000000,,,,391000000,56912000000,53800000000,45882000000,-1038000000,,1683000000,1683000000,4408,HUM,yearly
2017-12-31,,,4020000000,,2448000000,6419000000,10271000000,3474000000,3474000000,,-242000000,,,,1572000000,53767000000,50293000000,43496000000,546000000,,2448000000,2448000000,4408,HUM,yearly
2020-12-31,,,1139000000,,890000000,979000000,3232000000,1896000000,1896000000,,-486000000,,,,249000000,8530000000,6634000000,5298000000,-757000000,,890000000,890000000,4419,URI,yearly
2019-12-31,,,1514000000,,1174000000,1092000000,3745000000,2246000000,2246000000,,-587000000,,,,340000000,9351000000,7105000000,5606000000,-732000000,,1174000000,1174000000,4419,URI,yearly
2018-12-31,,,1476000000,,1096000000,1038000000,3430000000,2084000000,2084000000,,-481000000,,,,380000000,8047000000,5963000000,4617000000,-608000000,,1096000000,1096000000,4419,URI,yearly
2017-12-31,,,1048000000,,1346000000,903000000,2851000000,1689000000,1689000000,,-410000000,,,,-298000000,6641000000,4952000000,3790000000,-641000000,,1346000000,1346000000,4419,URI,yearly
2020-12-31,,,6012000000,248000000,4779000000,3814000000,10468000000,6654000000,6654000000,,-359000000,,,,1147000000,32637000000,25983000000,22169000000,-642000000,,4865000000,4779000000,4444,HON,yearly
2019-12-31,,,7559000000,219000000,6143000000,4866000000,12370000000,7504000000,7504000000,,-357000000,,,,1329000000,36709000000,29205000000,24339000000,55000000,,6230000000,6143000000,4444,HON,yearly
2018-12-31,,,7487000000,185000000,6765000000,4854000000,12756000000,7902000000,7902000000,,-367000000,,,,659000000,41802000000,33900000000,29046000000,-415000000,,6828000000,6765000000,4444,HON,yearly
2017-12-31,,,6950000000,168000000,1545000000,5191000000,12390000000,7199000000,7199000000,,-316000000,,,,5362000000,40534000000,33335000000,28144000000,-249000000,,1588000000,1545000000,4444,HON,yearly
2020-12-31,,,964000000,,793000000,953200000,3102000000,1152200000,1152200000,996600000,-188200000,,,,171000000,13162100000,12009900000,10060100000,-188200000,,793000000,793000000,4503,UNM,yearly
2019-12-31,,,1382100000,,1100300000,898300000,3428700000,1586800000,1586800000,943600000,-177400000,,,,281800000,11998900000,10412100000,8570200000,-204700000,,1100300000,1100300000,4503,UNM,yearly
2018-12-31,,,627800000,,523400000,885900000,2572200000,795100000,795100000,891200000,-167300000,,,,104400000,11598500000,10803400000,9026300000,-167300000,,523400000,523400000,4503,UNM,yearly
2017-12-31,,,1404000000,,994200000,852300000,3271200000,1563900000,1563900000,855000000,-159900000,,,,409800000,11286800000,9722900000,8015600000,-159900000,,994200000,994200000,4503,UNM,yearly
2020-12-31,,,896684000,,731773000,,1284426000,983388000,983388000,301038000,-86704000,,,,164911000,4737921000,3754533000,3453495000,-86704000,,731773000,731773000,4505,GL,yearly
2019-12-31,,,931279000,,760790000,9500000.0,1320410000,1023943000,1023943000,242124000,-84306000,,,,170397000,4527532000,3503589000,3207122000,-92664000,-92000.0,760882000,760790000,4505,GL,yearly
2018-12-31,,,863671000,,701466000,9000000.0,1233332000,953747000,953747000,230793000,-90076000,,,,162161000,4303751000,3350004000,3070419000,-91076000,-44000.0,701510000,701466000,4505,GL,yearly
2017-12-31,,,830648000,,1454494000,9300000.0,1172435000,915180000,915180000,210921000,-84532000,,,,-627615000,4155573000,3240393000,2983138000,-85532000,-3769000.0,1458263000,1454494000,4505,GL,yearly
2019-12-31,7000000,,786000000,20000000,4438000000,827000000,2518000000,1311000000,1311000000,,-413000000,,,,-3334000000,9821000000,8510000000,7303000000,-525000000,321000000,4120000000,4438000000,4525,NRG,yearly
2018-12-31,11000000,,467000000,19000000,268000000,799000000,2370000000,1139000000,1139000000,,-483000000,,,,7000000,9478000000,8339000000,7108000000,-672000000,-192000000,460000000,268000000,4525,NRG,yearly
2017-12-31,22000000,,-1389000000,2392000000,-2153000000,836000000,2188000000,821000000,821000000,-87000000.0,-557000000,,,,-44000000,9074000000,8253000000,6886000000,-2210000000,-992000000,-1345000000,-2153000000,4525,NRG,yearly
2016-12-31,48000000,,-931000000,2451000000,-774000000,1032000000,2239000000,596000000,596000000,-193000000.0,-583000000,,,,25000000,8915000000,8319000000,6676000000,-1527000000,65000000,-956000000,-701000000,4525,NRG,yearly
2020-12-31,175307000,,378949000,,1775888000,1200757000,1763235000,387171000,387171000,,,,,,-1396939000,2471941000,2084770000,708706000,-8222000,,1775888000,1775888000,4599,ALGN,yearly
2019-12-31,157361000,,555123000,,442776000,1072053000,1743897000,514483000,514483000,,,,,,112347000,2406796000,1892313000,662899000,40640000,,442776000,442776000,4599,ALGN,yearly
2018-12-31,128899000,,457958000,,400235000,852404000,1447867000,466564000,466564000,,,,,,57723000,1966492000,1499928000,518625000,-8606000,,400235000,400235000,4599,ALGN,yearly
2017-12-31,97559000,,361580000,,231418000,665777000,1116947000,353611000,353611000,,,,,,130162000,1473413000,1119802000,356466000,7969000,,231418000,231418000,4599,ALGN,yearly
2020-12-31,,,973800000,,785900000,1278500000,2214200000,935700000,935700000,,-61000000,,,,187900000,4895800000,3960100000,2681600000,38100000,,785900000,785900000,4604,CHD,yearly
2019-12-31,,,773700000,,615900000,1142600000,1984000000,841400000,841400000,,-73600000,,,,157800000,4357700000,3516300000,2373700000,-67700000,,615900000,615900000,4604,CHD,yearly
2018-12-31,,,719500000,,568600000,1056600000,1840800000,784200000,784200000,,-79400000,,,,150900000,4145900000,3361700000,2305100000,-64700000,,568600000,568600000,4604,CHD,yearly
2017-12-31,,,692700000,,743400000,952300000,1729600000,777300000,777300000,,-52600000,,,,-50700000,3776200000,2998900000,2046600000,-84600000,,743400000,743400000,4604,CHD,yearly
2020-12-31,486594000,,738863000,,634557000,289008000,1481886000,706284000,706284000,,,,,,104306000,2317512000,1611228000,835626000,32579000,,634557000,634557000,4617,ANET,yearly
2019-12-31,462759000,,862270000,,859867000,275805000,1544338000,805774000,805774000,,,,,,2403000,2410706000,1604932000,866368000,56496000,,859867000,859444000,4617,ANET,yearly
2018-12-31,442468000,,288801000,,328115000,252562000,1373377000,678347000,678347000,,-2701000.0,,,,-39314000,2151369000,1473022000,777992000,-389546000,,328115000,327926000,4617,ANET,yearly
2017-12-31,349594000,,474760000,,423201000,241903000,1061769000,470272000,470272000,,-2780000.0,,,,51559000,1646186000,1175914000,584417000,4488000,,423201000,422400000,4617,ANET,yearly
2020-12-31,,,4296000000,,3135000000,12642000000,22086000000,0,4411000000,5033000000,,,,,1161000000,31357000000,26946000000,9271000000,-115000000,,3135000000,3036000000,4628,AXP,yearly
2019-12-31,,,8429000000,,6759000000,13187000000,27321000000,0,8466000000,5668000000,,,,,1670000000,39983000000,31517000000,12662000000,-37000000,,6759000000,6631000000,4628,AXP,yearly
2018-12-31,,,8122000000,,6921000000,11869000000,25513000000,0,8187000000,5457000000,,,,,1201000000,36986000000,28799000000,11473000000,-65000000,,6921000000,6787000000,4628,AXP,yearly
2017-12-31,,,7425000000,,2748000000,11089000000,23793000000,0,7503000000,5201000000,,,,,4677000000,33872000000,26369000000,10079000000,-78000000,,2748000000,2646000000,4628,AXP,yearly
2020-12-31,,,1252083000,89390000,943953000,116059000,4657668000,1359354000,1359354000,2671762000,-109089000,,,,299293000,11558897000,10199543000,6901229000,-107271000,,952790000,940972000,4630,UHS,yearly
2019-12-31,,,1066337000,79099000,814854000,107809000,4538020000,1313539000,1313539000,2626280000,-163202000,,,,238794000,11378259000,10064720000,6840239000,-247202000,,827543000,812826000,4630,UHS,yearly
2018-12-31,,,1034525000,80823000,779705000,106094000,4349088000,1228572000,1228572000,2561377000,-156487000,,,,236642000,10772278000,9543706000,6423190000,-194047000,,797883000,778614000,4630,UHS,yearly
2017-12-31,,,1135009000,68624000,752303000,103127000,4324132000,1280178000,1280178000,2493062000,-145250000,,,,363697000,10409865000,9129687000,6085733000,-145169000,,771312000,751941000,4630,UHS,yearly
2020-12-31,,,151084000,556227000,413563000,99237000,841132000,187946000,187946000,,-218336000,,,,-9423000,1644875000,1456929000,803743000,-36862000,267450000,160507000,411147000,4634,PEAK,yearly
2019-12-31,,,169990000,582416000,45530000,91966000,833132000,305975000,305975000,,-217612000,,,,-5479000,1240339000,934364000,407207000,-135985000,-115381000,175469000,43987000,4634,PEAK,yearly
2018-12-31,,,832822000,568152000,1061093000,94702000,811526000,312143000,312143000,,-261280000,,,,-4396000,1191320000,879177000,379794000,520679000,236169000,837218000,1058424000,4634,PEAK,yearly
2017-12-31,,,421301000,293933000,414169000,87772000,1030164000,407666000,407666000,,-307716000,,,,-1333000,1848378000,1440712000,818214000,13635000,236169000,422634000,413013000,4634,PEAK,yearly
2020-12-31,140777000,,610914000,,521571000,527701000,1358676000,679611000,679611000,,-49070000,,,,89343000,2365365000,1685754000,1006689000,-68697000,,521571000,521571000,4644,WAT,yearly
2019-12-31,142955000,,678239000,,592198000,526451000,1395896000,716797000,716797000,,-48690000,,,,86041000,2406596000,1689799000,1010700000,-38558000,,592198000,592198000,4644,WAT,yearly
2018-12-31,143403000,,682146000,,593794000,585015000,1427365000,691235000,691235000,,-48641000,,,,88352000,2419929000,1728694000,992564000,-9089000,,593794000,593794000,4644,WAT,yearly
2017-12-31,132593000,,641097000,,20311000,544703000,1362011000,677972000,677972000,,-56839000,,,,620786000,2309078000,1631106000,947067000,-36875000,,20311000,20311000,4644,WAT,yearly
2020-12-31,9237000000,,-6871000000,60000000,-9015000000,7369000000,34045000000,7751000000,7751000000,,-1381000000,,,,2124000000,42518000000,34767000000,8473000000,-14622000000,,-8995000000,-9015000000,4648,BMY,yearly
2019-12-31,5891000000,,4975000000,100000000,3439000000,4799000000,18925000000,7100000000,7100000000,,-623000000,,,,1515000000,26145000000,19045000000,7220000000,-2125000000,,3460000000,3439000000,4648,BMY,yearly
2018-12-31,6253000000,,5968000000,96000000,4920000000,4523000000,16151000000,5278000000,5278000000,,-152000000,,,,1021000000,22561000000,17283000000,6410000000,690000000,,4947000000,4920000000,4648,BMY,yearly
2017-12-31,6085000000,,5131000000,106000000,1007000000,4749000000,14911000000,3980000000,3980000000,,-196000000,,,,4156000000,20776000000,16796000000,5865000000,1151000000,,975000000,1007000000,4648,BMY,yearly
2020-03-31,96000000,,1144000000,1619000000,900000000,9086000000,12023000000,2841000000,2841000000,,-249000000,,,,18000000,231051000000,228210000000,219028000000,-1697000000,-6000000,1126000000,900000000,4654,MCK,yearly
2019-03-31,71000000,,610000000,1586000000,34000000,8403000000,11754000000,3259000000,3259000000,21000000.0,-264000000,,,,356000000,214319000000,211060000000,202565000000,-2649000000,1000000,254000000,34000000,4654,MCK,yearly
2018-03-31,125000000,,239000000,1712000000,67000000,8138000000,11184000000,2907000000,2907000000,14000000.0,-283000000,,,,-53000000,208357000000,205450000000,197173000000,-2668000000,5000000,292000000,67000000,4654,MCK,yearly
2017-03-31,341000000,,6891000000,1505000000,5070000000,7447000000,11271000000,3483000000,3483000000,14000000.0,-308000000,,,,1614000000,198533000000,195050000000,187262000000,3408000000,-124000000,5277000000,5070000000,4654,MCK,yearly
2020-12-31,180080000,,365709000,,349246000,656791000,1260880000,424009000,424009000,,-34923000,,,,16463000,1725625000,1301616000,464745000,-58300000,,349246000,349246000,4685,ETSY,yearly
2019-12-31,121878000,,80646000,,95894000,332787000,547343000,92678000,92678000,,-24320000,,,,-15248000,818379000,725701000,271036000,-12032000,,95894000,95894000,4685,ETSY,yearly
2018-12-31,88859000,,55078000,,77491000,241016000,412912000,83037000,83037000,,-22178000,,,,-22413000,603693000,520656000,190781000,-27959000,,77491000,77454000,4685,ETSY,yearly
2017-12-31,71384000,,32265000,,81800000,190644000,290983000,28955000,28955000,,-11130000,,,,-49535000,441231000,412276000,150248000,3310000,,81800000,81720000,4685,ETSY,yearly
2020-12-31,,,882525000,,704216000,567410000,1882550000,972559000,972559000,-2279000,-129803000,,,,178309000,2388855000,1416296000,506305000,-90034000,,704216000,704216000,4687,FLT,yearly
2019-12-31,,,1077819000,,895073000,612016000,2118179000,1233249000,1233249000,-1296000,-150048000,,,,182746000,2648848000,1415599000,530669000,-155430000,,895073000,895073000,4687,FLT,yearly
2018-12-31,,,1095125000,,811483000,571765000,1945797000,1099398000,1099398000,25000,-138494000,,,,283642000,2433492000,1334094000,487695000,-4273000,,811483000,811483000,4687,FLT,yearly
2017-12-31,,,893590000,,740200000,558411000,1706792000,883760000,883760000,61000,-107146000,,,,153390000,2249538000,1365778000,542746000,9830000,,740200000,740200000,4687,FLT,yearly
2020-09-26,18752000000,,67091000000,,57411000000,19916000000,104956000000,66288000000,66288000000,,-2873000000,,,,9680000000,274515000000,208227000000,169559000000,803000000,,57411000000,57411000000,4688,AAPL,yearly
2019-09-28,16217000000,,65737000000,,55256000000,18245000000,98392000000,63930000000,63930000000,,-3576000000,,,,10481000000,260174000000,196244000000,161782000000,1807000000,,55256000000,55256000000,4688,AAPL,yearly
2018-09-29,14236000000,,72903000000,,59531000000,16705000000,101839000000,70898000000,70898000000,,-3240000000,,,,13372000000,265595000000,194697000000,163756000000,2005000000,,59531000000,59531000000,4688,AAPL,yearly
2017-09-30,11581000000,,64089000000,,48351000000,15261000000,88186000000,61344000000,61344000000,,-2323000000,,,,15738000000,229234000000,167890000000,141048000000,2745000000,,48351000000,48351000000,4688,AAPL,yearly
2020-12-31,,,9770000000,312000000,7179000000,34585000000,48248000000,13663000000,13663000000,,-2907000000,,,,2569000000,267908000000,254245000000,219660000000,-3893000000,-9000000,7201000000,7179000000,4696,CVS,yearly
2019-12-31,,,8997000000,306000000,6634000000,32699000000,44517000000,11818000000,11818000000,,-3035000000,,,,2366000000,255765000000,243947000000,211248000000,-2821000000,-9000000,6631000000,6629000000,4696,CVS,yearly
2018-12-31,,,1406000000,318000000,-594000000,20827000000,30878000000,10051000000,10051000000,,-2619000000,,,,2002000000,193919000000,183868000000,163041000000,-8645000000,-9000000,-596000000,-597000000,4696,CVS,yearly
2017-12-31,,,8268000000,4000000,6622000000,18737000000,28507000000,9770000000,9770000000,,-1062000000,,,,1637000000,184765000000,174995000000,156258000000,-1710000000,-8000000,6631000000,6598000000,4696,CVS,yearly
2020-12-31,1142000000,,675000000,239000000,681000000,2675000000,5710000000,1211000000,1211000000,,-45000000,,,,-81000000,14217000000,13006000000,8507000000,-536000000,-55000000,756000000,681000000,4707,CTVA,yearly
2019-12-31,1147000000,,-316000000,246000000,-959000000,2874000000,5543000000,1047000000,1047000000,,-136000000,,,,-46000000,13846000000,12799000000,8303000000,-1363000000,-671000000,-270000000,-959000000,4707,CTVA,yearly
2018-12-31,1355000000,,-6806000000,493000000,-5065000000,2766000000,5893000000,1381000000,1381000000,,-337000000,,,,-31000000,14287000000,12906000000,8394000000,-8187000000,1748000000,-6775000000,-5065000000,4707,CTVA,yearly
2017-12-31,1075000000,,-498000000,493000000,2916000000,3082000000,4785000000,336000000,336000000,195000000.0,-369000000,,,,-2616000000,10684000000,10348000000,5899000000,-834000000,835000000,2118000000,2916000000,4707,CTVA,yearly
2020-05-31,,,1437100000,,1098100000,1299200000,2759700000,1460500000,1460500000,,-38800000,,,,339000000,4040500000,2580000000,1280800000,-23400000,,1098100000,1098100000,4725,PAYX,yearly
2019-05-31,,,1368000000,,1034400000,1218100000,2594700000,1376600000,1376600000,,-17600000,,,,333600000,3772500000,2395900000,1177800000,-8600000,,1034400000,1034400000,4725,PAYX,yearly
2018-05-31,,,1300100000,,994100000,1068000000,2359500000,1291500000,1291500000,,-3900000,,,,306000000,3377700000,2086200000,1018200000,8600000,,994100000,994100000,4725,PAYX,yearly
2017-05-31,,,1259100000,,826300000,979700000,2233600000,1253900000,1253900000,,-2500000,,,,432800000,3153000000,1899100000,919400000,5200000,,826300000,826300000,4725,PAYX,yearly
2021-01-02,112800000,,733600000,,555900000,936900000,1923300000,873600000,873600000,,-70000000,,,,177700000,6971500000,6097900000,5048200000,-140000000,,555900000,555900000,4729,AVY,yearly
2019-12-28,92600000,,246900000,,303600000,994400000,1904100000,817100000,817100000,,-75800000,,,,-56700000,7070100000,6253000000,5166000000,-570200000,,303600000,303600000,4729,AVY,yearly
2018-12-29,98200000,,552800000,,467400000,1015200000,1915500000,802100000,802100000,,-58500000,,,,85400000,7159000000,6356900000,5243500000,-249300000,,467400000,467400000,4729,AVY,yearly
2017-12-30,93400000,,589500000,,281800000,988600000,1812200000,730200000,730200000,,-63000000,,,,307700000,6613800000,5883600000,4801600000,-140700000,,281800000,281800000,4729,AVY,yearly
2020-12-31,,,-13612000000,,-9919000000,2710000000,4164000000,-2589000000,-2589000000,668000000,-1365000000,,,,-2337000000,69897000000,72486000000,65733000000,-11023000000,1205000000,-11275000000,-9919000000,4733,MPC,yearly
2019-12-31,,,4329000000,9413000000.0,2637000000,3411000000,13869000000,6069000000,6069000000,751000000,-1238000000,,,,1074000000,124112000000,118043000000,110243000000,-1740000000,1205000000,3255000000,2636000000,4733,MPC,yearly
2018-12-31,,,4568000000,9878000000.0,2780000000,2424000000,10640000000,5169000000,5169000000,557000000,-946000000,,,,962000000,96706000000,91537000000,86066000000,-601000000,1205000000,3606000000,2779000000,4733,MPC,yearly
2017-12-31,,,3344000000,7795000000.0,3432000000,1743000000,7964000000,3653000000,3653000000,454000000,-625000000,,,,-460000000,75053000000,71400000000,67089000000,-309000000,1205000000,3804000000,3430000000,4733,MPC,yearly
2020-09-30,,,2335000000,42000000,1965000000,3986000000,7029000000,2848000000,2848000000,195000000,-175000000,,,,345000000,16785000000,13937000000,9756000000,-513000000,,1990000000,1965000000,4738,EMR,yearly
2019-09-30,,,2859000000,40000000,2306000000,4457000000,7815000000,3062000000,3062000000,296000000,-201000000,,,,531000000,18372000000,15310000000,10557000000,-203000000,,2328000000,2306000000,4738,EMR,yearly
2018-09-30,,,2667000000,43000000,2203000000,4269000000,7432000000,2906000000,2906000000,257000000,-202000000,,,,443000000,17408000000,14502000000,9976000000,-239000000,,2224000000,2203000000,4738,EMR,yearly
2017-09-30,,,2335000000,52000000,1518000000,3607000000,6431000000,2617000000,2617000000,207000000,-201000000,,,,660000000,15264000000,12647000000,8833000000,-282000000,-125000000.0,1675000000,1518000000,4738,EMR,yearly
2021-01-31,3915000000,,4409000000,,4332000000,1538000000,10821000000,5368000000,5368000000,,-184000000,,,,77000000,16675000000,11307000000,5854000000,-959000000,,4332000000,4332000000,4754,NVDA,yearly
2020-01-26,2829000000,,2970000000,,2796000000,1093000000,6768000000,2846000000,2846000000,,-52000000,,,,174000000,10918000000,8072000000,4150000000,124000000,,2796000000,2796000000,4754,NVDA,yearly
2019-01-27,2376000000,,3896000000,,4141000000,991000000,7171000000,3804000000,3804000000,,-58000000,,,,-245000000,11716000000,7912000000,4545000000,92000000,,4141000000,4141000000,4754,NVDA,yearly
2018-01-28,1797000000,,3196000000,,3047000000,815000000,5822000000,3210000000,3210000000,,-61000000,,,,149000000,9714000000,6504000000,3892000000,-14000000,,3047000000,3047000000,4754,NVDA,yearly
2020-10-25,31900000,,1114747000,4778000,908082000,729415000,1905964000,1144649000,1144649000,,-21069000,,,,206393000,9608462000,8463813000,7702498000,-29902000,,908354000,908082000,4767,HRL,yearly
2019-10-27,32500000,,1209715000,4077000,978806000,711584000,1884648000,1140564000,1140564000,,-18070000,,,,230567000,9497317000,8356753000,7612669000,69151000,,979148000,978806000,4767,HRL,yearly
2018-10-28,33800000,,1181284000,4007000,1012140000,807405000,1979473000,1138268000,1138268000,,-26494000,,,,168702000,9545700000,8407432000,7566227000,43016000,,1012582000,1012140000,4767,HRL,yearly
2017-10-29,34200000,,1278645000,3790000,846735000,725104000,1996636000,1237332000,1237332000,,-12683000,,,,431542000,9167519000,7930187000,7170883000,41313000,,847103000,846735000,4767,HRL,yearly
2020-12-31,,,1538000000,164000000,1368000000,28000000,3874000000,1993000000,1993000000,410000000,-720000000,,,,167000000,12177000000,10184000000,8303000000,-455000000,,1371000000,1366000000,4774,DTE,yearly
2019-12-31,,,1324000000,164000000,1169000000,39000000,3417000000,1701000000,1701000000,414000000,-641000000,,,,152000000,12669000000,10968000000,9252000000,-377000000,,1172000000,1167000000,4774,DTE,yearly
2018-12-31,,,1216000000,480000000,1120000000,37000000,3150000000,1584000000,1584000000,405000000,-559000000,,,,98000000,14212000000,12628000000,11062000000,-368000000,,1118000000,1118000000,4774,DTE,yearly
2017-12-31,,,1287000000,478000000,1134000000,65000000,3173000000,1687000000,1687000000,391000000,-536000000,,,,175000000,12607000000,10920000000,9434000000,-400000000,,1112000000,1132000000,4774,DTE,yearly
2020-12-31,341400000,,541700000,,488500000,1191400000,2024400000,491600000,491600000,,,,,,53200000,2594400000,2102800000,570000000,50100000,,488500000,488500000,4786,FTNT,yearly
2019-12-31,277100000,,386000000,,331700000,1029000000,1657100000,351000000,351000000,,,,,,54300000,2163000000,1812000000,505900000,35000000,,331700000,331700000,4786,FTNT,yearly
2018-12-31,244500000,,254300000,,334900000,875300000,1354200000,234400000,234400000,,,,,,-80600000,1804600000,1570200000,450400000,19900000,,334900000,334900000,4786,FTNT,yearly
2017-12-31,210600000,,124000000,,31400000,788900000,1109600000,110100000,110100000,,,,,,92600000,1494900000,1384800000,385300000,13900000,,31400000,31400000,4786,FTNT,yearly
2020-12-31,,,-1464000000,1321000000,-931000000,3983000000,3810000000,-173000000,-173000000,,-515000000,,,,-173000000,12549000000,12722000000,8739000000,-1291000000,,-1291000000,-931000000,4820,L,yearly
2019-12-31,,,1119000000,2811000000,932000000,4851000000,6634000000,1783000000,1783000000,,-591000000,,,,248000000,14905000000,13122000000,8271000000,-664000000,,871000000,932000000,4820,L,yearly
2018-12-31,,,834000000,2868000000,636000000,4806000000,6236000000,1430000000,1430000000,,-574000000,,,,128000000,14066000000,12636000000,7830000000,-596000000,,706000000,636000000,4820,L,yearly
2017-12-31,,,1582000000,5362000000,1164000000,4665000000,6893000000,2228000000,2228000000,,-646000000,,,,170000000,13735000000,11507000000,6842000000,-646000000,,1412000000,1164000000,4820,L,yearly
2020-12-31,,,1142700000,4900000,967200000,1139000000,4128300000,1830500000,1830500000,82900000,-348000000,,,,173100000,10153600000,8323100000,6025300000,-687800000,,969600000,967200000,4949,RSG,yearly
2019-12-31,,,1295800000,2700000,1073300000,1188200000,4081000000,1770400000,1770400000,81900000,-383900000,,,,222000000,10299400000,8529000000,6218400000,-474600000,,1073800000,1073300000,4949,RSG,yearly
2018-12-31,,,1320900000,2400000,1036900000,1059500000,3890900000,1717300000,1717300000,80700000,-389200000,,,,283300000,10040900000,8323600000,6150000000,-396400000,,1037600000,1036900000,4949,RSG,yearly
2017-12-31,,,1282100000,2300000,1278400000,1057400000,3826900000,1653400000,1653400000,79800000,-366100000,,,,3100000,10041500000,8388100000,6214600000,-371300000,,1279000000,1278400000,4949,RSG,yearly
2020-12-31,,,969969000,427334000,751989000,3161249000,4828075000,1185790000,1185790000,,-67753000,,,,214101000,23826195000,22640405000,18998120000,-215821000,,755868000,751989000,4960,CBRE,yearly
2019-12-31,,,1361345000,40419000,1282357000,3420717000,5205078000,1345137000,1345137000,,-85754000,,,,69895000,23894091000,22548954000,18689013000,16208000,,1291450000,1282357000,4960,CBRE,yearly
2018-12-31,,,1379006000,71105000,1063219000,3356649000,4890876000,1082239000,1082239000,,-98685000,,,,313058000,21340088000,20257849000,16449212000,296767000,,1065948000,1063219000,4960,CBRE,yearly
2017-12-31,,,1171333000,60118000,697109000,2831369000,4323688000,1086205000,1086205000,,-126961000,,,,467757000,18628787000,17542582000,14305099000,85128000,,703576000,697109000,4960,CBRE,yearly
2020-12-31,,,-499790000,,-549177000,2172934000,2172471000,-7463000,-7463000,,-47259000,,,,49387000,4474667000,4482130000,2302196000,-492327000,,-549177000,-549177000,4967,UA,yearly
2019-12-31,,,162163000,,92139000,2222163000,2470533000,242270000,242270000,,-21240000,,,,70024000,5267132000,5024862000,2796599000,-80107000,,92139000,92139000,4967,UA,yearly
2018-12-31,,,-66854000,,-46302000,2176239000,2361271000,178932000,178932000,,-33568000,,,,-20552000,5193185000,5014253000,2831914000,-245786000,,-46302000,-46302000,4967,UA,yearly
2017-12-31,,,-10309000,,-48260000,2091322000,2256491000,156969000,156969000,,-34538000,,,,37951000,4989244000,4832275000,2732753000,-167278000,,-48260000,-48260000,4967,UA,yearly
2020-05-31,,,2887000000,,2539000000,13126000000,16241000000,3115000000,3115000000,,-151000000,,,,348000000,37403000000,34288000000,21162000000,-228000000,,2539000000,2539000000,4988,NKE,yearly
2019-05-31,,,4801000000,,4029000000,12702000000,17474000000,4772000000,4772000000,,-131000000,,,,772000000,39117000000,34345000000,21643000000,29000000,,4029000000,4029000000,4988,NKE,yearly
2018-05-31,,,4325000000,,1933000000,11511000000,15956000000,4445000000,4445000000,,-124000000,,,,2392000000,36397000000,31952000000,20441000000,-120000000,,1933000000,1933000000,4988,NKE,yearly
2017-05-31,,,4886000000,,4240000000,10563000000,15312000000,4749000000,4749000000,,-86000000,,,,646000000,34350000000,29601000000,19038000000,137000000,,4240000000,4240000000,4988,NKE,yearly
2020-05-31,,,-161000000,,-52400000,759900000,1408400000,292600000,292600000,,-62200000,,,,-111800000,7806900000,7514300000,6398500000,-453600000,-3200000,-49200000,-52400000,4999,DRI,yearly
2019-05-26,,,782300000,,713400000,660800000,1849000000,851500000,851500000,,-54000000,,,,63700000,8510400000,7658900000,6661400000,-69200000,-5200000,718600000,713400000,4999,DRI,yearly
2018-05-27,,,605700000,,596000000,662100000,1745400000,770200000,770200000,,-59700000,,,,1900000,8080100000,7309900000,6334700000,-164500000,-7800000,603800000,596000000,4999,DRI,yearly
2017-05-28,,,637300000,,479100000,627400000,1569400000,669100000,669100000,,-41500000,,,,154800000,7170200000,6501100000,5600800000,-31800000,-3400000,482500000,479100000,4999,DRI,yearly
2020-12-31,,,802316000,,612809000,779601000,3432096000,1948805000,1948805000,125028000,-712886000,,,,189507000,8542242000,6593437000,5110146000,-1146489000,,612809000,611709000,5004,OKE,yearly
2019-12-31,,,1650991000,,1278577000,876427000,3376327000,1904209000,1904209000,119156000,-491773000,,,,372414000,10164367000,8260158000,6788040000,-253218000,,1278577000,1277477000,5004,OKE,yearly
2018-12-31,,,1517935000,,1151703000,819882000,3170488000,1818127000,1818127000,103922000,-469620000,,,,362903000,12593196000,10775069000,9422708000,-300192000,,1155032000,1150603000,5004,OKE,yearly
2017-12-31,,,1040801000,157485000.0,387841000,737917000,2635862000,1393214000,1393214000,98396000,-485658000,,,,447282000,12173907000,10780693000,9538045000,-352413000,,593519000,387074000,5004,OKE,yearly
2020-12-31,,,-499790000,,-549177000,2172934000,2172471000,-7463000,-7463000,,-47259000,,,,49387000,4474667000,4482130000,2302196000,-492327000,,-549177000,-549177000,5007,UAA,yearly
2019-12-31,,,162163000,,92139000,2222163000,2470533000,242270000,242270000,,-21240000,,,,70024000,5267132000,5024862000,2796599000,-80107000,,92139000,92139000,5007,UAA,yearly
2018-12-31,,,-66854000,,-46302000,2176239000,2361271000,178932000,178932000,,-33568000,,,,-20552000,5193185000,5014253000,2831914000,-245786000,,-46302000,-46302000,5007,UAA,yearly
2017-12-31,,,-10309000,,-48260000,2091322000,2256491000,156969000,156969000,,-34538000,,,,37951000,4989244000,4832275000,2732753000,-167278000,,-48260000,-48260000,5007,UAA,yearly
2020-05-31,,,1058291000,,876037000,2061832000,3233748000,1171916000,1171916000,,-105393000,,,,181931000,7085120000,5913204000,3851372000,-113625000,-323000,876360000,867879000,5009,CTAS,yearly
2019-05-31,,,1102399000,,884981000,1980644000,3128588000,1147944000,1147944000,,-101736000,,,,219764000,6892303000,5744359000,3763715000,-45545000,2346000,882635000,875413000,5009,CTAS,yearly
2018-05-31,,,841001000,,842586000,1916792000,2908523000,991731000,991731000,,-110175000,,,,57069000,6476632000,5484901000,3568109000,-150730000,58654000,783932000,830792000,5009,CTAS,yearly
2017-05-31,,,687404000,,480708000,1527380000,2380295000,852915000,852915000,,-86524000,,,,230118000,5323381000,4470466000,2943086000,-165511000,23422000,457286000,472540000,5009,CTAS,yearly
2020-12-31,,,-3090000000,134000000,-2680000000,338000000,1557000000,73000000,73000000,-169000000,-259000000,,,,-547000000,4503000000,4430000000,2946000000,-3163000000,-128000000,-2543000000,-2684000000,5037,DVN,yearly
2019-12-31,,,-109000000,118000000,-355000000,475000000,2686000000,177000000,177000000,479000000,-260000000,,,,-30000000,6423000000,6246000000,3737000000,-286000000,-274000000,-79000000,-357000000,5037,DVN,yearly
2018-12-31,,,944000000,118000000,3064000000,574000000,2965000000,1390000000,1390000000,-464000000,-287000000,,,,230000000,8439000000,7049000000,5474000000,-446000000,2510000000,714000000,3056000000,5037,DVN,yearly
2017-12-31,,,40000000,4850000000,898000000,645000000,2165000000,142000000,142000000,24000000,-337000000,,,,7000000,6340000000,6198000000,4175000000,-102000000,1045000000,33000000,897000000,5037,DVN,yearly
2020-06-30,,,1464000000,322000000,999000000,1741000000,4496000000,2497000000,2497000000,,-369000000,,,,402000000,12303000000,9806000000,7807000000,-1033000000,,1062000000,999000000,5061,FOXA,yearly
2019-06-30,,,2224000000,200000000,1595000000,1419000000,4062000000,2431000000,2431000000,,-203000000,,,,581000000,11389000000,8958000000,7327000000,-207000000,,1643000000,1595000000,5061,FOXA,yearly
2018-06-30,,,2170000000,275000000,2187000000,1262000000,3648000000,2215000000,2215000000,,-43000000,,,,-58000000,10153000000,7938000000,6505000000,-45000000,,2228000000,2187000000,5061,FOXA,yearly
2017-06-30,,,2241000000,154000000,1372000000,1117000000,3821000000,2535000000,2535000000,,-23000000,,,,832000000,9921000000,7386000000,6100000000,-294000000,,1409000000,1372000000,5061,FOXA,yearly
2020-12-31,1181000000,,7225000000,,6375000000,6927000000,16010000000,7902000000,7902000000,,-553000000,,,,850000000,32218000000,24316000000,16208000000,-677000000,,6375000000,6375000000,5108,TMO,yearly
2019-12-31,1003000000,,4070000000,,3696000000,6080000000,11345000000,4262000000,4262000000,,-676000000,,,,374000000,25542000000,21280000000,14197000000,-192000000,,3696000000,3696000000,5108,TMO,yearly
2018-12-31,967000000,,3262000000,,2938000000,6022000000,10869000000,3880000000,3880000000,,-667000000,,,,324000000,24358000000,20478000000,13489000000,-618000000,,2938000000,2938000000,5108,TMO,yearly
2017-12-31,887000000,,2429000000,,2225000000,5428000000,9536000000,3221000000,3221000000,6000000.0,-592000000,,,,201000000,20918000000,17697000000,11382000000,-792000000,-3000000.0,2228000000,2225000000,5108,TMO,yearly
2020-12-31,,,23967000000,1430000000,17801000000,31573000000,77091000000,28798000000,28798000000,,-4247000000,,,,5619000000,128292000000,99494000000,51201000000,-4831000000,,18348000000,17801000000,5127,VZ,yearly
2019-12-31,,,22733000000,1440000000,19265000000,28939000000,77142000000,31521000000,31521000000,,-4730000000,,,,2945000000,131868000000,100347000000,54726000000,-8788000000,,19788000000,19265000000,5127,VZ,yearly
2018-12-31,,,19623000000,1565000000,15528000000,27287000000,75658000000,30991000000,30991000000,,-4833000000,,,,3584000000,130863000000,99872000000,55205000000,-11368000000,,16039000000,15528000000,5127,VZ,yearly
2017-12-31,,,20594000000,1591000000,30101000000,27344000000,72971000000,28673000000,28673000000,,-4733000000,,,,-9956000000,126034000000,97361000000,53063000000,-8079000000,,30550000000,30101000000,5127,VZ,yearly
2020-09-30,,,740000000,4000000,699000000,685000000,2694000000,1840000000,1840000000,,-1029000000,,,,87000000,5103000000,3263000000,2409000000,-1100000000,47000000,653000000,514000000,5166,TDG,yearly
2019-09-30,,,1063000000,10000000,890000000,665000000,2899000000,2099000000,2099000000,,-859000000,,,,222000000,5223000000,3124000000,2324000000,-1036000000,51000000,841000000,779000000,5166,TDG,yearly
2018-09-30,,,986000000,10000000,957000000,450000000,2184000000,1662000000,1662000000,,-663000000,,,,24000000,3811000000,2149000000,1627000000,-676000000,-5000000,962000000,901000000,5166,TDG,yearly
2017-09-30,,,837430000,10000000,596887000,414392000,2005248000,1501630000,1501630000,,-602589000,,,,208889000,3504286000,2002656000,1499038000,-664200000,-31654000,628541000,437630000,5166,TDG,yearly
2020-12-31,,,1234000000,218000000,1101000000,203000000,7163000000,2465000000,2465000000,2575000000,-1033000000,,,,90000000,12246000000,9781000000,5083000000,-1231000000,,1144000000,1101000000,5171,ED,yearly
2019-12-31,,,1736000000,191000000,1343000000,81000000,6766000000,2595000000,2595000000,2406000000,-1004000000,,,,296000000,12574000000,9979000000,5808000000,-859000000,,1440000000,1343000000,5171,ED,yearly
2018-12-31,,,1783000000,113000000,1382000000,170000000,6237000000,2363000000,2363000000,2266000000,-829000000,,,,401000000,12337000000,9974000000,6100000000,-580000000,,1382000000,1382000000,5171,ED,yearly
2017-12-31,,,1997000000,7000000,1525000000,163000000,6269000000,2610000000,2610000000,2155000000,-737000000,,,,472000000,12033000000,9423000000,5764000000,-613000000,,1525000000,1525000000,5171,ED,yearly
2020-12-31,,,581000000,1033000000,3301000000,49501000000,58319000000,0,2117000000,6701000000,,,,,-3005000000,58319000000,56202000000,0,-1536000000,,3586000000,1710000000,5195,WFC,yearly
2019-12-31,,,24198000000,838000000,19549000000,50325000000,82458000000,0,24198000000,7935000000,,,,,4157000000,82458000000,58260000000,0,0,,20041000000,17938000000,5195,WFC,yearly
2018-12-31,,,28538000000,900000000,22393000000,47655000000,84696000000,0,28538000000,8503000000,,,,,5662000000,84696000000,56158000000,0,0,,22876000000,20689000000,5195,WFC,yearly
2017-12-31,,,27377000000,1143000000,22183000000,40422000000,85989000000,0,29816000000,15751000000,,,,,4917000000,85989000000,56173000000,0,-2439000000,,22460000000,20554000000,5195,WFC,yearly
2020-12-31,907000000,,623000000,191000000,512000000,1589000000,3974000000,1357000000,1357000000,,-276000000,,,,111000000,11303000000,9946000000,7329000000,-734000000,,512000000,414000000,5202,GLW,yearly
2019-12-31,1001000000,,1216000000,90000000,960000000,1649000000,4423000000,1660000000,1660000000,,-221000000,,,,256000000,11503000000,9843000000,7080000000,-444000000,,960000000,862000000,5202,GLW,yearly
2018-12-31,987000000,,1503000000,94000000,1066000000,1873000000,4558000000,1604000000,1604000000,,-191000000,,,,437000000,11290000000,9686000000,6732000000,-101000000,,1066000000,968000000,5202,GLW,yearly
2017-12-31,864000000,,1657000000,72000000,-497000000,1473000000,4020000000,1608000000,1608000000,,-155000000,,,,2154000000,10116000000,8508000000,6096000000,49000000,,-497000000,-595000000,5202,GLW,yearly
2021-01-02,,,835500000,21700000,627000000,1094900000,2010400000,915500000,915500000,,-53800000,,,,189100000,3942200000,3026700000,1931800000,-80000000,,646400000,627000000,5204,SNA,yearly
2019-12-28,,,923000000,21700000,693500000,1128800000,2089600000,960800000,960800000,,-48800000,,,,211800000,4067700000,3106900000,1978100000,-37800000,,711200000,693500000,5204,SNA,yearly
2018-12-29,,,910600000,19800000,679900000,1140300000,2099900000,959600000,959600000,,-50100000,,,,214400000,4070400000,3110800000,1970500000,-49000000,,696200000,679900000,5204,SNA,yearly
2017-12-30,,,823100000,18400000,557700000,1161900000,2043100000,881200000,881200000,,-52100000,,,,250900000,4000300000,3119100000,1957200000,-104000000,,572200000,557700000,5204,SNA,yearly
2020-12-31,,,1797000000,,1385000000,3038000000,5852000000,0,2172000000,642000000,,,,,412000000,5852000000,3680000000,0,-375000000,,1385000000,1343000000,5208,SYF,yearly
2019-12-31,,,4887000000,,3747000000,3356000000,9132000000,0,5160000000,616000000,,,,,1140000000,9132000000,3972000000,0,-273000000,,3747000000,3747000000,5208,SYF,yearly
2018-12-31,,,3644000000,,2790000000,3187000000,7739000000,0,3883000000,669000000,,,,,854000000,7739000000,3856000000,0,-239000000,,2790000000,2790000000,5208,SYF,yearly
2017-12-31,,,3324000000,,1935000000,2804000000,7071000000,0,3637000000,630000000,,,,,1389000000,7071000000,3434000000,0,-313000000,,1935000000,1935000000,5208,SYF,yearly
2020-12-31,37577000,,1494997000,3531000,1278708000,1858457000,3703478000,1804501000,1804501000,,-153471000,,,,219584000,8149719000,6345218000,4446241000,-309504000,,1275413000,1278708000,5210,HSY,yearly
2019-12-31,37146000,,1380784000,5772000,1149692000,1906509000,3622478000,1678823000,1678823000,,-152122000,,,,234032000,7986252000,6307429000,4363774000,-298039000,,1146752000,1149692000,5210,HSY,yearly
2018-12-31,38521000,,1410061000,8545000,1177562000,1817660000,3586648000,1730467000,1730467000,,-146858000,,,,239010000,7791069000,6060602000,4204421000,-320406000,,1171051000,1177562000,5210,HSY,yearly
2017-12-31,45850000,,1110668000,16227000,782981000,1861961000,3460523000,1552712000,1552712000,,-100066000,,,,354131000,7515426000,5962714000,4054903000,-442044000,,756537000,782981000,5210,HSY,yearly
2019-12-31,298210000,,522583000,,451295000,514600000,1371329000,521640000,521640000,,-3461000,,,,71288000,1515892000,994252000,144563000,943000,,451295000,451295000,5212,ANSS,yearly
2018-12-31,233802000,,487085000,,419375000,410080000,1164785000,480074000,480074000,,-59000,,,,67710000,1293636000,813562000,128851000,7011000,,419375000,419375000,5212,ANSS,yearly
2017-12-31,195946000,,395694000,,259251000,337540000,981880000,398628000,398628000,,-86000,,,,136443000,1095250000,696622000,113370000,-2934000,,259251000,259251000,5212,ANSS,yearly
2016-12-31,183093000,,380315000,,265636000,269115000,879697000,376642000,376642000,,-86000,,,,114679000,988465000,611823000,108768000,3673000,,265636000,265636000,5212,ANSS,yearly
2020-12-31,42740000000,,24194000000,,21331000000,87193000000,152757000000,22899000000,22899000000,-75000000,-1647000000,,,,2863000000,386064000000,363165000000,233307000000,1295000000,,21331000000,21331000000,5215,AMZN,yearly
2019-12-31,35931000000,,13962000000,,11588000000,64313000000,114986000000,14404000000,14404000000,338000000,-1600000000,,,,2374000000,280522000000,266118000000,165536000000,-442000000,,11588000000,11588000000,5215,AMZN,yearly
2018-12-31,28837000000,,11270000000,,10073000000,52177000000,93731000000,12421000000,12421000000,296000000,-1417000000,,,,1197000000,232887000000,220466000000,139156000000,-1151000000,,10073000000,10073000000,5215,AMZN,yearly
2017-12-31,22620000000,,3802000000,,3033000000,38992000000,65932000000,4106000000,4106000000,214000000,-848000000,,,,769000000,177866000000,173760000000,111934000000,-304000000,,3033000000,3033000000,5215,AMZN,yearly
2020-12-31,,,1556000000,,1343000000,3367000000,5665000000,0,1691000000,605000000,,,,,227000000,5665000000,3974000000,0,-135000000,14000000,1329000000,1237000000,5216,KEY,yearly
2019-12-31,,,2022000000,,1717000000,3212000000,6062000000,0,2344000000,503000000,,,,,314000000,6062000000,3718000000,0,-322000000,9000000,1708000000,1620000000,5216,KEY,yearly
2018-12-31,,,2203000000,1000000.0,1866000000,3338000000,6178000000,0,2380000000,460000000,,,,,344000000,6178000000,3798000000,0,-177000000,7000000,1859000000,1800000000,5216,KEY,yearly
2017-12-31,,,1928000000,2000000.0,1296000000,3352000000,6026000000,0,2116000000,558000000,,,,,637000000,6026000000,3910000000,0,-188000000,7000000,1291000000,1226000000,5216,KEY,yearly
2020-12-31,,,1020000000,,904000000,956000000,2692000000,1762000000,1762000000,-26000000,-558000000,,,,116000000,5652000000,3890000000,2960000000,-742000000,,904000000,904000000,5241,YUM,yearly
2019-12-31,,,1373000000,,1294000000,921000000,2827000000,1931000000,1931000000,-25000000,-519000000,,,,79000000,5597000000,3666000000,2770000000,-558000000,,1294000000,1294000000,5241,YUM,yearly
2018-12-31,,,1839000000,,1542000000,901000000,2664000000,1763000000,1763000000,7000000,-496000000,,,,297000000,5688000000,3925000000,3024000000,76000000,,1542000000,1542000000,5241,YUM,yearly
2017-12-31,,,2274000000,,1340000000,971000000,2717000000,1746000000,1746000000,7000000,-473000000,,,,934000000,5878000000,4132000000,3161000000,528000000,,1340000000,1340000000,5241,YUM,yearly
2020-12-31,,,1032000000,142000000,871000000,-116000000,2858000000,1416000000,1416000000,483000000,-419000000,,,,155000000,5540000000,4124000000,2682000000,-384000000,,877000000,871000000,5252,AEE,yearly
2019-12-31,,,1016000000,142000000,828000000,-90000000,2743000000,1357000000,1357000000,481000000,-381000000,,,,182000000,5646000000,4289000000,2903000000,-341000000,,834000000,828000000,5252,AEE,yearly
2018-12-31,,,1058000000,142000000,815000000,-70000000,2795000000,1427000000,1427000000,483000000,-401000000,,,,237000000,6009000000,4582000000,3214000000,-369000000,,821000000,815000000,5252,AEE,yearly
2017-12-31,,,1105000000,142000000,523000000,-44000000,2783000000,1454000000,1454000000,477000000,-391000000,,,,576000000,5909000000,4455000000,3126000000,-349000000,,529000000,523000000,5252,AEE,yearly
2020-12-31,374964000,,901015000,,784147000,476013000,1785741000,902190000,902190000,1771000,-24182000,,,,116868000,3121469000,2219279000,1335728000,-1175000,,784147000,784147000,5281,TER,yearly
2019-12-31,322824000,,525772000,,467468000,446351000,1339829000,529743000,529743000,764000,-22224000,,,,58304000,2294965000,1765222000,955136000,-3971000,,467468000,467468000,5281,TER,yearly
2018-12-31,301505000,,467801000,,451779000,387945000,1220394000,490522000,490522000,1231000,-21780000,,,,16022000,2100802000,1610280000,880408000,-22721000,,451779000,451779000,5281,TER,yearly
2017-12-31,307305000,,524412000,,257692000,343791000,1221453000,539917000,539917000,-90000,-21663000,,,,266720000,2136606000,1596689000,915153000,-15505000,,257692000,257692000,5281,TER,yearly
2020-02-29,,,1160986000,,888433000,1940135000,3178370000,1238303000,1238303000,-68000,-83007000,,,,272553000,21424087000,20185784000,18245717000,-77317000,,888433000,888433000,5298,KMX,yearly
2019-02-28,,,1112806000,,842413000,1730328000,2919281000,1189006000,1189006000,-53000,-75792000,,,,270393000,19146000000,17956994000,16226719000,-76200000,,842413000,842413000,5298,KMX,yearly
2018-02-28,,,1063608000,,664112000,1617101000,2750041000,1132990000,1132990000,-50000,-70745000,,,,399496000,17976809000,16843819000,15226768000,-69382000,,664112000,664112000,5298,KMX,yearly
2017-02-28,,,1006405000,,626970000,1488504000,2552278000,1063774000,1063774000,-50000,-56416000,,,,379435000,16637118000,15573344000,14084840000,-57369000,,626970000,626970000,5298,KMX,yearly
2020-12-31,1415000000,,4009000000,47000000,2998000000,3835000000,10127000000,4957000000,4957000000,-80000000,-514000000,,,,1006000000,41748000000,36791000000,31621000000,-948000000,,3003000000,2998000000,5364,CAT,yearly
2019-12-31,1693000000,,7840000000,41000000,6093000000,4796000000,14462000000,8113000000,8113000000,-140000000,-421000000,,,,1746000000,53800000000,45687000000,39338000000,-273000000,,6094000000,6093000000,5364,CAT,yearly
2018-12-31,1850000000,,7846000000,41000000,6147000000,4806000000,14903000000,8336000000,8336000000,-89000000,-404000000,,,,1698000000,54722000000,46386000000,39819000000,-490000000,,6148000000,6147000000,5364,CAT,yearly
2017-12-31,1842000000,,4098000000,69000000,754000000,4425000000,11824000000,5576000000,5576000000,-19000000,-531000000,,,,3339000000,45462000000,39886000000,33638000000,-1478000000,,759000000,754000000,5364,CAT,yearly
2020-03-31,877800000,,150400000,,570600000,678300000,3242100000,692100000,692100000,,-497300000,,,,-420200000,5274200000,4582100000,2032100000,-541700000,,570600000,570600000,5370,MCHP,yearly
2019-03-31,826300000,,204500000,,355900000,684400000,3297000000,1112200000,1112200000,,-502900000,,,,-151400000,5349500000,4237300000,2052500000,-907700000,,355900000,355900000,5370,MCHP,yearly
2018-03-31,529300000,,737300000,,255400000,453900000,2420700000,952000000,952000000,,-199000000,,,,481900000,3980800000,3028800000,1560100000,-214700000,,255400000,255400000,5370,MCHP,yearly
2017-03-31,545300000,,89800000,,164600000,500800000,1943900000,560100000,560100000,,-146300000,,,,-80800000,3407800000,2847700000,1463900000,-470300000,-6000000.0,170600000,164600000,5370,MCHP,yearly
2020-12-31,1829600000,,3199349000,,2761395000,3304848000,9719737000,4585289000,4585289000,,-767499000,,,,437954000,24996056000,20410767000,15276319000,-1385940000,,2761395000,2761395000,5371,NFLX,yearly
2019-12-31,1545149000,,2062231000,,1866916000,3566831000,7716234000,2604254000,2604254000,,-626023000,,,,195315000,20156447000,17552193000,12440213000,-542023000,,1866916000,1866916000,5371,NFLX,yearly
2018-12-31,1221814000,,1226458000,,1211242000,2999763000,5826803000,1605226000,1605226000,,-420493000,,,,15216000,15794341000,14189115000,9967538000,-378768000,,1211242000,1211242000,5371,NFLX,yearly
2017-12-31,953710000,,485321000,,558929000,1867324000,3659713000,838679000,838679000,,-238204000,,,,-73608000,11692713000,10854034000,8033000000,-353358000,,558929000,558929000,5371,NFLX,yearly
2020-12-31,140102000,,748743000,,602739000,808021000,1801031000,796243000,796243000,,-38616000,,,,146004000,3085177000,2288934000,1284146000,-47500000,,602739000,602739000,5374,MTD,yearly
2019-12-31,143950000,,681394000,,561109000,814383000,1741211000,733188000,733188000,,-37411000,,,,120285000,3008652000,2275464000,1267441000,-51794000,,561109000,561109000,5374,MTD,yearly
2018-12-31,141071000,,651858000,,512611000,806602000,1684378000,689181000,689181000,,-34511000,,,,139247000,2935586000,2246405000,1251208000,-37323000,,512611000,512611000,5374,MTD,yearly
2017-12-31,128308000,,574222000,,375972000,790861000,1575751000,613911000,613911000,,-32785000,,,,198250000,2725053000,2111142000,1149302000,-39689000,,375972000,375972000,5374,MTD,yearly
2020-12-31,273900000,,1657900000,,1298400000,408900000,2301000000,1618200000,1618200000,,-8700000,,,,359500000,18728500000,17110300000,16427500000,39700000,,1298400000,1298400000,5402,PCAR,yearly
2019-12-31,326600000,,3099200000,,2387900000,502400000,3863000000,3034000000,3034000000,,-9600000,,,,711300000,25599700000,22565700000,21736700000,65200000,,2387900000,2387900000,5402,PCAR,yearly
2018-12-31,306100000,,2810200000,,2195100000,470200000,3519500000,2743200000,2743200000,,-9600000,,,,615100000,23495700000,20752500000,19976200000,67000000,,2195100000,2195100000,5402,PCAR,yearly
2017-12-31,264700000,,2173300000,,1675200000,412000000,2820300000,2143600000,2143600000,,-1700000,,,,498100000,19456400000,17312800000,16636100000,29700000,,1675200000,1675200000,5402,PCAR,yearly
2020-12-31,,,1018691000,2343529000,872727000,133112000,1733811000,905322000,905322000,11626000,-431717000,,,,0,2765686000,1860364000,1031875000,113369000,,1018691000,862227000,5412,BXP,yearly
2019-12-31,,,651999000,2329549000,521534000,140777000,1841363000,1032722000,1032722000,11626000,-412717000,,,,0,2927361000,1894639000,1085998000,-380723000,,651999000,511034000,5412,BXP,yearly
2018-12-31,,,712563000,2330797000,582847000,121722000,1692682000,925311000,925311000,11626000,-378168000,,,,0,2707300000,1781989000,1014618000,-212748000,,712563000,572246000,5412,BXP,yearly
2017-12-31,,,562481000,2288499000,462439000,113715000,1657811000,926549000,926549000,11626000,-374481000,,,,0,2620515000,1693966000,962704000,-364068000,,562481000,451939000,5412,BXP,yearly
2020-12-31,,,-2856000000,17567000000,-5176000000,38039000000,91840000000,25285000000,25285000000,,-7925000000,,,,965000000,171760000000,146475000000,79920000000,-28141000000,,-3821000000,-5369000000,5430,T,yearly
2019-12-31,,,18468000000,17713000000,13903000000,41094000000,97052000000,27741000000,27741000000,,-8422000000,,,,3493000000,181193000000,153452000000,84141000000,-9273000000,,14975000000,13900000000,5430,T,yearly
2018-12-31,,,24873000000,9795000000,19370000000,31289000000,91337000000,31618000000,31618000000,,-7957000000,,,,4920000000,170756000000,139138000000,79419000000,-6745000000,,19953000000,19370000000,5430,T,yearly
2017-12-31,,,15139000000,1146000000,29450000000,34354000000,82736000000,23995000000,23995000000,,-6300000000,,,,-14708000000,160546000000,136551000000,77810000000,-8856000000,,29847000000,29450000000,5430,T,yearly
2021-01-01,,,781000000,9000000,628000000,770000000,1737000000,1035000000,1035000000,,-182000000,,,,152000000,12297000000,11262000000,10560000000,-254000000,,629000000,628000000,5432,LDOS,yearly
2020-01-03,,,866000000,4000000,667000000,689000000,1548000000,899000000,899000000,,-147000000,,,,196000000,11094000000,10195000000,9546000000,-33000000,,670000000,667000000,5432,LDOS,yearly
2018-12-28,,,610000000,3000000,581000000,729000000,1504000000,775000000,775000000,,-145000000,,,,28000000,10194000000,9419000000,8690000000,-165000000,,582000000,581000000,5432,LDOS,yearly
2017-12-29,,,393000000,13000000,366000000,737000000,1432000000,685000000,685000000,,-148000000,,,,29000000,10170000000,9485000000,8738000000,-292000000,,364000000,366000000,5432,LDOS,yearly
2020-12-31,873011000,,-50939000,,-1135626000,1300292000,2349961000,176658000,176658000,,-152878000,,,,1084687000,3716349000,3539691000,1366388000,-227597000,,-1135626000,-1135626000,5434,TWTR,yearly
2019-12-31,682281000,,390139000,,1465659000,1273634000,2322288000,366373000,366373000,,-138180000,,,,-1075520000,3459329000,3092956000,1137041000,23766000,,1465659000,1465659000,5434,TWTR,yearly
2018-12-31,553858000,,423544000,,1205596000,1070179000,2077362000,453325000,453325000,,-132606000,,,,-782052000,3042359000,2589034000,964997000,-29781000,,1205596000,1205596000,5434,TWTR,yearly
2017-12-31,542010000,,-95418000,,-108063000,1001307000,1582057000,38740000,38740000,,-105237000,,,,12645000,2443299000,2404559000,861242000,-134158000,,-108063000,-108063000,5434,TWTR,yearly
2020-02-01,,,2164288000,,1660928000,3170687000,5316869000,2146182000,2146182000,,-9740000,,,,503360000,16039073000,13892891000,10722204000,18106000,,1660928000,1660928000,5513,ROST,yearly
2019-02-02,,,2050876000,,1587457000,2786350000,4827064000,2040714000,2040714000,,-16407000,,,,463419000,14983541000,12942827000,10156477000,10162000,,1587457000,1587457000,5513,ROST,yearly
2018-02-03,,,2040720000,,1362753000,2576098000,4624494000,2048396000,2048396000,,-18847000,,,,677967000,14134732000,12086336000,9510238000,-7676000,,1362753000,1362753000,5513,ROST,yearly
2017-01-28,,,1786156000,,1117654000,2395608000,4198252000,1802644000,1802644000,,-19569000,,,,668502000,12866757000,11064113000,8668505000,-16488000,,1117654000,1117654000,5513,ROST,yearly
2020-12-31,,,1338000000,112000000,996000000,235000000,4149000000,1721000000,1721000000,1458000000,-244000000,,,,318000000,9352000000,7631000000,5203000000,-383000000,,1020000000,996000000,5544,WLTW,yearly
2019-12-31,,,1322000000,120000000,1044000000,244000000,4024000000,1576000000,1576000000,1475000000,-234000000,,,,249000000,9039000000,7463000000,5015000000,-254000000,,1073000000,1044000000,5544,WLTW,yearly
2018-12-31,,,851000000,145000000,695000000,243000000,3670000000,1291000000,1291000000,1394000000,-208000000,,,,136000000,8513000000,7222000000,4843000000,-440000000,,715000000,695000000,5544,WLTW,yearly
2017-12-31,,,492000000,151000000,568000000,261000000,3457000000,1139000000,1139000000,1273000000,-188000000,,,,-100000000,8202000000,7063000000,4745000000,-647000000,,592000000,568000000,5544,WLTW,yearly
2020-12-31,,,421882000,,306276000,1666041000,2012611000,345351000,345351000,,,,,,115606000,5109000000,4763649000,3096389000,76531000,,306276000,306276000,5567,RHI,yearly
2019-12-31,,,625515000,,454433000,1958295000,2525129000,565473000,565473000,,,,,,171082000,6074432000,5508959000,3549303000,60042000,,454433000,454433000,5567,RHI,yearly
2018-12-31,,,591602000,,434288000,1810601000,2411012000,598706000,598706000,,,,,,157314000,5800271000,5201565000,3389259000,-7104000,,434288000,434288000,5567,RHI,yearly
2017-12-31,,,517516000,,290584000,1646532000,2163812000,515717000,515717000,,,,,,226932000,5266789000,4751072000,3102977000,1799000,,290584000,290584000,5567,RHI,yearly
2021-01-30,,,89263000,,90470000,7020917000,7603147000,582230000,582230000,,-180734000,,,,-1207000,32136962000,31554732000,24533815000,-492967000,,90470000,90470000,5665,TJX,yearly
2020-02-01,,,4406183000,,3272193000,10433826000,14850035000,4416209000,4416209000,,-59086000,,,,1133990000,41716977000,37300768000,26866942000,-10026000,,3272193000,3272193000,5665,TJX,yearly
2019-02-02,,,4173211000,,3059798000,6923564000,11141757000,4218193000,4218193000,,-64839000,,,,1113413000,38972934000,34754741000,27831177000,-44982000,,3059798000,3059798000,5665,TJX,yearly
2018-02-03,,,3856588000,,2607948000,6375071000,10362497000,3987426000,3987426000,,-64295000,,,,1248640000,35864664000,31877238000,25502167000,-130838000,,2607948000,2607948000,5665,TJX,yearly
2021-01-02,,,1276100000,6800000,1233800000,2872400000,5039100000,1905000000,1905000000,220600000,-223100000,,,,41400000,14534600000,12629600000,9495500000,-628900000,,1234700000,1210400000,5673,SWK,yearly
2019-12-28,,,1118800000,5900000,955800000,2868500000,4845200000,1694700000,1694700000,249000000,-284300000,,,,160800000,14442200000,12747500000,9597000000,-575900000,,958000000,955800000,5673,SWK,yearly
2018-12-29,,,1022100000,3700000,605200000,2985900000,4916800000,1692000000,1692000000,210900000,-277900000,,,,416300000,13982400000,12290400000,9065600000,-669900000,,605800000,605200000,5673,SWK,yearly
2017-12-30,,,1527800000,2800000,1227300000,2945200000,4825100000,1559900000,1559900000,303700000,-222600000,,,,300900000,12966600000,11406700000,8141500000,-32100000,,1226900000,1227300000,5673,SWK,yearly
2020-12-31,,,-7293000000,837000000,-5944000000,7961000000,10698000000,2737000000,2737000000,,-1457000000,,,,-1460000000,43337000000,40600000000,32639000000,-10030000000,4000000,-5833000000,-5973000000,5706,AIG,yearly
2019-12-31,,,5287000000,1752000000,3348000000,8319000000,15346000000,7027000000,7027000000,,-1417000000,,,,1166000000,49744000000,42717000000,34398000000,-1740000000,48000000,4121000000,3326000000,5706,AIG,yearly
2018-12-31,,,257000000,948000000,-6000000,8907000000,10856000000,1949000000,1949000000,,-1309000000,,,,154000000,47408000000,45459000000,36552000000,-1692000000,-42000000,103000000,-6000000,5706,AIG,yearly
2017-12-31,,,1466000000,537000000,-6084000000,8694000000,11596000000,2902000000,2902000000,,-1168000000,,,,7526000000,49448000000,46546000000,37852000000,-1436000000,4000000,-6060000000,-6084000000,5706,AIG,yearly
2020-12-31,227798000,,4907638000,,3806267000,802967000,1435922000,405157000,405157000,,-21861000,,,,1101371000,2545626000,2140469000,1109704000,4502481000,,3806267000,3806267000,5711,BIO,yearly
2019-12-31,196610000,,2261081000,,1758675000,810225000,1261696000,254861000,254861000,,-23416000,,,,502406000,2311659000,2056798000,1049963000,2006220000,,1758675000,1758675000,5711,BIO,yearly
2018-12-31,199196000,,512659000,,365614000,834783000,1227251000,193272000,193272000,,-23962000,,,,147045000,2289415000,2096143000,1062164000,319387000,,365614000,365614000,5711,BIO,yearly
2017-12-31,234657000,,97805000,,122249000,802790000,1189803000,152356000,152356000,,-23014000,,,,-24444000,2160153000,2007797000,970350000,-54551000,,122249000,122249000,5711,BIO,yearly
2020-12-31,2642000000,,5065000000,44000000,4202000000,3931000000,10001000000,3428000000,3428000000,,-209000000,,,,863000000,21454000000,18026000000,11453000000,1637000000,,4202000000,4202000000,5715,PYPL,yearly
2019-12-31,2085000000,,2998000000,44000000,2459000000,3112000000,7987000000,2797000000,2797000000,-7000000.0,-115000000,,,,539000000,17772000000,14975000000,9785000000,201000000,,2459000000,2459000000,5715,PYPL,yearly
2018-12-31,1831000000,,2376000000,44000000,2057000000,2855000000,7189000000,2219000000,2219000000,284000000.0,-77000000,,,,319000000,15451000000,13232000000,8262000000,157000000,,2057000000,2057000000,5715,PYPL,yearly
2017-12-31,1740000000,,2200000000,44000000,1795000000,2370000000,6399000000,2197000000,2197000000,92000000.0,-7000000,,,,405000000,13094000000,10897000000,6695000000,3000000,,1795000000,1795000000,5715,PYPL,yearly
2020-12-31,1002900000,,569000000,,603400000,1378400000,5516400000,2881400000,2881400000,,-104700000,,,,-34400000,6069900000,3188500000,553500000,-2312400000,,603400000,603400000,5716,ALXN,yearly
2019-12-31,886000000,,2178800000,,2404300000,1261100000,4596600000,2139900000,2139900000,,-77800000,,,,-225500000,4991100000,2851200000,394500000,38900000,,2404300000,2404300000,5716,ALXN,yearly
2018-12-31,730300000,,242200000,,77600000,1092400000,3762700000,1619900000,1619900000,,-98200000,,,,164600000,4131200000,2511300000,368500000,-1377700000,,77600000,77600000,5716,ALXN,yearly
2017-12-31,862100000,,547800000,,443300000,1083500000,3249000000,983300000,983300000,,-98400000,,,,104500000,3551100000,2567800000,302100000,-435500000,,443300000,443300000,5716,ALXN,yearly
2020-12-31,,,293781000,,355766000,618498000,2071093000,327140000,327140000,871406000,-554000,,,,-61985000,5984634000,5657494000,3913541000,-33359000,,355766000,355766000,5728,CMG,yearly
2019-12-31,,,458285000,,350158000,583900000,1903321000,479509000,479509000,616026000,-1853000,,,,108127000,5586369000,5106860000,3683048000,-21224000,,350158000,350158000,5728,CMG,yearly
2018-12-31,,,268436000,,176553000,460103000,1591023000,352059000,352059000,568336000,-536000,,,,91883000,4864985000,4512926000,3273962000,-83623000,,176553000,176553000,5728,CMG,yearly
2017-12-31,,,275743000,,176253000,402733000,1407860000,284139000,284139000,545299000,-364000,,,,99490000,4476412000,4192273000,3068552000,-8396000,,176253000,176253000,5728,CMG,yearly
2020-12-31,,,3237000000,,2697000000,4509000000,8085000000,3576000000,3576000000,,-339000000,,,,540000000,31981000000,28405000000,23896000000,-339000000,,2697000000,2678000000,5731,TRV,yearly
2019-12-31,,,3138000000,,2622000000,4365000000,7847000000,3482000000,3482000000,,-344000000,,,,516000000,31581000000,28099000000,23734000000,-344000000,,2622000000,2603000000,5731,TRV,yearly
2018-12-31,,,2961000000,,2523000000,4297000000,7610000000,3313000000,3313000000,,-352000000,,,,438000000,30282000000,26969000000,22672000000,-352000000,,2523000000,2504000000,5731,TRV,yearly
2017-12-31,,,2730000000,,2056000000,4170000000,7269000000,3099000000,3099000000,,-369000000,,,,674000000,28902000000,25803000000,21633000000,-369000000,,2056000000,2041000000,5731,TRV,yearly
2020-12-31,,,571346000,4791000,445596000,975074000,1660847000,609069000,609069000,,-45013000,,,,119387000,11202672000,10593603000,9541825000,-37723000,,451959000,445596000,5737,PWR,yearly
2019-12-31,,,572287000,3539000,402044000,955991000,1600252000,582170000,582170000,,-66890000,,,,165472000,12112153000,11529983000,10511901000,-9883000,,406815000,402044000,5737,PWR,yearly
2018-12-31,,,457666000,1294000,293346000,856274000,1479964000,579696000,579696000,,-36945000,,,,161659000,11171423000,10591727000,9691459000,-122030000,,296007000,293346000,5737,PWR,yearly
2017-12-31,,,353757000,4058000,314978000,777920000,1241860000,431735000,431735000,,-20946000,,,,35532000,9466478000,9034743000,8224618000,-77978000,,318225000,314978000,5737,PWR,yearly
2020-01-31,,,2201730000,,1712555000,6152157000,8489061000,2336904000,2336904000,,-100574000,,,,489175000,27753973000,25417069000,19264912000,-135174000,,1712555000,1712555000,5795,DG,yearly
2019-02-01,,,2015416000,,1589472000,5683464000,7803870000,2120406000,2120406000,,-99871000,,,,425944000,25625043000,23504637000,17821173000,-104990000,,1589472000,1589472000,5795,DG,yearly
2018-02-02,,,1907280000,,1538960000,5205741000,7221359000,2015618000,2015618000,,-97036000,,,,368320000,23470967000,21455349000,16249608000,-108338000,,1538960000,1538960000,5795,DG,yearly
2017-02-03,,,1965628000,,1251133000,4712889000,6782638000,2069749000,2069749000,,-97821000,,,,714495000,21986598000,19916849000,15203960000,-104121000,,1251133000,1251133000,5795,DG,yearly
2020-12-31,,,10969000000,1936000000,8056000000,7332000000,19125000000,11720000000,11720000000,,-728000000,,,,2377000000,28694000000,16974000000,9569000000,-751000000,,8592000000,8036000000,5843,PM,yearly
2019-12-31,,,10021000000,1978000000,7185000000,8168000000,19292000000,11058000000,11058000000,,-796000000,,,,2293000000,29805000000,18747000000,10513000000,-1037000000,,7728000000,7168000000,5843,PM,yearly
2018-12-31,,,10731000000,1720000000,7911000000,7449000000,18867000000,11336000000,11336000000,,-855000000,,,,2445000000,29625000000,18289000000,10758000000,-605000000,,8286000000,7895000000,5843,PM,yearly
2017-12-31,,,10648000000,1856000000,6035000000,6725000000,18316000000,11503000000,11503000000,,-1096000000,,,,4307000000,28748000000,17245000000,10432000000,-855000000,,6341000000,6021000000,5843,PM,yearly
2020-12-31,,,2519200000,,2030400000,5474300000,8682600000,2857800000,2857800000,37100000,-340400000,,,,488800000,18361700000,15503900000,9679100000,-338600000,,2030400000,2030400000,5845,SHW,yearly
2019-12-31,,,1981800000,,1541300000,5308600000,8036100000,2391700000,2391700000,23000000,-349300000,,,,440500000,17900800000,15509100000,9864700000,-409900000,,1541300000,1541300000,5845,SHW,yearly
2018-12-31,,,1359700000,,1108700000,5054700000,7418600000,1869500000,1869500000,176300000,-366700000,,,,251000000,17534500000,15665000000,10115900000,-509800000,,1108700000,1108700000,5845,SHW,yearly
2017-12-31,,,1469300000,,1727900000,4781900000,6718800000,1714700000,1714700000,15400000,-263500000,,,,-300200000,14983800000,13269100000,8265000000,-245400000,-41600000.0,1769500000,1727900000,5845,SHW,yearly
2020-09-30,274000000,,903000000,1086000000,631000000,5031000000,7411000000,2106000000,2106000000,,-240000000,,,,108000000,22317000000,20211000000,14906000000,-1203000000,,795000000,631000000,5852,JCI,yearly
2019-09-30,319000000,,1056000000,1063000000,5674000000,5223000000,7693000000,2151000000,2151000000,,-335000000,,,,-233000000,23968000000,21817000000,16275000000,-1095000000,4574000000.0,1289000000,5674000000,5852,JCI,yearly
2018-09-30,310000000,,1546000000,1294000000,2162000000,5440000000,7667000000,1917000000,1917000000,,-409000000,,,,197000000,23400000000,21483000000,15733000000,-371000000,987000000.0,1349000000,2162000000,5852,JCI,yearly
2017-09-30,307000000,,1151000000,1131000000,1611000000,5707000000,7530000000,1516000000,1516000000,,-446000000,,,,322000000,22835000000,21319000000,15305000000,-365000000,939000000.0,829000000,1611000000,5852,JCI,yearly
2020-04-30,,,1009000000,,827000000,1030000000,2127000000,1113000000,1113000000,-16000000,-82000000,,,,182000000,3363000000,2250000000,1236000000,-104000000,,827000000,827000000,5854,BF-B,yearly
2019-04-30,,,1042000000,,835000000,1059000000,2166000000,1116000000,1116000000,-9000000,-88000000,,,,207000000,3324000000,2208000000,1158000000,-74000000,,835000000,835000000,5854,BF-B,yearly
2018-04-30,,,977000000,,717000000,1179000000,2202000000,1030000000,1030000000,-7000000,-68000000,,,,260000000,3248000000,2218000000,1046000000,-53000000,,717000000,717000000,5854,BF-B,yearly
2017-04-30,,,933000000,,669000000,1050000000,2021000000,991000000,991000000,-20000000,-59000000,,,,264000000,2994000000,2003000000,973000000,-58000000,,669000000,669000000,5854,BF-B,yearly
2020-12-31,3984600000,,5052800000,-14200000,4000600000,2511500000,11639400000,4655300000,4655300000,232900000,-213100000,,,,992300000,13444600000,8789300000,1805200000,397500000,,4060500000,4000600000,5869,BIIB,yearly
2019-12-31,2264900000,,7046500000,-4100000,5888500000,2362900000,12422500000,7279100000,7279100000,241600000,-187400000,,,,1158000000,14377900000,7098800000,1955400000,-232600000,,5888500000,5888500000,5869,BIIB,yearly
2018-12-31,2597200000,,5899600000,-8000000,4430700000,2109100000,11636600000,6364100000,6364100000,185000000,-200600000,,,,1425600000,13452900000,7088800000,1816300000,-464500000,,4474000000,4430700000,5869,BIIB,yearly
2017-12-31,2253600000,,5128800000,-14700000,2539100000,1936400000,10643900000,5886300000,5886300000,112300000,-250800000,,,,2458700000,12273900000,6387600000,1630000000,-757500000,,2670100000,2539100000,5869,BIIB,yearly
2020-12-26,705685000,,1103410000,,992324000,721411000,2481336000,1054240000,1054240000,,,,,,111086000,4186573000,3132333000,1705237000,49170000,,992324000,992324000,5874,GRMN,yearly
2019-12-28,605366000,,987222000,,952486000,683024000,2233976000,945586000,945586000,,,,,,34736000,3757505000,2811919000,1523529000,41636000,,952486000,952486000,5874,GRMN,yearly
2018-12-29,567805000,,823247000,,694080000,633571000,1979719000,778343000,778343000,,,,,,129167000,3347444000,2569101000,1367725000,44904000,,694080000,694080000,5874,GRMN,yearly
2017-12-30,511634000,,697071000,,709007000,602670000,1797941000,683637000,683637000,,,,,,-11936000,3121560000,2437923000,1323619000,13434000,,709007000,709007000,5874,GRMN,yearly
2020-12-31,,,827171000,1718066000,770959000,133341000,1371205000,539760000,539760000,,-171609000,,,,0,1901429000,1361669000,530224000,287411000,,827171000,760791000,5879,ARE,yearly
2019-12-31,,,404047000,1300652000,363165000,108823000,1095940000,442505000,442505000,,-173675000,,,,0,1541432000,1098927000,445492000,-38458000,,404047000,350995000,5879,ARE,yearly
2018-12-31,,,402793000,552749000,379312000,90405000,953881000,385815000,385815000,,-157495000,,,,0,1335001000,949186000,381120000,16978000,,402793000,363983000,5879,ARE,yearly
2017-12-31,,,194204000,533503000,169093000,75009000,803808000,312016000,312016000,,-128645000,,,,0,1129417000,817401000,325609000,-117812000,,194204000,145395000,5879,ARE,yearly
2020-12-31,,,1893000000,2000000,1496000000,1578000000,5877000000,2628000000,2628000000,,-425000000,,,,397000000,15218000000,12590000000,9341000000,-735000000,,1496000000,1496000000,5882,WM,yearly
2019-12-31,,,2105000000,2000000,1670000000,1631000000,5975000000,2770000000,2770000000,,-411000000,,,,434000000,15455000000,12685000000,9480000000,-665000000,,1671000000,1670000000,5882,WM,yearly
2018-12-31,,,2376000000,1000000,1925000000,1453000000,5665000000,2735000000,2735000000,,-374000000,,,,453000000,14914000000,12179000000,9249000000,-359000000,,1923000000,1925000000,5882,WM,yearly
2017-12-31,,,2191000000,23000000,1949000000,1468000000,5464000000,2620000000,2620000000,,-368000000,,,,242000000,14485000000,11865000000,9021000000,-429000000,,1949000000,1949000000,5882,WM,yearly
2020-12-31,749007000,,991473000,,780088000,2937201000,4572847000,831044000,831044000,,-29080000,,,,211385000,5505788000,4674744000,932941000,160429000,,780088000,780088000,5900,CERN,yearly
2019-12-28,737136000,,654512000,,529454000,3046935000,4621557000,749669000,749669000,,-14469000,,,,125058000,5692598000,4942929000,1071041000,-95157000,,529454000,529454000,5900,CERN,yearly
2018-12-29,683663000,,800851000,,630059000,2883165000,4428977000,774785000,774785000,,-7987000,,,,170792000,5366325000,4591540000,937348000,26066000,,630059000,630059000,5900,CERN,yearly
2017-12-30,605046000,,967129000,,866978000,2632088000,4288181000,960471000,960471000,,-8012000,,,,100151000,5142272000,4181801000,854091000,6658000,,866978000,866978000,5900,CERN,yearly
2019-12-31,,,1906900000,346700000,1921100000,-120000000,6497700000,2868700000,2868700000,1234500000,-1072500000,,,,-12900000,15561400000,12692700000,9063700000,-961800000,,1919800000,1921100000,5905,AEP,yearly
2018-12-31,,,2046600000,100400000,1923800000,-124500000,6182600000,2877800000,2877800000,1142700000,-984400000,,,,115300000,16195700000,13317900000,10013100000,-831200000,,1931300000,1923800000,5905,AEP,yearly
2017-12-31,,,2898600000,26600000,1912600000,-45500000,6442300000,3431200000,3431200000,1059400000,-895000000,,,,969700000,15424900000,11993700000,8982600000,-532600000,,1928900000,1912600000,5905,AEP,yearly
2016-12-31,,,546800000,23100000,610900000,-43200000,6412000000,3474900000,3474900000,1018000000,-877200000,,,,-73700000,16380100000,12905200000,9968100000,-2928100000,-2500000.0,620500000,610900000,5905,AEP,yearly
2020-12-31,1150000000,,2616000000,,2197000000,1848000000,5826000000,2828000000,2828000000,,-99000000,,,,419000000,8086000000,5258000000,2260000000,-212000000,,2197000000,2197000000,5917,ATVI,yearly
2019-12-31,998000000,,1633000000,,1503000000,1658000000,4400000000,1744000000,1744000000,,-90000000,,,,130000000,6489000000,4745000000,2089000000,-111000000,,1503000000,1503000000,5917,ATVI,yearly
2018-12-31,1101000000,,1877000000,,1848000000,1884000000,4983000000,1998000000,1998000000,,-140000000,,,,29000000,7500000000,5502000000,2517000000,-121000000,,1848000000,1848000000,5917,ATVI,yearly
2017-12-31,1069000000,,1151000000,,273000000,2123000000,4516000000,1324000000,1324000000,,-162000000,,,,878000000,7017000000,5693000000,2501000000,-173000000,,273000000,273000000,5917,ATVI,yearly
2020-12-31,958400000,,265200000,,257800000,1169600000,2573700000,445700000,445700000,,-77000000,,,,7400000,4445100000,3999400000,1871400000,-180500000,,257800000,257800000,5920,JNPR,yearly
2019-12-31,955700000,,414400000,,345000000,1167000000,2616800000,494100000,494100000,,-88700000,,,,69400000,4445400000,3951300000,1828600000,-79700000,,345000000,345000000,5920,JNPR,yearly
2018-12-31,1003200000,,532700000,,566900000,1158500000,2741200000,579500000,579500000,7000000.0,-103200000,,,,-34200000,4647500000,4068000000,1906300000,-46800000,,566900000,566900000,5920,JNPR,yearly
2017-12-31,980700000,,811800000,,306200000,1175600000,3072100000,915800000,915800000,7000000.0,-101200000,,,,505600000,5027200000,4111400000,1955100000,-104000000,,306200000,306200000,5920,JNPR,yearly
2020-12-31,,,-425215000,1021224000,-297005000,159377000,832368000,273296000,273296000,,-229251000,,,,36630000,1612188000,1338892000,779820000,-698511000,,-461845000,-348843000,5948,VNO,yearly
2019-12-31,,,3437731000,1467863000,3147937000,169920000,1085584000,496557000,496557000,,-264083000,,,,103439000,2003565000,1507008000,917981000,2941174000,-30000.0,3334292000,3097497000,5948,VNO,yearly
2018-12-31,,,459598000,1426214000,449954000,141871000,1209391000,607847000,607847000,13103000.0,-347949000,,,,37633000,2172869000,1565022000,963478000,-148249000,638000.0,421965000,384788000,5948,VNO,yearly
2017-12-31,,,319731000,1654986000,227416000,150782000,1207632000,627461000,627461000,13103000.0,-345654000,,,,42375000,2096004000,1468543000,888372000,-307730000,-13228000.0,277356000,161971000,5948,VNO,yearly
2020-12-31,,,956564000,3590000,696140000,18436000,1219724000,940437000,940437000,203892000,,,,,258350000,10116481000,9176044000,8896757000,16127000,,698214000,696140000,5952,EXPD,yearly
2019-12-31,,,795794000,2191000,590395000,44002000,1047971000,766692000,766692000,186327000,,,,,203778000,8175426000,7408734000,7127455000,29102000,,592016000,590395000,5952,EXPD,yearly
2018-12-31,,,818329000,882000,618199000,45346000,1074301000,796563000,796563000,178373000,,,,,198539000,8138365000,7341802000,7064064000,21766000,,619790000,618199000,5952,EXPD,yearly
2017-12-31,,,718595000,2515000,489345000,44290000,932337000,696260000,696260000,142477000,,,,,228212000,6920948000,6224688000,5988611000,22335000,,490383000,489345000,5952,EXPD,yearly
2020-12-31,,,2766000000,129000000,2089000000,2153000000,6036000000,3143000000,3143000000,,-357000000,,,,658000000,6036000000,2893000000,0,-377000000,,2108000000,2089000000,5954,ICE,yearly
2019-12-31,,,2481000000,109000000,1933000000,1869000000,5202000000,2702000000,2702000000,,-285000000,,,,521000000,5202000000,2500000000,0,-221000000,,1960000000,1933000000,5954,ICE,yearly
2018-12-31,,,2520000000,101000000,1988000000,1780000000,4979000000,2613000000,2613000000,,-244000000,,,,500000000,4979000000,2366000000,0,-93000000,,2020000000,1988000000,5954,ICE,yearly
2017-12-31,,,2526000000,28000000,2526000000,1679000000,4638000000,2424000000,2424000000,,-187000000,,,,-28000000,4638000000,2214000000,0,102000000,,2554000000,2526000000,5954,ICE,yearly
2020-12-31,,,400782000,770650000,356402000,358181000,2238457000,512823000,512823000,1074000,-333021000,,,,38047000,3845980000,3333157000,1607523000,-112041000,,362735000,263346000,5960,DLR,yearly
2019-12-31,,,611216000,770253000,579761000,286397000,2024547000,635558000,635558000,14118000,-353057000,,,,11995000,3217308000,2581750000,1192761000,-24342000,,599221000,493011000,5960,DLR,yearly
2018-12-31,,,343199000,1015398000,331246000,236567000,1981474000,628093000,628093000,2818000,-321529000,,,,2084000,3079457000,2451364000,1097983000,-284894000,,341115000,249930000,5960,DLR,yearly
2017-12-31,,,264168000,754271000,248259000,211541000,1588833000,581851000,581851000,3077000,-258642000,,,,7901000,2483444000,1901593000,894611000,-317683000,,256267000,173148000,5960,DLR,yearly
2020-12-31,,,648225000,119290000,550559000,-56341000,1634653000,844493000,844493000,232123000,-247501000,,,,78173000,3586982000,2742489000,1952329000,-196268000,,570052000,550559000,5980,PNW,yearly
2019-12-31,,,542040000,122540000,538320000,-22989000,1487356000,694949000,694949000,224467000,-235251000,,,,-15773000,3471209000,2776260000,1983853000,-152909000,,557813000,538320000,5980,PNW,yearly
2018-12-31,,,664442000,125790000,511047000,-49791000,1578387000,823478000,823478000,222346000,-243465000,,,,133902000,3691247000,2867769000,2112860000,-159036000,,530540000,511047000,5980,PNW,yearly
2017-12-31,,,766221000,129040000,488456000,-24664000,1634888000,934427000,934427000,191007000,-219796000,,,,258272000,3565296000,2630869000,1930408000,-168206000,,507949000,488456000,5980,PNW,yearly
2020-06-30,2600000,,260400000,,220700000,570900000,983300000,409800000,409800000,,-126100000,,,,39700000,3094300000,2684500000,2111000000,-149400000,,220700000,173000000,5992,CTLT,yearly
2019-06-30,3300000,,160300000,,137400000,507200000,805100000,294600000,294600000,,-110900000,,,,22900000,2518000000,2223400000,1712900000,-134300000,,137400000,132000000,5992,CTLT,yearly
2018-06-30,6300000,,152000000,,83600000,458500000,752600000,287800000,287800000,,-111400000,,,,68400000,2463400000,2175600000,1710800000,-135800000,,83600000,83600000,5992,CTLT,yearly
2017-06-30,7000000,,135600000,,109800000,395600000,654600000,252000000,252000000,,-90100000,,,,25800000,2075400000,1823400000,1420800000,-116400000,,109800000,109800000,5992,CTLT,yearly
2020-09-30,441324000,,396397000,,307441000,1086244000,1942935000,415367000,415367000,,,,,,88956000,2350822000,1935455000,407887000,-18970000,,307441000,307441000,6020,FFIV,yearly
2019-09-30,408058000,,541111000,,427734000,952076000,1885870000,525736000,525736000,,,,,,113377000,2242447000,1716711000,356577000,15375000,,427734000,427734000,6020,FFIV,yearly
2018-09-30,366084000,,603760000,,453689000,824517000,1799926000,609325000,609325000,,,,,,150071000,2161407000,1552082000,361481000,-5565000,,453689000,453689000,6020,FFIV,yearly
2017-09-30,350365000,,575517000,,420761000,809126000,1736556000,577065000,577065000,,,,,,154756000,2090041000,1512976000,353485000,-1548000,,420761000,420761000,6020,FFIV,yearly
2020-12-31,,,982000000,,797000000,467000000,2085000000,1578000000,1578000000,40000000,-443000000,,,,185000000,7532000000,5954000000,5447000000,-596000000,,797000000,797000000,6068,WY,yearly
2019-12-31,,,-213000000,,-76000000,493000000,1142000000,615000000,615000000,34000000,-378000000,,,,-137000000,6554000000,5939000000,5412000000,-828000000,,-76000000,-76000000,6068,WY,yearly
2018-12-31,,,807000000,,748000000,678000000,1884000000,1146000000,1146000000,60000000,-375000000,,,,59000000,7476000000,6330000000,5592000000,-339000000,,748000000,748000000,6068,WY,yearly
2017-12-31,,,716000000,,582000000,459000000,1898000000,1415000000,1415000000,24000000,-393000000,,,,134000000,7196000000,5781000000,5298000000,-699000000,,582000000,582000000,6068,WY,yearly
2020-12-31,,,362200000,142000000,351100000,372100000,1668200000,1005500000,1005500000,,-192200000,,,,8000000,8064500000,7059000000,6396300000,-643300000,,354200000,351100000,6158,IPG,yearly
2019-12-31,,,878700000,214400000,656000000,419900000,1816500000,1118100000,1118100000,,-199300000,,,,204800000,8625100000,7507000000,6808600000,-239400000,,673900000,656000000,6158,IPG,yearly
2018-12-31,,,836900000,207500000,618900000,131500000,1378400000,1044000000,1044000000,,-123000000,,,,199200000,8031600000,6987600000,6653200000,-207100000,,637700000,618900000,6158,IPG,yearly
2017-12-31,,,841700000,286900000,554400000,118500000,1199900000,924300000,924300000,,-90800000,,,,271300000,7473500000,6549200000,6273600000,-82600000,,570400000,554400000,6158,IPG,yearly
2020-12-31,,,1132700000,,859100000,1427400000,2567800000,1140400000,1140400000,,-9700000,,,,273600000,5647300000,4506900000,3079500000,-7700000,,859100000,859100000,6163,FAST,yearly
2019-12-31,,,1043700000,,790900000,1459400000,2515400000,1056000000,1056000000,,-13900000,,,,252800000,5333700000,4277700000,2818300000,-12300000,,790900000,790900000,6163,FAST,yearly
2018-12-31,,,987000000,,751900000,1400200000,2398900000,998700000,998700000,,-12600000,,,,235100000,4965100000,3966400000,2566200000,-11700000,,751900000,751900000,6163,FAST,yearly
2017-12-31,,,873100000,,578600000,1282800000,2163600000,880800000,880800000,,-9100000,,,,294500000,4390500000,3509700000,2226900000,-7700000,,578600000,578600000,6163,FAST,yearly
2020-12-31,6333000000,,4637000000,129000000,5590000000,20119000000,35575000000,9707000000,9707000000,-584000000,-1288000000,,,,-864000000,73621000000,63914000000,38046000000,-5070000000,89000000,5501000000,5590000000,6176,IBM,yearly
2019-12-31,5936000000,,10166000000,144000000,9431000000,19767000000,36489000000,11400000000,11400000000,-614000000,-1344000000,,,,731000000,77147000000,65747000000,40658000000,-1234000000,-4000000,9435000000,9431000000,6176,IBM,yearly
2018-12-31,5379000000,,11342000000,134000000,8728000000,19366000000,36937000000,13218000000,13218000000,-1026000000,-723000000,,,,2619000000,79591000000,66373000000,42654000000,-1876000000,5000000,8723000000,8728000000,6176,IBM,yearly
2017-12-31,5590000000,,11400000000,131000000,5753000000,21137000000,36943000000,11682000000,11682000000,-1466000000,-615000000,,,,5642000000,79139000000,67457000000,42196000000,-282000000,-5000000,5758000000,5753000000,6176,IBM,yearly
2020-12-31,1862000000,,6706000000,64000000,5384000000,6751000000,15685000000,7072000000,7072000000,,-529000000,,,,1318000000,32184000000,25112000000,16499000000,-366000000,,5388000000,5384000000,6177,MMM,yearly
2019-12-31,1874000000,,5712000000,63000000,4570000000,6390000000,15400000000,7136000000,7136000000,,-448000000,,,,1130000000,32136000000,25000000000,16736000000,-1424000000,,4582000000,4570000000,6177,MMM,yearly
2018-12-31,1816000000,,7000000000,52000000,5349000000,6527000000,16110000000,7767000000,7767000000,,-350000000,,,,1637000000,32765000000,24998000000,16655000000,-767000000,,5363000000,5349000000,6177,MMM,yearly
2017-12-31,1862000000,,7548000000,59000000,4858000000,6493000000,15688000000,7333000000,7333000000,,-322000000,,,,2679000000,31657000000,24324000000,15969000000,215000000,,4869000000,4858000000,6177,MMM,yearly
2020-12-31,,,14022000000,758000000,11370000000,33147000000,58369000000,0,14022000000,11200000000,,,,,2592000000,58369000000,44347000000,0,0,-20000000,11430000000,10201000000,6245,C,yearly
2019-12-31,,,23901000000,704000000,19401000000,32354000000,66068000000,0,23901000000,9813000000,,,,,4430000000,66068000000,42167000000,0,0,-4000000,19471000000,18171000000,6245,C,yearly
2018-12-31,,,23445000000,854000000,18045000000,32216000000,65500000000,0,23445000000,9839000000,,,,,5357000000,65500000000,42055000000,0,0,-8000000,18088000000,16671000000,6245,C,yearly
2017-12-31,,,22761000000,932000000,-6798000000,32151000000,65272000000,0,23092000000,10029000000,,,,,29388000000,65272000000,42180000000,0,-331000000,-111000000,-6627000000,-8048000000,6245,C,yearly
2020-12-31,,,2503000000,1561000000,3932000000,,4499000000,2833000000,2833000000,,-1082000000,,,,249000000,11370000000,8537000000,6871000000,-330000000,1850000000,2254000000,3764000000,6247,SRE,yearly
2019-12-31,,,2313000000,1876000000,2197000000,132000000.0,4196000000,2495000000,2495000000,,-1078000000,,,,315000000,10829000000,8334000000,6633000000,-182000000,363000000,1998000000,2055000000,6247,SRE,yearly
2018-12-31,,,888000000,2110000000,1049000000,157000000.0,3679000000,2031000000,2031000000,,-887000000,,,,-49000000,10102000000,8071000000,6423000000,-1143000000,188000000,937000000,924000000,6247,SRE,yearly
2017-12-31,,,1319000000,2470000000,256000000,127000000.0,3599000000,2036000000,2036000000,,-623000000,,,,938000000,9640000000,7604000000,6041000000,-717000000,-31000000,381000000,256000000,6247,SRE,yearly
2020-12-26,119000000,,1030000000,140000000,356000000,3165000000,9171000000,5887000000,5887000000,,-1394000000,,,,669000000,26185000000,20298000000,17014000000,-4857000000,,361000000,356000000,6269,KHC,yearly
2019-12-28,112000000,,2661000000,126000000,1935000000,2515000000,8195000000,5568000000,5568000000,,-1361000000,,,,728000000,24977000000,19409000000,16782000000,-2907000000,,1933000000,1935000000,6269,KHC,yearly
2018-12-29,109000000,,-11321000000,121000000,-10192000000,2604000000,9115000000,6402000000,6402000000,,-1284000000,,,,-1067000000,26268000000,19866000000,17153000000,-17723000000,,-10254000000,-10192000000,6269,KHC,yearly
2017-12-30,93000000,,5450000000,213000000,10941000000,2079000000,9497000000,7325000000,7325000000,,-1234000000,,,,-5482000000,26076000000,18751000000,16579000000,-1875000000,,10932000000,10941000000,6269,KHC,yearly
2020-07-03,973000000,,1032000000,,1004000000,473000000,2845000000,1385000000,1385000000,,-201000000,,,,28000000,10509000000,9124000000,7664000000,-353000000,,1004000000,1004000000,6272,STX,yearly
2019-06-28,991000000,,1372000000,,2012000000,453000000,2932000000,1465000000,1465000000,,-224000000,,,,-640000000,10390000000,8925000000,7458000000,-93000000,,2012000000,2012000000,6272,STX,yearly
2018-06-29,1022000000,,1418000000,,1182000000,560000000,3365000000,1730000000,1730000000,,-236000000,,,,236000000,11184000000,9454000000,7819000000,-312000000,,1182000000,1182000000,6272,STX,yearly
2017-06-30,1232000000,,815000000,,772000000,606000000,3174000000,1232000000,1232000000,,-222000000,,,,43000000,10771000000,9539000000,7597000000,-417000000,,772000000,772000000,6272,STX,yearly
2019-12-31,1174000000,,687000000,,4700000000,3953000000,7632000000,1806000000,1806000000,,-473000000,,,,-4013000000,10735000000,8929000000,3103000000,-1119000000,,4700000000,4700000000,6318,BSX,yearly
2018-12-31,1113000000,,1422000000,,1671000000,3557000000,6993000000,1724000000,1724000000,,-241000000,,,,-249000000,9823000000,8099000000,2830000000,-302000000,,1671000000,1671000000,6318,BSX,yearly
2017-12-31,997000000,,932000000,,104000000,3281000000,6442000000,1599000000,1599000000,,-229000000,,,,828000000,9048000000,7449000000,2606000000,-667000000,,104000000,104000000,6318,BSX,yearly
2016-12-31,920000000,,177000000,,347000000,3083000000,5939000000,1391000000,1391000000,,-233000000,,,,-170000000,8386000000,6995000000,2447000000,-1214000000,,347000000,347000000,6318,BSX,yearly
2020-07-31,1392000000,,2198000000,,1826000000,2727000000,6323000000,2176000000,2176000000,,-14000000,,,,372000000,7679000000,5503000000,1356000000,22000000,,1826000000,1826000000,6332,INTU,yearly
2019-07-31,1233000000,,1881000000,,1557000000,2524000000,5637000000,1854000000,1854000000,,-15000000,,,,324000000,6784000000,4930000000,1147000000,27000000,,1557000000,1557000000,6332,INTU,yearly
2018-07-31,1186000000,,1566000000,,1329000000,2295000000,5062000000,1560000000,1560000000,,-20000000,,,,237000000,6025000000,4465000000,963000000,6000000,,1329000000,1329000000,6332,INTU,yearly
2017-07-31,998000000,,1390000000,,985000000,1968000000,4398000000,1418000000,1418000000,,-31000000,,,,405000000,5196000000,3778000000,798000000,-28000000,,985000000,985000000,6332,INTU,yearly
2020-07-25,6347000000,,13970000000,,11214000000,11073000000,31683000000,14122000000,14122000000,,-585000000,,,,2756000000,49301000000,35179000000,17618000000,-152000000,,11214000000,11214000000,6402,CSCO,yearly
2019-07-27,6577000000,,14571000000,,11621000000,11777000000,32666000000,14162000000,14162000000,,-859000000,,,,2950000000,51904000000,37742000000,19238000000,409000000,,11621000000,11621000000,6402,CSCO,yearly
2018-07-28,6332000000,,13039000000,,110000000,11345000000,30733000000,12835000000,12835000000,,-943000000,,,,12929000000,49330000000,36495000000,18597000000,204000000,,110000000,110000000,6402,CSCO,yearly
2017-07-29,6059000000,,12287000000,,9609000000,11167000000,30224000000,12739000000,12739000000,,-861000000,,,,2678000000,48005000000,35266000000,17781000000,-452000000,,9609000000,9609000000,6402,CSCO,yearly
2020-12-31,,,-2181000000,565000000,-1685000000,1334000000,1838000000,-1608000000,-1608000000,834000000,-536000000,,,,-38000000,3612000000,5220000000,1774000000,-573000000,,-2143000000,-1685000000,6413,LVS,yearly
2019-12-31,,,3772000000,1320000000,2698000000,1890000000,10887000000,3788000000,3788000000,3980000000,-555000000,,,,468000000,13739000000,9951000000,2852000000,-16000000,,3304000000,2698000000,6413,LVS,yearly
2018-12-31,,,3326000000,1061000000,2413000000,1732000000,10845000000,3901000000,3901000000,4090000000,-446000000,,,,375000000,13729000000,9828000000,2884000000,-575000000,,2951000000,2413000000,6413,LVS,yearly
2017-12-31,,,3054000000,1141000000,2808000000,1640000000,9999000000,3484000000,3484000000,3600000000,-327000000,,,,-209000000,12728000000,9244000000,2729000000,-430000000,,3263000000,2808000000,6413,LVS,yearly
2020-12-31,860000000,,-2897000000,566000000,-2951000000,2203000000,6875000000,1693000000,1693000000,,-767000000,,,,-23000000,20397000000,18704000000,13522000000,-4590000000,-49000000,-2874000000,-2951000000,6448,DD,yearly
2019-12-31,955000000,,-474000000,569000000,498000000,2589000000,7709000000,3115000000,3115000000,,-668000000,,,,140000000,21512000000,18397000000,13803000000,-3589000000,1214000000,-614000000,497000000,6448,DD,yearly
2018-12-31,1070000000,,600000000,1608000000,3845000000,2932000000,8920000000,3874000000,3874000000,,-55000000,,,,195000000,22594000000,18720000000,13674000000,-3274000000,3595000000,405000000,3828000000,6448,DD,yearly
2017-12-31,657000000,,-1525000000,1597000000,1159000000,1580000000,3687000000,945000000,945000000,,-1057000000,,,,-1758000000,11672000000,10727000000,7985000000,-2470000000,1058000000,233000000,1146000000,6448,DD,yearly
2020-12-31,768000000,,2071000000,570000000,1225000000,1368000000,5185000000,2648000000,2648000000,,-827000000,,,,777000000,38542000000,35894000000,33357000000,-577000000,,1294000000,1216000000,6459,DOW,yearly
2019-12-31,765000000,,-1247000000,553000000,-1359000000,1385000000,6330000000,3761000000,3761000000,,-933000000,,,,470000000,42951000000,39190000000,36621000000,-5008000000,445000000.0,-1717000000,-1365000000,6459,DOW,yearly
2018-12-31,800000000,,3749000000,1138000000,4641000000,1659000000,8530000000,5602000000,5602000000,,-1063000000,,,,809000000,49604000000,44002000000,41074000000,-1853000000,1835000000.0,2940000000,4641000000,6459,DOW,yearly
2017-12-31,803000000,,237000000,1138000000,465000000,2471000000,7380000000,3706000000,3706000000,,-914000000,,,,1524000000,43730000000,40024000000,36350000000,-3469000000,1882000000.0,-1287000000,451000000,6459,DOW,yearly
2020-04-24,847000000,,944000000,,819000000,1845000000,3623000000,931000000,931000000,,-55000000,,,,125000000,5412000000,4481000000,1789000000,13000000,,819000000,819000000,6463,NTAP,yearly
2019-04-26,827000000,,1268000000,,1169000000,1935000000,3945000000,1183000000,1183000000,,-58000000,,,,99000000,6146000000,4963000000,2201000000,85000000,,1169000000,1169000000,6463,NTAP,yearly
2018-04-27,783000000,,1199000000,,116000000,1986000000,3709000000,940000000,940000000,,-62000000,,,,1083000000,5919000000,4979000000,2210000000,259000000,,116000000,116000000,6463,NTAP,yearly
2017-04-28,779000000,,621000000,,481000000,1922000000,3364000000,663000000,663000000,,-52000000,,,,140000000,5491000000,4828000000,2127000000,-42000000,,481000000,481000000,6463,NTAP,yearly
2020-06-30,,,-1524000000,807000000,-1269000000,3065000000,4081000000,372000000,372000000,,-25000000,,,,21000000,9008000000,8636000000,4927000000,-1896000000,,-1545000000,-1269000000,6468,NWS,yearly
2019-06-30,,,354000000,1167000000,155000000,3177000000,4435000000,599000000,599000000,,-59000000,,,,126000000,10074000000,9475000000,5639000000,-245000000,,228000000,155000000,6468,NWS,yearly
2018-06-30,,,-1089000000,1186000000,-1514000000,3081000000,4120000000,567000000,567000000,,-7000000,,,,355000000,9024000000,8457000000,4904000000,-1656000000,,-1444000000,-1516000000,6468,NWS,yearly
2017-06-30,,,-615000000,284000000,-738000000,2710000000,3610000000,451000000,451000000,,-7000000,,,,28000000,8139000000,7688000000,4529000000,-1066000000,,-643000000,-740000000,6468,NWS,yearly
2020-10-31,398000000,,842000000,,719000000,1395000000,2837000000,1044000000,1044000000,,-78000000,,,,123000000,5339000000,4295000000,2502000000,-202000000,,719000000,719000000,6474,A,yearly
2019-10-31,404000000,,919000000,,1071000000,1358000000,2805000000,1043000000,1043000000,,-74000000,,,,-152000000,5163000000,4120000000,2358000000,-124000000,,1071000000,1071000000,6474,A,yearly
2018-10-31,387000000,,946000000,4000000.0,316000000,1322000000,2680000000,971000000,971000000,,-75000000,,,,630000000,4914000000,3943000000,2234000000,-25000000,,316000000,316000000,6474,A,yearly
2017-10-31,341000000,,803000000,4000000.0,684000000,1205000000,2399000000,853000000,853000000,,-79000000,,,,119000000,4472000000,3619000000,2073000000,-50000000,,684000000,684000000,6474,A,yearly
2020-12-31,,,1212000000,3000000,933000000,1356000000,2903000000,1345000000,1345000000,,-101000000,,,,279000000,5627000000,4282000000,2724000000,-133000000,,933000000,933000000,6475,NDAQ,yearly
2019-12-31,,,1019000000,3000000,774000000,1208000000,2535000000,1137000000,1137000000,,-124000000,,,,245000000,4262000000,3125000000,1727000000,-118000000,,774000000,774000000,6475,NDAQ,yearly
2018-12-31,,,1064000000,3000000,458000000,1235000000,2526000000,1081000000,1081000000,,-150000000,,,,606000000,4277000000,3196000000,1751000000,-17000000,,458000000,458000000,6475,NDAQ,yearly
2017-12-31,,,872000000,3000000,729000000,1155000000,2411000000,1068000000,1068000000,,-143000000,,,,143000000,3948000000,2880000000,1537000000,-196000000,,729000000,729000000,6475,NDAQ,yearly
2020-12-31,,,1558872000,155570000,1205167000,-44400000,4447438000,2044234000,2044234000,1288545000,-538452000,,,,346186000,8904430000,6860196000,4456992000,-485362000,,1212686000,1205167000,6500,ES,yearly
2019-12-31,,,1190071000,155570000,909053000,-31300000,4123197000,1861435000,1861435000,1212404000,-533197000,,,,273499000,8526470000,6665035000,4403273000,-671364000,,916572000,909053000,6500,ES,yearly
2018-12-31,,,1329491000,155570000,1033000000,-60800000,3974019000,1760730000,1760730000,1202133000,-498805000,,,,288972000,8448201000,6687471000,4474182000,-431239000,,1040519000,1033000000,6500,ES,yearly
2017-12-31,,,1574407000,155570000,987996000,-29900000,3909629000,1918149000,1918149000,1157592000,-421755000,,,,578892000,7751952000,5833803000,3842323000,-343742000,,995515000,987996000,6500,ES,yearly
2020-12-31,,,2465000000,88000000,1969000000,1844000000,5174000000,2917000000,2917000000,,-334000000,,,,448000000,11066000000,8149000000,5892000000,-452000000,1000000,2017000000,1969000000,6510,AON,yearly
2019-12-31,,,1871000000,74000000,1532000000,2213000000,4968000000,2191000000,2191000000,,-307000000,,,,297000000,11013000000,8822000000,6045000000,-320000000,-1000000,1574000000,1532000000,6510,AON,yearly
2018-12-31,,,1246000000,68000000,1134000000,2279000000,4668000000,1796000000,1796000000,,-278000000,,,,146000000,10770000000,8974000000,6102000000,-550000000,74000000,1100000000,1134000000,6510,AON,yearly
2017-12-31,,,685000000,65000000,1226000000,1867000000,4208000000,1856000000,1856000000,,-282000000,,,,250000000,9998000000,8142000000,5790000000,-1171000000,828000000,435000000,1226000000,6510,AON,yearly
2020-12-31,,,557000000,200000000,614000000,24000000,1463000000,716000000,716000000,108000000,-285000000,,,,-57000000,3416000000,2700000000,1953000000,-159000000,,614000000,614000000,6512,LNT,yearly
2019-12-31,,,626000000,200000000,557000000,32000000,1456000000,746000000,746000000,111000000,-283000000,,,,69000000,3648000000,2902000000,2192000000,-120000000,,557000000,557000000,6512,LNT,yearly
2018-12-31,,,560000000,200000000,512000000,17000000,1305000000,677000000,677000000,104000000,-257000000,,,,48000000,3534000000,2857000000,2229000000,-117000000,,512000000,512000000,6512,LNT,yearly
2017-12-31,,,522600000,200000000,457300000,29700000,1238600000,641500000,641500000,105600000,-225800000,,,,66700000,3382200000,2740700000,2143600000,-118900000,1400000.0,455900000,457300000,6512,LNT,yearly
2020-12-31,,,-3140000000,,-2701000000,543000000,6794000000,-1729000000,-1729000000,1002000000,-806000000,,,,-485000000,19216000000,20945000000,12422000000,-1411000000,,-2655000000,-2701000000,6517,COP,yearly
2019-12-31,,,9524000000,69000000.0,7189000000,639000000,16182000000,7435000000,7435000000,1275000000,-778000000,,,,2267000000,33346000000,25911000000,17164000000,2089000000,,7257000000,7189000000,6517,COP,yearly
2018-12-31,,,9973000000,125000000.0,6257000000,585000000,17984000000,9673000000,9673000000,1401000000,-735000000,,,,3668000000,37491000000,27818000000,19507000000,300000000,,6305000000,6257000000,6517,COP,yearly
2017-12-31,,,-2615000000,194000000.0,-855000000,576000000,12241000000,2535000000,2535000000,1171000000,-1098000000,,,,-1822000000,29878000000,27343000000,17637000000,-5150000000,,-793000000,-855000000,6517,COP,yearly
2020-08-31,,,784000000,498000000,456000000,25026000000,28017000000,2991000000,2991000000,,-584000000,,,,360000000,139537000000,136546000000,111520000000,-2207000000,,424000000,456000000,6569,WBA,yearly
2019-08-31,,,4550000000,641000000,3982000000,24998000000,30076000000,5078000000,5078000000,,-676000000,,,,588000000,136866000000,131788000000,106790000000,-528000000,,3962000000,3982000000,6569,WBA,yearly
2018-08-31,,,6029000000,682000000,5024000000,24638000000,30792000000,6154000000,6154000000,,-577000000,,,,998000000,131537000000,125383000000,100745000000,-125000000,,5031000000,5024000000,6569,WBA,yearly
2017-08-31,,,4861000000,808000000,4078000000,23618000000,29162000000,5544000000,5544000000,,-643000000,,,,760000000,118214000000,112670000000,89052000000,-683000000,,4101000000,4078000000,6569,WBA,yearly
2019-12-31,518800000,,154400000,,16800000,2499600000,4551900000,1533500000,1533500000,,-517300000,,,,137600000,11500500000,9967000000,6948600000,-1379100000,,16800000,16800000,6624,VTRS,yearly
2018-12-31,586300000,,298400000,,352500000,2397300000,4572000000,1588400000,1588400000,,-542300000,,,,-54100000,11433900000,9845500000,6861900000,-1290000000,,352500000,352500000,6624,VTRS,yearly
2017-12-31,665600000,,903000000,,696000000,2564000000,4976200000,1746600000,1746600000,,-534600000,,,,207000000,11907700000,10161100000,6931500000,-843600000,,696000000,696000000,6624,VTRS,yearly
2016-12-31,697800000,,121700000,1400000.0,480000000,2351400000,4998500000,1949300000,1949300000,,-454800000,,,,-358300000,11076900000,9127600000,6078400000,-1827600000,,480000000,480000000,6624,VTRS,yearly
2020-12-31,580000000,,-11298000000,418000000,-10518000000,365000000,2601000000,1656000000,1656000000,,-563000000,,,,-812000000,23601000000,21945000000,21000000000,-12954000000,,-10486000000,-10518000000,6642,SLB,yearly
2019-12-31,717000000,,-10418000000,416000000,-10137000000,511000000,4197000000,2969000000,2969000000,,-609000000,,,,-311000000,32917000000,29948000000,28720000000,-13387000000,,-10107000000,-10137000000,6642,SLB,yearly
2018-12-31,702000000,,2624000000,424000000,2138000000,444000000,4337000000,3191000000,3191000000,,-575000000,,,,447000000,32815000000,29624000000,28478000000,-567000000,,2177000000,2138000000,6642,SLB,yearly
2017-12-31,787000000,,-1183000000,419000000,-1505000000,432000000,4142000000,2923000000,2923000000,,-566000000,,,,330000000,30440000000,27517000000,26298000000,-4106000000,,-1513000000,-1505000000,6642,SLB,yearly
2020-12-31,,,1078033000,,901248000,431008000,1574099000,1143091000,1143091000,,-39458000,,,,176785000,7562791000,6419700000,5988692000,-65058000,,901248000,901248000,6660,NVR,yearly
2019-12-31,,,1025795000,,878539000,447547000,1497677000,1050130000,1050130000,,-24335000,,,,147256000,7425585000,6375455000,5927908000,-24335000,,878539000,878539000,6660,NVR,yearly
2018-12-31,,,959732000,,797197000,428874000,1412642000,983768000,983768000,,-24036000,,,,162535000,7187106000,6203338000,5774464000,-24036000,,797197000,797197000,6660,NVR,yearly
2017-12-31,,,846911000,,537521000,392272000,1262220000,869948000,869948000,,-23037000,,,,309390000,6320226000,5450278000,5058006000,-23037000,,537521000,537521000,6660,NVR,yearly
2020-12-31,,,1435000000,,1141000000,3383000000,5414000000,0,1590000000,441000000,,,,,294000000,5954000000,4364000000,540000000,-155000000,,1141000000,1104000000,6666,DFS,yearly
2019-12-31,,,3835000000,,2957000000,3481000000,7819000000,0,3931000000,407000000,,,,,878000000,8228000000,4297000000,409000000,-96000000,,2957000000,2908000000,6666,DFS,yearly
2018-12-31,,,3597000000,,2742000000,3258000000,7324000000,0,3680000000,386000000,,,,,855000000,7674000000,3994000000,350000000,-83000000,,2742000000,2689000000,6666,DFS,yearly
2017-12-31,,,3537000000,,2099000000,3042000000,7003000000,0,3626000000,335000000,,,,,1438000000,7318000000,3692000000,315000000,-89000000,,2099000000,2031000000,6666,DFS,yearly
2020-12-31,210166000,,285004000,,212584000,379730000,947013000,357117000,357117000,,-27240000,,,,72420000,1923689000,1566572000,976676000,-72113000,,212584000,212584000,6671,FLIR,yearly
2019-12-31,203611000,,241916000,,171597000,417616000,935286000,314059000,314059000,,-27711000,,,,70319000,1887026000,1572967000,951740000,-72143000,,171597000,171597000,6671,FLIR,yearly
2018-12-31,174962000,,307103000,,282425000,389093000,904572000,340517000,340517000,,-16147000,,,,24678000,1775686000,1435169000,871114000,-33414000,,282425000,282425000,6671,FLIR,yearly
2017-12-31,170735000,,279065000,,107223000,373867000,858776000,314174000,314174000,,-16804000,,,,171842000,1800434000,1486260000,941658000,-35109000,,107223000,107223000,6671,FLIR,yearly
2020-09-30,,,2983000000,281500000,2373700000,1683100000,4622000000,2938900000,2938900000,,,,,,602500000,20311100000,17372200000,15689100000,44100000,,2380500000,2373700000,6698,DHI,yearly
2019-09-30,,,2125300000,274200000,1618500000,1539500000,3650600000,2111100000,2111100000,,,,,,506700000,17592900000,15481800000,13942300000,14200000,,1618600000,1618500000,6698,DHI,yearly
2018-09-30,,,2060000000,174500000,1460300000,1404200000,3462800000,2058600000,2058600000,,,,,,597700000,16068000000,14009400000,12605200000,1400000,,1462300000,1460300000,6698,DHI,yearly
2017-09-30,,,1602100000,500000,1038400000,1232300000,2834800000,1602500000,1602500000,,,,,,563700000,14091000000,12488500000,11256200000,-400000,,1038400000,1038400000,6698,DHI,yearly
2021-01-31,,,20564000000,6233000000,13510000000,115908000000,138836000000,22928000000,22928000000,,-2315000000,,,,6858000000,559151000000,536223000000,420315000000,-2364000000,,13706000000,13510000000,6707,WMT,yearly
2020-01-31,,,20116000000,6883000000,14881000000,107891000000,129359000000,21468000000,21468000000,,-2599000000,,,,4915000000,523964000000,502496000000,394605000000,-1352000000,,15201000000,14881000000,6707,WMT,yearly
2019-01-31,,,11460000000,7138000000,6670000000,106987000000,129104000000,22117000000,22117000000,,-2346000000,,,,4281000000,514405000000,492288000000,385301000000,-10657000000,,7179000000,6670000000,6707,WMT,yearly
2018-01-31,,,15123000000,2953000000,9862000000,106010000000,126947000000,20937000000,20937000000,,-2330000000,,,,4600000000,500343000000,479406000000,373396000000,-5814000000,,10523000000,9862000000,6707,WMT,yearly
2020-12-31,,,2793000000,156000000,2016000000,,7434000000,3666000000,3666000000,3768000000,-515000000,,,,747000000,17224000000,13558000000,9790000000,-873000000,,2046000000,2016000000,6751,MMC,yearly
2019-12-31,,,2439000000,150000000,1742000000,,7410000000,3514000000,3514000000,3896000000,-524000000,,,,666000000,16652000000,13138000000,9242000000,-1075000000,,1773000000,1742000000,6751,MMC,yearly
2018-12-31,,,2244000000,73000000,1650000000,,6560000000,2983000000,2983000000,3577000000,-290000000,,,,574000000,14950000000,11967000000,8390000000,-739000000,,1670000000,1650000000,6751,MMC,yearly
2017-12-31,,,2643000000,83000000,1492000000,,6140000000,2856000000,2856000000,3284000000,-237000000,,,,1133000000,14024000000,11168000000,7884000000,-213000000,2000000.0,1510000000,1492000000,6751,MMC,yearly
2020-12-31,,,4159000000,,4778000000,3420000000,7821000000,4401000000,4401000000,,-242000000,,,,-619000000,22147000000,17746000000,14326000000,-242000000,,4778000000,4778000000,6766,AFL,yearly
2019-12-31,,,4445000000,,3304000000,3089000000,7762000000,4673000000,4673000000,,-228000000,,,,1141000000,22307000000,17634000000,14545000000,-228000000,,3304000000,3304000000,6766,AFL,yearly
2018-12-31,,,3983000000,,2920000000,2988000000,7193000000,4205000000,4205000000,,-222000000,,,,1063000000,21758000000,17553000000,14565000000,-222000000,,2920000000,2920000000,6766,AFL,yearly
2017-12-31,,,4018000000,,4604000000,2780000000,7038000000,4258000000,4258000000,,-240000000,,,,-586000000,21667000000,17409000000,14629000000,-240000000,,4604000000,4604000000,6766,AFL,yearly
2020-12-31,,,-739054000,,-604572000,483823000,6076745000,1555764000,1555764000,477934000,-205266000,,,,-134482000,11032048000,9476284000,4955303000,-2294818000,,-604572000,-604572000,6813,EOG,yearly
2019-12-31,,,3545267000,,2734910000,489397000,9120166000,3666294000,3666294000,619889000,-185129000,,,,810357000,17076085000,13409791000,7955919000,-121027000,,2734910000,2734910000,6813,EOG,yearly
2018-12-31,,,4240998000,,3419040000,426969000,9592707000,4343805000,4343805000,938121000,-245052000,,,,821958000,17266477000,12922672000,7673770000,-102807000,,3419040000,3419040000,6813,EOG,yearly
2017-12-31,,,661182000,,2582579000,434467000,6023377000,1069738000,1069738000,524834000,-274372000,,,,-1921397000,11287588000,10217850000,5264211000,-408556000,,2582579000,2582579000,6813,EOG,yearly
2020-12-31,,,-11453000000,,-8885000000,513000000,-5536000000,-11058000000,-11058000000,2969000000,-1227000000,,,,-2568000000,17337000000,28395000000,22873000000,-395000000,,-8885000000,-8885000000,6833,AAL,yearly
2019-12-31,,,2256000000,,1686000000,1602000000,12560000000,3889000000,3889000000,5087000000,-1095000000,,,,570000000,45768000000,41879000000,33208000000,-1633000000,,1686000000,1686000000,6833,AAL,yearly
2018-12-31,,,1884000000,,1412000000,1520000000,12204000000,3757000000,3757000000,5088000000,-1056000000,,,,472000000,44541000000,40784000000,32337000000,-1873000000,,1412000000,1412000000,6833,AAL,yearly
2017-12-31,,,3395000000,,1282000000,1477000000,13192000000,5103000000,5103000000,4910000000,-1053000000,,,,2113000000,42622000000,37519000000,29430000000,-1708000000,,1282000000,1282000000,6833,AAL,yearly
2020-02-02,,,444000000,-2000000,417300000,4643500000,5401300000,757800000,757800000,,-120000000,,,,28900000,9909000000,9151200000,4507700000,-313800000,,415100000,417300000,6862,PVH,yearly
2019-02-03,,,775600000,200000,746400000,4388400000,5310500000,922100000,922100000,,-120800000,,,,31000000,9656800000,8734700000,4346300000,-146500000,,744600000,746400000,6862,PVH,yearly
2018-02-04,,,510200000,2000000,537800000,4167300000,4894400000,727100000,727100000,,-128500000,,,,-25900000,8914800000,8187700000,4020400000,-216900000,,536100000,537800000,6862,PVH,yearly
2017-01-29,,,674200000,2000000,549000000,3596800000,4370300000,773500000,773500000,,-120900000,,,,125500000,8203100000,7429600000,3832800000,-99300000,,548700000,549000000,6862,PVH,yearly
2020-06-27,,,-624200000,,-652100000,2920400000,3357300000,436900000,436900000,,-71500000,,,,27900000,4961400000,4524500000,1604100000,-1061100000,,-652100000,-652100000,6864,TPR,yearly
2019-06-29,,,766200000,,643400000,3167400000,4081500000,914100000,914100000,,-66900000,,,,122800000,6027100000,5113000000,1945600000,-147900000,,643400000,643400000,6864,TPR,yearly
2018-06-30,,,596800000,,397500000,2971800000,3964900000,993100000,993100000,,-86300000,,,,199300000,5880000000,4886900000,1915100000,-396300000,,397500000,397500000,6864,TPR,yearly
2017-07-01,,,759000000,,591000000,2271400000,3084000000,812600000,812600000,,-26800000,,,,168000000,4488300000,3675700000,1404300000,-53600000,,591000000,591000000,6864,TPR,yearly
2020-06-30,97300000,,811200000,61200000,612200000,1282800000,2535500000,1190800000,1190800000,-35400000,-206900000,,,,186900000,12467500000,11276700000,9932000000,-379600000,-7700000,624300000,611800000,6912,AMCR,yearly
2019-06-30,64000000,,608200000,65700000,430200000,815200000,1799100000,938300000,938300000,-18400000,-207900000,,,,171500000,9458200000,8519900000,7659100000,-330100000,700000,436700000,429400000,6912,AMCR,yearly
2018-06-30,72700000,,705400000,68800000,575200000,784200000,1856800000,1042900000,1042900000,-43000000,-210000000,,,,118800000,9319100000,8276200000,7462300000,-337500000,700000,586600000,573900000,6912,AMCR,yearly
2017-06-30,69100000,,729900000,69600000,564000000,912500000,1911800000,971300000,971300000,-41100000,-190900000,,,,148900000,9101000000,8129700000,7189200000,-241400000,700000,581000000,562300000,6912,AMCR,yearly
2020-04-24,2331000000,,4275000000,135000000,4959000000,11673000000,19644000000,5269000000,5269000000,371000000,-679000000,,,,-701000000,28913000000,23644000000,9269000000,-994000000,,4976000000,4959000000,6914,MDT,yearly
2019-04-26,2330000000,,5300000000,121000000,4724000000,11955000000,21493000000,6771000000,6771000000,437000000,-959000000,,,,557000000,30557000000,23786000000,9064000000,-1471000000,,4743000000,4724000000,6914,MDT,yearly
2018-04-27,2256000000,,5675000000,102000000,3104000000,10077000000,20914000000,6545000000,6545000000,213000000,-1146000000,,,,2580000000,29953000000,23408000000,9039000000,-870000000,,3095000000,3104000000,6914,MDT,yearly
2017-04-28,2193000000,,4602000000,122000000,4028000000,9715000000,20464000000,6110000000,6110000000,466000000,-1094000000,,,,578000000,29710000000,23600000000,9246000000,-1508000000,,4024000000,4028000000,6914,MDT,yearly
2020-12-31,,,1971000000,,1469000000,-262000000,4425000000,3093000000,3093000000,307000000,-1001000000,,,,502000000,7607000000,4514000000,3182000000,-1122000000,,1469000000,1468000000,6921,PPL,yearly
2019-12-31,,,2155000000,,1746000000,-316000000,4357000000,3161000000,3161000000,313000000,-994000000,,,,409000000,7769000000,4608000000,3412000000,-1006000000,,1746000000,1745000000,6921,PPL,yearly
2018-12-31,,,2285000000,,1827000000,-257000000,4258000000,3109000000,3109000000,312000000,-963000000,,,,458000000,7785000000,4676000000,3527000000,-824000000,,1827000000,1825000000,6921,PPL,yearly
2017-12-31,,,1912000000,,1128000000,-167000000,4201000000,3068000000,3068000000,292000000,-901000000,,,,784000000,7447000000,4379000000,3246000000,-1320000000,,1128000000,1126000000,6921,PPL,yearly
2021-01-02,,,282000000,,309000000,962000000,1591000000,629000000,629000000,,-145000000,,,,-27000000,11651000000,11022000000,10060000000,-347000000,,309000000,309000000,6935,TXT,yearly
2020-01-04,,,942000000,,815000000,1039000000,2199000000,1160000000,1160000000,,-146000000,,,,127000000,13630000000,12470000000,11431000000,-218000000,,815000000,815000000,6935,TXT,yearly
2018-12-29,,,1384000000,,1222000000,1199000000,2347000000,1148000000,1148000000,,-135000000,,,,162000000,13972000000,12824000000,11625000000,236000000,,1222000000,1222000000,6935,TXT,yearly
2017-12-30,,,762000000,,307000000,1305000000,2342000000,1037000000,1037000000,,-145000000,,,,456000000,14198000000,13161000000,11856000000,-275000000,1000000.0,306000000,307000000,6935,TXT,yearly
2020-12-31,5635700000,,7229900000,183600000,6193700000,5869400000,19056500000,7551400000,7551400000,,-359600000,,,,1036200000,24539800000,16988400000,5483300000,-321500000,,6193700000,6193700000,6946,LLY,yearly
2019-12-31,5595000000,,5265900000,92200000,8318400000,6003900000,17598300000,5999400000,5999400000,,-400600000,,,,628000000,22319500000,16320100000,4721200000,-733500000,3680500000.0,4637900000,8318400000,6946,LLY,yearly
2018-12-31,5051200000,,3680100000,1080400000,3232000000,5734600000,16811600000,6025800000,6025800000,,-242500000,,,,529500000,21493300000,15467500000,4681700000,-2345700000,81400000.0,3150600000,3232000000,6946,LLY,yearly
2017-12-31,5096200000,,2304800000,75700000,-204100000,5733400000,15526100000,4696500000,4696500000,,-225000000,,,,2391200000,19973800000,15277300000,4447700000,-2391700000,-117700000.0,-86400000,-204100000,6946,LLY,yearly
2020-06-30,145000000,,1185000000,,939000000,1654000000,3063000000,1256000000,1256000000,8000000,-99000000,,,,246000000,6721000000,5465000000,3658000000,-71000000,,939000000,939000000,6970,CLX,yearly
2019-06-30,136000000,,1024000000,,820000000,1482000000,2728000000,1110000000,1110000000,8000000,-97000000,,,,204000000,6214000000,5104000000,3486000000,-86000000,,820000000,820000000,6970,CLX,yearly
2018-06-30,132000000,,1054000000,,823000000,1407000000,2675000000,1125000000,1125000000,11000000,-85000000,,,,231000000,6124000000,4999000000,3449000000,-71000000,,823000000,823000000,6970,CLX,yearly
2017-06-30,135000000,,1033000000,,701000000,1409000000,2671000000,1109000000,1109000000,18000000,-88000000,,,,330000000,5973000000,4864000000,3302000000,-76000000,-2000000.0,703000000,701000000,6970,CLX,yearly
2020-09-27,5975000000,,5719000000,,5198000000,2074000000,14276000000,6227000000,6227000000,,-602000000,,,,521000000,23531000000,17304000000,9255000000,-508000000,,5198000000,5198000000,6995,QCOM,yearly
2019-09-29,5398000000,,7481000000,,4386000000,2195000000,15674000000,8081000000,8081000000,,-627000000,,,,3095000000,24273000000,16192000000,8599000000,-600000000,,4386000000,4386000000,6995,QCOM,yearly
2018-09-30,5625000000,,392000000,,-4964000000,2986000000,12367000000,3774000000,3774000000,-18000000.0,-768000000,,,,5356000000,22611000000,18837000000,10244000000,-3382000000,,-4964000000,-4964000000,6995,QCOM,yearly
2017-09-24,5455000000,,2987000000,,2445000000,2429000000,12466000000,4582000000,4582000000,-18000000.0,-494000000,,,,543000000,22258000000,17676000000,9792000000,-1595000000,,2444000000,2445000000,6995,QCOM,yearly
2020-12-31,6181000000,,3398000000,21000000,4616000000,9867000000,31747000000,15699000000,15699000000,,-2454000000,,,,-1224000000,45804000000,30105000000,14057000000,-12301000000,,4622000000,4556000000,7038,ABBV,yearly
2019-12-31,5377000000,,8426000000,21000000,7882000000,6763000000,25827000000,13697000000,13697000000,-10000000.0,-1784000000,,,,544000000,33266000000,19569000000,7439000000,-5271000000,,7882000000,7842000000,7038,ABBV,yearly
2018-12-31,5259000000,,5197000000,21000000,5687000000,7353000000,25035000000,11923000000,11923000000,500000000.0,-1348000000,,,,-490000000,32753000000,20830000000,7718000000,-6726000000,,5687000000,5657000000,7038,ABBV,yearly
2017-12-31,5007000000,,7727000000,21000000,5309000000,6248000000,21528000000,10273000000,10273000000,500000000.0,-1150000000,,,,2418000000,28216000000,17943000000,6688000000,-2546000000,,5309000000,5283000000,7038,ABBV,yearly
2020-12-31,,,727000000,14000000,482000000,3030000000,6207000000,1719000000,1719000000,171000000,-600000000,,,,245000000,20580000000,18861000000,14373000000,-992000000,,482000000,482000000,7049,IP,yearly
2019-12-31,,,1854000000,5000000,1225000000,3243000000,7108000000,2389000000,2389000000,170000000,-706000000,,,,634000000,22376000000,19987000000,15268000000,-535000000,,1220000000,1225000000,7049,IP,yearly
2018-12-31,,,2117000000,21000000,2012000000,3784000000,7751000000,2468000000,2468000000,171000000,-734000000,,,,445000000,23306000000,20838000000,15555000000,-351000000,345000000.0,1672000000,2012000000,7049,IP,yearly
2017-12-31,,,1025000000,19000000,2144000000,3585000000,6941000000,1844000000,1844000000,169000000,-758000000,,,,-1085000000,21743000000,19899000000,14802000000,-819000000,34000000.0,2110000000,2144000000,7049,IP,yearly
2020-12-31,,,411199000,32247000,395486000,73215000,1547022000,796769000,796769000,,-309336000,,,,14693000,1651625000,854856000,104603000,-385570000,,396506000,395486000,7060,O,yearly
2019-12-31,,,443636000,29702000,436482000,66483000,1403006000,742562000,742562000,,-290991000,,,,6158000,1491591000,749029000,88585000,-298926000,,437478000,436482000,7060,O,yearly
2018-12-31,,,369938000,32236000,363614000,65497000,1261512000,656235000,656235000,,-266020000,,,,5340000,1327838000,671603000,66326000,-286297000,,364598000,363614000,7060,O,yearly
2017-12-31,,,325362000,19207000,318798000,58446000,1146288000,589054000,589054000,,-247413000,,,,6044000,1215768000,626714000,69480000,-263692000,,319318000,301514000,7060,O,yearly
2021-01-03,12159000000,,16497000000,,14714000000,22084000000,54257000000,20014000000,20014000000,,-201000000,,,,1783000000,82584000000,62570000000,28327000000,-3517000000,,14714000000,14714000000,7064,JNJ,yearly
2019-12-29,11355000000,,17328000000,,15119000000,22178000000,54503000000,20970000000,20970000000,,-318000000,,,,2209000000,82059000000,61089000000,27556000000,-3642000000,,15119000000,15119000000,7064,JNJ,yearly
2018-12-30,10775000000,,17999000000,,15297000000,22540000000,54490000000,21175000000,21175000000,,-1005000000,,,,2702000000,81581000000,60406000000,27091000000,-3176000000,,15297000000,15297000000,7064,JNJ,yearly
2017-12-31,10594000000,,17673000000,,1300000000,21520000000,51011000000,18897000000,18897000000,,-934000000,,,,16373000000,76450000000,57553000000,25439000000,-1224000000,,1300000000,1300000000,7064,JNJ,yearly
2021-01-03,,,469700000,,401900000,688700000,1180900000,492200000,492200000,,-15300000,,,,67800000,3086200000,2594000000,1905300000,-22500000,,401900000,401900000,7065,TDY,yearly
2019-12-29,,,473700000,,402300000,741200000,1244100000,502900000,502900000,,-22000000,,,,71400000,3163600000,2660700000,1919500000,-29200000,,402300000,402300000,7065,TDY,yearly
2018-12-30,,,393900000,,333800000,677800000,1115700000,437900000,437900000,,-29200000,,,,60100000,2901800000,2463900000,1786100000,-44000000,,333800000,333800000,7065,TDY,yearly
2017-12-31,,,287000000,,227200000,629800000,988300000,358500000,358500000,,-33200000,,,,59800000,2603800000,2245300000,1615500000,-71500000,,227200000,227200000,7065,TDY,yearly
2020-08-02,92000000,,766000000,6000000,1628000000,1519000000,3008000000,1291000000,1291000000,106000000,-345000000,,,,174000000,8691000000,7400000000,5683000000,-525000000,1036000000,592000000,1628000000,7066,CPB,yearly
2019-07-28,88000000,,625000000,9000000,211000000,1383000000,2711000000,1117000000,1117000000,123000000,-356000000,,,,151000000,8107000000,6990000000,5396000000,-492000000,-263000000,474000000,211000000,7066,CPB,yearly
2018-07-29,91000000,,830000000,9000000,261000000,1177000000,2461000000,1404000000,1404000000,-211000000,-183000000,,,,106000000,6615000000,5211000000,4154000000,-574000000,-463000000,724000000,261000000,7066,CPB,yearly
2017-07-30,93000000,,1316000000,8000000,887000000,1090000000,2446000000,1503000000,1503000000,-240000000,-115000000,,,,392000000,5837000000,4334000000,3391000000,-187000000,-37000000,924000000,887000000,7066,CPB,yearly
2021-01-31,3598000000,,2561000000,,4072000000,11761000000,15814000000,455000000,455000000,,,,,,-1511000000,21252000000,20797000000,5438000000,2106000000,,4072000000,4072000000,7093,CRM,yearly
2020-01-31,2766000000,,706000000,,126000000,9594000000,12863000000,503000000,503000000,,-131000000.0,,,,580000000,17098000000,16595000000,4235000000,203000000,,126000000,126000000,7093,CRM,yearly
2019-01-31,1886000000,,983000000,,1110000000,7386000000,9831000000,559000000,559000000,,-154000000.0,,,,-127000000,13282000000,12723000000,3451000000,424000000,,1110000000,1110000000,7093,CRM,yearly
2018-01-31,1553000000,,420000000,,360000000,5760000000,7767000000,454000000,454000000,,-154000000.0,,,,60000000,10540000000,10086000000,2773000000,-34000000,,360000000,360000000,7093,CRM,yearly
2020-12-26,,,513811000,963912000,403794000,2246947000,2814343000,567396000,567396000,,-41377000,,,,95374000,10119141000,9551745000,7304798000,-53585000,986000,418437000,403794000,7143,HSIC,yearly
2019-12-28,,,884976000,919351000,694734000,2357920000,3090886000,732966000,732966000,,-50792000,,,,159515000,9985803000,9252837000,6894917000,152010000,-5957000,725461000,694734000,7143,HSIC,yearly
2018-12-29,,,557873000,892612000,535881000,2217273000,2910747000,693474000,693474000,,-76016000,,,,107432000,9417603000,8724129000,6506856000,-135601000,105164000,450441000,535881000,7143,HSIC,yearly
2017-12-30,,,627451000,845049000,406299000,2071576000,2746662000,675086000,675086000,,-51066000,,,,308975000,8883438000,8208352000,6136776000,-47635000,113127000,318476000,406299000,7143,HSIC,yearly
2020-12-31,,,1076000000,,1056000000,678000000,3891000000,1967000000,1967000000,-362000000,-689000000,,,,20000000,5840000000,3873000000,1949000000,-891000000,,1056000000,999000000,7168,CCI,yearly
2019-12-31,,,881000000,,860000000,614000000,3777000000,1591000000,1591000000,-362000000,-683000000,,,,21000000,5763000000,4172000000,1986000000,-710000000,,860000000,747000000,7168,CCI,yearly
2018-12-31,,,641000000,,622000000,563000000,3526000000,1436000000,1436000000,-362000000,-642000000,,,,19000000,5370000000,3934000000,1844000000,-795000000,,622000000,509000000,7168,CCI,yearly
2017-12-31,,,392000000,,366000000,426000000,2712000000,1045000000,1045000000,-362000000,-591000000,,,,26000000,4255000000,3210000000,1543000000,-653000000,,366000000,308000000,7168,CCI,yearly
2020-12-31,,,1048820000,1252343000,978844000,128394000,1983500000,816669000,816669000,,-514388000,,,,9968000,4605967000,3789298000,2622467000,232151000,,1038852000,978844000,7176,WELL,yearly
2019-12-31,,,1333367000,1442060000,1232432000,126549000,2412574000,1258952000,1258952000,,-555559000,,,,2957000,5121306000,3862354000,2708732000,74415000,,1330410000,1232432000,7176,WELL,yearly
2018-12-31,,,838424000,1378311000,804954000,126383000,2267482000,1190640000,1190640000,,-526592000,,,,8674000,4700499000,3509859000,2433017000,-352216000,,829750000,758250000,7176,WELL,yearly
2017-12-31,,,560741000,877499000,522774000,122008000,2169750000,1126022000,1126022000,,-484622000,,,,20128000,4316641000,3190619000,2146891000,-565281000,,540613000,463595000,7176,WELL,yearly
2020-12-31,,,672000000,,539000000,1415000000,2405000000,0,698000000,292000000,,,,,133000000,2405000000,1707000000,0,-26000000,,539000000,505000000,7180,ZION,yearly
2019-12-31,,,1053000000,,816000000,1450000000,2797000000,0,1113000000,234000000,,,,,237000000,2797000000,1684000000,0,-60000000,,816000000,777000000,7180,ZION,yearly
2018-12-31,,,1143000000,,884000000,1403000000,2821000000,0,1197000000,221000000,,,,,259000000,2821000000,1624000000,0,-54000000,,884000000,845000000,7180,ZION,yearly
2017-12-31,,,936000000,,592000000,1344000000,2585000000,0,1000000000,241000000,,,,,344000000,2585000000,1585000000,0,-64000000,,592000000,546000000,7180,ZION,yearly
2020-12-31,,,1129000000,,1079000000,537000000,7773000000,1685000000,1685000000,4277000000,-1037000000,,,,126000000,10607000000,8922000000,2834000000,-556000000,76000000,1003000000,1079000000,7195,FE,yearly
2019-12-31,,,1117000000,,912000000,723000000,7690000000,1836000000,1836000000,3911000000,-1007000000,,,,213000000,10844000000,9008000000,3154000000,-719000000,8000000,904000000,908000000,7195,FE,yearly
2018-12-31,,,1512000000,,1348000000,144000000,7764000000,2358000000,2358000000,4126000000,-1097000000,,,,490000000,11063000000,8705000000,3299000000,-846000000,326000000,1022000000,981000000,7195,FE,yearly
2017-12-31,,,1426000000,,-1724000000,155000000,7197000000,2326000000,2326000000,3689000000,-988000000,,,,1715000000,10740000000,8414000000,3543000000,-900000000,-1435000000,-289000000,-1724000000,7195,FE,yearly
2020-04-03,328000000,,819000000,,3887000000,1069000000,2097000000,620000000,620000000,,-196000000,,,,241000000,2490000000,1870000000,393000000,199000000,3309000000,578000000,3887000000,7214,NLOK,yearly
2019-03-29,420000000,,-107000000,,31000000,1122000000,2001000000,379000000,379000000,,-208000000,,,,3000000,2456000000,2077000000,455000000,-486000000,141000000,-110000000,31000000,7214,NLOK,yearly
2018-03-30,455000000,,244000000,,1138000000,1328000000,2096000000,226000000,226000000,,-256000000,,,,-720000000,2559000000,2333000000,463000000,18000000,174000000,964000000,1138000000,7214,NLOK,yearly
2017-03-31,823000000,,-262000000,,-106000000,2023000000,3166000000,173000000,173000000,,-208000000,,,,-26000000,4019000000,3846000000,853000000,-435000000,130000000,-236000000,-106000000,7214,NLOK,yearly
2020-11-01,4968000000,,2443000000,,2960000000,1932000000,17370000000,4250000000,4250000000,,-1777000000,,,,-518000000,23888000000,19638000000,6518000000,-1807000000,-1000000,2961000000,2663000000,7239,AVGO,yearly
2019-11-03,4696000000,,2226000000,,2724000000,1635000000,15874000000,4331000000,4331000000,,-1444000000,,,,-510000000,22597000000,18266000000,6723000000,-2105000000,-12000000,2736000000,2695000000,7239,AVGO,yearly
2018-11-04,3768000000,,4545000000,,12259000000,1027000000,13827000000,5487000000,5487000000,,-628000000,,,,-8084000000,20848000000,15361000000,7021000000,-942000000,-19000000,12629000000,12259000000,7239,AVGO,yearly
2017-10-29,3302000000,,1825000000,2901000000.0,1692000000,777000000,11043000000,2689000000,2689000000,,-454000000,,,,35000000,17636000000,14947000000,6593000000,-864000000,-6000000,1790000000,1692000000,7239,AVGO,yearly
2020-12-31,,,-961000000,113000000,-732000000,89000000,-164000000,-918000000,-918000000,,-194000000,,,,-220000000,1590000000,2508000000,1754000000,-43000000,,-741000000,-732000000,7265,HST,yearly
2019-12-31,,,962000000,148000000,920000000,107000000,1591000000,822000000,822000000,,-222000000,,,,30000000,5483000000,4661000000,3892000000,140000000,,932000000,920000000,7265,HST,yearly
2018-12-31,,,1301000000,200000000,1087000000,104000000,1601000000,813000000,813000000,,-176000000,,,,150000000,5554000000,4741000000,3953000000,488000000,,1151000000,1087000000,7265,HST,yearly
2017-12-31,,,651000000,196000000,564000000,98000000,1541000000,735000000,735000000,,-167000000,,,,80000000,5417000000,4682000000,3876000000,-84000000,,571000000,564000000,7265,HST,yearly
2020-12-31,,,14418000000,,10996000000,24901000000,42804000000,0,17903000000,,,,,,3239000000,48198000000,30295000000,5394000000,-3485000000,,11179000000,10500000000,7271,MS,yearly
2019-12-31,,,11301000000,1148000000.0,9042000000,22890000000,36732000000,0,13842000000,,,,,,2064000000,41419000000,27577000000,4687000000,-2541000000,,9237000000,8512000000,7271,MS,yearly
2018-12-31,,,11237000000,1160000000.0,8748000000,21979000000,35698000000,0,13719000000,,,,,,2350000000,40107000000,26388000000,4409000000,-2482000000,-4000000.0,8887000000,8222000000,7271,MS,yearly
2017-12-31,,,10403000000,1075000000.0,6111000000,21273000000,34061000000,0,12788000000,,,,,,4168000000,37945000000,25157000000,3884000000,-2385000000,-19000000.0,6235000000,5588000000,7271,MS,yearly
2020-12-31,,,434000000,1901000000,739000000,1975000000,7112000000,2882000000,2882000000,288000000,-1034000000,,,,-305000000,13578000000,10696000000,6466000000,-2448000000,,739000000,739000000,7273,EIX,yearly
2019-12-31,,,1006000000,2193000000,1284000000,2184000000,6741000000,2439000000,2439000000,388000000,-962000000,,,,-278000000,12347000000,9908000000,5606000000,-1433000000,,1284000000,1284000000,7273,EIX,yearly
2018-12-31,,,-1210000000,2193000000,-423000000,-79000000,4454000000,2267000000,2267000000,395000000,-855000000,,,,-739000000,12657000000,10390000000,8203000000,-3477000000,34000000.0,-471000000,-423000000,7273,EIX,yearly
2017-12-31,,,825000000,2214000000,565000000,-37000000,4603000000,2231000000,2231000000,368000000,-763000000,,,,281000000,12320000000,10089000000,7717000000,-1406000000,34000000.0,544000000,565000000,7273,EIX,yearly
2020-12-31,,,3627000000,9000000,2765000000,,5795000000,4412000000,4412000000,,-754000000,,,,862000000,10583000000,6171000000,4788000000,-785000000,,2765000000,2765000000,7311,CSX,yearly
2019-12-31,,,4316000000,15000000,3331000000,,6379000000,5030000000,5030000000,,-737000000,,,,985000000,11937000000,6907000000,5558000000,-714000000,,3331000000,3331000000,7311,CSX,yearly
2018-12-31,,,4304000000,17000000,3309000000,,6262000000,4931000000,4931000000,,-639000000,,,,995000000,12250000000,7319000000,5988000000,-627000000,,3309000000,3308000000,7311,CSX,yearly
2017-12-31,,,3142000000,16000000,5471000000,,5113000000,3798000000,3798000000,,-546000000,,,,-2329000000,11408000000,7610000000,6295000000,-656000000,,5471000000,5470000000,7311,CSX,yearly
2020-12-31,,,823200000,326400000,617000000,,1413900000,1038600000,1038600000,17400000,-150900000,,,,204100000,2632600000,1594000000,1218700000,-215400000,,619100000,616800000,7322,KSU,yearly
2019-12-31,,,788400000,323400000,538900000,,1419700000,1050100000,1050100000,18900000,-115900000,,,,247600000,2866000000,1815900000,1446300000,-261700000,,540800000,538700000,7322,KSU,yearly
2018-12-31,,,886900000,319700000,627400000,,1295200000,968400000,968400000,-19900000,-110000000,,,,257500000,2714000000,1745600000,1418800000,-81500000,,629400000,627200000,7322,KSU,yearly
2017-12-31,,,874300000,316500000,962000000,,1215400000,921600000,921600000,-27100000,-100200000,,,,-89600000,2582900000,1661300000,1367500000,-47300000,,963900000,961800000,7322,KSU,yearly
2020-12-31,,,6980000000,,5349000000,,11433000000,7878000000,7878000000,1345000000,-1141000000,,,,1631000000,19533000000,11655000000,8100000000,-898000000,,5349000000,5349000000,7335,UNP,yearly
2019-12-31,,,7747000000,,5919000000,,11867000000,8591000000,8591000000,1060000000,-1050000000,,,,1828000000,21708000000,13117000000,9841000000,-844000000,,5919000000,5919000000,7335,UNP,yearly
2018-12-31,,,7741000000,,5966000000,-13000000.0,11743000000,8530000000,8530000000,1022000000,-870000000,,,,1775000000,22832000000,14302000000,11089000000,-789000000,,5966000000,5966000000,7335,UNP,yearly
2017-12-31,,,7632000000,,10712000000,-24000000.0,11200000000,8147000000,8147000000,948000000,-719000000,,,,-3080000000,21240000000,13093000000,10040000000,-515000000,,10712000000,10712000000,7335,UNP,yearly
2020-05-31,6067000000,,12063000000,643000000,10135000000,9275000000,31130000000,14151000000,14151000000,51000000,-1999000000,,,,1928000000,39068000000,24917000000,7938000000,-2088000000,,10135000000,10135000000,7409,ORCL,yearly
2019-05-31,6026000000,,12268000000,578000000,11083000000,9774000000,31511000000,14006000000,14006000000,16000000,-2082000000,,,,1185000000,39506000000,25500000000,7995000000,-1738000000,,11083000000,11083000000,7409,ORCL,yearly
2018-05-31,6084000000,,12424000000,501000000,3587000000,9715000000,31323000000,13901000000,13901000000,3000000,-2025000000,,,,8837000000,39383000000,25482000000,8060000000,-1477000000,,3587000000,3587000000,7409,ORCL,yearly
2017-05-31,6153000000,,11680000000,386000000,9452000000,9299000000,30340000000,13437000000,13437000000,3000000,-1798000000,,,,2228000000,37792000000,24355000000,7452000000,-1757000000,,9452000000,9452000000,7409,ORCL,yearly
2021-01-31,,,16978000000,,12866000000,24447000000,44853000000,18278000000,18278000000,,-1347000000,,,,4112000000,132110000000,113832000000,87257000000,-1300000000,,12866000000,12866000000,7454,HD,yearly
2020-02-02,,,14715000000,,11242000000,19740000000,37572000000,15843000000,15843000000,,-1201000000,,,,3473000000,110225000000,94382000000,72653000000,-1128000000,,11242000000,11242000000,7454,HD,yearly
2019-02-03,,,14556000000,,11121000000,19513000000,37160000000,15777000000,15777000000,,-1051000000,,,,3435000000,108203000000,92426000000,71043000000,-1221000000,,11121000000,11121000000,7454,HD,yearly
2018-01-28,,,13698000000,,8630000000,17864000000,34356000000,14681000000,14681000000,,-1057000000,,,,5068000000,100904000000,86223000000,66548000000,-983000000,,8630000000,8630000000,7454,HD,yearly
2020-12-31,,,12479000000,1640000000,9459000000,15976000000,35974000000,0,15899000000,2197000000,,,,,3020000000,41462000000,25563000000,5488000000,-3420000000,,9459000000,8890000000,7458,GS,yearly
2019-12-31,,,10583000000,1713000000,8466000000,15437000000,30801000000,0,11823000000,1837000000,,,,,2117000000,35481000000,23658000000,4680000000,-1240000000,,8466000000,7871000000,7458,GS,yearly
2018-12-31,,,12481000000,1568000000,10459000000,15091000000,31427000000,0,13325000000,1683000000,,,,,2022000000,35942000000,22617000000,4515000000,-844000000,,10459000000,9841000000,7458,GS,yearly
2017-12-31,,,11132000000,553000000,4286000000,14139000000,28300000000,0,11320000000,1689000000,,,,,6846000000,32073000000,20753000000,3773000000,-188000000,,4286000000,3661000000,7458,GS,yearly
2020-12-31,46900000,,418700000,,346200000,297100000,767800000,423800000,423800000,,-8200000,,,,72500000,2146900000,1723100000,1379100000,-5100000,,346200000,346200000,7486,WST,yearly
2019-12-31,38900000,,300700000,,241700000,269300000,605700000,299500000,299500000,-2000000.0,-8500000,,,,59000000,1839900000,1540400000,1234200000,1200000,,241700000,241700000,7486,WST,yearly
2018-12-31,40300000,,248300000,,206900000,256200000,545400000,250900000,250900000,-2000000.0,-8400000,,,,41400000,1717400000,1466500000,1172000000,-2600000,,206900000,206900000,7486,WST,yearly
2017-12-31,39100000,,231600000,,150700000,242900000,512900000,239200000,239200000,-8300000.0,-7800000,,,,80900000,1599100000,1359900000,1086200000,-7600000,,150700000,150700000,7486,WST,yearly
2020-12-31,27573000000,,48082000000,,40269000000,28998000000,97795000000,41224000000,41224000000,,-135000000,,,,7813000000,182527000000,141303000000,84732000000,6858000000,,40269000000,40269000000,7514,GOOGL,yearly
2019-12-31,26018000000,,39625000000,,34343000000,27461000000,89961000000,36482000000,36482000000,,-100000000,,,,5282000000,161857000000,125375000000,71896000000,3143000000,,34343000000,34343000000,7514,GOOGL,yearly
2018-12-31,21419000000,,34913000000,,30736000000,23256000000,77270000000,32595000000,32595000000,,-114000000,,,,4177000000,136819000000,104224000000,59549000000,2318000000,,30736000000,30736000000,7514,GOOGL,yearly
2017-12-31,16625000000,,27193000000,,12662000000,19733000000,65272000000,28914000000,28914000000,,-109000000,,,,14531000000,110855000000,81941000000,45583000000,-1721000000,,12662000000,12662000000,7514,GOOGL,yearly
2020-05-31,15400000,,478200000,,365900000,311800000,942200000,615000000,615000000,,-108000000,,,,112300000,3792400000,3177400000,2850200000,-136800000,,365900000,365900000,7517,LW,yearly
2019-05-26,15400000,,620800000,,478600000,316400000,1003500000,671700000,671700000,,-107100000,,,,133600000,3756500000,3084800000,2753000000,-50900000,,487200000,467800000,7517,LW,yearly
2018-05-27,13500000,,554900000,55600000.0,416800000,281900000,879500000,584100000,584100000,,-108800000,,,,121200000,3423700000,2839600000,2544200000,-29200000,,433700000,414100000,7517,LW,yearly
2017-05-28,10600000,,510400000,50700000.0,326900000,220700000,778800000,547500000,547500000,,-61200000,,,,170200000,3168000000,2620500000,2389200000,-37100000,,340200000,324800000,7517,LW,yearly
2020-10-02,464100000,,891700000,,814800000,231400000,1636300000,929000000,929000000,,,,,,76900000,3355700000,2426700000,1719400000,-37300000,,814800000,814800000,7521,SWKS,yearly
2019-09-27,424100000,,961000000,,853600000,198300000,1669900000,1024900000,1024900000,,,,,,107400000,3376800000,2351900000,1706900000,-63900000,,853600000,853600000,7521,SWKS,yearly
2018-09-28,404500000,,1332100000,,918400000,207800000,1950700000,1320100000,1320100000,,,,,,413700000,3868000000,2547900000,1917300000,12000000,,918400000,918400000,7521,SWKS,yearly
2017-09-29,355200000,,1257000000,,1010200000,205900000,1841800000,1253100000,1253100000,,,,,,246800000,3651400000,2398300000,1809600000,3900000,,1010200000,1010200000,7521,SWKS,yearly
2020-12-31,,,897500000,,712700000,411700000,1790700000,1020900000,1020900000,,-138200000,,,,184800000,2784600000,1763700000,993900000,-123400000,,712700000,712700000,7524,VRSK,yearly
2019-12-31,,,568400000,,449900000,475500000,1630300000,831100000,831100000,,-126800000,,,,118500000,2607100000,1776000000,976800000,-262700000,,449900000,449900000,7524,VRSK,yearly
2018-12-31,,,719700000,,598700000,377200000,1508900000,835600000,835600000,,-129700000,,,,121000000,2395100000,1559500000,886200000,-115900000,,598700000,598700000,7524,VRSK,yearly
2017-12-31,,,691000000,,555100000,316000000,1361400000,808000000,808000000,,-119400000,,,,135900000,2145200000,1337200000,783800000,-117000000,,555100000,555100000,7524,VRSK,yearly
2020-12-31,18447000000,,33180000000,,29146000000,18155000000,69273000000,32671000000,32671000000,,,,,,4034000000,85965000000,53294000000,16692000000,509000000,,29146000000,29146000000,7538,FB,yearly
2019-12-31,13600000000,,24812000000,,18485000000,15341000000,57927000000,28986000000,28986000000,,,,,,6327000000,70697000000,41711000000,12770000000,-4174000000,,18485000000,18485000000,7538,FB,yearly
2018-12-31,10273000000,,25361000000,,22112000000,11297000000,46483000000,24913000000,24913000000,,,,,,3249000000,55838000000,30925000000,9355000000,448000000,,22112000000,22111000000,7538,FB,yearly
2017-12-31,7754000000,,20594000000,,15934000000,7242000000,35199000000,20203000000,20203000000,,-6000000.0,,,,4660000000,40653000000,20450000000,5454000000,391000000,,15934000000,15920000000,7538,FB,yearly
2020-12-31,,,-1762275000,,-2067245000,720849000,352642000,-1232045000,-1232045000,67455000,-556474000,,,,564671000,2095861000,3327906000,1743219000,-530230000,,-2326946000,-2067245000,7638,WYNN,yearly
2019-12-31,,,488218000,-201573000.0,122985000,896670000,4784046000,898591000,898591000,2240000000,-414030000,,,,176840000,6611099000,5712508000,1827053000,-410373000,,311378000,122985000,7638,WYNN,yearly
2018-12-31,,,305740000,-219334000.0,572430000,761415000,5071385000,1257201000,1257201000,2442156000,-381849000,,,,-497344000,6717660000,5460459000,1646275000,-951461000,,803084000,572430000,7638,WYNN,yearly
2017-12-31,,,560269000,130504000.0,747181000,685485000,4512975000,1055565000,1055565000,2199576000,-388664000,,,,-328985000,6070160000,5014595000,1557185000,-495296000,,889254000,747181000,7638,WYNN,yearly
2020-12-31,,,824459000,2677000,827630000,57792000,1467025000,701902000,701902000,,-214151000,,,,-3247000,2302526000,1600624000,835501000,122557000,,827706000,827630000,7680,AVB,yearly
2019-12-31,,,799106000,3901000,785974000,67217000,1559289000,830494000,830494000,,-203585000,,,,13003000,2327490000,1496996000,768201000,-31388000,,786103000,783911000,7680,AVB,yearly
2018-12-31,,,974015000,3244000,974525000,61413000,1523717000,831108000,831108000,,-220974000,,,,-160000,2289150000,1458042000,765433000,142907000,,974175000,971686000,7680,AVB,yearly
2017-12-31,,,876801000,6056000,876921000,53695000,1466597000,828752000,828752000,,-199661000,,,,141000,2189262000,1360510000,722665000,48049000,,876660000,874458000,7680,AVB,yearly
2020-12-31,,,-865000000,,-773000000,29000000,2952000000,1218000000,1218000000,516000000,-529000000,,,,-274000000,7418000000,6200000000,4466000000,-2083000000,-182000000,-591000000,-949000000,7688,CNP,yearly
2019-12-31,,,774000000,,791000000,89000000,2983000000,1195000000,1195000000,474000000,-567000000,,,,92000000,7564000000,6369000000,4581000000,-421000000,109000000,682000000,674000000,7688,CNP,yearly
2018-12-31,,,551000000,,368000000,27000000,2502000000,841000000,841000000,404000000,-420000000,,,,155000000,6277000000,5436000000,3775000000,-290000000,-28000000,396000000,333000000,7688,CNP,yearly
2017-12-31,,,1063000000,,1792000000,65000000,2563000000,1071000000,1071000000,391000000,-390000000,,,,-729000000,9614000000,8543000000,7051000000,-8000000,-28000000,1792000000,1792000000,7688,CNP,yearly
2020-12-31,,,3242200000,1561700000,2372700000,844600000,3590300000,2745700000,2745700000,,,,,,718900000,6206700000,3461000000,2616400000,496500000,,2523300000,2307400000,7696,TROW,yearly
2019-12-31,,,2927300000,1121000000,2131300000,846000000,3233000000,2387000000,2387000000,,,,,,678400000,5617900000,3230900000,2384900000,540300000,,2248900000,2076000000,7696,TROW,yearly
2018-12-31,,,2384600000,740300000,1837500000,779500000,3125700000,2346200000,2346200000,,,,,,615900000,5372600000,3026400000,2246900000,38400000,,1768700000,1793900000,7696,TROW,yearly
2017-12-31,,,2505100000,992800000,1497800000,722600000,2781400000,2058800000,2058800000,,,,,,923900000,4854900000,2796100000,2073500000,446300000,,1581200000,1463900000,7696,TROW,yearly
2020-12-31,,,1455000000,910000000,1081000000,1894000000,3850000000,1894000000,1894000000,,-189000000,,,,384000000,19456000000,17562000000,15606000000,-439000000,,1071000000,1081000000,7816,WHR,yearly
2019-12-31,,,1552000000,923000000,1184000000,2147000000,3533000000,1317000000,1317000000,,-187000000,,,,354000000,20419000000,19102000000,16886000000,235000000,,1198000000,1184000000,7816,WHR,yearly
2018-12-31,,,-21000000,914000000,-183000000,2201000000,3537000000,1261000000,1261000000,,-192000000,,,,138000000,21037000000,19776000000,17500000000,-1282000000,,-159000000,-183000000,7816,WHR,yearly
2017-12-31,,,887000000,930000000,350000000,2135000000,3602000000,1388000000,1388000000,,-162000000,,,,550000000,21253000000,19865000000,17651000000,-501000000,,337000000,350000000,7816,WHR,yearly
2020-12-31,,,-643900000,256300000,-949000000,2406700000,3768300000,1361600000,1361600000,,-274600000,,,,301800000,9654000000,8292400000,5885700000,-2005500000,,-945700000,-949000000,7827,TAP,yearly
2019-12-31,,,479900000,253700000,241700000,2700100000,4201200000,1501100000,1501100000,,-280900000,,,,233700000,10579400000,9078300000,6378200000,-1021200000,,246200000,241700000,7827,TAP,yearly
2018-12-31,,,1359800000,228400000,1116500000,2725700000,4184800000,1459100000,1459100000,,-306200000,,,,225200000,10769600000,9310500000,6584800000,-99300000,,1134600000,1116500000,7827,TAP,yearly
2017-12-31,,,1383200000,208900000,1565600000,2934000000,4766100000,1832100000,1832100000,,-349300000,,,,-204600000,11002800000,9170700000,6236700000,-448900000,1500000.0,1587800000,1565600000,7827,TAP,yearly
2020-12-31,,,380000000,279000000,279000000,1762000000,3859000000,810000000,810000000,,-416000000,,,,72000000,11359000000,10549000000,7500000000,-430000000,,308000000,279000000,7842,IQV,yearly
2019-12-31,,,343000000,260000000,191000000,1711000000,3788000000,875000000,875000000,,-447000000,,,,116000000,11088000000,10213000000,7300000000,-532000000,,227000000,191000000,7842,IQV,yearly
2018-12-31,,,343000000,240000000,259000000,1692000000,3666000000,833000000,833000000,,-414000000,,,,59000000,10412000000,9579000000,6746000000,-490000000,,284000000,259000000,7842,IQV,yearly
2017-12-31,,,304000000,249000000,1277000000,1605000000,3401000000,785000000,785000000,,-346000000,,,,-992000000,9702000000,8917000000,6301000000,-481000000,,1296000000,1277000000,7842,IQV,yearly
2020-12-31,4857000000,,1669000000,,123000000,4834000000,20180000000,10489000000,10489000000,,-984000000,,,,1580000000,24689000000,14200000000,4509000000,-8820000000,,89000000,123000000,7919,GILD,yearly
2019-12-31,8306000000,,5160000000,125000000.0,5386000000,4381000000,17774000000,5087000000,5087000000,,-995000000,,,,-204000000,22449000000,17362000000,4675000000,73000000,,5364000000,5386000000,7919,GILD,yearly
2018-12-31,4198000000,,7799000000,147000000.0,5455000000,4056000000,17274000000,9020000000,9020000000,,-1077000000,,,,2339000000,22127000000,13107000000,4853000000,-1221000000,,5460000000,5455000000,7919,GILD,yearly
2017-12-31,3734000000,,13529000000,59000000.0,4628000000,3878000000,21736000000,14124000000,14124000000,,-1118000000,,,,8885000000,26107000000,11983000000,4371000000,-595000000,,4644000000,4628000000,7919,GILD,yearly
2020-12-31,,,135888000,222310000,131706000,48112000,543702000,240563000,240563000,,-136289000,,,,0,827432000,586869000,283730000,-104675000,,135888000,122672000,7926,FRT,yearly
2019-12-31,,,360542000,240549000,353866000,50181000,642445000,352506000,352506000,,-109623000,,,,0,933776000,581270000,291331000,8036000,,360542000,344817000,7926,FRT,yearly
2018-12-31,,,249026000,257647000,241907000,41535000,632103000,346323000,346323000,,-110154000,,,,0,912038000,565715000,279935000,-97297000,,249026000,232935000,7926,FRT,yearly
2017-12-31,,,297870000,265965000,289914000,45288000,593209000,331871000,331871000,,-100125000,,,,0,856931000,525060000,263722000,-34001000,,297870000,286514000,7926,FRT,yearly
2020-06-27,440166000,,678096000,,654694000,296722000,1432652000,691757000,691757000,929000,-35797000,,,,23402000,2191395000,1499638000,758743000,-13661000,,654694000,654694000,7952,MXIM,yearly
2019-06-29,435222000,,754421000,,827486000,308617000,1500506000,753483000,753483000,143000,-43543000,,,,-73065000,2314329000,1560846000,813823000,938000,,827486000,827486000,7952,MXIM,yearly
2018-06-30,450943000,,824885000,,467318000,322918000,1626121000,849400000,849400000,-1607000,-50215000,,,,357567000,2480066000,1630666000,853945000,-24515000,,467318000,467318000,7952,MXIM,yearly
2017-06-24,453977000,,679589000,,571613000,291511000,1449980000,718247000,718247000,-22944000,-34274000,,,,107976000,2295615000,1577368000,845635000,-38658000,,571613000,571613000,7952,MXIM,yearly
2020-12-31,74000000,,2251000000,369000000,1985000000,464000000,1293000000,734000000,734000000,-1000000,-109000000,,,,247000000,5655000000,4921000000,4362000000,1517000000,-12000000,2004000000,1985000000,7986,CE,yearly
2019-12-31,67000000,,988000000,391000000,852000000,502000000,1606000000,1013000000,1013000000,114000000,-115000000,,,,124000000,6297000000,5284000000,4691000000,-25000000,-6000000,864000000,852000000,7986,CE,yearly
2018-12-31,72000000,,1510000000,395000000,1207000000,606000000,1972000000,1270000000,1270000000,114000000,-125000000,,,,292000000,7155000000,5885000000,5183000000,240000000,-5000000,1218000000,1207000000,7986,CE,yearly
2017-12-31,73000000,,1075000000,412000000,843000000,451000000,1511000000,967000000,967000000,114000000,-122000000,,,,213000000,6140000000,5173000000,4629000000,108000000,-13000000,862000000,843000000,7986,CE,yearly
2020-12-31,,,3530000000,,3064000000,17205000000,40783000000,9427000000,9427000000,,-2730000000,,,,786000000,68397000000,58970000000,27614000000,-5897000000,320000000,2744000000,3064000000,7996,TMUS,yearly
2019-12-31,,,4603000000,,3468000000,13519000000,26477000000,6342000000,6342000000,,-1135000000,,,,1135000000,44998000000,38656000000,18521000000,-1739000000,320000000,3468000000,3468000000,7996,TMUS,yearly
2018-12-31,,,3917000000,,2888000000,12965000000,24956000000,5505000000,5505000000,,-1357000000,,,,1029000000,43310000000,37805000000,18354000000,-1588000000,320000000,2888000000,2888000000,7996,TMUS,yearly
2017-12-31,,,3161000000,,4536000000,12259000000,22896000000,4653000000,4653000000,,-1671000000,,,,-1375000000,40604000000,35951000000,17708000000,-1492000000,320000000,4536000000,4481000000,7996,TMUS,yearly
2020-12-31,,,87100000,173800000,666100000,371500000,1064900000,535200000,535200000,158200000,-214100000,,,,-578500000,8681700000,8146500000,7616800000,-448100000,,665600000,666100000,8023,MOS,yearly
2019-12-31,,,-1315500000,182100000,-1067400000,354100000,897300000,415400000,415400000,127800000,-216000000,,,,-224700000,8906300000,8490900000,8009000000,-1730900000,,-1090800000,-1067400000,8023,MOS,yearly
2018-12-31,,,547000000,207400000,470000000,341100000,1498400000,991400000,991400000,165900000,-215800000,,,,77100000,9587300000,8595900000,8088900000,-444400000,,469900000,470000000,8023,MOS,yearly
2017-12-31,,,390700000,21600000,-107200000,301300000,842800000,440200000,440200000,101300000,-171300000,,,,494900000,7409400000,6969200000,6566600000,-49500000,,-104200000,-107200000,8023,MOS,yearly
2020-12-31,,,-28883000000,6980000000,-22440000000,10881000000,57157000000,-2932000000,-2932000000,28425000000,-1158000000,,,,-5632000000,179784000000,182716000000,122627000000,-25951000000,,-23251000000,-22440000000,8066,XOM,yearly
2019-12-31,,,20056000000,7288000000,14340000000,12168000000,77366000000,11891000000,11891000000,33186000000,-830000000,,,,5282000000,255797000000,243906000000,178431000000,8165000000,,14774000000,14340000000,8066,XOM,yearly
2018-12-31,,,30953000000,6734000000,20840000000,12300000000,90308000000,23267000000,23267000000,35230000000,-766000000,,,,9532000000,281060000000,257793000000,190752000000,7686000000,,21421000000,20840000000,8066,XOM,yearly
2017-12-31,,,18674000000,6812000000,19710000000,11893000000,78109000000,14074000000,14074000000,32459000000,-601000000,,,,-1174000000,237162000000,223088000000,159053000000,4600000000,,19848000000,19710000000,8066,XOM,yearly
2020-12-31,,,-2779000000,69000000,-2542000000,968000000,434000000,-534000000,-534000000,,-84000000,,,,-242000000,6090000000,6624000000,5656000000,-2245000000,,-2537000000,-2542000000,8098,NOV,yearly
2019-12-31,,,-6462000000,68000000,-6095000000,1303000000,845000000,-458000000,-458000000,,-100000000,,,,-369000000,8479000000,8937000000,7634000000,-6004000000,,-6093000000,-6095000000,8098,NOV,yearly
2018-12-31,,,41000000,70000000,-31000000,1233000000,1444000000,211000000,211000000,,-93000000,,,,63000000,8453000000,8242000000,7009000000,-170000000,,-22000000,-31000000,8098,NOV,yearly
2017-12-31,,,-392000000,66000000,-237000000,1169000000,892000000,-277000000,-277000000,,-102000000,,,,-156000000,7304000000,7581000000,6412000000,-115000000,,-236000000,-237000000,8098,NOV,yearly
2020-12-31,,,626200000,,502900000,772700000,1609300000,799100000,799100000,,-174400000,,,,142100000,4903200000,4104100000,3293900000,-172900000,18800000,484100000,502900000,8124,SEE,yearly
2019-12-31,,,370300000,,263000000,852200000,1564800000,683700000,683700000,,-196000000,,,,76600000,4791100000,4107400000,3226300000,-313400000,-30700000,293700000,262500000,8124,SEE,yearly
2018-12-31,,,457800000,,193100000,757400000,1502100000,729000000,729000000,,-193000000,,,,307500000,4732700000,4003700000,3230600000,-271200000,42800000,150300000,192200000,8124,SEE,yearly
2017-12-31,,,393300000,,814900000,743900000,1412100000,655100000,655100000,,-201800000,,,,330500000,4461600000,3806500000,3049500000,-261800000,752100000,62800000,810000000,8124,SEE,yearly
2020-12-31,,,35407000000,,29131000000,60715000000,102063000000,0,36522000000,4826000000,,,,,6276000000,102063000000,65541000000,0,-1115000000,,29131000000,27410000000,8135,JPM,yearly
2019-12-31,,,44545000000,,36431000000,60182000000,109813000000,0,44784000000,4847000000,,,,,8114000000,109813000000,65029000000,0,-239000000,,36431000000,34642000000,8135,JPM,yearly
2018-12-31,,,40764000000,,32474000000,57417000000,103744000000,0,40836000000,5491000000,,,,,8290000000,103744000000,62908000000,0,-72000000,,32474000000,30709000000,8135,JPM,yearly
2017-12-31,,,35900000000,,24441000000,53436000000,94745000000,0,35220000000,6089000000,,,,,11459000000,94745000000,59525000000,0,680000000,,24441000000,22567000000,8135,JPM,yearly
2020-12-31,,,732200000,-14900000,618300000,,2388200000,1143900000,1143900000,364200000,-383900000,,,,102200000,4913400000,3769500000,2525200000,-411700000,,630000000,618300000,8138,EVRG,yearly
2019-12-31,,,782600000,-26600000,669900000,55600000.0,2432800000,1150000000,1150000000,365500000,-374000000,,,,97000000,5147800000,3997800000,2715000000,-367400000,,685600000,669900000,8138,EVRG,yearly
2018-12-31,,,605000000,-37500000,535800000,47800000.0,1920800000,985100000,985100000,269100000,-279600000,,,,59000000,4275900000,3290800000,2355100000,-380100000,,546000000,535800000,8138,EVRG,yearly
2017-12-31,,,487700000,-47700000,323900000,20000000.0,1218100000,658800000,658800000,167600000,-171000000,,,,151200000,2571000000,1912200000,1352900000,-181900000,,336500000,323900000,8138,EVRG,yearly
2020-12-31,,,6140700000,,4730500000,2245000000,9752100000,6857600000,6857600000,348900000,-1218100000,,,,1410200000,19207800000,12350200000,9455700000,-716900000,,4730500000,4730500000,8147,MCD,yearly
2019-12-31,,,8018100000,,6025400000,1966900000,11179400000,8954700000,8954700000,-4700000,-1121900000,,,,1992700000,21364400000,12409700000,10185000000,-936600000,,6025400000,6025400000,8147,MCD,yearly
2018-12-31,,,7816100000,,5924300000,1985400000,10832600000,8625700000,8625700000,6700000,-981200000,,,,1891800000,21257900000,12632200000,10425300000,-809600000,,5924300000,5924300000,8147,MCD,yearly
2017-12-31,,,8573500000,,5192300000,2231300000,10620800000,8392300000,8392300000,-2800000,-921300000,,,,3381200000,22820400000,14428100000,12199600000,181200000,,5192300000,5192300000,8147,MCD,yearly
2020-12-31,,,3116798000,,2711647000,770456000,3639846000,2869390000,2869390000,,-58151000,,,,405151000,6205683000,3336293000,2565837000,247408000,,2711647000,2711647000,8155,VRTX,yearly
2019-12-31,,,1394919000,,1176810000,658498000,1860523000,1202025000,1202025000,,-58502000,,,,218109000,4162821000,2960796000,2302298000,192894000,,1176810000,1176810000,8155,VRTX,yearly
2018-12-31,,,600241000,,2096896000,557616000,1221582000,663966000,663966000,,-72471000,,,,-1486862000,3047597000,2383631000,1826015000,-63725000,,2087103000,2096395000,8155,VRTX,yearly
2017-12-31,,,-15689000,13727000.0,263484000,496079000,888908000,392829000,392829000,,-69298000,,,,-107324000,2488652000,2095823000,1599744000,-408518000,,91635000,263191000,8155,VRTX,yearly
2020-03-31,296398000,,458439000,,404459000,776659000,1546520000,425350000,425350000,,-2637000,,,,53980000,3088970000,2663620000,1542450000,33089000,,404459000,404459000,8192,TTWO,yearly
2019-03-31,230170000,,232785000,,333837000,672634000,1152176000,209140000,209140000,,-8032000,,,,-101052000,2668394000,2459254000,1516218000,23645000,,333837000,333837000,8192,TTWO,yearly
2018-03-31,196373000,,136625000,,173533000,503920000,895641000,151379000,151379000,,-22269000,,,,-36908000,1792892000,1641513000,897251000,-14754000,,173533000,173374000,8192,TTWO,yearly
2017-03-31,137915000,,76965000,,67303000,496862000,776955000,111471000,111471000,,-29569000,,,,9662000,1779748000,1668277000,1002793000,-34506000,,67303000,66028000,8192,TTWO,yearly
2020-12-31,,,1741881000,213791000,1208368000,1817279000,3776922000,0,1769468000,190175000,,,,,447587000,3776922000,2007454000,0,-27587000,,1294294000,1191217000,8206,SIVB,yearly
2019-12-31,,,1610402000,150773000,1136856000,1429255000,3220624000,0,1639186000,152183000,,,,,425685000,3220624000,1581438000,0,-28784000,,1184717000,1136856000,8206,SIVB,yearly
2018-12-31,,,1362909000,148634000,973840000,1057866000,2551102000,0,1405985000,87251000,,,,,351561000,2551102000,1145117000,0,-43076000,,1011348000,973840000,8206,SIVB,yearly
2017-12-31,,,874641000,139620000,490506000,890465000,1882565000,0,906979000,85121000,,,,,355463000,1882565000,975586000,0,-32338000,,519178000,490506000,8206,SIVB,yearly
2020-12-31,,,1428100000,192800000,1199900000,-35500000,2895700000,1747300000,1747300000,208000000,-494900000,,,,227900000,7241700000,5494400000,4346000000,-319200000,,1200200000,1199900000,8211,WEC,yearly
2019-12-31,,,1258500000,141200000,1134000000,-30100000,2665600000,1567600000,1567600000,201800000,-502700000,,,,125000000,7523100000,5955500000,4857500000,-309100000,,1133500000,1134000000,8211,WEC,yearly
2018-12-31,,,1229100000,53800000,1059300000,-18900000,2518200000,1494400000,1494400000,196900000,-446300000,,,,169800000,7679500000,6185100000,5161300000,-265300000,,1059300000,1059300000,8211,WEC,yearly
2017-12-31,,,1587200000,30400000,1203700000,-1900000,2776800000,1785200000,1785200000,194900000,-416900000,,,,383500000,7648500000,5863300000,4871700000,-198000000,,1203700000,1203700000,8211,WEC,yearly
2020-12-31,,,972000000,,817000000,2507000000,3767000000,0,1045000000,215000000,,,,,155000000,3767000000,2722000000,0,-73000000,,817000000,717000000,8233,HBAN,yearly
2019-12-31,,,1659000000,,1411000000,2413000000,4390000000,0,1756000000,221000000,,,,,248000000,4390000000,2634000000,0,-97000000,,1411000000,1337000000,8233,HBAN,yearly
2018-12-31,,,1628000000,,1393000000,2286000000,4273000000,0,1766000000,221000000,,,,,235000000,4273000000,2507000000,0,-138000000,,1393000000,1323000000,8233,HBAN,yearly
2017-12-31,,,1394000000,,1186000000,2204000000,4108000000,0,1682000000,222000000,,,,,208000000,4108000000,2426000000,0,-288000000,,1186000000,1110000000,8233,HBAN,yearly
2020-12-31,,,584374000,6842000,515595000,1768221000,2533073000,764852000,764852000,,-52379000,,,,68647000,9552197000,8787345000,7019124000,-180478000,,515727000,515595000,8270,MHK,yearly
2019-12-31,,,749545000,6607000,744211000,1836149000,2768245000,932096000,932096000,,-41272000,,,,4974000,9970672000,9038576000,7202427000,-182551000,,744571000,744211000,8270,MHK,yearly
2018-12-31,,,1049201000,6245000,861704000,1711157000,2885133000,1173976000,1173976000,,-38827000,,,,184346000,9983634000,8809658000,7098501000,-124775000,,864855000,857812000,8270,MHK,yearly
2017-12-31,,,1317857000,37310000,971638000,1629326000,3045739000,1416413000,1416413000,,-31111000,,,,343165000,9491290000,8074877000,6445551000,-98556000,,974692000,971592000,8270,MHK,yearly
2020-03-28,,,326400000,,384300000,3081400000,3812800000,602100000,602100000,29600000,-17600000,,,,-57900000,6159800000,5557700000,2347000000,-275700000,,384300000,384300000,8292,RL,yearly
2019-03-30,,,582500000,,430900000,3144400000,3893200000,706700000,706700000,18200000,-20700000,,,,151600000,6313000000,5606300000,2419800000,-124200000,,430900000,430900000,8292,RL,yearly
2018-03-31,,,489200000,,162800000,3061300000,3759300000,663800000,663800000,18200000,-18200000,,,,326400000,6182300000,5518500000,2423000000,-174600000,,162800000,162800000,8292,RL,yearly
2017-04-01,,,-104900000,,-99300000,2857300000,3849000000,678000000,678000000,18200000,-12400000,,,,-5600000,6652800000,5974800000,2803800000,-782900000,,-99300000,-99300000,8292,RL,yearly
2020-12-31,,,6959000000,,5576000000,5640000000,14279000000,8521000000,8521000000,,-318000000,,,,1383000000,44791000000,36270000000,30512000000,-1562000000,,5576000000,5461000000,8350,ALL,yearly
2019-12-31,,,6089000000,,4847000000,5804000000,12487000000,6557000000,6557000000,,-327000000,,,,1242000000,44675000000,38118000000,32188000000,-468000000,,4847000000,4678000000,8350,ALL,yearly
2018-12-31,,,2628000000,,2160000000,6062000000,9188000000,3021000000,3021000000,,-332000000,,,,468000000,39815000000,36794000000,30627000000,-393000000,,2160000000,2012000000,8350,ALL,yearly
2017-12-31,,,4549000000,,3554000000,4979000000,10163000000,5085000000,5085000000,,-335000000,,,,995000000,39407000000,34322000000,29244000000,-536000000,,3554000000,3438000000,8350,ALL,yearly
2020-12-31,,,-17749000,15194000,24104000,194267000,1590028000,673791000,673791000,,-412802000,,,,-41796000,2083138000,1409347000,493110000,-691540000,,24047000,24104000,8358,SBAC,yearly
2019-12-31,,,186889000,16052000,146991000,191774000,1506386000,613437000,613437000,4097000.0,-415695000,,,,39605000,2014645000,1401208000,508259000,-426548000,,147284000,146991000,8358,SBAC,yearly
2018-12-31,,,51684000,16052000,47451000,141724000,1385939000,569311000,569311000,2791000.0,-399146000,,,,4233000,1865695000,1296384000,479756000,-517627000,,47451000,47451000,8358,SBAC,yearly
2017-12-31,,,116891000,16052000,103654000,130697000,1268995000,490751000,490751000,4447000.0,-348568000,,,,13237000,1727674000,1236923000,458679000,-373860000,,103654000,103654000,8358,SBAC,yearly
2020-12-31,,,4302000000,6476000000,3222000000,3097000000,21198000000,8397000000,8397000000,,-3848000000,,,,626000000,48097000000,39700000000,26899000000,-4095000000,,3676000000,3222000000,8369,CHTR,yearly
2019-12-31,,,2431000000,7366000000,1668000000,3113000000,19584000000,6545000000,6545000000,,-3797000000,,,,439000000,45764000000,39219000000,26180000000,-4114000000,,1992000000,1668000000,8369,CHTR,yearly
2018-12-31,,,1686000000,7987000000,1230000000,2850000000,18816000000,5648000000,5648000000,235000000.0,-3540000000,,,,180000000,43634000000,37986000000,24818000000,-3962000000,,1506000000,1230000000,8369,CHTR,yearly
2017-12-31,,,1028000000,8447000000,9895000000,11484000000,26525000000,4453000000,4453000000,235000000.0,-3090000000,,,,-9087000000,41581000000,37128000000,15056000000,-3425000000,,10115000000,9895000000,8369,CHTR,yearly
2020-09-30,83900000,,2423800000,363300000,1886700000,731000000,2998200000,2247200000,2247200000,-63900000,-109300000,,,,478400000,8856300000,6609100000,5858100000,176600000,-14300000,1945400000,1886700000,8378,APD,yearly
2019-09-30,72900000,,2289500000,334700000,1760000000,729700000,2943400000,2219900000,2219900000,-79100000,-137000000,,,,480100000,8918900000,6699000000,5975500000,69600000,-14300000,1809400000,1760000000,8378,APD,yearly
2018-09-30,64500000,,2015000000,318800000,1497800000,801200000,2740700000,1925200000,1925200000,-50200000,-130500000,,,,524300000,8930200000,7005000000,6189500000,89800000,42200000,1490700000,1497800000,8378,APD,yearly
2017-09-30,57600000,,1416100000,99300000,3000400000,630400000,2436100000,1844800000,1844800000,-96700000,-120600000,,,,260900000,8187600000,6342800000,5751500000,-428700000,1866000000,1155200000,3000400000,8378,APD,yearly
2020-11-30,68600000,,922300000,13900000,747400000,1203000000,2300400000,1028800000,1028800000,,-135600000,,,,174900000,5601300000,4572500000,3300900000,-106500000,,747400000,747400000,8392,MKC,yearly
2019-11-30,67300000,,860100000,12500000,702700000,1081800000,2145300000,996200000,996200000,,-165200000,,,,157400000,5347400000,4351200000,3202100000,-136100000,,702700000,702700000,8392,MKC,yearly
2018-11-30,69400000,,776100000,11300000,933400000,1081800000,2093300000,942100000,942100000,,-174600000,,,,-157300000,5302800000,4360700000,3209500000,-166000000,,933400000,933400000,8392,MKC,yearly
2017-11-30,66100000,,628700000,11000000,477400000,962500000,1814900000,786300000,786300000,,-95700000,,,,151300000,4730300000,3944000000,2915400000,-157600000,,477400000,477400000,8392,MKC,yearly
2020-12-31,,,-5775130000,,-5797462000,1199620000,-556303000,-3035177000,-3035177000,,-844238000,,,,0,2208805000,5243982000,2765108000,-2739953000,,-5775130000,-5797462000,8402,RCL,yearly
2019-12-31,,,1940200000,569981000.0,1878887000,1750892000,5095290000,2098456000,2098456000,,-408513000,,,,32600000,10950661000,8852205000,5855371000,-158256000,,1907600000,1878887000,8402,RCL,yearly
2018-12-31,,,1836692000,542020000.0,1811042000,1260130000,4231642000,1937815000,1937815000,,-333672000,,,,20900000,9493849000,7556034000,5262207000,-101123000,,1815792000,1811042000,8402,RCL,yearly
2017-12-31,,,1643433000,542020000.0,1625133000,1186016000,3881266000,1744056000,1744056000,,-297056000,,,,18300000,8777845000,7033789000,4896579000,-100623000,,1625133000,1625133000,8402,RCL,yearly
2020-08-31,,,6774331000,498637000,5107839000,7462514000,13976158000,6513644000,6513644000,,-33071000,,,,1589018000,44327039000,37813395000,30350881000,260687000,,5185313000,5107839000,8431,ACN,yearly
2019-08-31,,,6251797000,418683000,4779112000,7009614000,13314688000,6305074000,6305074000,,-22963000,,,,1405556000,43215013000,36909939000,29900325000,-53277000,,4846241000,4779112000,8431,ACN,yearly
2018-08-31,,,5808093000,359835000,4059907000,6594585000,12493364000,5898779000,5898779000,,-19539000,,,,1593499000,40992534000,35093755000,28499170000,-90686000,,4214594000,4059907000,8431,ACN,yearly
2017-08-31,,,4616032000,760723000,3445149000,5928090000,11071492000,5143402000,5143402000,,-15545000,,,,981100000,36176841000,31033439000,25105349000,-527370000,,3634932000,3445149000,8431,ACN,yearly
2019-12-31,,,275739000,,233290000,2103995000,2694753000,378979000,378979000,,-102831000,,,,42449000,4245321000,3866342000,1550568000,-103240000,,233290000,233290000,8432,IT,yearly
2018-12-31,,,181121000,,122456000,1884846000,2506654000,366207000,366207000,,-126774000,,,,58665000,3975454000,3609247000,1468800000,-185086000,,122456000,122456000,8432,IT,yearly
2017-12-31,,,-127817000,,3279000,1599759000,1991296000,151366000,151366000,,-127947000,,,,-131096000,3311494000,3160128000,1320198000,-279183000,,3279000,3279000,8432,IT,yearly
2016-12-31,,,288431000,,193582000,1089184000,1498892000,347739000,347739000,,-27565000,,,,94849000,2444540000,2096801000,945648000,-59308000,,193582000,193582000,8432,IT,yearly
2020-12-31,359900000,,225000000,,493600000,620700000,1280100000,299500000,299500000,,-84700000,,,,-268600000,1926700000,1627200000,646600000,-74500000,,493600000,493600000,8492,DXCM,yearly
2019-12-31,273500000,,104200000,,101100000,515700000,931500000,142300000,142300000,,-60300000,,,,3100000,1476000000,1333700000,544500000,-38100000,,101100000,101100000,8492,DXCM,yearly
2018-12-31,417400000,,-126500000,,-127100000,432800000,663900000,-186300000,-186300000,,-22700000,,,,600000,1031600000,1217900000,367700000,59800000,,-127100000,-127100000,8492,DXCM,yearly
2017-12-31,185400000,,-48600000,,-50200000,349200000,492100000,-42500000,-42500000,,-12800000,,,,1600000,718500000,761000000,226400000,-6100000,,-50200000,-50200000,8492,DXCM,yearly
2020-05-31,,,1669000000,,1286000000,427000000,16837000000,2730000000,2730000000,10065000000,-672000000,,,,383000000,69217000000,66487000000,52380000000,-1061000000,,1286000000,1284000000,8500,FDX,yearly
2019-05-31,,,655000000,,540000000,468000000,14929000000,1581000000,1581000000,9527000000,-588000000,,,,115000000,69693000000,68112000000,54764000000,-926000000,,540000000,539000000,8500,FDX,yearly
2018-05-31,,,4353000000,,4572000000,442000000,18005000000,5460000000,5460000000,9008000000,-558000000,,,,-219000000,65450000000,59990000000,47445000000,-1107000000,,4572000000,4566000000,8500,FDX,yearly
2017-05-31,,,4579000000,,2997000000,458000000,16784000000,5098000000,5098000000,8233000000,-512000000,,,,1582000000,60319000000,55221000000,43535000000,-519000000,,2997000000,2993000000,8500,FDX,yearly
2021-01-02,,,1587000000,524000000,1251000000,2885000000,4740000000,1855000000,1855000000,,-281000000,,,,323000000,13770000000,11915000000,9030000000,-268000000,,1264000000,1251000000,8510,K,yearly
2019-12-28,,,1298000000,567000000,960000000,2827000000,4433000000,1606000000,1606000000,,-284000000,,,,321000000,13578000000,11972000000,9145000000,-308000000,,977000000,960000000,8510,K,yearly
2018-12-29,,,1525000000,558000000,1336000000,3022000000,4825000000,1803000000,1803000000,,-287000000,,,,181000000,13547000000,11744000000,8722000000,-278000000,,1344000000,1336000000,8510,K,yearly
2017-12-30,,,1664000000,16000000,1254000000,3017000000,4814000000,1797000000,1797000000,,-256000000,,,,410000000,12854000000,11057000000,8040000000,-133000000,,1254000000,1254000000,8510,K,yearly
2020-12-31,,,374359000,,299377000,86308000,498148000,375844000,375844000,,-1142000,,,,74982000,689125000,313281000,190977000,-1485000,,299377000,299377000,8533,MKTX,yearly
2019-12-31,,,257424000,,204902000,75742000,353481000,250882000,250882000,,-1142000,,,,52522000,511352000,260470000,157871000,6542000,,204902000,204902000,8533,MKTX,yearly
2018-12-31,,,218086000,,172852000,66918000,302582000,212584000,212584000,,-1142000,,,,45234000,435565000,222981000,132983000,5502000,,172852000,172852000,8533,MKTX,yearly
2017-12-31,,,201768000,,148089000,52172000,271061000,199615000,199615000,,-1142000,,,,53679000,393422000,193807000,122361000,2153000,,148089000,148089000,8533,MKTX,yearly
2020-12-31,,,1871000000,195000000,1804000000,1103000000,2057000000,810000000,810000000,,-164000000,,,,49000000,13066000000,12256000000,11009000000,1061000000,,1822000000,1769000000,8604,APTV,yearly
2019-12-31,,,1141000000,192000000,990000000,1217000000,2763000000,1408000000,1408000000,,-164000000,,,,132000000,14357000000,12949000000,11594000000,-267000000,,1009000000,990000000,8604,APTV,yearly
2018-12-31,,,1357000000,211000000,1067000000,1011000000,2733000000,1598000000,1598000000,,-141000000,,,,250000000,14435000000,12837000000,11702000000,-241000000,,1107000000,1067000000,8604,APTV,yearly
2017-12-31,,,1286000000,218000000,1355000000,984000000,2623000000,1522000000,1522000000,,-140000000,,,,223000000,12884000000,11362000000,10261000000,-236000000,365000000.0,1063000000,1355000000,8604,APTV,yearly
2020-12-31,,,-782000000,,-1232000000,3464000000,11778000000,3604000000,3604000000,,-1668000000,,,,450000000,20712000000,17108000000,8934000000,-4386000000,,-1232000000,-1232000000,8673,LUMN,yearly
2019-12-31,,,-4766000000,,-5269000000,3550000000,12324000000,3945000000,3945000000,,-2021000000,,,,503000000,22401000000,18456000000,10077000000,-8711000000,,-5269000000,-5269000000,8673,LUMN,yearly
2018-12-31,,,-1563000000,,-1733000000,3560000000,12581000000,3901000000,3901000000,,-2177000000,,,,170000000,23443000000,19542000000,10862000000,-5464000000,,-1733000000,-1733000000,8673,LUMN,yearly
2017-12-31,,,540000000,,1389000000,3844000000,10003000000,2223000000,2223000000,,-1481000000,,,,-849000000,17656000000,15433000000,7653000000,-1683000000,,1389000000,1389000000,8673,LUMN,yearly
2020-12-31,,,414758000,586463000,379802000,91826000,638991000,233497000,233497000,,-128473000,,,,0,1027549000,794052000,388558000,181261000,,414758000,356105000,8694,SLG,yearly
2019-12-31,,,291487000,769030000,281345000,100875000,752549000,381816000,381816000,-2500000.0,-206298000,,,,0,1211177000,829361000,458628000,-90329000,,291487000,253745000,8694,SLG,yearly
2018-12-31,,,270856000,734566000,258646000,92631000,782840000,413902000,413902000,-3200000.0,-223034000,,,,0,1231503000,817601000,448663000,-143046000,,270856000,231760000,8694,SLG,yearly
2017-12-31,,,101069000,1128050000,112775000,100498000,962447000,458629000,458629000,-3200000.0,-275127000,,,,0,1533365000,1074736000,570918000,-357560000,,101069000,85953000,8694,SLG,yearly
2020-09-30,,,-522600000,18200000,-690900000,1521100000,3196800000,1275200000,1275200000,,-465500000,,,,163500000,17578800000,16303600000,14382000000,-1797800000,,-686100000,-691000000,8718,WRK,yearly
2019-09-30,,,1144700000,16200000,862900000,1641000000,3581500000,1527300000,1527300000,,-489400000,,,,276800000,18289000000,16761700000,14707500000,-382600000,,867900000,862800000,8718,WRK,yearly
2018-09-30,,,1034800000,17200000,1906100000,1451300000,3362000000,1590500000,1590500000,,-352800000,,,,-874500000,16285100000,14694600000,12923100000,-555700000,,1909300000,1905900000,8718,WRK,yearly
2017-09-30,,,857600000,48300000,708200000,1405400000,2718200000,1083200000,1083200000,,-222500000,,,,159000000,14859700000,13776500000,12141500000,-225600000,,698600000,708100000,8718,WRK,yearly
2020-12-31,2476000000,,-14476000000,241000000,-11873000000,4493000000,-1690000000,-8659000000,-8659000000,,-2156000000,,,,-2535000000,58158000000,66817000000,59848000000,-5817000000,,-11941000000,-11873000000,8729,BA,yearly
2019-12-31,3219000000,,-2259000000,317000000,-636000000,3642000000,4759000000,-2102000000,-2102000000,,-722000000,,,,-1623000000,76559000000,78661000000,71800000000,-157000000,,-636000000,-636000000,8729,BA,yearly
2018-12-31,3269000000,,11604000000,71000000,10460000000,4525000000,19637000000,11843000000,11843000000,,-475000000,,,,1144000000,101127000000,89284000000,81490000000,-239000000,,10460000000,10460000000,8729,BA,yearly
2017-12-31,3179000000,,10107000000,57000000,8458000000,4101000000,17393000000,10113000000,10113000000,,-360000000,,,,1649000000,94005000000,83892000000,76612000000,-6000000,,8458000000,8458000000,8729,BA,yearly
2020-12-31,,,1769521000,,1353152000,2632982000,5154761000,0,1838193000,683586000,,,,,416369000,5154761000,3316568000,0,-68672000,,1353152000,1279066000,8736,MTB,yearly
2019-12-31,,,2547261000,,1929149000,2587972000,5967943000,0,2658286000,721685000,,,,,618112000,5967943000,3309657000,0,-111025000,,1929149000,1849509000,8736,MTB,yearly
2018-12-31,,,2508240000,,1918080000,2371485000,5796302000,0,2736288000,688529000,,,,,590160000,5796302000,3060014000,0,-228048000,,1918080000,1836028000,8736,MTB,yearly
2017-12-31,,,2323862000,,1408306000,2233711000,5464187000,0,2457099000,773377000,,,,,915556000,5464187000,3007088000,0,-133237000,,1408306000,1327503000,8736,MTB,yearly
2020-12-31,,,1402500000,702200000,945400000,360500000,2316900000,1733800000,1733800000,,-185700000,,,,381700000,13171100000,11437300000,10854200000,-331300000,,1020800000,945400000,8755,OMC,yearly
2019-12-31,,,1940300000,727100000,1339100000,405900000,2712500000,2075100000,2075100000,,-197100000,,,,504400000,14953700000,12878600000,12241200000,-134800000,,1435900000,1339100000,8755,OMC,yearly
2018-12-31,,,1933200000,804100000,1326400000,453200000,2764400000,2047200000,2047200000,,-209100000,,,,492700000,15290200000,13243000000,12525800000,-114000000,,1440500000,1326400000,8755,OMC,yearly
2017-12-31,,,1888400000,719500000,1088400000,439700000,2756600000,2034800000,2034800000,,-199600000,,,,696200000,15273600000,13238800000,12517000000,-146400000,,1192200000,1086800000,8755,OMC,yearly
2019-12-31,131300000,,345400000,2400000,262900000,1492000000,2190400000,526300000,526300000,5300000,-29400000,,,,82300000,4029200000,3502900000,1838800000,-180900000,,263100000,262900000,8788,XRAY,yearly
2018-12-31,160500000,,-958400000,11900000,-1011000000,1538300000,2067800000,341900000,341900000,5300000,-37300000,,,,52500000,3986300000,3644400000,1918500000,-1300300000,,-1010900000,-1011000000,8788,XRAY,yearly
2017-12-31,151700000,,-1603500000,11600000,-1550000000,1532200000,2188500000,504600000,504600000,5300000,-38300000,,,,-53200000,3993400000,3488800000,1804900000,-2108100000,,-1550300000,-1550000000,8788,XRAY,yearly
2016-12-31,128500000,,440900000,11600000,429900000,1373600000,2000900000,498800000,498800000,5300000,-35900000,,,,9500000,3745300000,3246500000,1744400000,-57900000,,431400000,429900000,8788,XRAY,yearly
2020-03-31,99334000,,256825000,,203009000,341600000,689578000,248644000,248644000,,,,,,53816000,840883000,592239000,151305000,8181000,,203009000,203009000,8790,ABMD,yearly
2019-03-31,94418000,,263360000,,259016000,321550000,639865000,223897000,223897000,,,,,,4344000,769432000,545535000,129567000,39463000,,259016000,259016000,8790,ABMD,yearly
2018-03-31,73960000,,160437000,,112170000,262734000,495168000,158474000,158474000,,,,,,48267000,593749000,435275000,98581000,1963000,,112170000,112170000,8790,ABMD,yearly
2017-03-31,64796000,,91343000,,52116000,218153000,374677000,91728000,91728000,,,,,,39227000,445304000,353576000,70627000,-385000,,52116000,52116000,8790,ABMD,yearly
2020-12-31,,,241123000,,200529000,105391000,760715000,296026000,296026000,-47024000,-54124000,,,,40594000,1405220000,1109194000,644505000,-54903000,,200529000,200529000,8798,COG,yearly
2019-12-31,,,900224000,,681070000,92770000,1333834000,878816000,878816000,-63755000,-54952000,,,,219154000,1985469000,1106653000,651635000,21408000,,681070000,681070000,8798,COG,yearly
2018-12-31,,,698137000,,557043000,96641000,1393141000,786991000,786991000,-21790000,-73201000,,,,141094000,2143716000,1356725000,750575000,-88854000,,557043000,557043000,8798,COG,yearly
2017-12-31,,,-228435000,,100393000,97786000,1148292000,-39209000,-39209000,16561000,-82130000,,,,-328828000,1747293000,1786502000,599001000,-189226000,,100393000,100393000,8798,COG,yearly
2020-12-31,,,3728000000,,3189000000,3249000000,7478000000,4229000000,4229000000,,-593000000,,,,539000000,36799000000,32570000000,29321000000,-501000000,,3189000000,3189000000,8803,NOC,yearly
2019-12-31,,,2548000000,,2248000000,4290000000,7259000000,2969000000,2969000000,,-528000000,,,,300000000,33841000000,30872000000,26582000000,-421000000,,2248000000,2248000000,8803,NOC,yearly
2018-12-31,,,3742000000,,3229000000,2617000000,6820000000,4203000000,4203000000,,-562000000,,,,513000000,30095000000,25892000000,23275000000,-461000000,,3229000000,3229000000,8803,NOC,yearly
2017-12-31,,,4229000000,,2869000000,1477000000,5930000000,4453000000,4453000000,,-360000000,,,,1360000000,26004000000,21551000000,20074000000,-224000000,,2869000000,2869000000,8803,NOC,yearly
2020-11-30,,,882700000,13800000,870700000,1159600000,2697800000,948300000,948300000,-1700000,-236600000,,,,13300000,4287800000,3339500000,1590000000,-65600000,,869400000,870700000,8847,INFO,yearly
2019-11-30,,,742000000,15100000,502700000,1200700000,2757600000,976300000,976300000,7500000,-259700000,,,,242600000,4414600000,3438300000,1657000000,-234300000,,499400000,502700000,8847,INFO,yearly
2018-11-30,,,423800000,5900000,542300000,1187200000,2513500000,783400000,783400000,1700000,-225700000,,,,-115400000,4009200000,3225800000,1495700000,-359600000,,539200000,542300000,8847,INFO,yearly
2017-11-30,,,367100000,19100000,416900000,1102900000,2251300000,637200000,637200000,18700000,-154300000,,,,-49900000,3599700000,2962500000,1348400000,-270100000,,417000000,416900000,8847,INFO,yearly
2020-12-31,,,660400000,,468200000,364200000,1254300000,714100000,714100000,17500000,-38700000,,,,192200000,3427100000,2713000000,2172800000,-53700000,,468200000,467000000,8855,CBOE,yearly
2019-12-31,,,501400000,,374900000,336400000,1136900000,609100000,609100000,14800000,-37800000,,,,130600000,2496100000,1887000000,1359200000,-107700000,,370800000,372700000,8855,CBOE,yearly
2018-12-31,,,571200000,9400000.0,426500000,369500000,1216900000,629400000,629400000,14000000,-40500000,,,,146000000,2768800000,2139400000,1551900000,-58200000,,425200000,422100000,8855,CBOE,yearly
2017-12-31,,,334400000,9400000.0,401700000,337000000,995600000,456300000,456300000,10100000,-42600000,,,,-66200000,2229100000,1772800000,1233500000,-121900000,,400600000,396700000,8855,CBOE,yearly
2020-12-31,,,1411000000,,-401000000,,5258000000,2055000000,2055000000,871000000,-1377000000,,,,83000000,14172000000,12117000000,8914000000,-644000000,-1878000000,1328000000,-465000000,8873,D,yearly
2019-12-31,,,1727000000,2039000000.0,1358000000,-141000000.0,7970000000,4416000000,4416000000,1040000000,-1773000000,,,,351000000,16572000000,12156000000,8602000000,-2689000000,-1878000000,1376000000,1341000000,8873,D,yearly
2018-12-31,,,3129000000,1941000000.0,2447000000,-260000000.0,6482000000,4039000000,4039000000,703000000,-1493000000,,,,580000000,13366000000,9327000000,6884000000,-910000000,-1878000000,2549000000,2447000000,8873,D,yearly
2017-12-31,,,3090000000,2228000000.0,2999000000,-237000000.0,6378000000,4042000000,4042000000,668000000,-1205000000,,,,-30000000,12586000000,8544000000,6208000000,-952000000,-1878000000,3120000000,2999000000,8873,D,yearly
2020-12-31,,,6051000000,630000000,4959000000,11360000000,19242000000,0,6227000000,1655000000,,,,,1066000000,19242000000,13015000000,0,-176000000,,4985000000,4621000000,8959,USB,yearly
2019-12-31,,,8594000000,630000000,6914000000,10999000000,21140000000,0,8962000000,1179000000,,,,,1648000000,21140000000,12178000000,0,-368000000,,6946000000,6583000000,8959,USB,yearly
2018-12-31,,,8678000000,628000000,7096000000,10594000000,20813000000,0,8839000000,1380000000,,,,,1554000000,20813000000,11974000000,0,-161000000,,7124000000,6784000000,8959,USB,yearly
2017-12-31,,,7517000000,626000000,6218000000,10086000000,19883000000,0,7692000000,2105000000,,,,,1264000000,19883000000,12191000000,0,-175000000,,6253000000,5913000000,8959,USB,yearly
2020-10-02,280600000,,358300000,9300000,269200000,675000000,1377200000,421600000,421600000,,-14000000,,,,88900000,3168200000,2746600000,1791000000,-63300000,,269400000,269200000,9006,VAR,yearly
2019-09-27,247600000,,420800000,9300000,291900000,624600000,1370300000,498100000,498100000,,-8800000,,,,128600000,3225100000,2727000000,1854800000,-77300000,,292200000,291900000,9006,VAR,yearly
2018-09-28,233900000,,452100000,4300000,149900000,545200000,1273600000,494500000,494500000,,-6800000,,,,301800000,2919100000,2424600000,1645500000,-42400000,,150300000,149900000,9006,VAR,yearly
2017-09-29,210000000,,303100000,4300000,218500000,556200000,1113900000,347700000,347700000,,-10700000,,,,77100000,2619300000,2271600000,1505400000,-44600000,-6800000.0,226000000,218500000,9006,VAR,yearly
2020-12-31,,,3810400000,,3513200000,1441000000,4455500000,3294900000,3294900000,-280400000,-56900000,,,,297200000,8310400000,5015500000,3854900000,515500000,,3513200000,3513200000,9007,REGN,yearly
2019-12-31,,,2429100000,,2115800000,1306700000,3342500000,2245000000,2245000000,-209200000,-30200000,,,,313300000,6557600000,4312600000,3215100000,184100000,,2115800000,2115800000,9007,REGN,yearly
2018-12-31,,,2553500000,,2444400000,1127200000,3259300000,2534400000,2534400000,-402300000,-28200000,,,,109100000,5145600000,2611200000,1886300000,19100000,,2444400000,2444400000,9007,REGN,yearly
2017-12-31,,,2078500000,,1198500000,1320400000,3400000000,2079600000,2079600000,-402300000,-25100000,,,,880000000,5872200000,3792600000,2472200000,-31200000,,1198500000,1198500000,9007,REGN,yearly
2020-12-31,,,3203000000,,2714000000,13060000000,18259000000,0,3263000000,1936000000,,,,,486000000,18259000000,14996000000,0,-60000000,-3000000,2717000000,2375000000,9037,COF,yearly
2019-12-31,,,6874000000,,5546000000,13287000000,22357000000,0,7335000000,1735000000,,,,,1341000000,22357000000,15022000000,0,-461000000,13000000,5533000000,5192000000,9037,COF,yearly
2018-12-31,,,7318000000,,6015000000,12424000000,22220000000,0,7856000000,1940000000,,,,,1293000000,22220000000,14364000000,0,-538000000,-10000000,6025000000,5710000000,9037,COF,yearly
2017-12-31,,,5492000000,,1982000000,11782000000,19686000000,0,6071000000,1833000000,,,,,3375000000,19686000000,13615000000,0,-579000000,-135000000,2117000000,1704000000,9037,COF,yearly
2020-12-31,,,947000000,265000000,695000000,2834000000,4238000000,1344000000,1344000000,,-93000000,,,,192000000,11797000000,10453000000,7559000000,-397000000,,755000000,695000000,9040,GWW,yearly
2019-12-31,,,1209000000,205000000,849000000,2912000000,4397000000,1407000000,1407000000,,-79000000,,,,314000000,11486000000,10079000000,7089000000,-198000000,,895000000,849000000,9040,GWW,yearly
2018-12-31,,,1081000000,172000000,782000000,2909000000,4348000000,1347000000,1347000000,,-82000000,,,,258000000,11221000000,9874000000,6873000000,-266000000,,823000000,782000000,9040,GWW,yearly
2017-12-31,,,936000000,138000000,586000000,2845000000,4098000000,1164000000,1164000000,,-86000000,,,,313000000,10425000000,9261000000,6327000000,-228000000,,623000000,586000000,9040,GWW,yearly
2020-12-31,,,4793000000,76000000,3555000000,5956000000,10446000000,4296000000,4296000000,,-515000000,,,,1224000000,26581000000,22285000000,16135000000,497000000,,3569000000,3555000000,9041,MDLZ,yearly
2019-12-31,,,3946000000,76000000,3929000000,6076000000,10337000000,4087000000,4087000000,,-583000000,,,,2000000,25868000000,21781000000,15531000000,-141000000,,3944000000,3929000000,9041,MDLZ,yearly
2018-12-31,,,4104000000,76000000,3317000000,6411000000,10352000000,3765000000,3765000000,,-446000000,,,,773000000,25938000000,22173000000,15586000000,339000000,,3331000000,3317000000,9041,MDLZ,yearly
2017-12-31,,,3508000000,80000000,2828000000,6106000000,10034000000,3750000000,3750000000,,-396000000,,,,666000000,25896000000,22146000000,15862000000,-242000000,,2842000000,2828000000,9041,MDLZ,yearly
2020-03-31,1559000000,,1508000000,,3039000000,1137000000,4168000000,1450000000,1450000000,,-44000000,,,,-1531000000,5537000000,4087000000,1369000000,58000000,,3039000000,3039000000,9058,EA,yearly
2019-03-31,1433000000,,1079000000,,1019000000,1162000000,3628000000,1010000000,1010000000,,-45000000,,,,60000000,4950000000,3940000000,1322000000,69000000,,1019000000,1019000000,9058,EA,yearly
2018-03-31,1320000000,,1449000000,,1043000000,1110000000,3873000000,1434000000,1434000000,,-44000000,,,,406000000,5150000000,3716000000,1277000000,15000000,,1043000000,1043000000,9058,EA,yearly
2017-03-31,1205000000,,1210000000,,967000000,1112000000,3562000000,1239000000,1239000000,,-47000000,,,,243000000,4845000000,3606000000,1283000000,-29000000,,967000000,967000000,9058,EA,yearly
2020-12-31,1348000000,,4495000000,11000000,3646000000,6880000000,12932000000,4704000000,4704000000,,-275000000,,,,849000000,22284000000,17580000000,9352000000,-209000000,,3646000000,3510000000,9059,DHR,yearly
2019-12-31,1126000000,,3305000000,11000000,3008000000,5577000000,9984000000,3281000000,3281000000,,-108000000,,,,873000000,17911000000,14630000000,7927000000,24000000,576000000.0,2432000000,2940000000,9059,DHR,yearly
2018-12-31,1059000000,,2962000000,12300000,2651000000,5356000000,9505000000,3090000000,3090000000,,-137000000,,,,556000000,17049000000,13959000000,7544000000,-128000000,245000000.0,2406000000,2651000000,9059,DHR,yearly
2017-12-31,956400000,,2543200000,9600000,2492100000,5011900000,8571300000,2603000000,2603000000,,-140100000,,,,371000000,15518800000,12915800000,6947500000,-59800000,319900000.0,2172200000,2492100000,9059,DHR,yearly
2020-12-31,269315000,,602976000,,557054000,1032439000,2065477000,721674000,721674000,,-69120000,,,,45922000,3198149000,2476475000,1132672000,-118698000,,557054000,557054000,9081,AKAM,yearly
2019-12-31,261365000,,531385000,,478035000,1032529000,1905993000,573518000,573518000,,-49364000,,,,53350000,2893617000,2320099000,987624000,-42133000,,478035000,478035000,9081,AKAM,yearly
2018-12-31,246165000,,343089000,,298373000,1015922000,1760989000,465591000,465591000,,-43202000,,,,44716000,2714474000,2248883000,953485000,-122502000,,298373000,298373000,9081,AKAM,yearly
2017-12-31,222434000,,314192000,,222766000,967314000,1613198000,392546000,392546000,,-18839000,,,,91426000,2489035000,2096489000,875837000,-78354000,,222766000,222766000,9081,AKAM,yearly
2020-12-31,,,1361227000,18032000,1357213000,80299000,2128103000,1493247000,1493247000,1300000,-56283000,,,,0,2995565000,1502318000,867462000,-132020000,,1361227000,1098335000,9082,PSA,yearly
2019-12-31,,,1525651000,16756000,1520534000,60946000,2111503000,1536439000,1536439000,1200000,-45641000,,,,0,2924655000,1388216000,813152000,-10788000,,1525651000,1272767000,9082,PSA,yearly
2018-12-31,,,1717223000,25250000,1711031000,103612000,2105935000,1517577000,1517577000,1100000,-32542000,,,,0,2863018000,1345441000,757083000,199646000,,1717223000,1488900000,9082,PSA,yearly
2017-12-31,,,1448465000,24360000,1442217000,82182000,2036205000,1498797000,1498797000,700000,-12690000,,,,0,2744183000,1245386000,707978000,-50332000,,1448465000,1171609000,9082,PSA,yearly
2020-12-31,,,9749000000,1985000000,7747000000,9731000000,19581000000,9798000000,9798000000,52000000,-1437000000,,,,1981000000,33014000000,23216000000,13433000000,-49000000,,7768000000,7747000000,9092,KO,yearly
2019-12-31,,,10786000000,2117000000,8920000000,12011000000,22647000000,10625000000,10625000000,11000000,-946000000,,,,1801000000,37266000000,26641000000,14619000000,161000000,,8985000000,8920000000,9092,KO,yearly
2018-12-31,,,8225000000,2077000000,6434000000,11013000000,21233000000,10203000000,10203000000,17000000,-950000000,,,,1749000000,34300000000,24097000000,13067000000,-1978000000,,6476000000,6434000000,9092,KO,yearly
2017-12-31,,,6890000000,1905000000,1248000000,12901000000,22491000000,9340000000,9340000000,250000000,-853000000,,,,5607000000,36212000000,26872000000,13721000000,-2450000000,,1283000000,1248000000,9092,KO,yearly
2020-12-31,122000000,,3332000000,871000000,2829000000,361000000,6159000000,3299000000,3299000000,,-308000000,,,,704000000,11497000000,8198000000,5338000000,33000000,163000000,2628000000,2829000000,9102,NEM,yearly
2019-12-31,150000000,,3788000000,997000000,2805000000,293000000,4377000000,1754000000,1754000000,,-301000000,,,,832000000,9740000000,7986000000,5363000000,2034000000,-72000000,2956000000,2805000000,9102,NEM,yearly
2018-12-31,153000000,,705000000,1010000000,341000000,244000000,3276000000,1205000000,1205000000,,-207000000,,,,386000000,7253000000,6048000000,3977000000,-500000000,61000000,319000000,341000000,9102,NEM,yearly
2017-12-31,143000000,,1056000000,984000000,-114000000,250000000,3323000000,1567000000,1567000000,,-241000000,,,,1127000000,7379000000,5812000000,4056000000,-511000000,-38000000,-71000000,-114000000,9102,NEM,yearly
2020-12-31,,,1069100000,658900000,761600000,564100000,1880300000,1316200000,1316200000,,-323800000,,,,261600000,6145600000,4829400000,4265300000,-247100000,,807500000,524800000,9114,IVZ,yearly
2019-12-31,,,972900000,839300000,688300000,539800000,2026200000,1486400000,1486400000,,-364200000,,,,235100000,6117400000,4631000000,4091200000,-513500000,,737800000,564700000,9114,IVZ,yearly
2018-12-31,,,1138100000,753600000,882800000,459200000,1805400000,1346200000,1346200000,,-302200000,,,,255000000,5314100000,3967900000,3508700000,-208100000,,883100000,882800000,9114,IVZ,yearly
2017-12-31,,,1429200000,502700000,1127300000,428700000,1807600000,1378900000,1378900000,,-250100000,,,,268200000,5160300000,3781400000,3352700000,50300000,,1161000000,1127300000,9114,IVZ,yearly
2020-12-31,,,1272687000,618766000,1112564000,292853000,3716888000,1968348000,1968348000,137679000,-784400000,,,,-4637000,4604042000,2635694000,887154000,-695661000,,1277324000,1109227000,9142,SPG,yearly
2019-12-31,,,2453242000,603913000,2101584000,375313000,4638845000,2818131000,2818131000,104898000,-789353000,,,,30054000,5660489000,2842358000,1021644000,-364889000,,2423188000,2098247000,9142,SPG,yearly
2018-12-31,,,2859241000,730438000,2440058000,334461000,4637324000,2926299000,2926299000,94110000,-815923000,,,,36898000,5645288000,2718989000,1007964000,-67058000,,2822343000,2436721000,9142,SPG,yearly
2017-12-31,,,2268246000,743076000,1947962000,337987000,4547256000,2802340000,2802340000,131477000,-809393000,,,,23343000,5527336000,2724996000,980080000,-534094000,,2244903000,1944625000,9142,SPG,yearly
2020-12-27,259522000,,322062000,64474000,222519000,1657570000,2789518000,727680000,727680000,,-202130000,,,,96621000,5465443000,4737763000,2675925000,-405618000,,225441000,222519000,9163,HAS,yearly
2019-12-29,262156000,,594210000,64474000,520454000,1552501000,2412244000,550328000,550328000,,-121478000,,,,73756000,4720227000,4169899000,2307983000,43882000,,520454000,520454000,9163,HAS,yearly
2018-12-30,246165000,,270402000,64474000,220434000,1476226000,2333402000,582308000,582308000,,-90826000,,,,49968000,4579646000,3997338000,2246244000,-311906000,,220434000,220434000,9163,HAS,yearly
2017-12-31,269020000,,786150000,64474000,396607000,1608606000,2734803000,828359000,828359000,,-98268000,,,,389543000,5209782000,4381423000,2474979000,-42209000,,396607000,396607000,9163,HAS,yearly
2020-12-31,,,1314000000,,1094000000,2824000000,4955000000,0,1396000000,735000000,,,,,220000000,4955000000,3559000000,0,-82000000,,1094000000,991000000,9165,RF,yearly
2019-12-31,,,1985000000,,1582000000,2654000000,5473000000,0,2030000000,789000000,,,,,403000000,5473000000,3443000000,0,-45000000,,1582000000,1503000000,9165,RF,yearly
2018-12-31,,,1955000000,,1759000000,2638000000,5517000000,0,2019000000,860000000,,,,,387000000,5517000000,3498000000,0,-64000000,191000000.0,1568000000,1695000000,9165,RF,yearly
2017-12-31,,,1860000000,,1263000000,2697000000,5425000000,0,1891000000,837000000,,,,,619000000,5425000000,3534000000,0,-31000000,22000000.0,1241000000,1199000000,9165,RF,yearly
2020-12-31,,,1467000000,,1473000000,246000000,4914000000,2108000000,2108000000,612000000,-840000000,,,,-6000000,11526000000,9418000000,6612000000,-641000000,,1473000000,1473000000,9297,XEL,yearly
2019-12-31,,,1500000000,,1372000000,247000000,4659000000,2078000000,2078000000,569000000,-773000000,,,,128000000,11529000000,9451000000,6870000000,-578000000,,1372000000,1372000000,9297,XEL,yearly
2018-12-31,,,1442000000,,1261000000,324000000,4373000000,1851000000,1851000000,556000000,-700000000,,,,181000000,11537000000,9686000000,7164000000,-409000000,,1261000000,1261000000,9297,XEL,yearly
2017-12-31,,,1690000000,,1148000000,329000000,4457000000,2104000000,2104000000,545000000,-663000000,,,,542000000,11404000000,9300000000,6947000000,-414000000,,1148000000,1148000000,9297,XEL,yearly
2020-10-31,93300000,,266500000,200000,238400000,992500000,1624900000,401900000,401900000,,-36800000,,,,28100000,2430900000,2029000000,806000000,-135400000,,238400000,238400000,9319,COO,yearly
2019-10-31,86700000,,477400000,200000,466700000,969500000,1785000000,583000000,583000000,,-68000000,,,,10700000,2653400000,2070400000,868400000,-105600000,,466700000,466700000,9319,COO,yearly
2018-10-31,84800000,,331900000,200000,139900000,973300000,1632300000,427500000,427500000,,-82700000,,,,192000000,2532800000,2105300000,900500000,-95600000,,139900000,139900000,9319,COO,yearly
2017-10-31,69200000,,394000000,100000,372900000,799100000,1365800000,429100000,429100000,,-33400000,,,,21100000,2139000000,1709900000,773200000,-60600000,,372900000,372900000,9319,COO,yearly
2020-12-31,,,1266828000,254410000,1388334000,,4458214000,1795818000,1795818000,1049310000,-856300000,,,,-121506000,10113636000,8317818000,5655422000,-528990000,,1388334000,1388334000,9321,ETR,yearly
2019-12-31,,,1071401000,254410000,1241226000,,4269867000,1771524000,1771524000,1018327000,-824594000,,,,-169825000,10878673000,9107149000,6608806000,-700123000,,1241226000,1241226000,9321,ETR,yearly
2018-12-31,,,-188165000,219402000,848661000,3300000.0,3844937000,1140686000,1140686000,1331509000,-782543000,,,,-1036826000,11009452000,9868766000,7164515000,-1328851000,,848661000,848661000,9321,ETR,yearly
2017-12-31,,,954182000,197803000,411612000,5900000.0,4298997000,2011779000,2011779000,891340000,-720953000,,,,542570000,11074481000,9062702000,6775484000,-1057597000,,411612000,411612000,9321,ETR,yearly
2020-12-31,119747000,,357732000,,335324000,775132000,1324874000,429995000,429995000,,-66494000,,,,21931000,2537156000,2107161000,1212282000,-72263000,-477000,335801000,335324000,9391,TFX,yearly
2019-12-31,113857000,,339903000,,461466000,797851000,1409005000,497297000,497297000,,-80270000,,,,-122078000,2595362000,2098065000,1186357000,-157394000,-515000,461981000,461466000,9391,TFX,yearly
2018-12-31,106208000,,219628000,,200802000,744085000,1302816000,452523000,452523000,,-103020000,,,,23196000,2448383000,1995860000,1145567000,-232895000,4370000,196432000,200802000,9391,TFX,yearly
2017-12-31,84770000,,284911000,,152530000,696388000,1171802000,390644000,390644000,,-82546000,,,,129648000,2146303000,1755659000,974501000,-105733000,-2733000,155263000,152530000,9391,TFX,yearly
2020-12-31,2565000000,,5197000000,1522000000,5704000000,11122000000,13514000000,-173000000,-173000000,,-1333000000,,,,-474000000,79619000000,79792000000,66105000000,5370000000,-125000000,5671000000,5066000000,9403,GE,yearly
2019-12-31,3118000000,,1148000000,1545000000,-4979000000,12380000000,21916000000,6418000000,6418000000,,-2115000000,,,,726000000,95214000000,88796000000,73298000000,-5270000000,-5335000000,422000000,-5440000000,9403,GE,yearly
2018-12-31,3415000000,,-20988000000,20500000000,-22355000000,11450000000,21576000000,6711000000,6711000000,,-2415000000,,,,93000000,97012000000,90301000000,75436000000,-27699000000,-1363000000,-21081000000,-22809000000,9403,GE,yearly
2017-12-31,3415000000,,-11345000000,20859000000,-8484000000,12455000000,7111000000,-5344000000,-5344000000,,-2538000000,,,,-2808000000,99279000000,104623000000,92168000000,-6001000000,-312000000,-8537000000,-8944000000,9403,GE,yearly
2020-03-31,,,-5228000000,344000000,-5369000000,1074000000,4676000000,1660000000,1660000000,,-383000000,,,,130000000,19577000000,17917000000,14901000000,-6888000000,,-5358000000,-5369000000,9425,DXC,yearly
2019-03-31,,,1515000000,323000000,1257000000,1376000000,5807000000,2463000000,2463000000,,-334000000,,,,288000000,20753000000,18290000000,14946000000,-948000000,35000000.0,1227000000,1257000000,9425,DXC,yearly
2018-03-31,,,1304000000,350000000,1751000000,1381000000,5416000000,2240000000,2240000000,,-320000000,,,,-242000000,21733000000,19493000000,16317000000,-936000000,236000000.0,1546000000,1751000000,9425,DXC,yearly
2017-03-31,,,-174000000,278000000,-123000000,1258000000,2058000000,153000000,153000000,,-117000000,,,,-74000000,7607000000,7454000000,5549000000,-327000000,236000000.0,-100000000,-123000000,9425,DXC,yearly
2020-12-31,,,1288200000,19400000,854900000,2233700000,3827500000,1593800000,1593800000,,-248700000,,,,296800000,12454700000,10860900000,8627200000,-305600000,-122300000,991400000,854900000,9426,TT,yearly
2019-12-31,,,1398900000,44800000,1410900000,2339900000,4027700000,1687800000,1687800000,,-242800000,,,,238600000,13075900000,11388100000,9048200000,-288900000,265800000,1160300000,1410900000,9426,TT,yearly
2018-12-31,,,1257800000,42100000,1337600000,2252000000,3786500000,1534500000,1534500000,,-221000000,,,,234900000,12343800000,10809300000,8557300000,-276700000,329800000,1022900000,1337600000,9426,TT,yearly
2017-12-31,,,1417900000,66600000,1302600000,2736800000,4432800000,1696000000,1696000000,,-215800000,,,,80200000,14197600000,12501600000,9764800000,-278100000,-25400000,1337700000,1302600000,9426,TT,yearly
2020-02-01,41000000,,528000000,,351000000,6923000000,8000000000,1036000000,1036000000,,-76000000,,,,177000000,16383000000,15347000000,8383000000,-508000000,,351000000,351000000,9427,GPS,yearly
2019-02-02,50000000,,1322000000,,1003000000,4898000000,6322000000,1374000000,1374000000,,-73000000,,,,319000000,16580000000,15206000000,10258000000,-52000000,,1003000000,1003000000,9427,GPS,yearly
2018-02-03,51000000,,1424000000,,848000000,4573000000,6066000000,1442000000,1442000000,,-74000000,,,,576000000,15855000000,14413000000,9789000000,-18000000,,848000000,848000000,9427,GPS,yearly
2017-01-28,46000000,,1124000000,,676000000,4147000000,5640000000,1447000000,1447000000,,-75000000,,,,448000000,15516000000,14069000000,9876000000,-323000000,,676000000,676000000,9427,GPS,yearly
2020-12-31,,,1959000000,132000000,1431000000,1509000000,3717000000,2107000000,2107000000,-2000000,-166000000,,,,460000000,9437000000,7330000000,5720000000,-148000000,,1499000000,1425000000,9452,DGX,yearly
2019-12-31,,,1133000000,122000000,858000000,1414000000,2724000000,1214000000,1214000000,-2000000,-180000000,,,,247000000,7726000000,6512000000,5002000000,-81000000,20000000.0,886000000,855000000,9452,DGX,yearly
2018-12-31,,,970000000,128000000,736000000,1395000000,2627000000,1144000000,1144000000,-2000000,-169000000,,,,182000000,7531000000,6387000000,4904000000,-174000000,20000000.0,788000000,733000000,9452,DGX,yearly
2017-12-31,,,1065000000,114000000,772000000,1421000000,2694000000,1198000000,1198000000,1000000,-153000000,,,,241000000,7402000000,6204000000,4708000000,-133000000,20000000.0,824000000,769000000,9452,DGX,yearly
2020-12-31,984000000,,1954000000,,1599000000,4759000000,9158000000,2943000000,2943000000,,-315000000,,,,355000000,14351000000,11408000000,5193000000,-989000000,,1599000000,1599000000,9454,SYK,yearly
2019-12-31,971000000,,2562000000,,2083000000,4978000000,9801000000,3388000000,3388000000,,-287000000,,,,479000000,14884000000,11496000000,5083000000,-826000000,,2083000000,2083000000,9454,SYK,yearly
2018-12-31,862000000,,2356000000,,3553000000,4808000000,8981000000,2894000000,2894000000,,-264000000,,,,-1197000000,13601000000,10707000000,4620000000,-538000000,,3553000000,3553000000,9454,SYK,yearly
2017-12-31,787000000,,2063000000,14000000.0,1020000000,4380000000,8259000000,2721000000,2721000000,,-247000000,,,,1043000000,12444000000,9723000000,4185000000,-658000000,,1020000000,1020000000,9454,SYK,yearly
2020-12-31,,,743798000,,584480000,359772000,1281481000,891734000,891734000,29975000,-134393000,,,,155803000,4856826000,3965092000,3575345000,-147936000,-3515000,587995000,584480000,9476,VMC,yearly
2019-12-31,,,757701000,,617662000,372093000,1255901000,872461000,872461000,11347000,-130155000,,,,135198000,4929103000,4056642000,3673202000,-114760000,-4841000,622503000,617662000,9476,VMC,yearly
2018-12-31,,,623290000,,515805000,339277000,1100945000,756763000,756763000,4905000,-137977000,,,,105449000,4382869000,3626106000,3281924000,-133473000,-2036000,517841000,515805000,9476,VMC,yearly
2017-12-31,,,361316000,,601185000,327887000,993513000,643802000,643802000,21824000,-295522000,,,,-232075000,3890296000,3246494000,2896783000,-282486000,7794000,593391000,601185000,9476,VMC,yearly
2020-12-31,113000000,,1379000000,133000000,1420000000,1100000000,3394000000,2181000000,2181000000,,-533000000,,,,-43000000,27753000000,25572000000,24359000000,-802000000,-2000000,1422000000,1417000000,9481,LYB,yearly
2019-12-31,111000000,,4045000000,135000000,3390000000,1083000000,5426000000,4232000000,4232000000,,-354000000,,,,648000000,34727000000,30495000000,29301000000,-187000000,-7000000,3397000000,3384000000,9481,LYB,yearly
2018-12-31,115000000,,5309000000,139000000,4688000000,1037000000,6475000000,5323000000,5323000000,,-362000000,,,,613000000,39004000000,33681000000,32529000000,-14000000,-8000000,4696000000,4682000000,9481,LYB,yearly
2017-12-31,106000000,,5493000000,1000000,4879000000,843000000,6425000000,5476000000,5476000000,,-491000000,,,,598000000,34484000000,29008000000,28059000000,17000000,-18000000,4895000000,4874000000,9481,LYB,yearly
2020-12-31,,,1797000000,,1427000000,3536000000,6515000000,0,1797000000,1182000000,,,,,370000000,6515000000,4718000000,0,0,,1427000000,1317000000,9492,FITB,yearly
2019-12-31,,,3202000000,,2512000000,3412000000,7893000000,0,3457000000,1024000000,,,,,690000000,7893000000,4436000000,0,-255000000,,2512000000,2398000000,9492,FITB,yearly
2018-12-31,,,2765000000,,2193000000,3031000000,6772000000,0,2841000000,900000000,,,,,572000000,6772000000,3931000000,0,-76000000,,2193000000,2095000000,9492,FITB,yearly
2017-12-31,,,2979000000,20000000.0,2180000000,2847000000,6820000000,0,3052000000,921000000,,,,,799000000,6820000000,3768000000,0,-73000000,,2180000000,2082000000,9492,FITB,yearly
2020-12-31,,,277000000,2814000000,211000000,471000000,4780000000,2566000000,2566000000,22000000,-1172000000,,,,79000000,7719000000,5153000000,2939000000,-2289000000,,198000000,208000000,9505,WMB,yearly
2019-12-31,,,1064000000,3001000000,850000000,533000000,4699000000,2444000000,2444000000,8000000,-1186000000,,,,335000000,8201000000,5757000000,3502000000,-1380000000,-15000000.0,729000000,847000000,9505,WMB,yearly
2018-12-31,,,331000000,1337000000,-155000000,594000000,4335000000,1954000000,1954000000,62000000,-1112000000,,,,138000000,8686000000,6732000000,4351000000,-1623000000,-15000000.0,193000000,-156000000,9505,WMB,yearly
2017-12-31,,,535000000,6519000000,2174000000,656000000,4155000000,1680000000,1680000000,83000000,-1083000000,,,,-1974000000,8031000000,6351000000,3876000000,-1145000000,-15000000.0,2509000000,2174000000,9505,WMB,yearly
2020-12-31,,,-1116000000,121000000,-1279000000,8628000000,6123000000,-2505000000,-2505000000,,-1651000000,,,,160000000,127144000000,129649000000,121021000000,1389000000,,-1276000000,-1279000000,9507,F,yearly
2019-12-31,,,-640000000,45000000,47000000,10218000000,12876000000,2658000000,2658000000,,-1049000000,,,,-724000000,155900000000,153242000000,143024000000,-3298000000,,84000000,47000000,9507,F,yearly
2018-12-31,,,4345000000,134000000,3677000000,9781000000,14835000000,5054000000,5054000000,,-1228000000,,,,650000000,160338000000,155284000000,145503000000,-709000000,,3695000000,3677000000,9507,F,yearly
2017-12-31,,,8159000000,126000000,7731000000,9962000000,16558000000,6596000000,6596000000,,-1190000000,,,,402000000,156776000000,150180000000,140218000000,1563000000,,7757000000,7731000000,9507,F,yearly
2020-12-31,,,3119000000,882000000,2422000000,5389000000,10293000000,4506000000,4506000000,5000000,-1031000000,,,,535000000,25285000000,20779000000,14992000000,-1387000000,117000000,2584000000,2422000000,9557,VIAC,yearly
2019-12-31,,,3170000000,336000000,3308000000,5580000000,10285000000,4287000000,4287000000,5000000,-962000000,,,,-29000000,26998000000,22711000000,16713000000,-1117000000,140000000,3199000000,3308000000,9557,VIAC,yearly
2018-12-31,,,3937000000,293000000,3455000000,5113000000,11026000000,5486000000,5486000000,5000000,-1030000000,,,,580000000,26425000000,20939000000,15399000000,-1549000000,135000000,3357000000,3455000000,9557,VIAC,yearly
2017-12-31,,,4124000000,293000000,2321000000,5252000000,11052000000,5357000000,5357000000,5000000,-1088000000,,,,804000000,26535000000,21178000000,15483000000,-1233000000,-947000000,3320000000,2321000000,9557,VIAC,yearly
2020-11-01,1589000000,,3835000000,7000000,2751000000,2747000000,8955000000,4548000000,4548000000,71000000,-305000000,,,,1082000000,35514000000,30966000000,26559000000,-713000000,,2753000000,2751000000,9576,DE,yearly
2019-11-03,1782000000,,4109000000,18000000,3253000000,3008000000,9187000000,4310000000,4310000000,87000000,-232000000,,,,852000000,39233000000,34923000000,30046000000,-201000000,,3257000000,3253000000,9576,DE,yearly
2018-10-28,1658000000,,4098000000,17000000,2368000000,2897000000,8985000000,4159000000,4159000000,271000000,-268000000,,,,1727000000,37318000000,33159000000,28333000000,-61000000,,2371000000,2368000000,9576,DE,yearly
2017-10-29,1356680000,,3130000000,17200000,2159000000,2493920000,6777600000,2926000000,2926000000,1000000,-230000000,,,,971000000,29071000000,26145000000,22293400000,204000000,,2159000000,2159000000,9576,DE,yearly
2020-12-31,,,-227000000,785000000,-374000000,13906000000,13648000000,-258000000,-258000000,,,,,,-81000000,57091000000,57349000000,43443000000,31000000,,-146000000,-395000000,9582,PRU,yearly
2019-12-31,,,5185000000,604000000,4186000000,13389000000,18501000000,5112000000,5112000000,,-1540000000.0,,,,947000000,64807000000,59695000000,46306000000,-1467000000,,4238000000,4140000000,9582,PRU,yearly
2018-12-31,,,4910000000,414000000,4074000000,11948000000,16783000000,4835000000,4835000000,,-1423000000.0,,,,822000000,62992000000,58157000000,46209000000,-1348000000,,4088000000,4026000000,9582,PRU,yearly
2017-12-31,,,6536000000,275000000,7863000000,11911000000,18515000000,6604000000,6604000000,,-1334000000.0,,,,-1438000000,59802000000,53198000000,41287000000,-1402000000,,7974000000,7768000000,9582,PRU,yearly
2021-01-01,,,1322000000,,1119000000,3315000000,5339000000,2024000000,2024000000,,-270000000,,,,234000000,18194000000,16170000000,12855000000,-702000000,-2000000,1088000000,1119000000,9622,LHX,yearly
2020-01-03,,,1816000000,157000000.0,1644000000,2684000000,5358000000,2674000000,2674000000,,-270000000,,,,146000000,18526000000,15852000000,13168000000,-858000000,-2000000,1670000000,1644000000,9622,LHX,yearly
2019-06-28,,,1113000000,157000000.0,949000000,991000000,2334000000,1343000000,1343000000,,-169000000,,,,160000000,6801000000,5458000000,4467000000,-230000000,-4000000,953000000,947000000,9622,LHX,yearly
2018-06-29,,,908000000,157000000.0,699000000,946000000,2102000000,1156000000,1156000000,,-170000000,,,,206000000,6168000000,5012000000,4066000000,-248000000,-3000000,702000000,697000000,9622,LHX,yearly
2020-10-31,1050519000,,1311617000,,1220761000,641027000,3690478000,1569477000,1569477000,,-193305000,,,,90856000,5603056000,4033579000,1912578000,-257860000,,1220761000,1220761000,9637,ADI,yearly
2019-11-02,1130348000,,1485728000,,1363011000,647897000,4013750000,1806464000,1806464000,,-229075000,,,,122717000,5991065000,4184601000,1977315000,-320736000,,1363011000,1359782000,9637,ADI,yearly
2018-11-03,1165047000,,1655314000,,1506980000,696597000,4250396000,1959850000,1959850000,,-253589000,,,,148334000,6224689000,4264839000,1974293000,-304536000,,1506980000,1501071000,9637,ADI,yearly
2017-10-28,968133000,,934747000,,805379000,644398000,3526959000,1617077000,1617077000,,-250840000,,,,129368000,5246354000,3629277000,1719395000,-682330000,,805379000,803136000,9637,ADI,yearly
2020-12-31,,,-2850000000,969000000,-3093000000,1575000000,3607000000,-343000000,-343000000,-50000000,-468000000,,,,-11000000,4543000000,4886000000,936000000,-2507000000,,-2839000000,-3093000000,9640,HES,yearly
2019-12-31,,,221000000,974000000,-408000000,1634000000,4575000000,576000000,576000000,10000000,-380000000,,,,461000000,6311000000,5735000000,1736000000,-355000000,,-240000000,-412000000,9640,HES,yearly
2018-12-31,,,220000000,1259000000,-282000000,1516000000,4381000000,755000000,755000000,-116000000,-399000000,,,,335000000,6152000000,5397000000,1771000000,-535000000,,-115000000,-328000000,9640,HES,yearly
2017-12-31,,,-5778000000,1303000000,-4074000000,1854000000,4080000000,-2849000000,-2849000000,4000000,-325000000,,,,-1837000000,5347000000,8196000000,1267000000,-2929000000,,-3941000000,-4120000000,9640,HES,yearly
2020-12-31,8879000000,,7498000000,,9616000000,10890000000,33334000000,10129000000,10129000000,,-1449000000,,,,477000000,41908000000,31779000000,8574000000,-2631000000,2631000000,7021000000,9616000000,9688,PFE,yearly
2019-12-31,7984000000,,17682000000,303000000.0,16273000000,14103000000,41739000000,15042000000,15042000000,,-1574000000,,,,1384000000,51750000000,36708000000,10011000000,2640000000,4000000,16298000000,16272000000,9688,PFE,yearly
2018-12-31,7959000000,,11885000000,351000000.0,11153000000,13943000000,42519000000,15724000000,15724000000,-1002000000.0,-1316000000,,,,706000000,53647000000,37923000000,11128000000,-3839000000,10000000,11179000000,11152000000,9688,PFE,yearly
2017-12-31,7645000000,,12304000000,348000000.0,21308000000,14606000000,41720000000,14711000000,14711000000,-1002000000.0,-1270000000,,,,-9049000000,52546000000,37835000000,10826000000,-2407000000,2000000,21353000000,21307000000,9688,PFE,yearly
2020-12-31,,,365000000,2146000000,46000000,167000000,2511000000,2344000000,2344000000,,-1038000000,,,,216000000,9660000000,7316000000,7149000000,-1979000000,3000000,149000000,46000000,9693,AES,yearly
2019-12-31,,,829000000,2293000000,303000000,213000000,2349000000,2136000000,2136000000,,-1050000000,,,,352000000,10189000000,8053000000,7840000000,-1307000000,1000000,477000000,303000000,9693,AES,yearly
2018-12-31,,,2057000000,2456000000,1203000000,202000000,2574000000,2372000000,2372000000,,-1056000000,,,,708000000,10736000000,8364000000,8162000000,-315000000,218000000,1349000000,1203000000,9693,AES,yearly
2017-12-31,,,842000000,2440000000,-1161000000,216000000,2487000000,2271000000,2271000000,,-1170000000,,,,990000000,10530000000,8259000000,8043000000,-1429000000,-654000000,-148000000,-1161000000,9693,AES,yearly
2020-12-31,17000000,,171000000,,261000000,296000000,1422000000,830000000,830000000,,-381000000,,,,-40000000,5259000000,4429000000,3837000000,-659000000,50000000,211000000,259000000,9700,HWM,yearly
2019-12-31,28000000,,210000000,14000000.0,470000000,412000000,1910000000,1175000000,1175000000,,-338000000,,,,84000000,7098000000,5923000000,5188000000,-965000000,344000000,126000000,468000000,9700,HWM,yearly
2018-12-31,41000000,,428000000,12000000.0,642000000,390000000,1664000000,915000000,915000000,4000000.0,-377000000,,,,119000000,6778000000,5863000000,5114000000,-487000000,333000000,309000000,640000000,9700,HWM,yearly
2017-12-31,109000000,,470000000,14000000.0,-74000000,851000000,2739000000,1228000000,1228000000,12000000.0,-496000000,,,,544000000,12960000000,11732000000,10221000000,-758000000,333000000,-74000000,-127000000,9700,HWM,yearly
2020-12-31,,,2899000000,,2420000000,6433000000,11615000000,0,3316000000,1866000000,,,,,479000000,11615000000,8299000000,0,-417000000,,2420000000,2257000000,9718,STT,yearly
2019-12-31,,,2712000000,,2242000000,6480000000,11746000000,0,3135000000,2131000000,,,,,470000000,11746000000,8611000000,0,-423000000,,2242000000,2009000000,9718,STT,yearly
2018-12-31,,,3101000000,,2593000000,6419000000,12116000000,0,3651000000,2046000000,,,,,508000000,12116000000,8465000000,0,-550000000,,2593000000,2404000000,9718,STT,yearly
2017-12-31,,,2995000000,,2156000000,6089000000,11264000000,0,3475000000,1700000000,,,,,839000000,11264000000,7789000000,0,-480000000,,2156000000,1972000000,9718,STT,yearly
2020-03-31,65546000,,498681000,12848000,407605000,708506000,1322393000,548341000,548341000,,-40279000,,,,90876000,3030895000,2482554000,1708502000,-49660000,,407805000,407605000,9740,STE,yearly
2019-03-31,63038000,,369470000,7988000,304051000,644787000,1185148000,477323000,477323000,,-45015000,,,,64394000,2782170000,2304847000,1597022000,-107853000,,305076000,304051000,9740,STE,yearly
2018-03-31,60782000,,354982000,11340000,290915000,615767000,1092746000,416197000,416197000,,-50629000,,,,63360000,2619996000,2203799000,1527250000,-61215000,,291622000,290915000,9740,STE,yearly
2017-03-31,59397000,,184646000,11431000,109965000,651957000,1026213000,314859000,314859000,,-44520000,,,,74015000,2612756000,2297897000,1586543000,-130213000,,110631000,109965000,9740,STE,yearly
2020-12-31,,,-8822000000,,-7069000000,459000000,-2542000000,-8975000000,-8975000000,3486000000,-992000000,,,,-1753000000,15355000000,24330000000,17897000000,153000000,,-7069000000,-7069000000,9772,UAL,yearly
2019-12-31,,,3914000000,,3009000000,1863000000,14782000000,4568000000,4568000000,6063000000,-646000000,,,,905000000,43259000000,38691000000,28477000000,-654000000,,3009000000,3009000000,9772,UAL,yearly
2018-12-31,,,2648000000,,2122000000,1769000000,13194000000,3670000000,3670000000,5590000000,-605000000,,,,526000000,41303000000,37633000000,28109000000,-1022000000,,2122000000,2122000000,9772,UAL,yearly
2017-12-31,,,3023000000,,2143000000,1652000000,12771000000,3690000000,3690000000,5333000000,-552000000,,,,880000000,37784000000,34094000000,25013000000,-667000000,,2143000000,2143000000,9772,UAL,yearly
2020-12-31,,,1002300000,,788500000,2022400000,3210100000,1187700000,1187700000,,-154900000,,,,213800000,18467500000,17279800000,15257400000,-185400000,,788500000,788500000,9829,CDW,yearly
2019-12-31,,,949700000,,736800000,1906300000,3039900000,1133600000,1133600000,,-159400000,,,,212900000,18032400000,16898800000,14992500000,-183900000,,736800000,736800000,9829,CDW,yearly
2018-12-31,,,840500000,,643000000,1719600000,2706900000,987300000,987300000,,-148600000,,,,197500000,16240500000,15253200000,13533600000,-146800000,,643000000,643000000,9829,CDW,yearly
2017-12-31,,,660700000,,523100000,1583700000,2450200000,866500000,866500000,,-150500000,,,,137600000,14832900000,13966400000,12382700000,-263200000,,523100000,523100000,9829,CDW,yearly
2020-09-03,2600000000,,2990000000,,2687000000,881000000,6552000000,3060000000,3060000000,11000000,-194000000,,,,280000000,21435000000,18375000000,14883000000,-70000000,,2710000000,2687000000,9839,MU,yearly
2019-08-29,2441000000,,7051000000,987000000.0,6313000000,836000000,10702000000,7390000000,7390000000,35000000,-128000000,,,,693000000,23406000000,16016000000,12704000000,-339000000,,6358000000,6313000000,9839,MU,yearly
2018-08-30,2141000000,,14306000000,967000000.0,14135000000,813000000,17891000000,14926000000,14926000000,11000000,-342000000,,,,168000000,30391000000,15465000000,12500000000,-620000000,,14138000000,14135000000,9839,MU,yearly
2017-08-31,1824000000,,5204000000,849000000.0,5089000000,730000000,8436000000,5877000000,5877000000,5000000,-601000000,,,,114000000,20322000000,14445000000,11886000000,-673000000,,5090000000,5089000000,9839,MU,yearly
2020-02-01,,,1098700000,,827000000,7367600000,8951900000,1584300000,1584300000,,-161800000,,,,271700000,23610800000,22026500000,14658900000,-485600000,,827000000,827000000,9850,DLTR,yearly
2019-02-02,,,-1309000000,,-1590800000,5104500000,6947500000,1843000000,1843000000,,-213000000,,,,281800000,22823300000,20980300000,15875800000,-3152000000,,-1590800000,-1590800000,9850,DLTR,yearly
2018-02-03,,,1704000000,,1714300000,4998700000,7021900000,2004700000,2004700000,,-301800000,,,,-10300000,22245500000,20240800000,15223600000,-300700000,,1714300000,1714300000,9850,DLTR,yearly
2017-01-28,,,1329400000,,896200000,5969100000,7677600000,1708500000,1708500000,,-372900000,,,,433200000,20719200000,19010700000,13041600000,-379100000,,896200000,896200000,9850,DLTR,yearly
2020-12-26,13556000000,,25078000000,,20899000000,6180000000,43612000000,23876000000,23876000000,,-629000000,,,,4179000000,77867000000,53991000000,34255000000,1202000000,,20899000000,20899000000,9853,INTC,yearly
2019-12-28,13362000000,,24058000000,,21048000000,6350000000,42140000000,22428000000,22428000000,393000000.0,-489000000,,,,3010000000,71965000000,49537000000,29825000000,1630000000,,21048000000,21048000000,9853,INTC,yearly
2018-12-29,13543000000,,23317000000,,21053000000,6950000000,43737000000,23244000000,23244000000,-72000000.0,-468000000,,,,2264000000,70848000000,47604000000,27111000000,73000000,,21053000000,21053000000,9853,INTC,yearly
2017-12-30,13035000000,,20352000000,,9601000000,7452000000,39098000000,18434000000,18434000000,-72000000.0,-646000000,,,,10751000000,62761000000,44327000000,23663000000,1918000000,,9601000000,9601000000,9853,INTC,yearly
2020-12-31,20100000,,110700000,,103000000,142300000,285500000,123100000,123100000,,-3900000,,,,10900000,796000000,672900000,510500000,-12400000,3200000,99800000,103000000,11,PNR,quarterly
2020-09-30,19300000,,125200000,,110800000,128200000,280000000,132500000,132500000,,-5400000,,,,14400000,798500000,666000000,518500000,-7300000,3200000,110800000,110800000,11,PNR,quarterly
2020-06-30,17300000,,103600000,,72100000,115600000,245100000,112200000,112200000,,-7700000,,,,29800000,713300000,601100000,468200000,-8600000,-1700000,73800000,72100000,11,PNR,quarterly
2020-03-31,19000000,,92600000,,72700000,129200000,251600000,103400000,103400000,,-6900000,,,,19900000,710000000,606600000,458400000,-10800000,-1700000,72700000,72700000,11,PNR,quarterly
2020-12-31,,,105800000,3200000,93300000,156600000,320700000,164100000,164100000,,-12300000,,,,12400000,727300000,563200000,406600000,-58300000,,93400000,93300000,37,ALLE,quarterly
2020-09-30,,,159700000,2800000,146900000,151200000,321100000,169900000,169900000,,-12900000,,,,12800000,728400000,558500000,407300000,-10200000,,146900000,146900000,37,ALLE,quarterly
2020-06-30,,,87900000,2500000,73700000,137500000,248900000,111400000,111400000,,-13000000,,,,14200000,589500000,478100000,340600000,-23500000,,73700000,73700000,37,ALLE,quarterly
2020-03-31,,,12000000,2500000,400000,167400000,293100000,125700000,125700000,,-12900000,,,,11500000,674700000,549000000,381600000,-113700000,,500000,400000,37,ALLE,quarterly
2020-12-31,,,824000000,1000000,642000000,553000000,1475000000,887000000,887000000,,-52000000,,,,182000000,3475000000,2588000000,2000000000,-63000000,,642000000,642000000,45,ITW,quarterly
2020-09-30,,,739000000,1000000,582000000,557000000,1397000000,792000000,792000000,,-52000000,,,,157000000,3307000000,2515000000,1910000000,-53000000,,582000000,582000000,45,ITW,quarterly
2020-06-30,,,406000000,1000000,319000000,483000000,970000000,452000000,452000000,,-51000000,,,,87000000,2564000000,2112000000,1594000000,-46000000,,319000000,319000000,45,ITW,quarterly
2020-03-31,,,735000000,1000000,566000000,557000000,1357000000,764000000,764000000,,-51000000,,,,169000000,3228000000,2464000000,1871000000,-29000000,,566000000,566000000,45,ITW,quarterly
2021-01-31,606000000,,1240000000,,1130000000,308000000,2361000000,1447000000,1447000000,,-61000000,,,,110000000,5162000000,3715000000,2801000000,-207000000,,1130000000,1130000000,48,AMAT,quarterly
2020-10-25,560000000,,1243000000,,1131000000,261000000,2130000000,1309000000,1309000000,,-59000000,,,,112000000,4688000000,3379000000,2558000000,-66000000,,1131000000,1131000000,48,AMAT,quarterly
2020-07-26,572000000,,1040000000,,841000000,255000000,1970000000,1143000000,1143000000,,-61000000,,,,199000000,4395000000,3252000000,2425000000,-103000000,,841000000,841000000,48,AMAT,quarterly
2020-04-26,550000000,,878000000,,755000000,246000000,1757000000,961000000,961000000,,-61000000,,,,123000000,3957000000,2996000000,2200000000,-83000000,,755000000,755000000,48,AMAT,quarterly
2020-12-31,144000000,,101000000,26000000,127000000,443000000,888000000,301000000,301000000,,-69000000,,,,-26000000,2689000000,2388000000,1801000000,-200000000,,127000000,127000000,52,NWL,quarterly
2020-09-30,144000000,,283000000,24000000,304000000,545000000,914000000,369000000,369000000,,-71000000,,,,-21000000,2699000000,2330000000,1785000000,-86000000,,304000000,304000000,52,NWL,quarterly
2020-06-30,144000000,,93000000,24000000,78000000,489000000,664000000,175000000,175000000,,-71000000,,,,15000000,2111000000,1936000000,1447000000,-82000000,,78000000,78000000,52,NWL,quarterly
2020-03-31,144000000,,-1483000000,25000000,-1279000000,544000000,617000000,73000000,73000000,,-63000000,,,,-204000000,1886000000,1813000000,1269000000,-1556000000,,-1279000000,-1279000000,52,NWL,quarterly
2020-12-31,,,87094000,216775000,83342000,11677000,250411000,109149000,109149000,,-40952000,,,,795000,423661000,314512000,173250000,-22055000,,86299000,82311000,54,MAA,quarterly
2020-09-30,,,62701000,215183000,59910000,11360000,240694000,101655000,101655000,,-41010000,,,,665000,423199000,321544000,182505000,-38954000,,62036000,58910000,54,MAA,quarterly
2020-06-30,,,78928000,216743000,75062000,10557000,243825000,106078000,106078000,,-42118000,,,,1200000,413026000,306948000,169201000,-27150000,,77728000,74040000,54,MAA,quarterly
2020-03-31,,,38619000,218146000,36648000,13264000,250283000,110631000,110631000,,-43482000,,,,667000,418098000,307467000,167815000,-72012000,,37952000,35676000,54,MAA,quarterly
2020-12-31,,,263334000,576786000,252856000,11093000,389939000,177017000,177017000,,-119410000,,,,350000,613435000,436418000,223496000,86317000,,262984000,252084000,80,EQR,quarterly
2020-09-30,,,95627000,530592000,91286000,10859000,393899000,182435000,182435000,,-82975000,,,,262000,622433000,439998000,228534000,-86808000,,95365000,90513000,80,EQR,quarterly
2020-06-30,,,271668000,576498000,260888000,11835000,430434000,212623000,212623000,,-83996000,,,,187000,653532000,440909000,223098000,59045000,,271481000,260116000,80,EQR,quarterly
2020-03-31,,,332724000,593661000,308606000,14518000,441072000,214132000,214132000,,-87631000,,,,53000,682329000,468197000,241257000,118592000,,332671000,307833000,80,EQR,quarterly
2020-12-31,,,1030000000,35000000,873000000,2599000000,3771000000,1172000000,1172000000,,-43000000,,,,153000000,4853000000,3681000000,1082000000,-142000000,,877000000,873000000,97,EL,quarterly
2020-09-30,,,671000000,29000000,523000000,2029000000,2740000000,711000000,711000000,,-45000000,,,,146000000,3562000000,2851000000,822000000,-40000000,,525000000,523000000,97,EL,quarterly
2020-06-30,,,-605000000,27000000,-462000000,1841000000,1664000000,-177000000,-177000000,,-49000000,,,,-146000000,2430000000,2607000000,766000000,-428000000,,-459000000,-462000000,97,EL,quarterly
2020-03-31,,,80000000,29000000,-6000000,2033000000,2510000000,477000000,477000000,,-42000000,,,,84000000,3345000000,2868000000,835000000,-348000000,,-4000000,-6000000,97,EL,quarterly
2020-12-31,140000000,,553000000,43000000,475000000,773000000,1509000000,596000000,596000000,,-162000000,,,,77000000,4687000000,4091000000,3178000000,-43000000,,476000000,475000000,119,ETN,quarterly
2020-09-30,132000000,,525000000,42000000,446000000,760000000,1475000000,583000000,583000000,,-90000000,,,,78000000,4526000000,3943000000,3051000000,-58000000,,447000000,446000000,119,ETN,quarterly
2020-06-30,126000000,,47000000,47000000,51000000,703000000,979000000,150000000,150000000,,-84000000,,,,-7000000,3856000000,3706000000,2877000000,-103000000,,54000000,51000000,119,ETN,quarterly
2020-03-31,153000000,,621000000,43000000,438000000,875000000,1487000000,459000000,459000000,,-84000000,,,,183000000,4789000000,4330000000,3302000000,162000000,,438000000,438000000,119,ETN,quarterly
2020-12-31,,,6119000000,,5470000000,12395000000,20046000000,0,6942000000,709000000,,,,,649000000,20046000000,13104000000,0,-823000000,,5470000000,5208000000,134,BAC,quarterly
2020-09-30,,,4546000000,,4881000000,12089000000,18947000000,0,4546000000,2312000000,,,,,-335000000,18947000000,14401000000,0,0,,4881000000,4440000000,134,BAC,quarterly
2020-06-30,,,3799000000,,3533000000,11934000000,17209000000,0,3799000000,1476000000,,,,,266000000,17209000000,13410000000,0,0,,3533000000,3284000000,134,BAC,quarterly
2020-03-31,,,4531000000,,4010000000,12065000000,18006000000,0,4531000000,1410000000,,,,,521000000,18006000000,13475000000,0,0,,4010000000,3541000000,134,BAC,quarterly
2021-01-02,235018000,,176134000,,170972000,136701000,553875000,172425000,172425000,,-14228000,,,,5162000,803404000,630979000,249529000,3709000,,170972000,170972000,137,XLNX,quarterly
2020-09-26,219647000,,194646000,,193816000,113793000,548415000,205417000,205417000,,-14226000,,,,830000,766535000,561118000,218120000,-10771000,,193816000,193816000,137,XLNX,quarterly
2020-06-27,210113000,,163362000,,93836000,105383000,500570000,175515000,175515000,,-11656000,,,,69526000,726673000,551158000,226103000,-12153000,,93836000,93836000,137,XLNX,quarterly
2020-03-28,214968000,,189747000,,162258000,103675000,535132000,206391000,206391000,,-9565000,,,,27489000,756169000,549778000,221037000,-16644000,,162258000,162258000,137,XLNX,quarterly
2020-12-31,132000000,,210000000,37000000,168000000,621000000,1260000000,507000000,507000000,,-41000000,,,,39000000,3181000000,2674000000,1921000000,-297000000,,171000000,168000000,144,BAX,quarterly
2020-09-30,122000000,,415000000,35000000,356000000,574000000,1209000000,513000000,513000000,,-42000000,,,,56000000,2972000000,2459000000,1763000000,-98000000,,359000000,356000000,144,BAX,quarterly
2020-06-30,118000000,,289000000,32000000,246000000,576000000,1075000000,381000000,381000000,,-40000000,,,,42000000,2718000000,2337000000,1643000000,-92000000,,247000000,246000000,144,BAX,quarterly
2020-03-31,124000000,,378000000,31000000,332000000,603000000,1195000000,468000000,468000000,,-30000000,,,,45000000,2802000000,2334000000,1607000000,-90000000,,333000000,332000000,144,BAX,quarterly
2020-12-31,,,202798000,154674000,182644000,808316000,1116398000,308082000,308082000,,-82500000,,,,17980000,1930193000,1622111000,813795000,-105284000,,184818000,182644000,149,GPN,quarterly
2020-09-30,,,273064000,218185000,220971000,660775000,1016894000,356119000,356119000,,-82100000,,,,42834000,1917815000,1561696000,900921000,-83055000,,230230000,220971000,149,GPN,quarterly
2020-06-30,,,40280000,207130000,37331000,588438000,778212000,189774000,189774000,,-81100000,,,,836000,1671952000,1482178000,893740000,-149494000,,39444000,37331000,149,GPN,quarterly
2020-03-31,,,166110000,199622000,143575000,654148000,969727000,315579000,315579000,,-81100000,,,,15502000,1903598000,1588019000,933871000,-149469000,,150608000,143575000,149,GPN,quarterly
2020-12-31,,,591600000,314000000,472600000,1161800000,1753400000,591600000,591600000,,,,,,100100000,3765100000,3173500000,2011700000,0,,491500000,472600000,150,PFG,quarterly
2020-09-30,,,275100000,348700000,236000000,1165900000,1441000000,275100000,275100000,,,,,,39200000,3310700000,3035600000,1869700000,0,,235900000,236000000,150,PFG,quarterly
2020-06-30,,,498600000,340600000,398300000,983300000,1481900000,498600000,498600000,,,,,,82500000,3114600000,2616000000,1632700000,0,,416100000,398300000,150,PFG,quarterly
2020-03-31,,,328200000,304800000,288900000,1335500000,1663700000,328200000,328200000,,,,,,43200000,4551300000,4223100000,2887600000,0,,285000000,288900000,150,PFG,quarterly
2020-12-31,,,-314000000,,-164000000,459000000,358000000,145000000,145000000,-306000000,-112000000,,,,-150000000,508000000,363000000,150000000,-459000000,,-164000000,-164000000,151,MAR,quarterly
2020-09-30,,,127000000,,100000000,131000000,331000000,253000000,253000000,-106000000,-113000000,,,,27000000,465000000,212000000,134000000,-126000000,,100000000,100000000,151,MAR,quarterly
2020-06-30,,,-298000000,,-234000000,178000000,141000000,-133000000,-133000000,39000000,-127000000,,,,-64000000,262000000,395000000,121000000,-165000000,,-234000000,-234000000,151,MAR,quarterly
2020-03-31,,,19000000,,31000000,270000000,612000000,202000000,202000000,80000000,-93000000,,,,-12000000,884000000,682000000,272000000,-183000000,,31000000,31000000,151,MAR,quarterly
2020-12-31,,,-1331000000,,-908000000,168000000,-601000000,-1200000000,-1200000000,116000000,-102000000,,,,-423000000,2013000000,3213000000,2614000000,-131000000,,-908000000,-908000000,185,LUV,quarterly
2020-09-30,,,-1542000000,,-1157000000,168000000,-774000000,-1577000000,-1577000000,488000000,-99000000,,,,-385000000,1793000000,3370000000,2567000000,35000000,,-1157000000,-1157000000,185,LUV,quarterly
2020-06-30,,,-1239000000,,-915000000,168000000,-1399000000,-2154000000,-2154000000,442000000,-94000000,,,,-324000000,1008000000,3162000000,2407000000,915000000,,-915000000,-915000000,185,LUV,quarterly
2020-03-31,,,-144000000,,-94000000,168000000,842000000,-110000000,-110000000,641000000,-47000000,,,,-50000000,4234000000,4344000000,3392000000,-34000000,,-94000000,-94000000,185,LUV,quarterly
2020-12-31,31766000,,65596000,1292000,49339000,44686000,146879000,70427000,70427000,,,,,,15920000,336630000,266203000,189751000,-4831000,,49676000,49339000,187,IPGP,quarterly
2020-09-30,31710000,,42522000,861000,35604000,46370000,152792000,74712000,74712000,,,,,,6992000,318441000,243729000,165649000,-32190000,,35530000,35604000,187,IPGP,quarterly
2020-06-30,31584000,,49514000,954000,38226000,43725000,136449000,61140000,61140000,,,,,,11148000,296411000,235271000,159962000,-11626000,,38366000,38226000,187,IPGP,quarterly
2020-03-31,31838000,,48060000,861000,36403000,45807000,102876000,25231000,25231000,,,,,,11294000,249242000,224011000,146366000,22829000,,36766000,36403000,187,IPGP,quarterly
2020-12-31,181000000,,522000000,17000000,412000000,321000000,1151000000,592000000,592000000,,-58000000,,,,109000000,2273000000,1681000000,1122000000,-70000000,,413000000,412000000,200,MSI,quarterly
2020-09-26,175000000,,251000000,16000000,205000000,293000000,912000000,390000000,390000000,,-60000000,,,,45000000,1868000000,1478000000,956000000,-139000000,,206000000,205000000,200,MSI,quarterly
2020-06-27,161000000,,176000000,15000000,135000000,278000000,781000000,291000000,291000000,,-60000000,,,,40000000,1618000000,1327000000,837000000,-115000000,,136000000,135000000,200,MSI,quarterly
2020-03-28,168000000,,224000000,18000000,197000000,321000000,793000000,251000000,251000000,,-55000000,,,,26000000,1655000000,1404000000,862000000,-27000000,,198000000,197000000,200,MSI,quarterly
2020-09-26,42600000,,-127700000,100000,-154600000,280900000,428100000,108500000,108500000,-3900000,-35700000,,,,26900000,1213700000,1105200000,785600000,-236200000,,-154600000,-154600000,219,PRGO,quarterly
2020-06-27,47100000,,71800000,500000,60600000,267400000,434700000,121100000,121100000,-900000,-35600000,,,,11200000,1219100000,1098000000,784400000,-49300000,,60600000,60600000,219,PRGO,quarterly
2020-03-28,41900000,,114700000,500000,106400000,294500000,483200000,145700000,145700000,1100000,-31900000,,,,8300000,1341000000,1195300000,857800000,-31000000,,106400000,106400000,219,PRGO,quarterly
2019-12-31,59400000,,-34200000,300000,-19000000,285700000,480800000,148200000,148200000,-12500000,-36700000,,,,-15200000,1322800000,1174600000,842000000,-182400000,,-19000000,-19000000,219,PRGO,quarterly
2020-12-31,,,400796000,,471736000,288383000,690684000,402301000,402301000,,-1505000,,,,-70940000,1196283000,793982000,505599000,-1505000,,471736000,471736000,257,MNST,quarterly
2020-09-30,,,454033000,,347654000,277930000,736531000,458601000,458601000,,-1268000,,,,106379000,1246362000,787761000,509831000,-4568000,,347654000,347654000,257,MNST,quarterly
2020-06-30,,,405468000,,311369000,251005000,659469000,408464000,408464000,,-1196000,,,,94099000,1093896000,685432000,434427000,-2996000,,311369000,311369000,257,MNST,quarterly
2020-03-31,,,365860000,,278835000,269168000,637196000,368028000,368028000,,-728000,,,,87025000,1062097000,694069000,424901000,-2168000,,278835000,278835000,257,MNST,quarterly
2020-12-31,137000000,,216000000,,199000000,218000000,618000000,237000000,237000000,,-7000000,,,,17000000,1308000000,1071000000,690000000,-21000000,,199000000,199000000,276,ZBRA,quarterly
2020-09-26,113000000,,138000000,,116000000,190000000,493000000,170000000,170000000,,-10000000,,,,22000000,1132000000,962000000,639000000,-32000000,,116000000,116000000,276,ZBRA,quarterly
2020-06-27,98000000,,103000000,,100000000,183000000,419000000,122000000,122000000,,-14000000,,,,3000000,956000000,834000000,537000000,-19000000,,100000000,100000000,276,ZBRA,quarterly
2020-03-28,105000000,,103000000,,89000000,196000000,473000000,156000000,156000000,,-45000000,,,,14000000,1052000000,896000000,579000000,-53000000,,89000000,89000000,276,ZBRA,quarterly
2020-12-31,15375000,,92076000,200367000,84635000,115008000,265420000,135037000,135037000,,-19152000,,,,-10101000,879147000,744110000,613727000,-42961000,,102177000,84635000,321,ALB,quarterly
2020-09-30,13532000,,147698000,200500000,98301000,84972000,254056000,155552000,155552000,,-19227000,,,,30653000,746868000,591316000,492812000,-7854000,,117045000,98301000,321,ALB,quarterly
2020-06-30,14210000,,119189000,181689000,85624000,91953000,233359000,127196000,127196000,,-17852000,,,,15431000,764049000,636853000,530690000,-8007000,,103758000,85624000,321,ALB,quarterly
2020-03-31,16097000,,142077000,163521000,107204000,94467000,242718000,132154000,132154000,,-16885000,,,,18442000,738845000,606691000,496127000,9923000,,123635000,107204000,321,ALB,quarterly
2020-12-31,,,378000000,35000000,300300000,809600000,1287600000,478000000,478000000,,-48400000,,,,73100000,3065300000,2587300000,1777700000,-100000000,,304900000,300300000,323,ECL,quarterly
2020-09-30,,,291700000,34700000,246200000,787500000,1258500000,471000000,471000000,,-55900000,,,,42400000,3018600000,2547600000,1760100000,-179300000,,249300000,246200000,323,ECL,quarterly
2020-06-30,,,148400000,35000000,-2035000000,773500000,1077000000,303500000,303500000,,-61100000,,,,14100000,2685700000,2382200000,1608700000,-155100000,-2163900000.0,134300000,-2035000000,323,ECL,quarterly
2020-03-31,,,343300000,38500000,283400000,892900000,1309500000,416600000,416600000,,-52600000,,,,47000000,3020600000,2604000000,1711100000,-73300000,-8600000.0,296300000,283400000,323,ECL,quarterly
2020-12-31,,,5378000000,65000000,4135000000,3710000000,5973000000,1768000000,1768000000,,-353000000,,,,1236000000,41879000000,40111000000,35906000000,3610000000,,4142000000,4135000000,344,CI,quarterly
2020-09-30,,,1804000000,66000000,1388000000,3207000000,5934000000,2234000000,2234000000,,-318000000,,,,406000000,40987000000,38753000000,35053000000,-430000000,,1398000000,1388000000,344,CI,quarterly
2020-06-30,,,2289000000,39000000,1754000000,3295000000,6580000000,2789000000,2789000000,,-356000000,,,,529000000,39303000000,36514000000,32723000000,-500000000,,1760000000,1754000000,344,CI,quarterly
2020-03-31,,,1397000000,42000000,1181000000,3263000000,5869000000,2108000000,2108000000,,-373000000,,,,208000000,38381000000,36273000000,32512000000,-711000000,,1189000000,1181000000,344,CI,quarterly
2020-12-31,,,1476000000,,1135000000,1708000000,4049000000,0,1899000000,165000000,,,,,341000000,4176000000,2277000000,127000000,-423000000,,1135000000,1050000000,350,SCHW,quarterly
2020-09-30,,,889000000,,698000000,1291000000,2375000000,0,889000000,73000000,,,,,191000000,2448000000,1559000000,73000000,0,,698000000,615000000,350,SCHW,quarterly
2020-06-30,,,888000000,,671000000,1275000000,2372000000,0,888000000,100000000,,,,,217000000,2450000000,1562000000,78000000,0,,671000000,621000000,350,SCHW,quarterly
2020-03-31,,,1047000000,,795000000,1322000000,2542000000,0,1047000000,77000000,,,,,252000000,2617000000,1570000000,75000000,0,,795000000,757000000,350,SCHW,quarterly
2020-12-31,83400000,,1264100000,8500000,1215600000,494800000,762100000,183900000,183900000,,-36800000,,,,12500000,1324900000,1141000000,562800000,1080200000,-36000000,1251600000,1198400000,361,FTV,quarterly
2020-09-25,110700000,,265100000,12000000,225800000,563100000,983400000,309600000,309600000,,-43900000,,,,39300000,1902300000,1592700000,918900000,-44500000,-36000000,225800000,208500000,361,FTV,quarterly
2020-06-26,106600000,,153200000,11600000,130000000,517400000,814300000,190300000,190300000,,-43200000,,,,22900000,1571200000,1380900000,756900000,-37100000,-300000,130300000,112800000,361,FTV,quarterly
2020-03-27,113700000,,71400000,11200000,41900000,538100000,875800000,224000000,224000000,,-43600000,,,,29100000,1713500000,1489500000,837700000,-152600000,-400000,42300000,24600000,361,FTV,quarterly
2020-12-31,,,-74000000,189000000,-12000000,2943000000,3945000000,274000000,274000000,536000000,-177000000,,,,-55000000,26550000000,26276000000,22605000000,-348000000,,-19000000,-12000000,375,CNC,quarterly
2020-09-30,,,772000000,154000000,568000000,2822000000,4622000000,1017000000,1017000000,619000000,-184000000,,,,207000000,27554000000,26537000000,22932000000,-245000000,,565000000,568000000,375,CNC,quarterly
2020-06-30,,,1944000000,149000000,1206000000,2564000000,5519000000,2190000000,2190000000,568000000,-187000000,,,,742000000,25826000000,23636000000,20307000000,-246000000,,1202000000,1206000000,375,CNC,quarterly
2020-03-31,,,131000000,143000000,46000000,2434000000,3826000000,629000000,629000000,597000000,-180000000,,,,85000000,24246000000,23617000000,20420000000,-498000000,,46000000,46000000,375,CNC,quarterly
2020-12-26,,,386707000,,347240000,1195245000,1649017000,453772000,453772000,,-34315000,,,,59048000,2971541000,2517769000,1322524000,-67065000,19581000,327659000,347240000,470,VFC,quarterly
2020-09-26,,,293661000,,256722000,997960000,1329118000,331158000,331158000,,-34107000,,,,50415000,2608324000,2277166000,1279206000,-37497000,13476000,243246000,256722000,470,VFC,quarterly
2020-06-27,,,-312945000,,-285613000,801949000,583342000,-218607000,-218607000,,-29262000,,,,-35203000,1076293000,1294900000,492951000,-94338000,-7871000,-277742000,-285613000,470,VFC,quarterly
2020-03-28,,,-497945000,,-483776000,899434000,899227000,-207000,-207000,,-26802000,,,,71906000,1439063000,1439270000,539836000,-497738000,86075000,-569851000,-483776000,470,VFC,quarterly
2020-12-31,,,756000000,96000000,687000000,720000000,1352000000,615000000,615000000,2000000,-69000000,,,,63000000,17978000000,17363000000,16626000000,141000000,,693000000,687000000,488,ADM,quarterly
2020-09-30,,,200000000,104000000,225000000,620000000,1042000000,413000000,413000000,2000000,-100000000,,,,-26000000,15126000000,14713000000,14084000000,-213000000,,226000000,225000000,488,ADM,quarterly
2020-06-30,,,552000000,103000000,469000000,613000000,1108000000,478000000,478000000,3000000,-87000000,,,,80000000,16281000000,15803000000,15173000000,74000000,,472000000,469000000,488,ADM,quarterly
2020-03-31,,,375000000,95000000,391000000,664000000,951000000,287000000,287000000,2000000,-83000000,,,,-16000000,14970000000,14683000000,14019000000,88000000,,391000000,391000000,488,ADM,quarterly
2020-12-31,,,4877000000,359000000,3854000000,5112000000,10492000000,5380000000,5380000000,,-143000000,,,,990000000,19745000000,14365000000,9253000000,-503000000,,3887000000,3788000000,541,PG,quarterly
2020-09-30,,,5297000000,394000000,4277000000,4978000000,10176000000,5198000000,5198000000,,-136000000,,,,989000000,19318000000,14120000000,9142000000,99000000,,4308000000,4211000000,541,PG,quarterly
2020-06-30,,,3461000000,357000000,2800000000,5280000000,9039000000,3759000000,3759000000,,-157000000,,,,675000000,17698000000,13939000000,8659000000,-298000000,,2786000000,2730000000,541,PG,quarterly
2020-03-31,,,3498000000,401000000,2917000000,5024000000,8696000000,3672000000,3672000000,,-100000000,,,,541000000,17214000000,13542000000,8518000000,-174000000,,2957000000,2853000000,541,PG,quarterly
2020-12-31,38777000,,177436000,707000,174790000,185630000,409502000,185095000,185095000,,-7828000,,,,2478000,720938000,535843000,311436000,-7659000,,174958000,174790000,543,IDXX,quarterly
2020-09-30,37517000,,163954000,539000,146219000,213233000,422606000,171856000,171856000,,-8110000,,,,17633000,721789000,549933000,299183000,-7902000,,146321000,146219000,543,IDXX,quarterly
2020-06-30,31645000,,183822000,437000,148940000,154449000,379342000,193248000,193248000,,-9495000,,,,34826000,637592000,444344000,258250000,-9426000,,148996000,148940000,543,IDXX,quarterly
2020-03-31,33310000,,136773000,381000,111827000,181955000,359590000,144325000,144325000,,-7692000,,,,24917000,626336000,482011000,266746000,-7552000,,111856000,111827000,543,IDXX,quarterly
2020-12-31,,,181000000,,145000000,-12000000,494000000,275000000,275000000,78000000,-99000000,,,,36000000,923000000,648000000,429000000,-94000000,,145000000,145000000,562,AWK,quarterly
2020-09-30,,,352000000,,264000000,-12000000,660000000,445000000,445000000,73000000,-99000000,,,,88000000,1079000000,634000000,419000000,-93000000,,264000000,264000000,562,AWK,quarterly
2020-06-30,,,232000000,,176000000,-12000000,540000000,325000000,325000000,75000000,-101000000,,,,56000000,931000000,606000000,391000000,-93000000,,176000000,176000000,562,AWK,quarterly
2020-03-31,,,159000000,,124000000,-13000000,461000000,252000000,252000000,77000000,-96000000,,,,35000000,844000000,592000000,383000000,-93000000,,124000000,124000000,562,AWK,quarterly
2020-12-31,388000000,,1927000000,,1688000000,364000000,2646000000,1847000000,1847000000,,-48000000,,,,239000000,4076000000,2229000000,1430000000,80000000,,1688000000,1680000000,579,TXN,quarterly
2020-09-30,386000000,,1587000000,,1353000000,415000000,2453000000,1601000000,1601000000,,-49000000,,,,234000000,3817000000,2216000000,1364000000,-14000000,,1353000000,1347000000,579,TXN,quarterly
2020-06-30,379000000,,1279000000,,1380000000,410000000,2082000000,1243000000,1243000000,,-48000000,,,,-101000000,3239000000,1996000000,1157000000,36000000,,1380000000,1373000000,579,TXN,quarterly
2020-03-31,377000000,,1224000000,,1174000000,427000000,2088000000,1234000000,1234000000,,-45000000,,,,50000000,3329000000,2095000000,1241000000,-10000000,,1174000000,1168000000,579,TXN,quarterly
2020-12-31,,,164000000,259000000,158000000,,3588000000,393000000,393000000,3195000000,-230000000,,,,6000000,19418000000,19025000000,15830000000,-229000000,,158000000,124000000,619,MET,quarterly
2020-09-30,,,923000000,253000000,706000000,,4393000000,1152000000,1152000000,3241000000,-229000000,,,,214000000,16015000000,14863000000,11622000000,-229000000,,709000000,633000000,619,MET,quarterly
2020-06-30,,,197000000,247000000,145000000,,3180000000,428000000,428000000,2752000000,-232000000,,,,47000000,14099000000,13671000000,10919000000,-231000000,,150000000,68000000,619,MET,quarterly
2020-03-31,,,5643000000,242000000,4398000000,,8916000000,5865000000,5865000000,3051000000,-222000000,,,,1242000000,18310000000,12445000000,9394000000,-222000000,,4401000000,4366000000,619,MET,quarterly
2021-01-01,,,354111000,43877000,257048000,386419000,632060000,245641000,245641000,,-17313000,,,,87023000,3381836000,3136195000,2749776000,108470000,-14000,267088000,257048000,623,J,quarterly
2020-10-02,,,60156000,39955000,81990000,343176000,667249000,324073000,324073000,,-14043000,,,,-19721000,3519689000,3195616000,2852440000,-263917000,12473000,79877000,82001000,623,J,quarterly
2020-06-26,,,303681000,49181000,244929000,428823000,629026000,200203000,200203000,,-18193000,,,,67674000,3260057000,3059854000,2631031000,103478000,18043000,236007000,244903000,623,J,quarterly
2020-03-27,,,-176805000,51200000,-92087000,424452000,648135000,223683000,223683000,,-15154000,,,,-61122000,3427180000,3203497000,2779045000,-400488000,29880000,-115683000,-92087000,623,J,quarterly
2020-12-31,,,303000000,,249000000,226000000,547000000,322000000,322000000,-1000000,-46000000,,,,54000000,2757000000,2435000000,2210000000,-19000000,,249000000,249000000,680,HII,quarterly
2020-09-30,,,226000000,,222000000,191000000,436000000,245000000,245000000,-1000000,-27000000,,,,4000000,2314000000,2069000000,1878000000,-19000000,,222000000,222000000,680,HII,quarterly
2020-06-30,,,65000000,,53000000,184000000,264000000,80000000,80000000,-1000000,-25000000,,,,12000000,2027000000,1947000000,1763000000,-15000000,,53000000,53000000,680,HII,quarterly
2020-03-31,,,216000000,,172000000,184000000,423000000,239000000,239000000,-1000000,-16000000,,,,44000000,2263000000,2024000000,1840000000,-23000000,,172000000,172000000,680,HII,quarterly
2020-12-31,,,133700000,46500000,142200000,220800000,569600000,267000000,267000000,,-47800000,,,,-19400000,1651300000,1384300000,1081700000,-133300000,,153100000,142200000,690,AJG,quarterly
2020-09-30,,,209500000,46500000,176600000,197400000,614100000,282800000,282800000,,-48100000,,,,21700000,1785700000,1502900000,1171600000,-73300000,,187800000,176600000,690,AJG,quarterly
2020-06-30,,,171700000,45900000,153700000,208800000,583700000,252300000,252300000,,-50000000,,,,9900000,1534400000,1282100000,950700000,-80600000,,161800000,153700000,690,AJG,quarterly
2020-03-31,,,356000000,40600000,346300000,251300000,743100000,319400000,319400000,,-50500000,,,,600000,1810400000,1491000000,1067300000,36600000,,355400000,346300000,690,AJG,quarterly
2020-12-31,,,165400000,,123600000,129700000,344400000,213400000,213400000,1300000,-24400000,,,,41800000,1714200000,1500800000,1369800000,-48000000,,123600000,122700000,691,PKG,quarterly
2020-09-30,,,185700000,,139100000,126500000,345400000,218500000,218500000,400000,-24400000,,,,46600000,1693700000,1475200000,1348300000,-32800000,,139100000,138100000,691,PKG,quarterly
2020-06-30,,,91600000,,56700000,135700000,334900000,199300000,199300000,-100000,-25100000,,,,34900000,1541600000,1342300000,1206700000,-107700000,,56700000,56200000,691,PKG,quarterly
2020-03-31,,,190100000,,141700000,145300000,365800000,216900000,216900000,3600000,-19600000,,,,48400000,1708700000,1491800000,1342900000,-26800000,,141700000,140500000,691,PKG,quarterly
2020-12-31,260700000,,460200000,67000000,357000000,11900000,765600000,493000000,493000000,,-28300000,,,,100000000,2426000000,1933000000,1660400000,-32800000,,360200000,357000000,704,APH,quarterly
2020-09-30,260700000,,448800000,65000000,346600000,259100000,734900000,475800000,475800000,,-28000000,,,,99300000,2323400000,1847600000,1588500000,-27000000,,349500000,346600000,704,APH,quarterly
2020-06-30,260700000,,328500000,61700000,257700000,246400000,603800000,357400000,357400000,,-30200000,,,,68000000,1987500000,1630100000,1383700000,-28900000,,260500000,257700000,704,APH,quarterly
2020-03-31,260700000,,289200000,59900000,242100000,242900000,559800000,316900000,316900000,,-28800000,,,,46000000,1862000000,1545100000,1302200000,-27700000,,243200000,242100000,704,APH,quarterly
2020-12-31,22411000,,48412000,,54094000,62736000,138669000,48036000,48036000,,-610000,,,,-5682000,283285000,235249000,144616000,376000,,54094000,54094000,732,TYL,quarterly
2020-09-30,21642000,,49936000,,39284000,66819000,143509000,49656000,49656000,,-610000,,,,10652000,285746000,236090000,142237000,280000,,39284000,39284000,732,TYL,quarterly
2020-06-30,21949000,,41811000,,53892000,62521000,131203000,41341000,41341000,,-610000,,,,-12081000,271091000,229750000,139888000,470000,,53892000,53892000,732,TYL,quarterly
2020-03-31,22361000,,34883000,,47550000,67485000,129131000,33893000,33893000,,-610000,,,,-12667000,276541000,242648000,147410000,990000,,47550000,47550000,732,TYL,quarterly
2020-12-31,291000000,,1157000000,,1003000000,1144000000,2766000000,1331000000,1331000000,,-118000000,,,,154000000,5315000000,3984000000,2549000000,-174000000,,1003000000,980000000,770,BDX,quarterly
2020-09-30,299000000,,143000000,,128000000,1205000000,2509000000,997000000,997000000,8000000.0,-123000000,,,,15000000,4784000000,3787000000,2275000000,-854000000,,128000000,105000000,770,BDX,quarterly
2020-06-30,262000000,,248000000,,286000000,978000000,1660000000,443000000,443000000,-23000000.0,-135000000,,,,-38000000,3855000000,3412000000,2195000000,-195000000,,286000000,277000000,770,BDX,quarterly
2020-03-31,264000000,,200000000,,183000000,1020000000,1971000000,687000000,687000000,-23000000.0,-134000000,,,,17000000,4253000000,3566000000,2282000000,-487000000,,183000000,145000000,770,BDX,quarterly
2020-12-31,36100000,,61314000,30330000,56893000,142938000,302055000,123017000,123017000,,-16778000,,,,856000,985308000,862291000,683253000,-61703000,,60458000,56893000,794,FLS,quarterly
2020-09-30,36100000,,72322000,30422000,51003000,195110000,290867000,95757000,95757000,,-14710000,,,,18672000,924301000,828544000,633434000,-23435000,,53650000,51003000,794,FLS,quarterly
2020-06-30,36100000,,16196000,27779000,8645000,194310000,303613000,109303000,109303000,,-12900000,,,,5409000,924965000,815662000,621352000,-93107000,,10787000,8645000,794,FLS,quarterly
2020-03-31,36100000,,37800000,25995000,-610000,237100000,275437000,38337000,38337000,,-12963000,,,,36310000,894457000,856120000,619020000,-537000,,1490000,-610000,794,FLS,quarterly
2020-12-31,,,894000000,358000000,647000000,1654000000,2643000000,925000000,925000000,64000000,-76000000,,,,202000000,4324000000,3399000000,1681000000,-31000000,,692000000,647000000,795,CL,quarterly
2020-09-30,,,967000000,420000000,698000000,1533000000,2540000000,1003000000,1003000000,4000000,-36000000,,,,222000000,4153000000,3150000000,1613000000,-36000000,,745000000,698000000,795,CL,quarterly
2020-06-30,,,891000000,464000000,635000000,1415000000,2369000000,926000000,926000000,28000000,-35000000,,,,216000000,3897000000,2971000000,1528000000,-35000000,,675000000,635000000,795,CL,quarterly
2020-03-31,,,895000000,454000000,715000000,1494000000,2469000000,935000000,935000000,40000000,-36000000,,,,147000000,4097000000,3162000000,1628000000,-40000000,,748000000,715000000,795,CL,quarterly
2020-12-31,,,199000000,,177100000,278600000,514600000,236000000,236000000,,-28100000,,,,21900000,1271800000,1035800000,757200000,-37000000,,177100000,177100000,805,WU,quarterly
2020-09-30,,,261000000,,228600000,246200000,537600000,291400000,291400000,,-28200000,,,,32400000,1258500000,967100000,720900000,-30400000,,228600000,228600000,805,WU,quarterly
2020-06-30,,,193200000,,161900000,229400000,453300000,223900000,223900000,,-29300000,,,,31300000,1114700000,890800000,661400000,-30700000,,161900000,161900000,805,WU,quarterly
2020-03-31,,,201900000,,176700000,266800000,507500000,240700000,240700000,,-32900000,,,,25200000,1190000000,949300000,682500000,-38800000,,176700000,176700000,805,WU,quarterly
2020-12-31,132517000,,119148000,,112091000,407709000,684118000,135285000,135285000,,-16361000,,,,7057000,809656000,674371000,125538000,-16137000,,112091000,112091000,812,CTXS,quarterly
2020-09-30,130628000,,115998000,,98227000,380250000,648177000,128305000,128305000,,-16639000,,,,17771000,767170000,638865000,118993000,-12307000,,98227000,98227000,812,CTXS,quarterly
2020-06-30,140477000,,129095000,,112906000,382319000,684992000,153199000,153199000,,-17076000,,,,16189000,798929000,645730000,113937000,-24104000,,112906000,112906000,812,CTXS,quarterly
2020-03-31,134458000,,190639000,,181222000,406208000,753649000,204000000,204000000,,-14611000,,,,9417000,860945000,656945000,107296000,-13361000,,181222000,181222000,812,CTXS,quarterly
2020-12-31,,,832600000,,647500000,744300000,1673400000,829000000,829000000,,-13900000,,,,185100000,3695700000,2866700000,2022300000,3600000,,647500000,647500000,875,ADP,quarterly
2020-09-30,,,765200000,,602100000,667600000,1539900000,768800000,768800000,,-15100000,,,,163100000,3470700000,2701900000,1930800000,-3600000,,602100000,602100000,875,ADP,quarterly
2020-06-30,,,531300000,,411600000,699300000,1405400000,610400000,610400000,,-15600000,,,,119700000,3376800000,2766400000,1971400000,-79100000,,411600000,411600000,875,ADP,quarterly
2020-03-31,,,1076700000,,820900000,726600000,1901600000,1082100000,1082100000,,-20000000,,,,255800000,4047800000,2965700000,2146200000,-5400000,,820900000,820900000,875,ADP,quarterly
2020-12-31,,,379255000,,295560000,583502000,1045299000,0,390905000,70892000,,,,,83695000,1045299000,654394000,0,-11650000,,295560000,279488000,967,FRC,quarterly
2020-09-30,,,364515000,,293137000,532071000,972725000,0,375518000,65136000,,,,,71378000,972725000,597207000,0,-11003000,,293137000,278321000,967,FRC,quarterly
2020-06-30,,,318406000,,256768000,497320000,887864000,0,329681000,60863000,,,,,61638000,887864000,558183000,0,-11275000,,256768000,241951000,967,FRC,quarterly
2020-03-31,,,271789000,,218686000,510520000,853806000,0,281974000,61312000,,,,,53103000,853806000,571832000,0,-10185000,,218686000,205666000,967,FRC,quarterly
2020-12-31,,,92240000,130000,50994000,480199000,741170000,260971000,260971000,,-90912000,,,,41304000,1571905000,1310934000,830735000,-168731000,,50936000,50994000,981,EQIX,quarterly
2020-09-30,,,96734000,152000,66687000,452077000,749314000,297237000,297237000,,-99736000,,,,29903000,1517293000,1220056000,767979000,-200503000,,66831000,66687000,981,EQIX,quarterly
2020-06-30,,,178103000,-22000,133304000,435014000,690024000,255010000,255010000,,-108480000,,,,44753000,1429368000,1174358000,739344000,-76907000,,133350000,133304000,981,EQIX,quarterly
2020-03-31,,,149148000,-70000,118792000,442047000,708260000,266213000,266213000,,-107338000,,,,30191000,1444542000,1178329000,736282000,-117065000,,118957000,118792000,981,EQIX,quarterly
2020-12-31,,,-707409000,,-738933000,186564000,-197413000,-546880000,-546880000,,-159205000,,,,31524000,9579000,556459000,206992000,-160529000,,-738933000,-738933000,986,NCLH,quarterly
2020-09-30,,,-681127000,,-677366000,156656000,-183639000,-517783000,-517783000,,-133028000,,,,-3761000,6518000,524301000,190157000,-163344000,,-677366000,-677366000,986,NCLH,quarterly
2020-06-30,,,-724366000,,-715243000,131436000,-284723000,-595411000,-595411000,,-93378000,,,,-9123000,16929000,612340000,301652000,-128955000,,-715243000,-715243000,986,NCLH,quarterly
2020-03-31,,,-1887145000,,-1880972000,270791000,252622000,-216366000,-216366000,,-68907000,,,,-6173000,1246882000,1463248000,994260000,-1670779000,,-1880972000,-1880972000,986,NCLH,quarterly
2020-12-31,,,170106000,388345000,156056000,24352000,265434000,184343000,184343000,,-41016000,,,,3797000,360159000,175816000,94725000,-14237000,,166309000,156056000,1005,EXR,quarterly
2020-09-30,,,128511000,378538000,114633000,23894000,249118000,168812000,168812000,,-43446000,,,,4657000,348629000,179817000,99511000,-40301000,,123854000,114456000,1005,EXR,quarterly
2020-06-30,,,114434000,369828000,102911000,25337000,236392000,155037000,155037000,,-42272000,,,,3177000,332290000,177253000,95898000,-40603000,,111257000,102738000,1005,EXR,quarterly
2020-03-31,,,118341000,376511000,108179000,23011000,240520000,162234000,162234000,,-45567000,,,,2179000,337495000,175261000,96975000,-43893000,,116162000,108016000,1005,EXR,quarterly
2020-12-31,,,571000000,,456000000,935000000,1583000000,0,571000000,77000000,,,,,115000000,1583000000,1012000000,0,0,,456000000,424000000,1010,CFG,quarterly
2020-09-30,,,375000000,,314000000,917000000,1363000000,0,375000000,71000000,,,,,61000000,1363000000,988000000,0,0,,314000000,289000000,1010,CFG,quarterly
2020-06-30,,,307000000,,253000000,895000000,1286000000,0,307000000,84000000,,,,,54000000,1286000000,979000000,0,0,,253000000,225000000,1010,CFG,quarterly
2020-03-31,,,45000000,,34000000,925000000,1057000000,0,45000000,87000000,,,,,11000000,1057000000,1012000000,0,0,,34000000,12000000,1010,CFG,quarterly
2020-12-31,,,275000000,226000000,195000000,353000000,662000000,309000000,309000000,,-34000000,,,,67000000,1860000000,1551000000,1198000000,-34000000,3000000,208000000,195000000,1018,MAS,quarterly
2020-09-30,,,380000000,200000000,275000000,337000000,752000000,415000000,415000000,,-40000000,,,,87000000,1983000000,1568000000,1231000000,-35000000,3000000,293000000,274000000,1018,MAS,quarterly
2020-06-30,,,302000000,173000000,224000000,297000000,628000000,331000000,331000000,,-35000000,,,,82000000,1764000000,1433000000,1136000000,-29000000,14000000,220000000,222000000,1018,MAS,quarterly
2020-03-31,,,174000000,183000000,530000000,330000000,547000000,217000000,217000000,,-35000000,,,,33000000,1581000000,1364000000,1034000000,-43000000,397000000,141000000,526000000,1018,MAS,quarterly
2020-12-31,643000000,,2388000000,219000000,2162000000,2525000000,6207000000,2531000000,2531000000,,-136000000,,,,230000000,10701000000,8170000000,4494000000,-143000000,4000000,2158000000,2151000000,1092,ABT,quarterly
2020-09-30,580000000,,1421000000,209000000,1232000000,2350000000,4887000000,1447000000,1447000000,,-137000000,,,,189000000,8853000000,7406000000,3966000000,-26000000,4000000,1232000000,1226000000,1092,ABT,quarterly
2020-06-30,564000000,,526000000,220000000,537000000,2221000000,4065000000,727000000,727000000,,-134000000,,,,-11000000,7328000000,6601000000,3263000000,-201000000,4000000,537000000,534000000,1092,ABT,quarterly
2020-03-31,576000000,,633000000,209000000,564000000,2474000000,4449000000,838000000,838000000,,-139000000,,,,89000000,7726000000,6888000000,3277000000,-205000000,20000000,544000000,561000000,1092,ABT,quarterly
2020-12-31,,,523750000,,438111000,279757000,811261000,528796000,528796000,2708000,-226000,,,,85639000,3192364000,2663568000,2381103000,-5046000,,438111000,434234000,1120,PHM,quarterly
2020-09-30,,,484167000,,416398000,271257000,759963000,484913000,484913000,3793000,-225000,,,,67769000,2954957000,2470044000,2194994000,-746000,,416398000,413011000,1120,PHM,quarterly
2020-06-30,,,457009000,,348620000,186558000,659295000,471102000,471102000,1635000,-3000000,,,,108389000,2593781000,2122679000,1934486000,-14093000,,348620000,345753000,1120,PHM,quarterly
2020-03-31,,,263769000,,203711000,263669000,555599000,290111000,290111000,1819000,-797000,,,,60058000,2294980000,2004869000,1739381000,-26342000,,203711000,201901000,1120,PHM,quarterly
2020-12-31,,,333000000,999000000,300000000,1459000000,1975000000,516000000,516000000,,-174000000,,,,20000000,3832000000,3316000000,1857000000,-183000000,,313000000,300000000,1125,FISV,quarterly
2020-09-30,,,400000000,997000000,264000000,1408000000,1953000000,545000000,545000000,,-176000000,,,,124000000,3786000000,3241000000,1833000000,-145000000,,276000000,264000000,1125,FISV,quarterly
2020-06-30,,,-18000000,1703000000,2000000,1337000000,1578000000,241000000,241000000,,-176000000,,,,-27000000,3465000000,3224000000,1887000000,-259000000,,9000000,2000000,1125,FISV,quarterly
2020-03-31,,,456000000,1703000000,392000000,1404000000,1602000000,198000000,198000000,,-189000000,,,,79000000,3769000000,3571000000,2167000000,258000000,,377000000,392000000,1125,FISV,quarterly
2020-10-31,,,1298000000,,1014000000,4644000000,7123000000,1938000000,1938000000,,-120000000,,,,284000000,22632000000,20694000000,15509000000,-640000000,,1014000000,1014000000,1145,TGT,quarterly
2020-08-01,,,2189000000,,1690000000,4433000000,7302000000,2327000000,2327000000,,-122000000,,,,499000000,22975000000,20648000000,15673000000,-138000000,,1690000000,1690000000,1145,TGT,quarterly
2020-05-02,,,329000000,,284000000,4023000000,5321000000,721000000,721000000,,-117000000,,,,45000000,19615000000,18894000000,14294000000,-392000000,,284000000,284000000,1145,TGT,quarterly
2020-02-01,,,1051000000,,834000000,4492000000,6343000000,1211000000,1211000000,,-108000000,,,,218000000,23399000000,22188000000,17056000000,-160000000,1000000.0,833000000,834000000,1145,TGT,quarterly
2020-12-31,,,158000000,8000000,148000000,,1373000000,189000000,189000000,1184000000,-21000000,,,,10000000,1373000000,1184000000,0,-31000000,,148000000,148000000,1157,XYL,quarterly
2020-09-30,45000000.0,,50000000,8000000,37000000,269000000.0,461000000,147000000,147000000,1184000000,-22000000,,,,13000000,1220000000,1073000000,759000000,-97000000,,37000000,37000000,1157,XYL,quarterly
2020-06-30,44000000.0,,35000000,9000000,31000000,291000000.0,434000000,99000000,99000000,1184000000,-18000000,,,,4000000,1160000000,1061000000,726000000,-64000000,,31000000,31000000,1157,XYL,quarterly
2020-03-31,49000000.0,,42000000,9000000,38000000,300000000.0,409000000,60000000,60000000,1184000000,-16000000,,,,4000000,1123000000,1063000000,714000000,-18000000,,38000000,38000000,1157,XYL,quarterly
2020-12-31,,,168102000,,149850000,167228000,334812000,167584000,167584000,,-428000,,,,18252000,789509000,621925000,454697000,518000,,149850000,149850000,1185,INCY,quarterly
2020-09-30,,,-3508000,,-15203000,121025000,133223000,12198000,12198000,,-544000,,,,11695000,620643000,608445000,487420000,-15706000,,-15203000,-15203000,1185,INCY,quarterly
2020-06-30,,,307264000,,290298000,118234000,354825000,236591000,236591000,,-600000,,,,16966000,688043000,451452000,333218000,70673000,,290298000,290298000,1185,INCY,quarterly
2020-03-31,,,-704076000,,-720642000,111385000,-546229000,-657614000,-657614000,,-602000,,,,16566000,568507000,1226121000,1114736000,-46462000,,-720642000,-720642000,1185,INCY,quarterly
2020-12-31,,,245000000,,-165000000,712000000,747000000,-79000000,-79000000,,-98000000,,,,410000000,1238000000,1317000000,491000000,324000000,,-165000000,-165000000,1196,BKNG,quarterly
2020-09-30,,,835000000,,801000000,1079000000,2123000000,929000000,929000000,,-98000000,,,,34000000,2640000000,1711000000,517000000,-94000000,,801000000,801000000,1196,BKNG,quarterly
2020-06-30,,,209000000,,122000000,516000000,178000000,-450000000,-450000000,,-96000000,,,,87000000,630000000,1080000000,452000000,659000000,,122000000,122000000,1196,BKNG,quarterly
2020-03-31,,,-722000000,,-699000000,1507000000,1804000000,180000000,180000000,,-64000000,,,,-23000000,2288000000,2108000000,484000000,-902000000,,-699000000,-699000000,1196,BKNG,quarterly
2021-01-02,,,46000000,13987000000,17000000,2950000000,4474000000,226000000,226000000,,-404000000,,,,16000000,16249000000,16023000000,11775000000,-180000000,-12000000,30000000,17000000,1226,DIS,quarterly
2020-10-03,,,-580000000,13929000000,-710000000,2250000000,3694000000,109000000,109000000,,-1058000000,,,,49000000,14707000000,14598000000,11013000000,-689000000,-12000000,-629000000,-710000000,1226,DIS,quarterly
2020-06-27,,,-4840000000,13759000000,-4721000000,2452000000,3883000000,54000000,54000000,,-456000000,,,,-331000000,11779000000,11725000000,7896000000,-4894000000,-3000000,-4509000000,-4721000000,1226,DIS,quarterly
2020-03-28,,,1045000000,13566000000,460000000,3397000000,6089000000,1357000000,1357000000,,-365000000,,,,522000000,18044000000,16687000000,11955000000,-312000000,-3000000,523000000,460000000,1226,DIS,quarterly
2020-12-31,,,400000000,194000000,314000000,352000000,881000000,472000000,472000000,,-15000000,,,,86000000,1290000000,818000000,409000000,-72000000,,314000000,314000000,1231,MCO,quarterly
2020-09-30,,,599000000,196000000,467000000,272000000,992000000,664000000,664000000,,-51000000,,,,132000000,1356000000,692000000,364000000,-65000000,,467000000,467000000,1231,MCO,quarterly
2020-06-30,,,666000000,196000000,509000000,308000000,1073000000,707000000,707000000,,-58000000,,,,157000000,1435000000,728000000,362000000,-41000000,,509000000,509000000,1231,MCO,quarterly
2020-03-31,,,564000000,6000000,488000000,303000000,950000000,598000000,598000000,,-39000000,,,,77000000,1290000000,692000000,340000000,-34000000,,487000000,488000000,1231,MCO,quarterly
2020-10-31,484000000,,125000000,47000000,157000000,1126000000,2233000000,529000000,529000000,15000000,-178000000,,,,-32000000,7208000000,6679000000,4975000000,-404000000,,157000000,157000000,1244,HPE,quarterly
2020-07-31,455000000,,-34000000,51000000,9000000,1103000000,2067000000,384000000,384000000,30000000,-178000000,,,,-43000000,6816000000,6432000000,4749000000,-418000000,,9000000,9000000,1244,HPE,quarterly
2020-04-30,450000000,,-911000000,48000000,-821000000,1073000000,1921000000,278000000,278000000,35000000,-341000000,,,,-90000000,6009000000,5731000000,4088000000,-1189000000,,-821000000,-821000000,1244,HPE,quarterly
2020-01-31,485000000,,378000000,54000000,333000000,1181000000,2302000000,495000000,495000000,21000000,-5000000,,,,45000000,6949000000,6454000000,4647000000,-117000000,,333000000,333000000,1244,HPE,quarterly
2020-12-31,25073000,,36601000,,24367000,119201000,194820000,36247000,36247000,,,,,,12234000,220947000,184700000,26127000,354000,,24367000,24367000,1274,PAYC,quarterly
2020-09-30,21772000,,34282000,,27482000,102662000,172254000,34036000,34036000,,88000.0,,,,6800000,196532000,162496000,24278000,246000,,27482000,27482000,1274,PAYC,quarterly
2020-06-30,21778000,,26735000,,28589000,96901000,158330000,26576000,26576000,,-103000.0,,,,-1854000,181587000,155011000,23257000,159000,,28589000,28576000,1274,PAYC,quarterly
2020-03-31,21621000,,88318000,,63015000,95152000,218252000,89264000,89264000,,-1616000.0,,,,25303000,242368000,153104000,24116000,-946000,,63015000,62988000,1274,PAYC,quarterly
2020-12-31,,,346000000,943000000,231000000,716000000,1216000000,333000000,333000000,,-12000000,,,,85000000,2414000000,2081000000,1198000000,13000000,,261000000,231000000,1275,NWSA,quarterly
2020-09-30,,,72000000,815000000,34000000,683000000,953000000,106000000,106000000,,-8000000,,,,25000000,2117000000,2011000000,1164000000,-34000000,,47000000,34000000,1275,NWSA,quarterly
2020-06-30,,,-401000000,807000000,-397000000,757000000,950000000,33000000,33000000,,-12000000,,,,0,1923000000,1890000000,973000000,-434000000,,-401000000,-397000000,1275,NWSA,quarterly
2020-03-31,,,-1046000000,736000000,-730000000,742000000,988000000,86000000,86000000,,-9000000,,,,-10000000,2266000000,2180000000,1278000000,-1132000000,,-1036000000,-730000000,1275,NWSA,quarterly
2020-12-26,,,81120000,35958000,67289000,1909429000,2098458000,189029000,189029000,,-146498000,,,,13831000,11558982000,11369953000,9460524000,-107909000,,67289000,67289000,1282,SYY,quarterly
2020-09-26,,,258738000,33977000,216900000,1784838000,2219845000,435007000,435007000,,-146717000,,,,41838000,11777379000,11342372000,9557534000,-176269000,,216900000,216900000,1282,SYY,quarterly
2020-06-27,,,-736245000,34265000,-618419000,1589107000,1565655000,-34124000,-34124000,,-164269000,,,,-117826000,8866564000,8900688000,7300909000,-702121000,,-618419000,-618419000,1282,SYY,quarterly
2020-03-28,,,-28780000,31553000,-3297000,2208118000,2564240000,347465000,347465000,,-83854000,,,,-25483000,13698699000,13351234000,11134459000,-376245000,,-3297000,-3297000,1282,SYY,quarterly
2020-12-31,,,640000000,2843000000,454000000,384000000,1308000000,872000000,872000000,,-32000000,,,,135000000,1867000000,995000000,559000000,-232000000,,505000000,454000000,1312,SPGI,quarterly
2020-09-30,,,636000000,2567000000,455000000,323000000,1327000000,952000000,952000000,,-35000000,,,,138000000,1846000000,894000000,519000000,-316000000,,498000000,455000000,1312,SPGI,quarterly
2020-06-30,,,1075000000,2461000000,792000000,285000000,1450000000,1114000000,1114000000,,-40000000,,,,233000000,1943000000,829000000,493000000,-39000000,,842000000,792000000,1312,SPGI,quarterly
2020-03-31,,,877000000,2324000000,639000000,288000000,1265000000,928000000,928000000,,-34000000,,,,188000000,1786000000,858000000,521000000,-51000000,,689000000,639000000,1312,SPGI,quarterly
2020-12-31,,,1754000000,31000000,1442000000,2096000000,4462000000,0,1754000000,612000000,,,,,298000000,4462000000,2708000000,0,0,,1456000000,1387000000,1323,PNC,quarterly
2020-09-30,,,1698000000,34000000,1519000000,1974000000,4229000000,0,1698000000,557000000,,,,,166000000,4229000000,2531000000,0,0,,1532000000,1447000000,1323,PNC,quarterly
2020-06-30,,,-902000000,25000000,4870000000,1920000000,1613000000,0,-902000000,595000000,,,,,-158000000,1613000000,2515000000,0,0,5621000000.0,-744000000,4797000000,1323,PNC,quarterly
2020-03-31,,,879000000,27000000,908000000,1921000000,3422000000,0,879000000,622000000,,,,,120000000,3422000000,2543000000,0,0,156000000.0,759000000,840000000,1323,PNC,quarterly
2020-12-31,,,327371000,1513214000,173773000,304519000,848441000,382436000,382436000,,-59092000,,,,73368000,2905322000,2522886000,2056881000,-55065000,-19633000,254003000,173773000,1333,DVA,quarterly
2020-09-30,,,283332000,1482517000,158674000,363280000,952347000,432173000,432173000,,-72280000,,,,65792000,2924066000,2491893000,1971719000,-148841000,-19633000,217540000,158674000,1333,DVA,quarterly
2020-06-30,,,338084000,1421839000,201602000,281209000,895415000,456830000,456830000,,-79218000,,,,83212000,2879979000,2423149000,1984564000,-118746000,-19633000,254872000,201602000,1333,DVA,quarterly
2020-03-31,,,369475000,1413534000,239593000,263576000,865788000,447533000,447533000,,-86440000,,,,91560000,2841237000,2393704000,1975449000,-78058000,9980000,277915000,239593000,1333,DVA,quarterly
2020-12-31,,,61000000,192000000,35000000,455000000,960000000,296000000,296000000,,-94000000,,,,25000000,1672000000,1376000000,712000000,-235000000,,36000000,35000000,1350,NLSN,quarterly
2020-09-30,,,79000000,188000000,7000000,451000000,900000000,232000000,232000000,,-92000000,,,,69000000,1563000000,1331000000,663000000,-153000000,,10000000,7000000,1350,NLSN,quarterly
2020-06-30,,,-64000000,186000000,-30000000,451000000,832000000,157000000,157000000,,-91000000,,,,-38000000,1496000000,1339000000,664000000,-221000000,,-26000000,-30000000,1350,NLSN,quarterly
2020-03-31,,,-2000000,187000000,-18000000,515000000,838000000,109000000,109000000,,-94000000,,,,11000000,1559000000,1450000000,721000000,-111000000,,-13000000,-18000000,1350,NLSN,quarterly
2020-12-31,4899000000,,18337000000,,15463000000,6086000000,28882000000,17897000000,17897000000,,-568000000,,,,2874000000,43076000000,25179000000,14194000000,440000000,,15463000000,15463000000,1358,MSFT,quarterly
2020-09-30,4926000000,,16124000000,,13893000000,5350000000,26152000000,15876000000,15876000000,,-585000000,,,,2231000000,37154000000,21278000000,11002000000,248000000,,13893000000,13893000000,1358,MSFT,quarterly
2020-06-30,5214000000,,13422000000,,11202000000,7073000000,25694000000,13407000000,13407000000,,-684000000,,,,2220000000,38033000000,24626000000,12339000000,15000000,,11202000000,11202000000,1358,MSFT,quarterly
2020-03-31,4887000000,,12843000000,,10752000000,6184000000,24046000000,12975000000,12975000000,,-615000000,,,,2091000000,35021000000,22046000000,10975000000,-132000000,,10752000000,10752000000,1358,MSFT,quarterly
2020-12-31,,,-240000000,9000000,-235000000,44000000,899000000,262000000,262000000,593000000,-135000000,,,,-13000000,3237000000,2975000000,2338000000,-502000000,,-227000000,-235000000,1368,HAL,quarterly
2020-09-30,,,-1000000,3000000,-17000000,41000000,305000000,256000000,256000000,8000000,-133000000,,,,18000000,2975000000,2719000000,2670000000,-257000000,,-19000000,-17000000,1368,HAL,quarterly
2020-06-30,,,-2083000000,7000000,-1676000000,43000000,279000000,-418000000,-418000000,654000000,-131000000,,,,-402000000,3196000000,3614000000,2917000000,-1665000000,,-1681000000,-1676000000,1368,HAL,quarterly
2020-03-31,,,-896000000,13000000,-1017000000,54000000,556000000,477000000,477000000,25000000,-144000000,,,,119000000,5037000000,4560000000,4481000000,-1373000000,,-1015000000,-1017000000,1368,HAL,quarterly
2020-12-26,,,176381000,,135893000,643522000,995530000,293518000,293518000,,-8086000,,,,40488000,2878265000,2584747000,1882735000,-117137000,,135893000,135893000,1369,TSCO,quarterly
2020-09-26,,,244969000,,190610000,621129000,947957000,272177000,272177000,,-7208000,,,,54359000,2606572000,2334395000,1658615000,-27208000,,190610000,190610000,1369,TSCO,quarterly
2020-06-27,,,439308000,,338678000,601520000,1156813000,502746000,502746000,,-8438000,,,,100630000,3176327000,2673581000,2019514000,-63438000,,338678000,338678000,1369,TSCO,quarterly
2020-03-28,,,107489000,,83777000,497275000,661249000,112538000,112538000,,-5049000,,,,23712000,1959188000,1846650000,1297939000,-5049000,,83777000,83777000,1369,TSCO,quarterly
2020-12-31,,,304000000,206000000,224000000,442000000,741000000,229000000,229000000,,-99000000,,,,74000000,4087000000,3858000000,3346000000,75000000,,230000000,224000000,1370,FOX,quarterly
2020-09-30,,,1479000000,325000000,1106000000,388000000,1549000000,1093000000,1093000000,,-99000000,,,,362000000,2717000000,1624000000,1168000000,386000000,,1117000000,1106000000,1370,FOX,quarterly
2020-06-30,,,200000000,322000000,122000000,494000000,1231000000,643000000,643000000,,-100000000,,,,55000000,2418000000,1775000000,1187000000,-443000000,,145000000,122000000,1370,FOX,quarterly
2020-03-31,,,145000000,277000000,78000000,464000000,1379000000,858000000,858000000,,-89000000,,,,55000000,3440000000,2582000000,2061000000,-713000000,,90000000,78000000,1370,FOX,quarterly
2020-12-31,2642000000,,-1993000000,,-2094000000,2789000000,8867000000,3436000000,3436000000,,,,,,99000000,12514000000,9078000000,3647000000,-5429000000,,-2092000000,-2094000000,1381,MRK,quarterly
2020-09-30,2539000000,,3428000000,84000000.0,2941000000,2109000000,9108000000,4460000000,4460000000,,-203000000.0,,,,483000000,12551000000,8091000000,3443000000,-1032000000,,2945000000,2941000000,1381,MRK,quarterly
2020-06-30,2174000000,,3519000000,102000000.0,3002000000,2143000000,7738000000,3421000000,3421000000,,-209000000.0,,,,509000000,10872000000,7451000000,3134000000,98000000,,3010000000,3002000000,1381,MRK,quarterly
2020-03-31,2159000000,,3838000000,95000000.0,3219000000,2454000000,8813000000,4200000000,4200000000,,-212000000.0,,,,619000000,12057000000,7857000000,3244000000,-362000000,,3219000000,3219000000,1381,MRK,quarterly
2020-12-31,,,416000000,1919000000,271000000,809000000,1797000000,630000000,630000000,,-173000000,,,,98000000,2886000000,2256000000,1089000000,-214000000,,318000000,245000000,1401,DISCK,quarterly
2020-09-30,,,319000000,1953000000,300000000,633000000,1559000000,585000000,585000000,,-171000000,,,,-11000000,2561000000,1976000000,1002000000,-266000000,,330000000,265000000,1401,DISCK,quarterly
2020-06-30,,,456000000,1933000000,271000000,635000000,1737000000,768000000,768000000,,-172000000,,,,156000000,2541000000,1773000000,804000000,-312000000,,300000000,243000000,1401,DISCK,quarterly
2020-03-31,,,537000000,1934000000,377000000,645000000,1765000000,794000000,794000000,,-175000000,,,,130000000,2683000000,1889000000,918000000,-257000000,,407000000,338000000,1401,DISCK,quarterly
2020-12-31,,,-443284000,610469000,-443332000,302277000,34109000,-403672000,-403672000,,-64051000,,,,20542000,237383000,641055000,203274000,-39612000,,-463826000,-436197000,1411,LYV,quarterly
2020-09-30,,,-559362000,633441000,-528902000,437564000,53269000,-504233000,-504233000,,-66093000,,,,-16904000,184018000,688251000,130749000,-55129000,,-542458000,-521912000,1411,LYV,quarterly
2020-06-30,,,-639767000,675833000,-567517000,344268000,-120473000,-587508000,-587508000,,-52689000,,,,-29183000,74084000,661592000,194557000,-52259000,,-610584000,-565922000,1411,LYV,quarterly
2020-03-31,,,-214252000,815084000,-184784000,542946000,491873000,-163053000,-163053000,,-43999000,,,,-3330000,1365693000,1528746000,873820000,-51199000,,-210922000,-199324000,1411,LYV,quarterly
2020-12-31,,,243060000,59800000,247411000,236438000,610429000,205608000,205608000,,-105127000,,,,-3695000,1059653000,854045000,449224000,37452000,,246755000,247411000,1421,IRM,quarterly
2020-09-30,,,52496000,63553000,38394000,232095000,602142000,212795000,212795000,,-106779000,,,,13934000,1036647000,823852000,434505000,-160299000,,38562000,38394000,1421,IRM,quarterly
2020-06-30,,,2570000,63543000,-7086000,240310000,583194000,179034000,179034000,,-106023000,,,,9683000,982239000,803205000,399045000,-176464000,,-7113000,-7086000,1421,IRM,quarterly
2020-03-31,,,74579000,62323000,63975000,238733000,601810000,200493000,200493000,,-107097000,,,,9687000,1068731000,868238000,466921000,-125914000,,64892000,63975000,1421,IRM,quarterly
2020-12-31,,,399000000,75000000,312000000,1610000000,2107000000,0,437000000,60000000,,,,,87000000,2234000000,1797000000,127000000,-38000000,,312000000,311000000,1467,RJF,quarterly
2020-09-30,,,256000000,62000000,209000000,1523000000,1921000000,0,319000000,79000000,,,,,47000000,2047000000,1728000000,126000000,-63000000,,209000000,209000000,1467,RJF,quarterly
2020-06-30,,,198000000,50000000,172000000,1377000000,1649000000,0,217000000,55000000,,,,,26000000,1772000000,1555000000,123000000,-19000000,,172000000,172000000,1467,RJF,quarterly
2020-03-31,,,239000000,36000000,169000000,1542000000,1791000000,0,196000000,53000000,,,,,70000000,1916000000,1720000000,125000000,43000000,,169000000,169000000,1467,RJF,quarterly
2020-12-31,,,144600000,85600000,84400000,17400000,517700000,241900000,241900000,74900000,-92900000,,,,56800000,1211000000,969100000,693300000,-97300000,,87800000,70700000,1509,NI,quarterly
2020-09-30,,,-237800000,85600000,-172900000,-600000,402900000,152700000,152700000,70200000,-95200000,,,,-64900000,902500000,749800000,499600000,-390500000,,-172900000,-186700000,1509,NI,quarterly
2020-06-30,,,1200000,85600000,-4700000,-3100000,421200000,178600000,178600000,68200000,-97000000,,,,5900000,962700000,784100000,541500000,-177400000,,-4700000,-18500000,1509,NI,quarterly
2020-03-31,,,60700000,85600000,75600000,-2700000,698500000,431000000,431000000,85900000,-92900000,,,,-14900000,1605500000,1174500000,907000000,-370300000,,75600000,61800000,1509,NI,quarterly
2021-01-31,199000000,,195000000,,172000000,301000000,707000000,212000000,212000000,-5000000,-20000000,,,,23000000,1180000000,968000000,473000000,-17000000,,172000000,172000000,1512,KEYS,quarterly
2020-10-31,193000000,,266000000,,217000000,287000000,756000000,278000000,278000000,-2000000,-19000000,,,,49000000,1220000000,942000000,464000000,-12000000,,217000000,217000000,1512,KEYS,quarterly
2020-07-31,169000000,,185000000,,176000000,241000000,606000000,200000000,200000000,-4000000,-20000000,,,,9000000,1011000000,811000000,405000000,-15000000,,176000000,176000000,1512,KEYS,quarterly
2020-04-30,166000000,,108000000,,71000000,241000000,516000000,112000000,112000000,-3000000,-20000000,,,,37000000,895000000,783000000,379000000,-4000000,,71000000,71000000,1512,KEYS,quarterly
2021-01-01,125800000,,128300000,1700000,180300000,199800000,491000000,127800000,127800000,,-17900000,,,,-52400000,829700000,701900000,338700000,500000,,180700000,180300000,1543,TRMB,quarterly
2020-10-02,117900000,,96400000,1300000,84700000,191000000,463300000,114400000,114400000,,-19600000,,,,11600000,792100000,677700000,328800000,-18000000,,84800000,84700000,1543,TRMB,quarterly
2020-07-03,114000000,,90900000,1200000,63000000,172400000,429300000,103100000,103100000,,-19600000,,,,27700000,733600000,630500000,304300000,-12200000,,63200000,63000000,1543,TRMB,quarterly
2020-04-03,118200000,,79400000,1000000,61900000,204700000,466500000,103200000,103200000,,-20500000,,,,17500000,792300000,689100000,325800000,-23800000,,61900000,61900000,1543,TRMB,quarterly
2020-12-31,7022000000,,18689000000,,15227000000,8145000000,30818000000,15651000000,15651000000,,-53000000,,,,3462000000,56898000000,41247000000,26080000000,3038000000,,15227000000,15227000000,1547,GOOG,quarterly
2020-09-30,6856000000,,13359000000,,11247000000,6987000000,25056000000,11213000000,11213000000,,-48000000,,,,2112000000,46173000000,34960000000,21117000000,2146000000,,11247000000,11247000000,1547,GOOG,quarterly
2020-06-30,6875000000,,8277000000,,6959000000,6486000000,19744000000,6383000000,6383000000,,-13000000,,,,1318000000,38297000000,31914000000,18553000000,1894000000,,6959000000,6959000000,1547,GOOG,quarterly
2020-03-31,6820000000,,7757000000,,6836000000,7380000000,22177000000,7977000000,7977000000,,-21000000,,,,921000000,41159000000,33182000000,18982000000,-220000000,,6836000000,6836000000,1547,GOOG,quarterly
2020-12-31,,,2187000000,23000000,1792000000,-60000000,2241000000,2258000000,2258000000,43000000,-149000000,,,,395000000,17032000000,14774000000,14791000000,-71000000,,1792000000,1792000000,1557,LMT,quarterly
2020-09-27,,,2056000000,33000000,1698000000,-59000000,2136000000,2201000000,2201000000,-6000000,-145000000,,,,303000000,16495000000,14294000000,14359000000,-145000000,-55000000.0,1753000000,1698000000,1557,LMT,quarterly
2020-06-28,,,1962000000,35000000,1626000000,-62000000,2213000000,2266000000,2266000000,9000000,-149000000,,,,336000000,16220000000,13954000000,14007000000,-304000000,-55000000.0,1626000000,1626000000,1557,LMT,quarterly
2020-03-29,,,2030000000,41000000,1717000000,-60000000,2091000000,2152000000,2152000000,-1000000,-148000000,,,,313000000,15651000000,13499000000,13560000000,-122000000,-55000000.0,1717000000,1717000000,1557,LMT,quarterly
2020-12-31,75000000,,105000000,4000000,77000000,431000000,699000000,171000000,171000000,,-25000000,,,,28000000,1930000000,1759000000,1231000000,-66000000,,77000000,74000000,1568,XRX,quarterly
2020-09-30,76000000,,119000000,4000000,90000000,431000000,651000000,131000000,131000000,,-30000000,,,,29000000,1767000000,1636000000,1116000000,-12000000,,90000000,86000000,1568,XRX,quarterly
2020-06-30,76000000,,35000000,4000000,27000000,418000000,564000000,60000000,60000000,,-18000000,,,,8000000,1465000000,1405000000,901000000,-25000000,,27000000,24000000,1568,XRX,quarterly
2020-03-31,84000000,,-3000000,7000000,-2000000,542000000,712000000,75000000,75000000,,-21000000,,,,-1000000,1860000000,1785000000,1148000000,-78000000,,-2000000,-6000000,1568,XRX,quarterly
2020-12-31,,,94500000,41900000,74500000,366500000,637600000,169700000,169700000,,-36900000,,,,16800000,1118500000,948800000,480900000,-75200000,,77700000,74500000,1597,EFX,quarterly
2020-09-30,,,300400000,37800000,224200000,332000000,635100000,202400000,202400000,,-37400000,,,,75400000,1068300000,865900000,433200000,98000000,,225000000,224200000,1597,EFX,quarterly
2020-06-30,,,122700000,40200000,95900000,311900000,573500000,164800000,164800000,,-36600000,,,,26600000,982800000,818000000,409300000,-42100000,,96100000,95900000,1597,EFX,quarterly
2020-03-31,,,150500000,43300000,112600000,318000000,543800000,133900000,133900000,,-30700000,,,,36000000,957900000,824000000,414100000,16600000,,114500000,112600000,1597,EFX,quarterly
2020-12-31,,,-1108000000,,-755000000,84000000,-2182000000,-5557000000,-5557000000,2814000000,-365000000,,,,-353000000,3973000000,9530000000,6155000000,4449000000,,-755000000,-755000000,1633,DAL,quarterly
2020-09-30,,,-6859000000,,-5379000000,94000000,-1442000000,-1004000000,-1004000000,-1077000000,-291000000,,,,-1480000000,3062000000,4066000000,4504000000,-5855000000,,-5379000000,-5379000000,1633,DAL,quarterly
2020-06-30,,,-7014000000,,-5717000000,45000000,-2743000000,-2295000000,-2295000000,-1084000000,-194000000,,,,-1297000000,1468000000,3763000000,4211000000,-4719000000,,-5717000000,-5717000000,1633,DAL,quarterly
2020-03-31,,,-607000000,,-534000000,358000000,1205000000,-342000000,-342000000,511000000,-79000000,,,,-73000000,8592000000,8934000000,7387000000,-265000000,,-534000000,-534000000,1633,DAL,quarterly
2020-12-31,,,69400000,,56300000,169000000,248400000,79400000,79400000,,-12100000,,,,13100000,1054900000,975500000,806500000,-10000000,,56300000,56300000,1636,BR,quarterly
2020-09-30,,,73600000,,65800000,151700000,230300000,78600000,78600000,,-15000000,,,,7800000,1017400000,938800000,787100000,-5000000,,65800000,65800000,1636,BR,quarterly
2020-06-30,,,294700000,,229700000,178900000,477700000,298800000,298800000,,-16200000,,,,65000000,1361900000,1063100000,884200000,-4100000,,229700000,229700000,1636,BR,quarterly
2020-03-31,,,210400000,,166800000,151100000,377400000,226300000,226300000,,-16700000,,,,43600000,1249900000,1023600000,872500000,-15900000,,166800000,166800000,1636,BR,quarterly
2020-12-31,,,419700000,687000000,365100000,196300000,1549900000,855300000,855300000,17100000,-196100000,,,,58100000,2122500000,1267200000,572600000,-435600000,,361600000,365100000,1641,AMT,quarterly
2020-09-30,,,502200000,1012300000,464400000,176000000,1450300000,802700000,802700000,-2300000,-190900000,,,,39300000,2012900000,1210200000,562600000,-300500000,,462900000,464400000,1641,AMT,quarterly
2020-06-30,,,459500000,982300000,446100000,188600000,1373000000,733500000,733500000,-4000000,-197700000,,,,11100000,1913000000,1179500000,540000000,-274000000,,448400000,446100000,1641,AMT,quarterly
2020-03-31,,,439700000,971600000,415000000,217800000,1441100000,758500000,758500000,-7500000,-208800000,,,,21100000,1993100000,1234600000,552000000,-318800000,,418600000,415000000,1641,AMT,quarterly
2021-01-31,249300000,,171100000,,911300000,501700000,957300000,189100000,189100000,,-2800000,,,,-740200000,1039200000,850100000,81900000,-18000000,,911300000,911300000,1642,ADSK,quarterly
2020-10-31,223400000,,156100000,,132200000,463400000,876500000,172500000,172500000,,-14600000,,,,23900000,952400000,779900000,75900000,-16400000,,132200000,132200000,1642,ADSK,quarterly
2020-07-31,224000000,,129000000,,98200000,449200000,839700000,149600000,149600000,,-8000000,,,,30800000,913100000,763500000,73400000,-20600000,,98200000,98200000,1642,ADSK,quarterly
2020-04-30,208400000,,90500000,,66500000,453100000,811400000,132800000,132800000,,-22300000,,,,24000000,885700000,752900000,74300000,-42300000,,66500000,66500000,1642,ADSK,quarterly
2020-12-31,,,38861000,73235000,38487000,20512000,187145000,71922000,71922000,7972000,-38301000,,,,-355000,267858000,195936000,80713000,-33061000,,39216000,38487000,1651,REG,quarterly
2020-09-30,,,13310000,73529000,12688000,19582000,173777000,68179000,68179000,1208000,-41049000,,,,0,251060000,182881000,77283000,-54869000,,13310000,12688000,1651,REG,quarterly
2020-06-30,,,19574000,75219000,19046000,21202000,157112000,48372000,48372000,2480000,-40950000,,,,0,233937000,185565000,76825000,-28798000,,19574000,19046000,1651,REG,quarterly
2020-03-31,,,-24783000,75813000,-25332000,13705000,216820000,112483000,112483000,1337000,-37978000,,,,0,295076000,182593000,78256000,-137266000,,-24783000,-25332000,1651,REG,quarterly
2020-12-31,,,28000000,,43000000,64000000,746000000,-18000000,-18000000,292000000,-36000000,,,,-15000000,2016000000,2034000000,1270000000,46000000,,43000000,43000000,1670,PXD,quarterly
2020-09-30,,,-16000000,,-20000000,64000000,633000000,91000000,91000000,69000000,-34000000,,,,4000000,1857000000,1766000000,1224000000,-107000000,,-20000000,-20000000,1670,PXD,quarterly
2020-06-30,,,-537000000,,-439000000,60000000,360000000,-527000000,-527000000,401000000,-33000000,,,,-98000000,1143000000,1670000000,783000000,-10000000,,-439000000,-438000000,1670,PXD,quarterly
2020-03-31,,,365000000,,289000000,56000000,731000000,675000000,675000000,-443000000,-27000000,,,,76000000,2010000000,1335000000,1279000000,-310000000,,289000000,288000000,1670,PXD,quarterly
2020-12-31,,,596000000,296000000,358000000,348000000,772000000,422000000,422000000,2000000,-23000000,,,,211000000,3926000000,3504000000,3154000000,174000000,,385000000,358000000,1690,BWA,quarterly
2020-09-30,,,272000000,161000000,111000000,202000000,517000000,319000000,319000000,-4000000,-20000000,,,,143000000,2534000000,2215000000,2017000000,-47000000,,129000000,111000000,1690,BWA,quarterly
2020-06-30,,,-90000000,152000000,-98000000,183000000,174000000,-8000000,-8000000,-1000000,-18000000,,,,-6000000,1426000000,1434000000,1252000000,-82000000,,-84000000,-98000000,1690,BWA,quarterly
2020-03-31,,,186000000,140000000,129000000,211000000,447000000,236000000,236000000,-1000000,-12000000,,,,49000000,2279000000,2043000000,1832000000,-50000000,,137000000,129000000,1690,BWA,quarterly
2020-12-31,,,108900000,69800000,151600000,246100000,526900000,130400000,130400000,38600000,-24400000,,,,-42200000,1510700000,1380300000,983800000,-21500000,,151100000,151600000,1703,IR,quarterly
2020-09-30,,,48100000,58200000,29500000,244200000,482000000,123000000,123000000,600000,-28800000,,,,18200000,1335200000,1212200000,853200000,-74900000,,29900000,29500000,1703,IR,quarterly
2020-06-30,,,-80700000,66900000,-177600000,246400000,360000000,-2100000,-2100000,1100000,-30800000,,,,95800000,1264400000,1266500000,904400000,-78600000,,-176500000,-177600000,1703,IR,quarterly
2020-03-31,,,-95700000,69300000,-36800000,154600000,244500000,33200000,33200000,1500000,-27100000,,,,-58900000,799900000,766700000,555400000,-128900000,,-36800000,-36800000,1703,IR,quarterly
2020-12-31,,,-319000000,1220000000,-63000000,,2564000000,1022000000,1022000000,334000000,-535000000,,,,-162000000,5777000000,4755000000,3213000000,-1341000000,7000000,-157000000,-77000000,1716,DUK,quarterly
2020-09-30,,,1339000000,1289000000,1304000000,,3420000000,1879000000,1879000000,324000000,-522000000,,,,105000000,6721000000,4842000000,3301000000,-540000000,7000000,1234000000,1276000000,1716,DUK,quarterly
2020-06-30,,,-1208000000,1127000000,-802000000,,2660000000,1176000000,1176000000,334000000,-554000000,,,,-316000000,5421000000,4245000000,2761000000,-2384000000,7000000,-892000000,-829000000,1716,DUK,quarterly
2020-03-31,,,1027000000,1162000000,938000000,,2964000000,1489000000,1489000000,345000000,-551000000,,,,137000000,5949000000,4460000000,2985000000,-462000000,7000000,890000000,911000000,1716,DUK,quarterly
2020-12-31,,,4416000000,2695000000,3380000000,11100000000,18270000000,3918000000,3918000000,,-1231000000,,,,979000000,27708000000,23790000000,9438000000,498000000,,3437000000,3380000000,1743,CMCSA,quarterly
2020-09-30,,,2770000000,2649000000,2019000000,9571000000,16967000000,4076000000,4076000000,,-1220000000,,,,739000000,25532000000,21456000000,8565000000,-1306000000,,2031000000,2019000000,1743,CMCSA,quarterly
2020-06-30,,,3955000000,2433000000,2988000000,8987000000,16898000000,4647000000,4647000000,,-1112000000,,,,946000000,23715000000,19068000000,6817000000,-692000000,,3009000000,2988000000,1743,CMCSA,quarterly
2020-03-31,,,2924000000,2536000000,2147000000,10192000000,18308000000,4852000000,4852000000,,-1212000000,,,,700000000,26609000000,21757000000,8301000000,-1928000000,,2224000000,2147000000,1743,CMCSA,quarterly
2020-12-31,,,1316000000,,1049000000,,1357000000,1330000000,1330000000,27000000,-14000000,,,,267000000,2694000000,1364000000,1337000000,-14000000,,1049000000,1049000000,1761,CINF,quarterly
2020-09-30,,,614000000,,484000000,,652000000,627000000,627000000,25000000,-13000000,,,,130000000,2227000000,1600000000,1575000000,-13000000,,484000000,484000000,1761,CINF,quarterly
2020-06-30,,,1145000000,,909000000,,1189000000,1159000000,1159000000,30000000,-14000000,,,,236000000,2714000000,1555000000,1525000000,-14000000,,909000000,909000000,1761,CINF,quarterly
2020-03-31,,,-1576000000,,-1226000000,,-1540000000,-1563000000,-1563000000,23000000,-13000000,,,,-350000000,-99000000,1464000000,1441000000,-13000000,,-1226000000,-1226000000,1761,CINF,quarterly
2020-12-31,,,-958000000,1010000000,-739000000,24000000,568000000,113000000,113000000,163000000,-50000000,,,,-202000000,767000000,654000000,199000000,-1071000000,,-756000000,-739000000,1764,FANG,quarterly
2020-09-30,,,-1409000000,1117000000,-1113000000,20000000,522000000,91000000,91000000,125000000,-48000000,,,,-304000000,683000000,592000000,161000000,-1500000000,,-1105000000,-1113000000,1764,FANG,quarterly
2020-06-30,,,-3092000000,1121000000,-2393000000,20000000,233000000,-486000000,-486000000,356000000,-54000000,,,,-681000000,404000000,890000000,171000000,-2606000000,,-2411000000,-2393000000,1764,FANG,quarterly
2020-03-31,,,-317000000,1490000000,-272000000,24000000,640000000,811000000,811000000,-602000000,-110000000,,,,83000000,855000000,44000000,215000000,-1128000000,,-400000000,-272000000,1764,FANG,quarterly
2021-01-31,471000000,,1296000000,,1068000000,1338000000,3324000000,1486000000,1486000000,,-63000000,,,,228000000,15646000000,14160000000,12322000000,-190000000,,1068000000,1068000000,1784,HPQ,quarterly
2020-10-31,381000000,,776000000,,668000000,1263000000,2679000000,1006000000,1006000000,,-145000000,,,,108000000,15258000000,14252000000,12579000000,-230000000,,668000000,668000000,1784,HPQ,quarterly
2020-07-31,359000000,,751000000,,734000000,1156000000,2393000000,849000000,849000000,,-55000000,,,,17000000,14294000000,13445000000,11901000000,-98000000,,734000000,734000000,1784,HPQ,quarterly
2020-04-30,338000000,,826000000,,764000000,1157000000,2493000000,969000000,969000000,,-64000000,,,,62000000,12469000000,11500000000,9976000000,-143000000,,764000000,764000000,1784,HPQ,quarterly
2020-12-31,,,1469000000,8494000000,708000000,117000000,1864000000,1335000000,1335000000,-31000000,-201000000,,,,611000000,4495000000,3160000000,2631000000,134000000,,858000000,708000000,1790,FCX,quarterly
2020-09-30,,,729000000,8326000000,329000000,72000000,1407000000,916000000,916000000,21000000,-120000000,,,,297000000,3851000000,2935000000,2444000000,-187000000,,432000000,326000000,1790,FCX,quarterly
2020-06-30,,,220000000,8201000000,53000000,76000000,951000000,516000000,516000000,11000000,-115000000,,,,96000000,3054000000,2538000000,2103000000,-296000000,,124000000,53000000,1790,FCX,quarterly
2020-03-31,,,-609000000,8108000000,-491000000,110000000,51000000,-434000000,-434000000,26000000,-127000000,,,,-60000000,2798000000,3232000000,2747000000,-175000000,,-549000000,-491000000,1790,FCX,quarterly
2021-01-01,535000000,,85000000,,62000000,265000000,960000000,160000000,160000000,,-81000000,,,,23000000,3943000000,3783000000,2983000000,-75000000,,62000000,62000000,1795,WDC,quarterly
2020-10-02,555000000,,-3000000,,-60000000,256000000,874000000,63000000,63000000,,-84000000,,,,57000000,3922000000,3859000000,3048000000,-66000000,,-60000000,-60000000,1795,WDC,quarterly
2020-07-03,546000000,,185000000,,148000000,268000000,1070000000,256000000,256000000,,-87000000,,,,37000000,4287000000,4031000000,3217000000,-71000000,,148000000,148000000,1795,WDC,quarterly
2020-04-03,563000000,,46000000,,17000000,281000000,1018000000,174000000,174000000,,-99000000,,,,29000000,4175000000,4001000000,3157000000,-128000000,,17000000,17000000,1795,WDC,quarterly
2020-12-31,,,101649000,215021000,95745000,23144000,253071000,99800000,99800000,,-55609000,,,,0,369733000,269933000,116662000,1849000,,101649000,95745000,1815,ESS,quarterly
2020-09-30,,,78842000,215204000,73661000,13310000,264755000,121243000,121243000,,-55430000,,,,0,385771000,264528000,121016000,-42401000,,78842000,73661000,1815,ESS,quarterly
2020-06-30,,,90076000,220048000,84458000,14952000,268957000,120396000,120396000,,-54447000,,,,0,387754000,267358000,118797000,-30320000,,90076000,84458000,1815,ESS,quarterly
2020-03-31,,,328765000,222427000,315006000,13982000,297675000,152134000,152134000,,-55147000,,,,0,413664000,261530000,115989000,176631000,,328765000,315006000,1815,ESS,quarterly
2020-12-31,,,252900000,,207700000,249800000,546300000,0,274400000,22100000,,,,,45200000,546300000,271900000,0,-21500000,,207700000,204200000,1867,PBCT,quarterly
2020-09-30,,,172100000,,144600000,249900000,464400000,0,193100000,21400000,,,,,27500000,464400000,271300000,0,-21000000,,144600000,141100000,1867,PBCT,quarterly
2020-06-30,,,110400000,,89900000,248200000,411700000,0,144900000,18600000,,,,,20500000,411700000,266800000,0,-34500000,,89900000,86400000,1867,PBCT,quarterly
2020-03-31,,,166200000,,130400000,261500000,484300000,0,201000000,21800000,,,,,35800000,484300000,283300000,0,-34800000,,130400000,126900000,1867,PBCT,quarterly
2020-12-31,149800000,,436500000,27600000,365200000,331400000,895800000,414600000,414600000,,,,,,72900000,1329100000,914500000,433300000,21900000,,363600000,365200000,1870,ISRG,quarterly
2020-09-30,155000000,,355200000,28900000,313900000,298900000,724300000,270400000,270400000,,,,,,38400000,1077700000,807300000,353400000,84800000,,316800000,313900000,1870,ISRG,quarterly
2020-06-30,143200000,,107200000,25900000,68000000,279100000,502900000,80600000,80600000,,,,,,37000000,852100000,771500000,349200000,26600000,,70200000,68000000,1870,ISRG,quarterly
2020-03-31,147100000,,308100000,23800000,313500000,308100000,738200000,283000000,283000000,,,,,,-8100000,1099500000,816500000,361300000,25100000,,316200000,313500000,1870,ISRG,quarterly
2020-12-31,,,989709000,351138000,732632000,429261000,1615425000,989639000,989639000,,,,,,228411000,4557365000,3567726000,2941940000,70000,,761298000,732632000,1909,DISH,quarterly
2020-09-30,,,806473000,634206000,504599000,516648000,1526979000,811248000,811248000,,6778000.0,,,,273514000,4531591000,3720343000,3004612000,-4775000,,532959000,504599000,1909,DISH,quarterly
2020-06-30,,,631750000,605847000,452343000,410689000,1200463000,637650000,637650000,,-11494000.0,,,,151344000,3187090000,2549440000,1986627000,-5900000,,480406000,452343000,1909,DISH,quarterly
2020-03-31,,,144280000,577801000,73099000,463956000,1131272000,500496000,500496000,,-15606000.0,,,,45006000,3217389000,2716893000,2086117000,-356216000,,99274000,73099000,1909,DISH,quarterly
2020-11-22,,,1420000000,449000000,1166000000,4298000000,5750000000,1430000000,1430000000,,-39000000,,,,239000000,43208000000,41778000000,37458000000,-10000000,,1181000000,1166000000,1962,COST,quarterly
2020-08-30,,,1869000000,421000000,1389000000,4786000000,7090000000,2278000000,2278000000,,-51000000,,,,465000000,53383000000,51105000000,46293000000,-409000000,,1404000000,1389000000,1962,COST,quarterly
2020-05-10,,,1163000000,401000000,838000000,3591000000,5061000000,1462000000,1462000000,,-37000000,,,,311000000,37266000000,35804000000,32205000000,-299000000,,852000000,838000000,1962,COST,quarterly
2020-02-16,,,1277000000,385000000,931000000,3743000000,5016000000,1266000000,1266000000,,-34000000,,,,330000000,39072000000,37806000000,34056000000,11000000,,947000000,931000000,1962,COST,quarterly
2020-12-31,,,2072000000,2320000000,1426000000,923000000,5534000000,2390000000,2390000000,1559000000,-383000000,,,,378000000,14293000000,11903000000,8759000000,-318000000,,1694000000,1426000000,2015,HCA,quarterly
2020-09-30,,,988000000,2273000000,668000000,923000000,5086000000,2141000000,2141000000,2251000000,-385000000,,,,209000000,13311000000,11170000000,8225000000,-1153000000,,779000000,668000000,2015,HCA,quarterly
2020-06-30,,,1560000000,2354000000,1079000000,923000000,3990000000,1152000000,1152000000,2147000000,-388000000,,,,344000000,11068000000,9916000000,7078000000,408000000,,1216000000,1079000000,2015,HCA,quarterly
2020-03-31,,,810000000,2259000000,581000000,923000000,4620000000,1519000000,1519000000,2427000000,-428000000,,,,112000000,12861000000,11342000000,8241000000,-709000000,,698000000,581000000,2015,HCA,quarterly
2020-12-26,719000000,,2357000000,98000000,1845000000,8500000000,12057000000,2848000000,2848000000,-10000000,-339000000,,,,498000000,22455000000,19607000000,10398000000,-491000000,,1859000000,1845000000,2027,PEP,quarterly
2020-09-05,719000000,,2833000000,112000000,2291000000,6776000000,9947000000,3169000000,3169000000,2000000,-264000000,,,,526000000,18091000000,14922000000,8144000000,-336000000,,2307000000,2291000000,2027,PEP,quarterly
2020-06-13,719000000,,2168000000,96000000,1646000000,6243000000,8877000000,2632000000,2632000000,2000000,-235000000,,,,510000000,15945000000,13313000000,7068000000,-464000000,,1658000000,1646000000,2027,PEP,quarterly
2020-03-21,719000000,,1711000000,94000000,1338000000,5537000000,7756000000,2053000000,2053000000,166000000,-290000000,,,,360000000,13881000000,11828000000,6125000000,-342000000,,1351000000,1338000000,2027,PEP,quarterly
2020-12-31,100038000,,79298000,109434000,67589000,214333000,513819000,149063000,149063000,2700000,-32756000,,,,12734000,1270073000,1121010000,756254000,-69765000,,66564000,63928000,2036,IFF,quarterly
2020-09-30,89968000,,105500000,112113000,84828000,188130000,524530000,198694000,198694000,2700000,-34844000,,,,19269000,1268076000,1069382000,743546000,-93194000,,86231000,85592000,2036,IFF,quarterly
2020-06-30,80948000,,103065000,111645000,86204000,188969000,482184000,163433000,163433000,2700000,-32062000,,,,15699000,1198773000,1035340000,716589000,-60368000,,87366000,84398000,2036,IFF,quarterly
2020-03-31,85909000,,153508000,115537000,124607000,210995000,566529000,226975000,226975000,-5700000,-32140000,,,,26297000,1347317000,1120342000,780788000,-73467000,,127211000,130213000,2036,IFF,quarterly
2020-12-31,,,-1425000000,,-1112000000,209000000,2070000000,-504000000,-504000000,491000000,-259000000,,,,-276000000,4160000000,4664000000,2090000000,-921000000,37000000,-1149000000,-1312000000,2062,OXY,quarterly
2020-09-30,,,-4058000000,,-3575000000,166000000,2158000000,-384000000,-384000000,411000000,-265000000,,,,-403000000,4108000000,4492000000,1950000000,-3674000000,80000000,-3655000000,-3778000000,2062,OXY,quarterly
2020-06-30,,,-8184000000,,-8131000000,225000000,1090000000,-7914000000,-7914000000,182000000,-386000000,,,,-1468000000,2928000000,10842000000,1838000000,-270000000,-1415000000,-6716000000,-8353000000,2062,OXY,quarterly
2020-03-31,,,-2038000000,,-2013000000,264000000,3893000000,315000000,315000000,422000000,-937000000,,,,-25000000,6613000000,6298000000,2720000000,-2353000000,-1415000000,-2013000000,-2232000000,2062,OXY,quarterly
2020-12-31,,,1242700000,20700000,938300000,518000000,1904900000,1296100000,1296100000,,-48300000,,,,304100000,4489800000,3193700000,2584900000,-53400000,,938600000,938300000,2070,LH,quarterly
2020-09-30,,,947100000,19900000,703400000,413200000,1559400000,1084000000,1084000000,,-51400000,,,,243400000,3896100000,2812100000,2336700000,-136900000,,703700000,703400000,2070,LH,quarterly
2020-06-30,,,297000000,19500000,231600000,383700000,760500000,316700000,316700000,,-52700000,,,,65400000,2768800000,2452100000,2008300000,-19700000,,231600000,231600000,2070,LH,quarterly
2020-03-31,,,-267700000,18500000,-317200000,383400000,728000000,282300000,282300000,,-55000000,,,,49200000,2823800000,2541500000,2095800000,-550000000,,-316900000,-317200000,2070,LH,quarterly
2020-12-31,,,667000000,2283000000,359000000,-15000000,2259000000,844000000,844000000,415000000,-394000000,,,,232000000,8114000000,7270000000,5855000000,-177000000,,435000000,359000000,2078,EXC,quarterly
2020-09-30,,,785000000,2219000000,501000000,-15000000,3132000000,1674000000,1674000000,452000000,-404000000,,,,216000000,8853000000,7179000000,5721000000,-889000000,,569000000,501000000,2078,EXC,quarterly
2020-06-30,,,793000000,2168000000,521000000,-13000000,1966000000,567000000,567000000,410000000,-427000000,,,,219000000,7325000000,6758000000,5359000000,226000000,,574000000,521000000,2078,EXC,quarterly
2020-03-31,,,82000000,2134000000,582000000,-10000000,2676000000,1228000000,1228000000,437000000,-410000000,,,,-294000000,8747000000,7519000000,6071000000,-1146000000,,376000000,582000000,2078,EXC,quarterly
2020-12-31,229064000,,527402000,15124000,457251000,181909000,981137000,570164000,570164000,,-38880000,,,,70419000,1650870000,1080706000,669733000,-42762000,,456983000,457251000,2081,KLAC,quarterly
2020-09-30,219038000,,483806000,15161000,420567000,172631000,918058000,526389000,526389000,,-39386000,,,,63664000,1538620000,1012231000,620562000,-42583000,,420142000,420567000,2081,KLAC,quarterly
2020-06-30,217100000,,405069000,15586000,411253000,169619000,838049000,451330000,451330000,,-40221000,,,,-5246000,1459593000,1008263000,621544000,-46261000,,410315000,411253000,2081,KLAC,quarterly
2020-03-31,215433000,,115199000,17763000,78452000,185760000,833806000,432613000,432613000,,-39231000,,,,37190000,1423964000,991351000,590158000,-317414000,,78009000,78452000,2081,KLAC,quarterly
2020-12-31,,,903000000,319000000,750000000,2493000000,3828000000,0,929000000,406000000,,,,,148000000,3828000000,2899000000,0,-26000000,,755000000,701000000,2095,BK,quarterly
2020-09-30,,,1157000000,430000000,937000000,2314000000,3838000000,0,1183000000,341000000,,,,,213000000,3838000000,2655000000,0,-26000000,,944000000,875000000,2095,BK,quarterly
2020-06-30,,,1181000000,269000000,950000000,2303000000,3867000000,0,1207000000,357000000,,,,,216000000,3867000000,2660000000,0,-26000000,,965000000,900000000,2095,BK,quarterly
2020-03-31,,,1227000000,234000000,980000000,2315000000,3939000000,0,1253000000,371000000,,,,,265000000,3939000000,2686000000,0,-26000000,,962000000,941000000,2095,BK,quarterly
2020-12-31,,,217766000,443196000,398843000,154119000,615328000,434209000,434209000,,-36342000,,,,-208100000,5260055000,4825846000,4644727000,-216443000,,425866000,398843000,2121,NUE,quarterly
2020-10-03,,,290418000,414653000,193415000,149113000,502195000,353082000,353082000,,-42281000,,,,67788000,4927960000,4574878000,4425765000,-62664000,,222630000,192214000,2121,NUE,quarterly
2020-07-04,,,181057000,428665000,108881000,142017000,377959000,235942000,235942000,,-38849000,,,,47904000,4327306000,4091364000,3949347000,-54885000,,133153000,108089000,2121,NUE,quarterly
2020-04-04,,,146297000,427865000,20331000,153392000,629268000,475876000,475876000,,-47596000,,,,91918000,5624337000,5148461000,4995069000,-329579000,,54379000,19701000,2121,NUE,quarterly
2020-12-31,,,71337000,,59174000,164744000,239095000,74351000,74351000,,-3061000,,,,12163000,839261000,764910000,600166000,-3014000,,59174000,59174000,2126,POOL,quarterly
2020-09-30,,,146458000,,119098000,180465000,328698000,148233000,148233000,,-1861000,,,,27360000,1139229000,990996000,810531000,-1775000,,119098000,119098000,2126,POOL,quarterly
2020-06-30,,,203288000,,157555000,167624000,373481000,205857000,205857000,,-2643000,,,,45733000,1280846000,1074989000,907365000,-2569000,,157555000,157555000,2126,POOL,quarterly
2020-03-31,,,30887000,,30912000,147097000,189629000,42532000,42532000,,-4789000,,,,-25000,677288000,634756000,487659000,-11645000,,30912000,30912000,2126,POOL,quarterly
2020-12-31,19403000,,182896000,,157314000,50401000,274312000,204508000,204508000,,-22537000,,,,25582000,320284000,115776000,45972000,-21612000,,157314000,157314000,2128,VRSN,quarterly
2020-09-30,19708000,,184887000,,170979000,46498000,272855000,206649000,206649000,,-22537000,,,,13908000,317879000,111230000,45024000,-21762000,,170979000,170979000,2128,VRSN,quarterly
2020-06-30,18202000,,191648000,,152479000,45775000,270757000,206780000,206780000,,-22535000,,,,39169000,314365000,107585000,43608000,-15132000,,152479000,152479000,2128,VRSN,quarterly
2020-03-31,17358000,,190813000,,334116000,43329000,266951000,206264000,206264000,,-22535000,,,,-143303000,312524000,106260000,45573000,-15451000,,334116000,334116000,2128,VRSN,quarterly
2020-12-31,,,3439000000,4647000000,2846000000,2088000000,5014000000,2926000000,2926000000,,-275000000,,,,642000000,37518000000,34592000000,32504000000,513000000,,2797000000,2801000000,2140,GM,quarterly
2020-09-30,,,4905000000,4667000000,4045000000,1230000000,6098000000,4868000000,4868000000,,-327000000,,,,887000000,35480000000,30612000000,29382000000,37000000,,4018000000,4005000000,2140,GM,quarterly
2020-06-30,,,-892000000,4189000000,-758000000,974000000,96000000,-878000000,-878000000,,-303000000,,,,-112000000,16778000000,17656000000,16682000000,-14000000,,-780000000,-806000000,2140,GM,quarterly
2020-03-31,,,643000000,4204000000,294000000,1611000000,3141000000,1530000000,1530000000,,-193000000,,,,357000000,32709000000,31179000000,29568000000,-887000000,,286000000,247000000,2140,GM,quarterly
2020-12-31,255000000,,635000000,927000000,501000000,559000000,1405000000,540000000,540000000,51000000,-29000000,,,,125000000,5830000000,5290000000,4425000000,95000000,,510000000,501000000,2206,CMI,quarterly
2020-09-27,224000000,,686000000,941000000,501000000,517000000,1305000000,603000000,603000000,-39000000,-25000000,,,,182000000,5118000000,4515000000,3813000000,83000000,,504000000,501000000,2206,CMI,quarterly
2020-06-28,189000000,,362000000,938000000,276000000,486000000,890000000,213000000,213000000,2000000,-23000000,,,,93000000,3852000000,3639000000,2962000000,149000000,,269000000,276000000,2206,CMI,quarterly
2020-03-29,238000000,,655000000,950000000,511000000,562000000,1294000000,492000000,492000000,2000000,-23000000,,,,127000000,5011000000,4519000000,3717000000,163000000,,528000000,511000000,2206,CMI,quarterly
2020-12-31,,,119395000,,63601000,11934000,186995000,175061000,175061000,,-14847000,,,,55794000,2802218000,2627157000,2615223000,-55666000,,63601000,63601000,2231,RE,quarterly
2020-09-30,,,272508000,,243057000,10618000,232286000,221668000,221668000,,-6641000,,,,29451000,2552703000,2331035000,2320417000,50840000,,243057000,240138000,2231,RE,quarterly
2020-06-30,,,237067000,,190880000,8733000,285543000,276810000,276810000,,-7253000,,,,46187000,2277005000,2000195000,1991462000,-39743000,,190880000,188381000,2231,RE,quarterly
2020-03-31,,,-43622000,,16612000,9833000,-49569000,-59402000,-59402000,,-7583000,,,,-60234000,1958653000,2018055000,2008222000,15780000,,16612000,16406000,2231,RE,quarterly
2020-12-31,,,151900000,,120000000,184700000,324100000,139400000,139400000,,-1000000,,,,31900000,834500000,695100000,510400000,12500000,,120000000,120000000,2265,AOS,quarterly
2020-09-30,,,137300000,,105400000,157200000,297100000,139900000,139900000,,-1600000,,,,31900000,760000000,620100000,462900000,-2600000,,105400000,105400000,2265,AOS,quarterly
2020-06-30,,,87000000,,67800000,153600000,247500000,93900000,93900000,,-2500000,,,,19200000,663900000,570000000,416400000,-6900000,,67800000,67800000,2265,AOS,quarterly
2020-03-31,,,67700000,,51700000,171300000,239500000,68200000,68200000,,-2200000,,,,16000000,636900000,568700000,397400000,-500000,,51700000,51700000,2265,AOS,quarterly
2021-01-03,126000000,,299000000,,257000000,373000000,637000000,131000000,131000000,,-16000000,,,,42000000,953000000,822000000,316000000,168000000,,257000000,257000000,2273,ILMN,quarterly
2020-09-27,172000000,,215000000,,179000000,217000000,533000000,137000000,137000000,,-11000000,,,,36000000,794000000,657000000,261000000,78000000,,179000000,179000000,2273,ILMN,quarterly
2020-06-28,155000000,,165000000,,47000000,177000000,435000000,96000000,96000000,,-11000000,,,,118000000,633000000,537000000,198000000,69000000,,47000000,47000000,2273,ILMN,quarterly
2020-03-29,156000000,,178000000,,173000000,182000000,626000000,281000000,281000000,,-11000000,,,,5000000,859000000,578000000,233000000,-103000000,,173000000,173000000,2273,ILMN,quarterly
2020-11-29,,,460200000,77500000,378900000,332800000,898400000,565600000,565600000,,-108100000,,,,80700000,2995200000,2429600000,2096800000,-105400000,,379500000,378900000,2276,CAG,quarterly
2020-08-30,,,416500000,77600000,329000000,270300000,820600000,550300000,550300000,,-114500000,,,,86700000,2678900000,2128600000,1858300000,-133800000,,329800000,329000000,2276,CAG,quarterly
2020-05-31,,,261100000,74600000,201400000,409000000,933000000,524000000,524000000,,-126100000,,,,59800000,3287900000,2763900000,2354900000,-262900000,,201300000,201400000,2276,CAG,quarterly
2020-02-23,,,273600000,78900000,204400000,282600000,695300000,412700000,412700000,,-119000000,,,,68900000,2555000000,2142300000,1859700000,-139100000,,204700000,204400000,2276,CAG,quarterly
2020-12-31,,,-562872000,4741724000,-447605000,634495000,582876000,-350349000,-350349000,,-188679000,,,,-106904000,1395287000,1745636000,812411000,-212523000,,-455968000,-447605000,2290,MGM,quarterly
2020-09-30,,,-678705000,4899528000,-534731000,613730000,396403000,-511701000,-511701000,,-173808000,,,,-76734000,1093603000,1605304000,697200000,-167004000,,-601971000,-532954000,2290,MGM,quarterly
2020-06-30,,,-1206725000,5032788000,-857257000,562142000,-84561000,-945827000,-945827000,,-156756000,,,,-270238000,273612000,1219439000,358173000,-260898000,,-936487000,-825075000,2290,MGM,quarterly
2020-03-31,,,936823000,5247729000,806869000,673713000,814653000,-177472000,-177472000,,-157137000,,,,262304000,2154631000,2332103000,1339978000,1114295000,,674519000,806869000,2290,MGM,quarterly
2020-12-31,,,282902000,,217678000,1253000,487577000,297587000,297587000,73452000,-22010000,,,,65224000,914480000,616893000,426903000,-14685000,,217678000,217527000,2299,ATO,quarterly
2020-09-30,,,83389000,,65333000,-1866000,276811000,102711000,102711000,64220000,-15494000,,,,18056000,474914000,372203000,198103000,-19322000,,65333000,65297000,2299,ATO,quarterly
2020-06-30,,,126690000,,117791000,1685000,317463000,137350000,137350000,71324000,-19580000,,,,8899000,492995000,355645000,175532000,-10660000,,117791000,117703000,2299,ATO,quarterly
2020-03-31,,,306278000,,239646000,1685000,511958000,329753000,329753000,74604000,-22171000,,,,66632000,977665000,647912000,465707000,-23475000,,239646000,239468000,2299,ATO,quarterly
2020-12-31,,,276707000,,221025000,135844000,428979000,293135000,293135000,,-19465000,,,,55682000,1198947000,905812000,769968000,-16428000,,221025000,221025000,2302,AME,quarterly
2020-09-30,,,248075000,,204581000,128482000,394237000,265755000,265755000,,-21187000,,,,43494000,1126942000,861187000,732705000,-17680000,,204581000,204581000,2302,AME,quarterly
2020-06-30,,,206452000,,166217000,120424000,342727000,222303000,222303000,,-22669000,,,,40235000,1011922000,789619000,669195000,-15851000,,166217000,166217000,2302,AME,quarterly
2020-03-31,,,351075000,,280616000,153359000,421271000,267912000,267912000,,-22741000,,,,70459000,1202218000,934306000,780947000,83163000,,280616000,280616000,2302,AME,quarterly
2020-12-26,59300000,,832400000,1100000,654400000,219500000,1243000000,892500000,892500000,,-28100000,,,,179000000,1609800000,717300000,366800000,-60100000,,653400000,654400000,2317,HOLX,quarterly
2020-09-26,57000000,,617100000,2100000,494900000,224200000,1002400000,650100000,650100000,-2900000.0,-25000000,,,,123500000,1346900000,696800000,344500000,-33000000,,493600000,494900000,2317,HOLX,quarterly
2020-06-27,55100000,,168400000,3500000,137900000,208800000,529000000,192000000,192000000,-2900000.0,-27400000,,,,32000000,822900000,630900000,293900000,-23600000,,136400000,137900000,2317,HOLX,quarterly
2020-03-28,49300000,,118900000,5100000,96300000,177100000,458700000,159300000,159300000,-2900000.0,-31300000,,,,24100000,756100000,596800000,297400000,-40400000,,94800000,96300000,2317,HOLX,quarterly
2020-12-31,,,468000000,,316000000,851000000,1539000000,543000000,543000000,,-3000000,,,,152000000,4184000000,3641000000,2645000000,-75000000,,316000000,316000000,2349,CTSH,quarterly
2020-09-30,,,624000000,,348000000,804000000,1617000000,675000000,675000000,,-6000000,,,,276000000,4243000000,3568000000,2626000000,-51000000,,348000000,348000000,2349,CTSH,quarterly
2020-06-30,,,495000000,,361000000,711000000,1410000000,563000000,563000000,,-9000000,,,,134000000,4000000000,3437000000,2590000000,-68000000,,361000000,361000000,2349,CTSH,quarterly
2020-03-31,,,509000000,,367000000,711000000,1484000000,640000000,640000000,,-6000000,,,,142000000,4225000000,3585000000,2741000000,-131000000,,367000000,367000000,2349,CTSH,quarterly
2020-12-31,,,-225000000,8416000000,-5000000,-51000000,2424000000,1100000000,1100000000,431000000,-111000000,,,,-35000000,4395000000,3295000000,1971000000,-1325000000,,-190000000,-5000000,2359,NEE,quarterly
2020-09-30,,,1252000000,4940000000,1229000000,-50000000,2752000000,1069000000,1069000000,454000000,-208000000,,,,129000000,4785000000,3716000000,2033000000,183000000,,1123000000,1229000000,2359,NEE,quarterly
2020-06-30,,,1314000000,4792000000,1275000000,-47000000,2569000000,1216000000,1216000000,419000000,-320000000,,,,185000000,4204000000,2988000000,1635000000,98000000,,1129000000,1275000000,2359,NEE,quarterly
2020-03-31,,,73000000,4710000000,421000000,-52000000,2962000000,1760000000,1760000000,406000000,-1311000000,,,,-235000000,4613000000,2853000000,1651000000,-1687000000,,308000000,421000000,2359,NEE,quarterly
2020-12-31,,,194769000,,147807000,124516000,331318000,206802000,206802000,,-12500000,,,,46962000,4549452000,4342650000,4218134000,-12033000,,147807000,147807000,2366,CHRW,quarterly
2020-09-30,,,160774000,,136529000,118130000,286369000,168239000,168239000,,-11900000,,,,24245000,4224800000,4056561000,3938431000,-7465000,,136529000,136529000,2366,CHRW,quarterly
2020-06-30,,,178576000,,143939000,125183000,313970000,188787000,188787000,,-12400000,,,,34637000,3627846000,3439059000,3313876000,-10211000,,143939000,143939000,2366,CHRW,quarterly
2020-03-31,,,94212000,,78146000,128293000,237733000,109440000,109440000,,-12328000,,,,16066000,3805008000,3695568000,3567275000,-15228000,,78146000,78146000,2366,CHRW,quarterly
2021-01-31,,,252452000,,193440000,57719000,315940000,258221000,258221000,,-4849000,,,,59012000,617031000,358810000,301091000,-5769000,,193440000,193440000,2391,CPRT,quarterly
2020-10-31,,,246815000,,200285000,57216000,305810000,248594000,248594000,,-5032000,,,,46530000,592940000,344346000,287130000,-1779000,,200285000,200285000,2391,CPRT,quarterly
2020-07-31,,,201883000,,165533000,44716000,250431000,205715000,205715000,,-4902000,,,,36350000,525659000,319944000,275228000,-3832000,,165533000,165533000,2391,CPRT,quarterly
2020-04-30,,,191800000,,147487000,47512000,242613000,195101000,195101000,,-5803000,,,,44313000,550360000,355259000,307747000,-3301000,,147487000,147487000,2391,CPRT,quarterly
2020-12-31,,,537300000,1635300000,345300000,284900000,830000000,486900000,486900000,,-29700000,,,,142500000,1995100000,1508200000,1165100000,50400000,,394800000,330700000,2409,BEN,quarterly
2020-09-30,,,199600000,1401200000,78900000,231900000,679000000,409800000,409800000,,-15700000,,,,73100000,1627400000,1217600000,948400000,-210200000,,126500000,63600000,2409,BEN,quarterly
2020-06-30,,,269800000,1603300000,290400000,165400000,384500000,202400000,202400000,,-54500000,,,,16100000,1188100000,985700000,803600000,67400000,,253700000,296100000,2409,BEN,quarterly
2020-03-31,,,102900000,1059200000,79100000,192600000,548700000,356100000,356100000,,-4200000,,,,44100000,1338300000,982200000,789600000,-430600000,,58800000,79100000,2409,BEN,quarterly
2020-12-31,446100000,,317500000,,255800000,153400000,966600000,367100000,367100000,,-63700000,,,,61700000,1505300000,1138200000,538700000,-49600000,,255800000,255800000,2437,ROP,quarterly
2020-09-30,446100000,,303100000,,234400000,508300000,875900000,367600000,367600000,,-62300000,,,,68700000,1366100000,998500000,490200000,-64500000,,234400000,234400000,2437,ROP,quarterly
2020-06-30,446100000,,284100000,,219200000,496500000,843700000,347200000,347200000,,-47500000,,,,64900000,1305000000,957800000,461300000,-63100000,,219200000,219200000,2437,ROP,quarterly
2020-03-31,446100000,,304600000,,240300000,507600000,856800000,349200000,349200000,,-45400000,,,,64300000,1350700000,1001500000,493900000,-44600000,,240300000,240300000,2437,ROP,quarterly
2020-12-31,,,427000000,4000000,629000000,1147000000,1776000000,513000000,513000000,,-46000000,,,,-203000000,41541000000,41028000000,39765000000,-86000000,,630000000,629000000,2448,CAH,quarterly
2020-09-30,,,-663000000,3000000,-253000000,1137000000,1715000000,460000000,460000000,,-45000000,,,,-410000000,39065000000,38605000000,37350000000,-1123000000,,-253000000,-253000000,2448,CAH,quarterly
2020-06-30,,,815000000,3000000,656000000,1137000000,1590000000,326000000,326000000,,-49000000,,,,158000000,36689000000,36363000000,35099000000,489000000,,657000000,656000000,2448,CAH,quarterly
2020-03-31,,,478000000,3000000,350000000,1165000000,1885000000,591000000,591000000,,-60000000,,,,127000000,39157000000,38566000000,37272000000,-113000000,,351000000,350000000,2448,CAH,quarterly
2021-01-02,,,616000000,143000000,467000000,475000000,1297000000,822000000,822000000,,-110000000,,,,144000000,10460000000,9638000000,9163000000,-206000000,,472000000,467000000,2473,TSN,quarterly
2020-10-03,,,781000000,132000000,613000000,678000000,1807000000,1129000000,1129000000,,-124000000,,,,165000000,11460000000,10331000000,9653000000,-348000000,,616000000,613000000,2473,TSN,quarterly
2020-06-27,,,667000000,146000000,527000000,509000000,1628000000,1119000000,1119000000,,-122000000,,,,140000000,10022000000,8903000000,8394000000,-452000000,,527000000,527000000,2473,TSN,quarterly
2020-03-28,,,491000000,145000000,364000000,411000000,1017000000,606000000,606000000,,-119000000,,,,124000000,10888000000,10282000000,9871000000,-115000000,,367000000,364000000,2473,TSN,quarterly
2021-01-03,,,189565000,,151897000,138404000,382448000,244044000,244044000,,-54479000,,,,37668000,1356567000,1112523000,974119000,-54479000,,151897000,151897000,2496,DPZ,quarterly
2020-09-06,,,123773000,,99129000,91652000,253833000,162181000,162181000,,-38605000,,,,24644000,967719000,805538000,713886000,-38408000,,99129000,99129000,2496,DPZ,quarterly
2020-06-14,,,124496000,,118668000,88068000,251651000,163583000,163583000,,-39727000,,,,5828000,920023000,756440000,668372000,-39087000,,118668000,118668000,2496,DPZ,quarterly
2020-03-22,,,117296000,,121602000,88489000,244323000,155834000,155834000,,-39470000,,,,-4306000,873102000,717268000,628779000,-38538000,,121602000,121602000,2496,DPZ,quarterly
2021-01-30,,,1043000000,,816000000,2368000000,3530000000,1162000000,1162000000,,-9000000,,,,227000000,16937000000,15775000000,13407000000,-119000000,,816000000,816000000,2507,BBY,quarterly
2020-10-31,,,555000000,,391000000,2103000000,2831000000,708000000,708000000,,-11000000,,,,164000000,11853000000,11145000000,9022000000,-153000000,,391000000,391000000,2507,BBY,quarterly
2020-08-01,,,561000000,,432000000,1682000000,2270000000,568000000,568000000,,-15000000,,,,129000000,9910000000,9342000000,7640000000,-7000000,,432000000,432000000,2507,BBY,quarterly
2020-05-02,,,218000000,,159000000,1716000000,1965000000,230000000,230000000,,-17000000,,,,59000000,8562000000,8332000000,6597000000,-12000000,,159000000,159000000,2507,BBY,quarterly
2020-12-31,,,1185000000,,1002000000,614000000,1850000000,1236000000,1236000000,,-132000000,,,,183000000,10481000000,9245000000,8631000000,-51000000,,1002000000,1002000000,2538,GD,quarterly
2020-09-27,,,978000000,,834000000,480000000,1595000000,1115000000,1115000000,,-118000000,,,,144000000,9431000000,8316000000,7836000000,-137000000,,834000000,834000000,2538,GD,quarterly
2020-06-28,,,727000000,,625000000,534000000,1415000000,881000000,881000000,,-132000000,,,,102000000,9264000000,8383000000,7849000000,-154000000,,625000000,625000000,2538,GD,quarterly
2020-03-29,,,848000000,,706000000,508000000,1488000000,980000000,980000000,,-107000000,,,,142000000,8749000000,7769000000,7261000000,-132000000,,706000000,706000000,2538,GD,quarterly
2021-01-30,,,1155365000,,860331000,1034319000,2306920000,1272601000,1272601000,,-116690000,,,,295034000,4817940000,3545339000,2511020000,-117236000,,860331000,860331000,2566,LB,quarterly
2020-10-31,,,410000000,4000000.0,331000000,808000000,1359000000,551000000,551000000,,-121000000,,,,79000000,3055000000,2504000000,1696000000,-141000000,,331000000,331000000,2566,LB,quarterly
2020-08-01,,,-60000000,4000000.0,-49000000,586000000,792000000,206000000,206000000,,-104000000,,,,-11000000,2319000000,2113000000,1527000000,-266000000,,-49000000,-49000000,2566,LB,quarterly
2020-05-02,,,-412000000,3000000.0,-297000000,658000000,385000000,-221000000,-221000000,-52000000.0,-97000000,,,,-115000000,1654000000,1875000000,1269000000,-191000000,,-297000000,-297000000,2566,LB,quarterly
2020-12-31,,,-349000000,4000000,-224000000,127000000,242000000,102000000,102000000,-49000000,-113000000,,,,-124000000,384000000,282000000,142000000,-451000000,,-225000000,-224000000,2632,HLT,quarterly
2020-09-30,,,-114000000,5000000,-79000000,69000000,241000000,17000000,17000000,65000000,-116000000,,,,-33000000,385000000,368000000,144000000,-131000000,,-81000000,-79000000,2632,HLT,quarterly
2020-06-30,,,-444000000,8000000,-430000000,66000000,81000000,-252000000,-252000000,179000000,-106000000,,,,-12000000,176000000,428000000,95000000,-192000000,,-432000000,-430000000,2632,HLT,quarterly
2020-03-31,,,-17000000,10000000,18000000,60000000,416000000,180000000,180000000,85000000,-94000000,,,,-35000000,655000000,475000000,239000000,-197000000,,18000000,18000000,2632,HLT,quarterly
2020-12-31,,,-4288000000,12000000,-3347000000,,-2059000000,-5493000000,-5493000000,2722000000,-175000000,,,,-941000000,24896000000,30389000000,26955000000,1205000000,,-3347000000,-3347000000,2653,UPS,quarterly
2020-09-30,,,2525000000,14000000,1957000000,,4999000000,2746000000,2746000000,1576000000,-176000000,,,,568000000,21238000000,18492000000,16239000000,-221000000,,1957000000,1957000000,2653,UPS,quarterly
2020-06-30,,,2357000000,13000000,1768000000,,4902000000,2717000000,2717000000,1524000000,-183000000,,,,589000000,20459000000,17742000000,15557000000,-360000000,,1768000000,1768000000,2653,UPS,quarterly
2020-03-31,,,1250000000,14000000,965000000,,3652000000,1444000000,1444000000,1560000000,-167000000,,,,285000000,18035000000,16591000000,14383000000,-194000000,,965000000,965000000,2653,UPS,quarterly
2020-12-31,,,527882000,185674000,374845000,735068000,1452230000,617609000,617609000,,-34578000,,,,149175000,52516556000,51898947000,51064326000,-89727000,,378707000,374845000,2669,ABC,quarterly
2020-09-30,,,-6143457000,179288000,-4846072000,671028000,1346317000,577952000,577952000,,-35761000,,,,-1298952000,49244768000,48666816000,47898451000,-6721409000,,-4844505000,-4846072000,2669,ABC,quarterly
2020-06-30,,,343835000,110699000,289439000,666885000,1226148000,463848000,463848000,,-39177000,,,,56567000,45366777000,44902929000,44140629000,-120013000,,287268000,289439000,2669,ABC,quarterly
2020-03-31,,,276203000,114523000,960277000,693413000,1393042000,605834000,605834000,,-41982000,,,,-694908000,47417639000,46811805000,46024597000,-329631000,,971111000,960277000,2669,ABC,quarterly
2020-12-31,40000000,,397000000,631000000,251000000,481000000,993000000,475000000,475000000,-3000000,-37000000,,,,118000000,3493000000,3018000000,2500000000,-78000000,,279000000,251000000,2673,OTIS,quarterly
2020-09-30,37000000,,413000000,641000000,266000000,453000000,988000000,511000000,511000000,-13000000,-39000000,,,,103000000,3268000000,2757000000,2280000000,-98000000,,310000000,266000000,2673,OTIS,quarterly
2020-06-30,37000000,,374000000,666000000,224000000,379000000,901000000,486000000,486000000,-1000000,-51000000,,,,109000000,3029000000,2543000000,2128000000,-112000000,,265000000,224000000,2673,OTIS,quarterly
2020-03-31,38000000,,327000000,632000000,165000000,456000000,897000000,393000000,393000000,10000000,-5000000,,,,125000000,2966000000,2573000000,2069000000,-66000000,,202000000,165000000,2673,OTIS,quarterly
2020-12-31,,,166418000,71476000,168816000,13196000,194057000,83053000,83053000,5454000,-24048000,,,,-3946000,269241000,186188000,75184000,83365000,,170364000,168433000,2676,DRE,quarterly
2020-09-30,,,71520000,70428000,71823000,11439000,183094000,77229000,77229000,5830000,-23059000,,,,-956000,264956000,187727000,81862000,-5709000,40000.0,72476000,71471000,2676,DRE,quarterly
2020-06-30,,,40047000,69596000,39820000,11506000,176515000,72725000,72725000,5580000,-22841000,,,,-150000,241241000,168516000,64726000,-32678000,23000.0,40197000,39464000,2676,DRE,quarterly
2020-03-31,,,19552000,67219000,19456000,21763000,166770000,56011000,56011000,3637000,-23494000,,,,-60000,228908000,172897000,62138000,-36459000,48000.0,19612000,19100000,2676,DRE,quarterly
2020-12-31,,,712000000,243000000,539000000,960000000,1710000000,815000000,815000000,-65000000,-64000000,,,,166000000,4836000000,4021000000,3126000000,-103000000,,546000000,539000000,2683,KMB,quarterly
2020-09-30,,,597000000,242000000,472000000,885000000,1697000000,783000000,783000000,29000000,-62000000,,,,114000000,4683000000,3900000000,2986000000,-186000000,,483000000,472000000,2683,KMB,quarterly
2020-06-30,,,891000000,227000000,681000000,817000000,1837000000,1000000000,1000000000,20000000,-65000000,,,,199000000,4612000000,3612000000,2775000000,-109000000,,692000000,681000000,2683,KMB,quarterly
2020-03-31,,,872000000,213000000,660000000,850000000,1861000000,1001000000,1001000000,10000000,-61000000,,,,197000000,5009000000,4008000000,3148000000,-129000000,,675000000,660000000,2683,KMB,quarterly
2020-12-31,100000000,,345000000,126000000,272000000,916000000,1651000000,428000000,428000000,82000000,-31000000,,,,67000000,3757000000,3329000000,2106000000,-83000000,,278000000,272000000,2684,PPG,quarterly
2020-09-30,92000000,,572000000,114000000,442000000,836000000,1659000000,578000000,578000000,21000000,-34000000,,,,124000000,3685000000,3107000000,2026000000,-6000000,,448000000,442000000,2684,PPG,quarterly
2020-06-30,86000000,,126000000,106000000,102000000,766000000,1312000000,320000000,320000000,17000000,-41000000,,,,29000000,3015000000,2695000000,1703000000,-194000000,3000000.0,97000000,102000000,2684,PPG,quarterly
2020-03-31,101000000,,319000000,114000000,243000000,881000000,1477000000,356000000,356000000,10000000,-32000000,,,,71000000,3377000000,3021000000,1900000000,-37000000,3000000.0,248000000,243000000,2684,PPG,quarterly
2020-12-31,,,197000000,581000000,158000000,-28000000,728000000,380000000,380000000,95000000,-140000000,,,,35000000,1798000000,1418000000,1070000000,-183000000,,162000000,158000000,2689,CMS,quarterly
2020-09-30,,,254000000,578000000,218000000,-29000000,672000000,398000000,398000000,75000000,-144000000,,,,44000000,1575000000,1177000000,903000000,-144000000,,210000000,218000000,2689,CMS,quarterly
2020-06-30,,,164000000,37000000,136000000,-30000000,571000000,303000000,303000000,75000000,-141000000,,,,27000000,1443000000,1140000000,872000000,-139000000,,137000000,136000000,2689,CMS,quarterly
2020-03-31,,,270000000,37000000,243000000,-31000000,798000000,399000000,399000000,114000000,-138000000,,,,27000000,1864000000,1465000000,1066000000,-129000000,,243000000,243000000,2689,CMS,quarterly
2020-12-31,57000000,,25000000,85000000,32000000,383000000,527000000,87000000,87000000,,-52000000,,,,-9000000,2186000000,2099000000,1659000000,-62000000,,34000000,32000000,2698,EMN,quarterly
2020-09-30,56000000,,190000000,81000000,161000000,135000000,508000000,317000000,317000000,,-54000000,,,,25000000,2122000000,1805000000,1614000000,-127000000,,165000000,161000000,2698,EMN,quarterly
2020-06-30,52000000,,-1000000,77000000,27000000,125000000,371000000,194000000,194000000,,-55000000,,,,-31000000,1924000000,1730000000,1553000000,-195000000,,30000000,27000000,2698,EMN,quarterly
2020-03-31,61000000,,316000000,75000000,258000000,130000000,577000000,386000000,386000000,,-53000000,,,,56000000,2241000000,1855000000,1664000000,-70000000,,260000000,258000000,2698,EMN,quarterly
2020-12-31,38400000,,118300000,30400000,87900000,232300000,526500000,185000000,185000000,,-48600000,,,,31500000,2023700000,1838700000,1497200000,-66700000,,86800000,87700000,2716,WAB,quarterly
2020-09-30,36500000,,175400000,35500000,128100000,238200000,571200000,226200000,226200000,,-45600000,,,,46900000,1865100000,1638900000,1293900000,-50800000,,128500000,127900000,2716,WAB,quarterly
2020-06-30,38200000,,114300000,35000000,86800000,187500000,503700000,205700000,205700000,,-51400000,,,,28500000,1737400000,1531700000,1233700000,-91400000,,85800000,86600000,2716,WAB,quarterly
2020-03-31,49000000,,149200000,35900000,111600000,225000000,578700000,235700000,235700000,,-53300000,,,,38000000,1929900000,1694200000,1351200000,-86500000,,111200000,111600000,2716,WAB,quarterly
2020-12-31,,,553000000,,431000000,-63000000,761000000,495000000,495000000,,-147000000,,,,122000000,2402000000,1907000000,1641000000,58000000,,431000000,431000000,2718,PEG,quarterly
2020-09-30,,,696000000,,575000000,-62000000,828000000,573000000,573000000,,-149000000,,,,121000000,2370000000,1797000000,1542000000,123000000,,575000000,575000000,2718,PEG,quarterly
2020-06-30,,,560000000,,451000000,-62000000,722000000,469000000,469000000,,-151000000,,,,109000000,2050000000,1581000000,1328000000,91000000,,451000000,451000000,2718,PEG,quarterly
2020-03-31,,,492000000,,448000000,-62000000,1121000000,859000000,859000000,,-153000000,,,,44000000,2781000000,1922000000,1660000000,-367000000,,448000000,448000000,2718,PEG,quarterly
2020-12-31,,,249899000,39659000,181012000,814992000,1170496000,284065000,284065000,,-25432000,,,,68708000,2953888000,2669823000,1783392000,-34166000,543000,181191000,181012000,2723,LKQ,quarterly
2020-09-30,,,272441000,51475000,193483000,817958000,1199375000,312762000,312762000,,-27878000,,,,78510000,3047684000,2734922000,1848309000,-40321000,543000,193931000,193483000,2723,LKQ,quarterly
2020-06-30,,,160362000,53512000,118792000,740093000,1016669000,210829000,210829000,,-28412000,,,,41869000,2626323000,2415494000,1609654000,-50467000,277000,118493000,118792000,2723,LKQ,quarterly
2020-03-31,,,207305000,53561000,145136000,900165000,1213872000,248212000,248212000,,-28482000,,,,60411000,3000935000,2752723000,1787063000,-40907000,-1018000,146894000,145136000,2723,LKQ,quarterly
2020-12-31,,,208300000,2600000,183000000,86300000,326200000,239300000,239300000,600000,-28400000,,,,25200000,1110900000,871600000,784700000,-31000000,,183100000,182900000,2726,MLM,quarterly
2020-09-30,,,375900000,2500000,294400000,68200000,404600000,334000000,334000000,2400000,-28700000,,,,81500000,1240700000,906700000,836100000,41900000,,294400000,294100000,2726,MLM,quarterly
2020-06-30,,,279000000,2500000,217600000,69500000,382100000,308600000,308600000,4000000,-31200000,,,,61400000,1189500000,880900000,807400000,-29600000,,217600000,217400000,2726,MLM,quarterly
2020-03-31,,,26000000,2500000,25900000,76700000,143600000,60100000,60100000,6800000,-29800000,,,,100000,891000000,830900000,747400000,-34100000,,25900000,25900000,2726,MLM,quarterly
2020-12-31,,,399407000,14995000,312150000,11161000,1072320000,467718000,467718000,593441000,-35663000,,,,86917000,2312471000,1844753000,1240151000,-68311000,,312490000,312150000,2807,WRB,quarterly
2020-09-30,,,206414000,44560000,151678000,11016000,840151000,251260000,251260000,577875000,-39768000,,,,54048000,2039819000,1788559000,1199668000,-44846000,,152366000,151678000,2807,WRB,quarterly
2020-06-30,,,105449000,44275000,71260000,10878000,724662000,136440000,136440000,577344000,-38373000,,,,33793000,1936026000,1799586000,1211364000,-30991000,,71656000,71260000,2807,WRB,quarterly
2020-03-31,,,-6468000,44069000,-4418000,11236000,608600000,8725000,8725000,588639000,-36734000,,,,-2942000,1810610000,1801885000,1202010000,-15193000,,-3526000,-4418000,2807,WRB,quarterly
2020-12-27,375172000,,979783000,,869229000,218899000,1603795000,1009724000,1009724000,,-52551000,,,,110554000,3456237000,2446513000,1852442000,-29941000,,869229000,869229000,2817,LRCX,quarterly
2020-09-27,355367000,,922272000,,823451000,189748000,1506179000,961064000,961064000,,-52115000,,,,98821000,3177080000,2216016000,1670901000,-38792000,,823451000,823451000,2817,LRCX,quarterly
2020-06-28,338810000,,748169000,,696673000,185800000,1280332000,755722000,755722000,,-49250000,,,,51496000,2791864000,2036142000,1511532000,-7553000,,696673000,696673000,2817,LRCX,quarterly
2020-03-29,307914000,,629495000,,574781000,164979000,1167007000,694114000,694114000,,-41580000,,,,54714000,2503625000,1809511000,1336618000,-64619000,,574781000,574781000,2817,LRCX,quarterly
2020-12-31,,,700700000,316200000,593300000,382000000,646500000,264500000,264500000,,-22600000,,,,110300000,1565300000,1300800000,918800000,436200000,,590400000,592600000,2861,ROK,quarterly
2020-09-30,,,299600000,319000000,262700000,365800000,639300000,273500000,273500000,,-26200000,,,,35900000,1570000000,1296500000,930700000,26100000,,263700000,262400000,2861,ROK,quarterly
2020-06-30,,,334500000,318600000,317800000,378100000,554200000,176100000,176100000,,-25400000,,,,20300000,1394000000,1217900000,839800000,158400000,,314200000,317500000,2861,ROK,quarterly
2020-03-31,,,167400000,317100000,132200000,360700000,698800000,338100000,338100000,,-25500000,,,,37500000,1681300000,1343200000,982500000,-170700000,,129900000,132200000,2861,ROK,quarterly
2021-01-03,56823000,,473091000,,380361000,258193000,836038000,521022000,521022000,,-12404000,,,,92657000,1354606000,833584000,518568000,-47931000,-73000,380434000,380361000,2880,PKI,quarterly
2020-10-04,50131000,,233757000,,176699000,220810000,527745000,256804000,256804000,,-12057000,,,,57021000,964025000,707221000,436280000,-23047000,-37000,176736000,176699000,2880,PKI,quarterly
2020-07-05,49521000,,164827000,,137162000,220547000,447744000,177676000,177676000,,-11586000,,,,27614000,811718000,634042000,363974000,-12849000,-51000,137213000,137162000,2880,PKI,quarterly
2020-04-05,48914000,,34689000,,33665000,206394000,309111000,53803000,53803000,,-13665000,,,,974000,652396000,598593000,343285000,-19114000,-50000,33715000,33665000,2880,PKI,quarterly
2020-11-21,,,569046000,,442433000,1060392000,1675617000,615225000,615225000,,-46179000,,,,126613000,3154261000,2539036000,1478644000,-46179000,,442433000,442433000,2892,AZO,quarterly
2020-08-29,,,952408000,,740457000,1386030000,2412975000,1026945000,1026945000,,-71326000,,,,211951000,4545968000,3519023000,2132993000,-74537000,,740457000,740457000,2892,AZO,quarterly
2020-05-09,,,444223000,,342896000,923975000,1490648000,566673000,566673000,,-47450000,,,,101327000,2779299000,2212626000,1288651000,-122450000,,342896000,342896000,2892,AZO,quarterly
2020-02-15,,,363603000,,299282000,958125000,1366063000,407938000,407938000,,-44335000,,,,64321000,2513663000,2105725000,1147600000,-44335000,,299282000,299282000,2892,AZO,quarterly
2021-01-31,,,361500000,,261500000,371700000,809400000,407900000,407900000,-27200000,-43500000,,,,100000000,2076700000,1668800000,1267300000,-46400000,,261500000,261500000,2919,SJM,quarterly
2020-10-31,,,303500000,,230800000,388000000,818200000,375600000,375600000,-4900000,-45100000,,,,72700000,2034000000,1658400000,1215800000,-72100000,,230800000,230800000,2919,SJM,quarterly
2020-07-31,,,313600000,,237000000,360700000,775400000,357900000,357900000,-2800000,-46100000,,,,76600000,1971800000,1613900000,1196400000,-44300000,,237000000,237000000,2919,SJM,quarterly
2020-04-30,,,298400000,,226300000,373400000,788400000,353300000,353300000,1800000,-45600000,,,,72100000,2092000000,1738700000,1303600000,-54900000,,226300000,226300000,2919,SJM,quarterly
2020-12-31,,,499929000,,392945000,937866000,1472138000,534272000,534272000,,-38349000,,,,106984000,2828773000,2294501000,1356635000,-34343000,,392945000,392945000,2920,ORLY,quarterly
2020-09-30,,,686406000,,527252000,955455000,1680468000,725013000,725013000,,-41668000,,,,159154000,3207638000,2482625000,1527170000,-38607000,,527252000,527252000,2920,ORLY,quarterly
2020-06-30,,,700410000,,531667000,900690000,1637180000,736490000,736490000,,-41723000,,,,168743000,3091595000,2355105000,1454415000,-36080000,,531667000,531667000,2920,ORLY,quarterly
2020-03-31,,,379660000,,300438000,872345000,1295906000,423561000,423561000,,-39386000,,,,79222000,2476487000,2052926000,1180581000,-43901000,,300438000,300438000,2920,ORLY,quarterly
2020-12-31,284297000,,13360000,,16648000,668999000,971226000,17930000,17930000,,-7708000,,,,-3288000,1250330000,1232400000,279104000,-4570000,,16648000,16648000,2965,NOW,quarterly
2020-09-30,268292000,,25433000,,12858000,562644000,900268000,69332000,69332000,,-7980000,,,,12575000,1151972000,1082640000,251704000,-43899000,,12858000,12858000,2965,NOW,quarterly
2020-06-30,245081000,,62030000,,40766000,530556000,837903000,62266000,62266000,,-8488000,,,,21264000,1070842000,1008576000,232939000,-236000,,40766000,40766000,2965,NOW,quarterly
2020-03-31,226657000,,48362000,,48231000,546982000,822974000,49335000,49335000,,-8570000,,,,131000,1046340000,997005000,223366000,-973000,,48231000,48231000,2965,NOW,quarterly
2020-10-31,,,99894000,,74798000,416378000,545519000,124901000,124901000,,-1383000,,,,25096000,1552033000,1427132000,1006514000,-25007000,,74798000,74798000,3010,ULTA,quarterly
2020-08-01,,,10138000,,8052000,271587000,329007000,53513000,53513000,,-2617000,,,,2086000,1228009000,1174496000,899002000,-43375000,,8052000,8052000,3010,ULTA,quarterly
2020-05-02,,,-102756000,,-78509000,380912000,303605000,-81942000,-81942000,,-1272000,,,,-24247000,1173210000,1255152000,869605000,-20814000,,-78509000,-78509000,3010,ULTA,quarterly
2020-02-01,,,288195000,,222719000,618215000,909558000,287756000,287756000,,-1272000,,,,65476000,2305918000,2018162000,1396360000,439000,,222719000,222719000,3010,ULTA,quarterly
2021-01-31,357468000,,177104000,4646000,162345000,248116000,774208000,148348000,148348000,,-739000,,,,15076000,970321000,821973000,196113000,28756000,,162028000,162345000,3036,SNPS,quarterly
2020-10-31,339566000,,191566000,4963000,197455000,256295000,812610000,195745000,195745000,,-750000,,,,-4989000,1025439000,829694000,212829000,-4179000,,196555000,197455000,3036,SNPS,quarterly
2020-07-31,322602000,,236854000,5392000,252911000,229972000,784844000,208621000,208621000,,-941000,,,,-16057000,964134000,755513000,179290000,28233000,,252911000,252911000,3036,SNPS,quarterly
2020-04-30,302571000,,110166000,5863000,109920000,208674000,690907000,155567000,155567000,,-1846000,,,,246000,861327000,705760000,170420000,-45401000,,109920000,109920000,3036,SNPS,quarterly
2021-01-29,,,1320000000,,978000000,4541000000,6456000000,1524000000,1524000000,,-204000000,,,,342000000,20311000000,18787000000,13855000000,-204000000,,978000000,973000000,3060,LOW,quarterly
2020-10-30,,,894000000,,692000000,4770000000,7300000000,2175000000,2175000000,,-227000000,,,,202000000,22309000000,20134000000,15009000000,-1281000000,,692000000,689000000,3060,LOW,quarterly
2020-07-31,,,3738000000,,2828000000,5020000000,9304000000,3957000000,3957000000,,-227000000,,,,910000000,27302000000,23345000000,17998000000,-219000000,,2828000000,2816000000,3060,LOW,quarterly
2020-05-01,,,1786000000,,1337000000,4196000000,6513000000,1991000000,1991000000,,-210000000,,,,449000000,19675000000,17684000000,13162000000,-205000000,,1337000000,1333000000,3060,LOW,quarterly
2020-12-31,,,2541000000,40000000,1924000000,522000000,3166000000,2626000000,2626000000,,-315000000,,,,619000000,5055000000,2429000000,1889000000,-85000000,,1922000000,1924000000,3130,MO,quarterly
2020-09-30,,,-324000000,132000000,-952000000,520000000,3718000000,3198000000,3198000000,,-318000000,,,,632000000,5678000000,2480000000,1960000000,-3522000000,,-956000000,-953000000,3130,MO,quarterly
2020-06-30,,,2565000000,136000000,1943000000,446000000,3339000000,2893000000,2893000000,,-318000000,,,,627000000,5062000000,2169000000,1723000000,-328000000,,1938000000,1940000000,3130,MO,quarterly
2020-03-31,,,2108000000,132000000,1552000000,488000000,3265000000,2777000000,2777000000,,-287000000,,,,558000000,5046000000,2269000000,1781000000,-669000000,,1550000000,1550000000,3130,MO,quarterly
2020-12-26,573000000,,549000000,,1781000000,308000000,1451000000,570000000,570000000,,-9000000,,,,-1232000000,3244000000,2674000000,1793000000,-21000000,,1781000000,1781000000,3152,AMD,quarterly
2020-09-26,508000000,,402000000,,390000000,273000000,1230000000,449000000,449000000,,-11000000,,,,12000000,2801000000,2352000000,1571000000,-47000000,,390000000,390000000,3152,AMD,quarterly
2020-06-27,460000000,,161000000,,157000000,215000000,848000000,173000000,173000000,,-14000000,,,,4000000,1932000000,1759000000,1084000000,-12000000,,157000000,157000000,3152,AMD,quarterly
2020-03-28,442000000,,168000000,,162000000,199000000,818000000,177000000,177000000,,-13000000,,,,6000000,1786000000,1609000000,968000000,-9000000,,162000000,162000000,3152,AMD,quarterly
2020-12-31,27056000,,195166000,,156216000,85569000,367726000,232671000,232671000,,-37330000,,,,38950000,443661000,210990000,75935000,-37505000,,156216000,156216000,3156,MSCI,quarterly
2020-09-30,24901000,,189043000,,182358000,80281000,354629000,227620000,227620000,,-37536000,,,,6685000,425333000,197713000,70704000,-38577000,,182358000,182358000,3156,MSCI,quarterly
2020-06-30,22534000,,139167000,,115123000,79926000,339160000,215175000,215175000,,-41227000,,,,24044000,409616000,194441000,70456000,-76008000,,115123000,115123000,3156,MSCI,quarterly
2020-03-31,26562000,,162849000,,148125000,86382000,342171000,207884000,207884000,,-40231000,,,,14724000,416780000,208896000,74609000,-45035000,,148125000,148125000,3156,MSCI,quarterly
2020-11-29,,,885300000,890300000,688400000,771200000,1721600000,950400000,950400000,,-100600000,,,,189400000,4719400000,3769000000,2997800000,-65100000,,695900000,688400000,3160,GIS,quarterly
2020-08-30,,,817200000,898200000,638900000,702900000,1590900000,888000000,888000000,,-111100000,,,,170800000,4364000000,3476000000,2773100000,-70800000,,646400000,638900000,3160,GIS,quarterly
2020-05-31,,,766600000,835600000,625700000,905000000,1770000000,865000000,865000000,,-124600000,,,,139600000,5023000000,4158000000,3253000000,-98400000,,627000000,625700000,3160,GIS,quarterly
2020-02-23,,,582100000,823600000,454100000,716300000,1410200000,693900000,693900000,,-109800000,,,,118200000,4180300000,3486400000,2770100000,-111800000,,463900000,454100000,3160,GIS,quarterly
2020-09-30,,,37930000000,4060000000,30137000000,,38665000000,38665000000,38665000000,,-1000000000,,,,7517000000,63024000000,24359000000,24359000000,-735000000,,30413000000,30137000000,3164,BRK-B,quarterly
2020-06-30,,,35409000000,3758000000,26295000000,,47302000000,47302000000,47302000000,,-1002000000,,,,9002000000,56840000000,9538000000,9538000000,-11893000000,,26407000000,26295000000,3164,BRK-B,quarterly
2020-03-31,,,-63049000000,3670000000,-49746000000,,-62325000000,-62325000000,-62325000000,,-1024000000,,,,-13352000000,61265000000,123590000000,123590000000,-724000000,,-49697000000,-49746000000,3164,BRK-B,quarterly
2019-12-31,,,36801000000,3772000000,29159000000,,37554000000,37554000000,37554000000,,-993000000,,,,7571000000,65635000000,28081000000,28081000000,-753000000,,29230000000,29159000000,3164,BRK-B,quarterly
2021-01-02,290309000,,186189000,,173738000,195766000,686373000,195523000,195523000,,-4873000,,,,12451000,759909000,564386000,73536000,-9334000,,173738000,173738000,3208,CDNS,quarterly
2020-09-26,250934000,,165713000,,161630000,159666000,584323000,169285000,169285000,,-5325000,,,,4083000,666607000,497322000,82284000,-3572000,,161630000,161630000,3208,CDNS,quarterly
2020-06-27,250821000,,150666000,,131288000,156117000,563203000,151675000,151675000,,-5914000,,,,19378000,638418000,486743000,75215000,-1009000,,131288000,131288000,3208,CDNS,quarterly
2020-03-28,241668000,,130180000,,123988000,159336000,543494000,138284000,138284000,,-4637000,,,,6192000,617957000,479673000,74463000,-8104000,,123988000,123988000,3208,CDNS,quarterly
2020-12-31,100000000,,195600000,5200000,333700000,807200000,1433700000,373900000,373900000,,-53100000,,,,-138200000,2085300000,1711400000,651600000,-178300000,,333800000,333700000,3210,ZBH,quarterly
2020-09-30,85900000,,255800000,6000000,242500000,772300000,1362200000,354300000,354300000,,-54000000,,,,9700000,1929300000,1575000000,567100000,-98500000,,246100000,242500000,3210,ZBH,quarterly
2020-06-30,87700000,,-221900000,2500000,-206600000,666400000,803000000,-98800000,-98800000,,-54000000,,,,-13700000,1226100000,1324900000,423100000,-123100000,,-208200000,-206600000,3210,ZBH,quarterly
2020-03-31,98400000,,-503900000,4100000,-508500000,749100000,1296700000,301600000,301600000,,-50900000,,,,5200000,1783800000,1482200000,487100000,-805500000,,-509100000,-508500000,3210,ZBH,quarterly
2020-12-31,,,278000000,,215000000,441000000,751000000,0,292000000,18000000,,,,,63000000,751000000,459000000,0,-14000000,,215000000,209000000,3214,CMA,quarterly
2020-09-30,,,259000000,,211000000,415000000,705000000,0,272000000,18000000,,,,,48000000,705000000,433000000,0,-13000000,,211000000,203000000,3214,CMA,quarterly
2020-06-30,,,140000000,,113000000,407000000,580000000,0,153000000,20000000,,,,,27000000,580000000,427000000,0,-13000000,,113000000,112000000,3214,CMA,quarterly
2020-03-31,,,-86000000,,-65000000,392000000,339000000,0,-76000000,23000000,,,,,-21000000,339000000,415000000,0,-10000000,,-65000000,-65000000,3214,CMA,quarterly
2020-12-31,15801000,,71352000,,72991000,27023000,121938000,79114000,79114000,,-5901000,,,,-1639000,264839000,185725000,142901000,-7762000,,72991000,72991000,3221,ENPH,quarterly
2020-09-30,15052000,,44845000,,39362000,28170000,94981000,51759000,51759000,,-5993000,,,,5483000,178503000,126744000,83522000,-6914000,,39362000,39362000,3221,ENPH,quarterly
2020-06-30,13192000,,-53855000,,-47294000,24341000,48387000,10854000,10854000,,-5952000,,,,-6561000,125538000,114684000,77151000,-64709000,,-47294000,-47294000,3221,ENPH,quarterly
2020-03-31,11876000,,57068000,,68936000,24087000,80675000,44712000,44712000,,-3155000,,,,-11868000,205545000,160833000,124870000,12356000,,68936000,68936000,3221,ENPH,quarterly
2020-12-31,,,210700000,,163600000,363200000,618100000,244000000,244000000,,-19500000,,,,47100000,1659700000,1415700000,1041600000,-33300000,,163600000,163600000,3232,FBHS,quarterly
2020-09-30,,,219800000,,164600000,327800000,580600000,242300000,242300000,,-20100000,,,,54000000,1652100000,1409800000,1071500000,-22500000,,165800000,164600000,3232,FBHS,quarterly
2020-06-30,,,154000000,1300000.0,115800000,276200000,482900000,196400000,196400000,,-22200000,,,,37800000,1375800000,1179400000,892900000,-42400000,,116200000,115800000,3232,FBHS,quarterly
2020-03-31,,,138700000,900000.0,109100000,313300000,493400000,169800000,169800000,,-22100000,,,,29900000,1402700000,1232900000,909300000,-31100000,,108800000,109100000,3232,FBHS,quarterly
2020-12-31,127000000,,1176000000,326000000,884000000,874000000,1300000000,263000000,263000000,36000000,-85000000,,,,289000000,4594000000,4331000000,3294000000,913000000,,887000000,884000000,3253,CARR,quarterly
2020-09-30,100000000,,1009000000,341000000,741000000,637000000,1560000000,821000000,821000000,2000000,-90000000,,,,261000000,5002000000,4181000000,3442000000,188000000,,748000000,741000000,3253,CARR,quarterly
2020-06-30,94000000,,375000000,338000000,261000000,594000000,1146000000,433000000,433000000,25000000,-85000000,,,,106000000,3972000000,3539000000,2826000000,-58000000,,269000000,261000000,3253,CARR,quarterly
2020-03-31,98000000,,295000000,329000000,96000000,671000000,1123000000,379000000,379000000,-25000000,-38000000,,,,193000000,3888000000,3509000000,2765000000,-84000000,,102000000,96000000,3253,CARR,quarterly
2020-12-31,,,129871000,123000,101068000,124335000,269168000,144833000,144833000,,-10788000,,,,28803000,614822000,469989000,345654000,-14962000,,101068000,101068000,3276,IEX,quarterly
2020-09-30,,,121275000,123000,103848000,116858000,251500000,134642000,134642000,,-10642000,,,,17427000,581113000,446471000,329613000,-13367000,,103848000,103848000,3276,IEX,quarterly
2020-06-30,,,91695000,123000,70864000,119096000,238907000,119811000,119811000,,-12439000,,,,20831000,561249000,441438000,322342000,-28116000,,70864000,70864000,3276,IEX,quarterly
2020-03-31,,,127499000,123000,101998000,133789000,271956000,138167000,138167000,,-10877000,,,,25501000,594462000,456295000,322506000,-10668000,,101998000,101998000,3276,IEX,quarterly
2020-12-31,42252000,,44443000,,42887000,41948000,128874000,44674000,44674000,,,,,,1556000,233043000,188369000,104169000,-231000,,42887000,42887000,3315,MPWR,quarterly
2020-09-30,37717000,,62473000,,55566000,43503000,143040000,61820000,61820000,,,,,,6907000,259422000,197602000,116382000,653000,,55566000,55566000,3315,MPWR,quarterly
2020-06-30,31673000,,33155000,,30167000,40883000,102593000,30037000,30037000,,,,,,2988000,186209000,156172000,83616000,3118000,,30167000,30167000,3315,MPWR,quarterly
2020-03-31,25956000,,29272000,,35756000,35914000,91447000,29577000,29577000,,,,,,-6484000,165778000,136201000,74331000,-305000,,35756000,35756000,3315,MPWR,quarterly
2020-12-31,,,576512000,16322000,447306000,363184000,907360000,544176000,544176000,,-62990000,,,,129015000,3411905000,2867729000,2504545000,32336000,,447497000,447306000,3316,PH,quarterly
2020-09-30,,,415295000,15285000,321409000,375430000,858362000,482932000,482932000,,-65958000,,,,93578000,3230540000,2747608000,2372178000,-67637000,,321717000,321409000,3316,PH,quarterly
2020-06-30,,,370568000,14546000,295716000,349264000,841284000,492020000,492020000,,-74549000,,,,74873000,3160603000,2668583000,2319319000,-121452000,,295695000,295716000,3316,PH,quarterly
2020-03-31,,,454157000,11437000,367253000,412575000,964739000,552164000,552164000,,-80765000,,,,86788000,3702432000,3150268000,2737693000,-98007000,,367369000,367253000,3316,PH,quarterly
2020-12-31,,,-138194000,553842000,-117747000,75502000,203358000,2977000,2977000,,-40604000,,,,-43643000,2900768000,2897791000,2697410000,-141171000,,-94551000,-119558000,3351,HFC,quarterly
2020-09-30,,,27918000,540426000,-2401000,73145000,174915000,-23510000,-23510000,,-30589000,,,,4573000,2819400000,2842910000,2644485000,51428000,,23345000,-2401000,3351,HFC,quarterly
2020-06-30,,,-181318000,531929000,-176677000,73581000,453579000,249820000,249820000,,-32695000,,,,-30911000,2062930000,1813110000,1609351000,-431138000,,-150407000,-176677000,3351,HFC,quarterly
2020-03-31,,,-455452000,516317000,-304623000,85233000,-181990000,-407798000,-407798000,,-22639000,,,,-162166000,3400545000,3808343000,3582535000,-47654000,,-293286000,-304623000,3351,HFC,quarterly
2020-12-31,,,117000000,2681000000,87000000,52000000,180000000,128000000,128000000,,-38000000,,,,-2000000,1102000000,974000000,922000000,-11000000,,119000000,87000000,3354,CF,quarterly
2020-09-30,,,-9000000,2649000000,-28000000,49000000,94000000,46000000,46000000,-1000000.0,-48000000,,,,-13000000,847000000,801000000,753000000,-55000000,,4000000,-28000000,3354,CF,quarterly
2020-06-30,,,251000000,2703000000,190000000,51000000,334000000,280000000,280000000,3000000.0,-49000000,,,,33000000,1204000000,924000000,870000000,-29000000,,218000000,190000000,3354,CF,quarterly
2020-03-31,,,104000000,2675000000,68000000,54000000,204000000,152000000,152000000,-2000000.0,-44000000,,,,13000000,971000000,819000000,767000000,-48000000,,91000000,68000000,3354,CF,quarterly
2020-12-31,299000000,,1109000000,,845000000,1057000000,2126000000,677000000,677000000,86000000,-94000000,,,,328000000,2868000000,2191000000,742000000,432000000,64000000,781000000,845000000,3376,EBAY,quarterly
2020-09-30,287000000,,774000000,,664000000,918000000,1950000000,679000000,679000000,60000000,-67000000,,,,153000000,2606000000,1927000000,656000000,95000000,43000000,621000000,664000000,3376,EBAY,quarterly
2020-06-30,234000000,,906000000,,746000000,828000000,1874000000,724000000,724000000,83000000,-123000000,,,,251000000,2423000000,1699000000,549000000,182000000,91000000,655000000,746000000,3376,EBAY,quarterly
2020-03-31,267000000,,631000000,,3412000000,833000000,1848000000,637000000,637000000,102000000,-70000000,,,,146000000,2374000000,1737000000,526000000,-6000000,2927000000,485000000,3412000000,3376,EBAY,quarterly
2020-12-25,162000000,,435000000,118000000,381000000,358000000,1146000000,608000000,608000000,18000000,-15000000,,,,60000000,3522000000,2914000000,2376000000,-173000000,6000000,375000000,381000000,3389,TEL,quarterly
2020-09-25,148000000,,337000000,112000000,230000000,352000000,969000000,469000000,469000000,18000000,-12000000,,,,109000000,3261000000,2792000000,2292000000,-132000000,2000000,228000000,230000000,3389,TEL,quarterly
2020-06-26,146000000,,127000000,108000000,-41000000,318000000,707000000,243000000,243000000,18000000,-13000000,,,,185000000,2548000000,2305000000,1841000000,-116000000,17000000,-58000000,-41000000,3389,TEL,quarterly
2020-03-27,158000000,,-410000000,105000000,-456000000,352000000,1029000000,519000000,519000000,18000000,-11000000,,,,42000000,3195000000,2676000000,2166000000,-929000000,-4000000,-452000000,-456000000,3389,TEL,quarterly
2020-12-31,195700000,,356100000,,309500000,338900000,895400000,360800000,360800000,,-15800000,,,,46600000,1191700000,830900000,296300000,-4700000,,309500000,309500000,3413,EW,quarterly
2020-09-30,195500000,,364300000,,325200000,307200000,859900000,357200000,357200000,,-800000,,,,39100000,1140900000,783700000,281000000,7100000,,325200000,325200000,3413,EW,quarterly
2020-06-30,182100000,,-168200000,,-121900000,274900000,686800000,229800000,229800000,,-800000,,,,-46300000,925000000,695200000,238200000,-398000000,,-121900000,-121900000,3413,EW,quarterly
2020-03-31,187400000,,364500000,,310600000,307800000,863600000,368400000,368400000,,-800000,,,,53900000,1128700000,760300000,265100000,-3900000,,310600000,310600000,3413,EW,quarterly
2020-12-31,,,130900000,500000,103200000,103200000,258100000,138600000,138600000,,-19500000,,,,27700000,1182000000,1043400000,923900000,-7700000,,103200000,103200000,3428,LEG,quarterly
2020-09-30,,,126900000,500000,104800000,105300000,267400000,145900000,145900000,,-20900000,,,,22000000,1207600000,1061700000,940200000,-19000000,,104900000,104800000,3428,LEG,quarterly
2020-06-30,,,2400000,400000,-6100000,97100000,146300000,32900000,32900000,,-21400000,,,,8500000,845100000,812200000,698800000,-30500000,,-6100000,-6100000,3428,LEG,quarterly
2020-03-31,,,60700000,400000,45700000,117700000,222900000,88800000,88800000,,-20900000,,,,15000000,1045500000,956700000,822600000,-28100000,,45700000,45700000,3428,LEG,quarterly
2020-12-31,,,-957000000,1038000000,-665000000,5629000000,11456000000,2494000000,2494000000,1272000000,-199000000,,,,-301000000,24843000000,22349000000,13387000000,-3451000000,,-656000000,-665000000,3433,CVX,quarterly
2020-09-30,,,-44000000,264000000,-207000000,5658000000,10549000000,-328000000,-328000000,1085000000,-164000000,,,,165000000,23997000000,24325000000,13448000000,284000000,,-209000000,-207000000,3433,CVX,quarterly
2020-06-30,,,-10597000000,268000000,-8270000000,6183000000,7782000000,-6981000000,-6981000000,968000000,-172000000,,,,-2320000000,15926000000,22907000000,8144000000,-3616000000,,-8277000000,-8270000000,3433,CVX,quarterly
2020-03-31,,,4145000000,984000000,3599000000,6072000000,14196000000,2511000000,2511000000,1167000000,-162000000,,,,564000000,29705000000,27194000000,15509000000,1634000000,,3581000000,3599000000,3433,CVX,quarterly
2020-12-31,,,2168000000,126000000,1785000000,1859000000,4120000000,2111000000,2111000000,,-108000000,,,,383000000,4120000000,2009000000,0,57000000,,1785000000,1785000000,3440,MA,quarterly
2020-09-30,,,1915000000,85000000,1513000000,1591000000,3837000000,2105000000,2105000000,,-105000000,,,,402000000,3837000000,1732000000,0,-190000000,,1513000000,1513000000,3440,MA,quarterly
2020-06-30,,,1690000000,78000000,1420000000,1461000000,3335000000,1729000000,1729000000,,-101000000,,,,270000000,3335000000,1606000000,0,-39000000,,1420000000,1420000000,3440,MA,quarterly
2020-03-31,,,1987000000,100000000,1693000000,1648000000,4009000000,2217000000,2217000000,,-69000000,,,,294000000,4009000000,1792000000,0,-230000000,,1693000000,1693000000,3440,MA,quarterly
2020-12-31,,,197347000,,154007000,92439000,440276000,199492000,199492000,13756000,-10831000,,,,43340000,2737652000,2538160000,2297376000,-2145000,,154007000,154007000,3449,JBHT,quarterly
2020-09-30,,,163608000,,125496000,77306000,398897000,175503000,175503000,13696000,-11895000,,,,38112000,2472523000,2297020000,2073626000,-11895000,,125496000,125496000,3449,JBHT,quarterly
2020-06-30,,,162365000,,121698000,75498000,394546000,175183000,175183000,13567000,-12818000,,,,40667000,2145573000,1970390000,1751027000,-12818000,,121698000,121698000,3449,JBHT,quarterly
2020-03-31,,,142705000,,104834000,77526000,375674000,154741000,154741000,13312000,-12036000,,,,37871000,2280826000,2126085000,1905152000,-24336000,,104834000,104834000,3449,JBHT,quarterly
2020-12-31,,,2167000000,,1548000000,474000000,2349000000,1848000000,1848000000,,-54000000,,,,427000000,4478000000,2630000000,2129000000,319000000,,1740000000,1548000000,3475,BLK,quarterly
2020-09-30,,,1981000000,2143000000.0,1364000000,461000000,2245000000,1757000000,1757000000,,-54000000,,,,464000000,4369000000,2612000000,2124000000,224000000,,1517000000,1364000000,3475,BLK,quarterly
2020-06-30,,,1763000000,1304000000.0,1214000000,378000000,1821000000,1416000000,1416000000,,-51000000,,,,361000000,3648000000,2232000000,1827000000,347000000,,1402000000,1214000000,3475,BLK,quarterly
2020-03-31,,,613000000,1497000000.0,806000000,1117000000,1851000000,709000000,709000000,,-46000000,,,,-14000000,3710000000,3001000000,1859000000,-96000000,,627000000,806000000,3475,BLK,quarterly
2020-12-31,,,416000000,1919000000,271000000,809000000,1797000000,630000000,630000000,,-173000000,,,,98000000,2886000000,2256000000,1089000000,-214000000,,318000000,245000000,3488,DISCA,quarterly
2020-09-30,,,319000000,1953000000,300000000,633000000,1559000000,585000000,585000000,,-171000000,,,,-11000000,2561000000,1976000000,1002000000,-266000000,,330000000,265000000,3488,DISCA,quarterly
2020-06-30,,,456000000,1933000000,271000000,635000000,1737000000,768000000,768000000,,-172000000,,,,156000000,2541000000,1773000000,804000000,-312000000,,300000000,243000000,3488,DISCA,quarterly
2020-03-31,,,537000000,1934000000,377000000,645000000,1765000000,794000000,794000000,,-175000000,,,,130000000,2683000000,1889000000,918000000,-257000000,,407000000,338000000,3488,DISCA,quarterly
2020-12-31,,,2752000000,,2418000000,877000000,3256000000,2294000000,2294000000,12000000,-126000000,,,,334000000,9898000000,7604000000,6642000000,458000000,,2418000000,2418000000,3490,CB,quarterly
2020-09-30,,,1336000000,,1194000000,733000000,1810000000,987000000,987000000,18000000,-130000000,,,,142000000,9488000000,8501000000,7678000000,349000000,,1194000000,1194000000,3490,CB,quarterly
2020-06-30,,,-393000000,,-331000000,727000000,632000000,-192000000,-192000000,25000000,-128000000,,,,-62000000,9025000000,9217000000,8393000000,-201000000,,-331000000,-331000000,3490,CB,quarterly
2020-03-31,,,467000000,,252000000,741000000,1412000000,570000000,570000000,28000000,-132000000,,,,215000000,7641000000,7071000000,6229000000,-103000000,,252000000,252000000,3490,CB,quarterly
2021-01-02,,,140744000,,111997000,892391000,1085230000,165502000,165502000,,-9296000,,,,28747000,2365131000,2199629000,1279901000,-24758000,,111997000,111997000,3553,AAP,quarterly
2020-10-03,,,197538000,,147476000,862981000,1128550000,265569000,265569000,,-11925000,,,,50062000,2541928000,2276359000,1413378000,-68031000,,147476000,147476000,3553,AAP,quarterly
2020-07-11,,,252540000,,189960000,824049000,1097009000,272960000,272960000,,-13422000,,,,62580000,2501380000,2228420000,1404371000,-20420000,,189960000,189960000,3553,AAP,quarterly
2020-04-18,,,60193000,,43588000,1078101000,1173986000,95885000,95885000,,-12243000,,,,16605000,2697882000,2601997000,1523896000,-35692000,,43588000,43588000,3553,AAP,quarterly
2020-12-31,,,225546000,13207000,171204000,1121115000,1448110000,257112000,257112000,,-21495000,,,,53914000,4251594000,3994482000,2803484000,-31566000,-428000,171632000,171204000,3561,GPC,quarterly
2020-09-30,,,297665000,20693000,227531000,1133851000,1528066000,319485000,319485000,,-25788000,,,,64747000,4370086000,4050601000,2842020000,-21820000,-5387000,232918000,227531000,3561,GPC,quarterly
2020-06-30,,,-304436000,21613000,-564372000,965305000,1290487000,247149000,247149000,,-25465000,,,,59065000,3823227000,3576078000,2532740000,-551585000,-200871000,-363501000,-564372000,3561,GPC,quarterly
2020-03-31,,,160593000,20329000,136535000,1136394000,1388178000,178011000,178011000,,-20965000,,,,38247000,4092526000,3914515000,2704348000,-17418000,14189000,122346000,136535000,3561,GPC,quarterly
2020-12-31,,,373400000,,240900000,1035500000,1524400000,0,425900000,63000000,,,,,132500000,1524400000,1098500000,0,-52500000,,240900000,234700000,3584,NTRS,quarterly
2020-09-30,,,389900000,,294500000,991100000,1484600000,0,389900000,103600000,,,,,95400000,1484600000,1094700000,0,0,,294500000,275000000,3584,NTRS,quarterly
2020-06-30,,,403200000,,313300000,959000000,1440100000,0,403200000,77900000,,,,,89900000,1440100000,1036900000,0,0,,313300000,305100000,3584,NTRS,quarterly
2020-03-31,,,461100000,,360600000,1022600000,1526700000,0,461100000,43000000,,,,,100500000,1526700000,1065600000,0,0,,360600000,326200000,3584,NTRS,quarterly
2020-12-31,,,-621000000,,-430000000,18000000,-234000000,-449000000,-449000000,97000000,-31000000,,,,-191000000,808000000,1257000000,1042000000,-172000000,,-430000000,-430000000,3596,ALK,quarterly
2020-09-30,,,-589000000,,-431000000,24000000,-284000000,-527000000,-527000000,114000000,-30000000,,,,-158000000,701000000,1228000000,985000000,-62000000,,-431000000,-431000000,3596,ALK,quarterly
2020-06-30,,,-291000000,,-214000000,4000000,-380000000,-594000000,-594000000,103000000,-16000000,,,,-77000000,421000000,1015000000,801000000,303000000,,-214000000,-214000000,3596,ALK,quarterly
2020-03-31,,,-317000000,,-232000000,55000000,182000000,-156000000,-156000000,175000000,-10000000,,,,-85000000,1636000000,1792000000,1454000000,-161000000,,-232000000,-232000000,3596,ALK,quarterly
2020-11-30,,,1164646000,104545000,882760000,570522000,1717361000,1156899000,1156899000,-10060000,-22401000,,,,273737000,6825890000,5668991000,5108529000,7747000,,890909000,872818000,3614,LEN,quarterly
2020-08-31,,,859013000,108242000,666418000,528610000,1410208000,869165000,869165000,12433000,-22401000,,,,189690000,5870254000,5001089000,4460046000,-10152000,,669323000,658620000,3614,LEN,quarterly
2020-05-31,,,676577000,89921000,517406000,490642000,1148477000,651183000,651183000,6652000,-22401000,,,,160479000,5287373000,4636190000,4138896000,25394000,,516098000,511118000,3614,LEN,quarterly
2020-02-29,,,423552000,148778000,398452000,465739000,895157000,421463000,421463000,7955000,-22401000,,,,32329000,4505337000,4083874000,3610180000,2089000,,391223000,394026000,3614,LEN,quarterly
2020-12-31,,,1520000000,,653000000,574000000,1009000000,435000000,435000000,,-69000000,,,,568000000,5495000000,5060000000,4486000000,1085000000,,952000000,653000000,3642,BKR,quarterly
2020-09-30,,,-264000000,5667000000.0,-170000000,562000000,799000000,223000000,223000000,14000000.0,-66000000,,,,6000000,5049000000,4826000000,4250000000,-487000000,,-270000000,-170000000,3642,BKR,quarterly
2020-06-30,,,-365000000,6311000000.0,-212000000,587000000,854000000,267000000,267000000,14000000.0,-70000000,,,,-21000000,4736000000,4469000000,3882000000,-632000000,,-344000000,-212000000,3642,BKR,quarterly
2020-03-31,,,-16093000000,6515000000.0,-10210000000,672000000,755000000,83000000,83000000,14000000.0,-59000000,,,,5000000,5425000000,5342000000,4670000000,-16176000000,,-16098000000,-10210000000,3642,BKR,quarterly
2020-12-31,,,183400000,3400000,139200000,,329400000,229500000,229500000,39900000,-26800000,,,,44400000,2555100000,2325600000,2225700000,-46100000,,139000000,134500000,3673,AIZ,quarterly
2020-09-30,,,-4100000,3600000,-30200000,,194500000,165300000,165300000,29200000,-25500000,,,,26400000,2502500000,2337200000,2308000000,-169400000,,-30500000,-34900000,3673,AIZ,quarterly
2020-06-30,,,226800000,16700000,178100000,,311800000,253500000,253500000,58300000,-26700000,,,,48400000,2467100000,2213600000,2155300000,-26700000,,178400000,173500000,3673,AIZ,quarterly
2020-03-31,,,109200000,16200000,154700000,,184600000,134700000,134700000,49900000,-25500000,,,,-46600000,2564200000,2429500000,2379600000,-25500000,,155800000,150000000,3673,AIZ,quarterly
2020-12-31,,,86898000,,62619000,159086000,269948000,88459000,88459000,,-591000,,,,24279000,536292000,447833000,266344000,-1561000,,62619000,62619000,3681,ROL,quarterly
2020-09-30,,,108902000,,79579000,168006000,308224000,117814000,117814000,,-866000,,,,29323000,583698000,465884000,275474000,-8912000,,79579000,79579000,3681,ROL,quarterly
2020-06-30,,,103520000,,75358000,171253000,297707000,104529000,104529000,,-1460000,,,,28162000,553329000,448800000,255622000,-1009000,,75358000,75358000,3681,ROL,quarterly
2020-03-31,,,55400000,,43268000,157862000,236749000,57290000,57290000,,-2165000,,,,12132000,487901000,430611000,251152000,-1890000,,43268000,43268000,3681,ROL,quarterly
2020-12-31,26780000,,93567000,,71982000,44167000,164579000,93632000,93632000,,-117000,,,,21585000,422361000,328729000,257782000,-65000,,71982000,71982000,3684,JKHY,quarterly
2020-09-30,26057000,,117539000,,91216000,45226000,188871000,117588000,117588000,,-117000,,,,26323000,451800000,334212000,262929000,-49000,,91216000,91216000,3684,JKHY,quarterly
2020-06-30,29902000,,76673000,,61345000,52098000,155702000,73702000,73702000,,-211000,,,,15328000,410537000,336835000,254835000,2971000,,61345000,61345000,3684,JKHY,quarterly
2020-03-31,28308000,,91970000,,73855000,47391000,170835000,95136000,95136000,,-165000,,,,18115000,429406000,334270000,258571000,-3166000,,73855000,73855000,3684,JKHY,quarterly
2020-12-31,133000000,,420000000,4000000,359000000,518000000,1221000000,530000000,530000000,,-58000000,,,,62000000,1807000000,1277000000,586000000,-110000000,,358000000,359000000,3687,ZTS,quarterly
2020-09-30,112000000,,597000000,5000000,479000000,419000000,1241000000,670000000,670000000,,-62000000,,,,118000000,1786000000,1116000000,545000000,-73000000,,479000000,479000000,3687,ZTS,quarterly
2020-06-30,111000000,,482000000,5000000,377000000,389000000,1098000000,558000000,558000000,,-58000000,,,,106000000,1548000000,990000000,450000000,-76000000,,376000000,377000000,3687,ZTS,quarterly
2020-03-31,107000000,,497000000,5000000,423000000,387000000,1077000000,543000000,543000000,,-53000000,,,,74000000,1534000000,991000000,457000000,-46000000,,423000000,423000000,3687,ZTS,quarterly
2020-12-31,,,111274000,333514000,110451000,23411000,485269000,70392000,70392000,,-114208000,,,,-679000,938226000,867834000,452957000,40882000,,111953000,110451000,3705,VTR,quarterly
2020-09-30,,,10542000,339998000,12751000,34228000,418692000,135098000,135098000,,-115505000,,,,-3195000,919233000,784135000,500541000,-124556000,,13737000,12751000,3705,VTR,quarterly
2020-06-30,,,-102879000,320618000,-157170000,29984000,407005000,136227000,136227000,,-123132000,,,,56356000,935808000,799581000,528803000,-239106000,,-159235000,-157170000,3705,VTR,quarterly
2020-03-31,,,325714000,281156000,473117000,42535000,525330000,246658000,246658000,,-116696000,,,,-149016000,1007025000,760367000,481695000,79056000,,474730000,473117000,3705,VTR,quarterly
2020-12-31,,,800000000,1130000000,607000000,187000000,1723000000,925000000,925000000,83000000,-381000000,,,,177000000,3115000000,2190000000,1392000000,-125000000,,623000000,603000000,3727,KMI,quarterly
2020-09-30,,,612000000,1133000000,455000000,153000000,1621000000,830000000,830000000,99000000,-383000000,,,,140000000,2919000000,2089000000,1298000000,-218000000,,472000000,452000000,3727,KMI,quarterly
2020-06-30,,,-520000000,1139000000,-637000000,155000000,1513000000,723000000,723000000,103000000,-395000000,,,,104000000,2560000000,1837000000,1047000000,-1243000000,,-624000000,-640000000,3727,KMI,quarterly
2020-03-31,,,-231000000,1151000000,-306000000,153000000,1823000000,1014000000,1014000000,91000000,-436000000,,,,60000000,3106000000,2092000000,1283000000,-1245000000,,-291000000,-309000000,3727,KMI,quarterly
2020-12-31,522000000,,379000000,1454000000,270000000,969000000,2066000000,575000000,575000000,,-241000000,,,,83000000,10744000000,10169000000,8678000000,-196000000,,296000000,270000000,3747,TSLA,quarterly
2020-09-30,366000000,,555000000,1469000000,331000000,931000000,2063000000,766000000,766000000,,-162000000,,,,186000000,8771000000,8005000000,6708000000,-211000000,,369000000,300000000,3747,TSLA,quarterly
2020-06-30,279000000,,150000000,1482000000,104000000,661000000,1267000000,327000000,327000000,,-173000000,,,,21000000,6036000000,5709000000,4769000000,-177000000,,129000000,104000000,3747,TSLA,quarterly
2020-03-31,324000000,,70000000,1499000000,16000000,627000000,1234000000,283000000,283000000,,-208000000,,,,2000000,5985000000,5702000000,4751000000,-213000000,,68000000,16000000,3747,TSLA,quarterly
2020-12-31,,,70000000,1602000000,10000000,76000000,755000000,180000000,180000000,22000000,-99000000,,,,15000000,1242000000,1062000000,487000000,-110000000,,55000000,10000000,3795,APA,quarterly
2020-09-30,,,72000000,1604000000,-4000000,52000000,732000000,179000000,179000000,45000000,-112000000,,,,31000000,1129000000,950000000,397000000,-107000000,,41000000,-4000000,3795,APA,quarterly
2020-06-30,,,-416000000,1591000000,-386000000,94000000,389000000,-440000000,-440000000,225000000,-107000000,,,,-38000000,771000000,1211000000,382000000,24000000,,-378000000,-386000000,3795,APA,quarterly
2020-03-31,,,-4566000000,1591000000,-4480000000,68000000,865000000,11000000,11000000,163000000,-105000000,,,,56000000,1357000000,1346000000,492000000,-4577000000,,-4622000000,-4480000000,3795,APA,quarterly
2020-11-30,,,1468600000,340400000,1280900000,447000000,1316200000,864900000,864900000,4300000,-95700000,,,,176600000,2438100000,1573200000,1121900000,603700000,,1292000000,1280900000,3803,STZ,quarterly
2020-08-31,,,657200000,315800000,512100000,398000000,1217600000,819600000,819600000,4300000,-100200000,,,,135400000,2260400000,1440800000,1042800000,-162400000,,521800000,512100000,3803,STZ,quarterly
2020-05-31,,,-68200000,311600000,-177900000,342900000,1017200000,674300000,674300000,4300000,-100000000,,,,104400000,1963400000,1289100000,946200000,-742500000,,-172600000,-177900000,3803,STZ,quarterly
2020-02-29,,,488900000,342500000,398400000,384000000,950600000,583200000,583200000,-16600000,-99400000,,,,79900000,1902900000,1319700000,952300000,-94300000,,409000000,398400000,3803,STZ,quarterly
2020-12-31,,,-691000000,2539000000,-539000000,1612000000,1262000000,-799000000,-799000000,91000000,-139000000,,,,-197000000,16412000000,17211000000,15150000000,108000000,,-494000000,-541000000,3817,PSX,quarterly
2020-09-30,,,-1350000000,2583000000,-799000000,1400000000,1440000000,-424000000,-424000000,112000000,-132000000,,,,-624000000,15949000000,16373000000,14509000000,-926000000,,-726000000,-801000000,3817,PSX,quarterly
2020-06-30,,,-445000000,2580000000,-141000000,1435000000,1324000000,-564000000,-564000000,110000000,-117000000,,,,-378000000,10932000000,11496000000,9608000000,119000000,,-67000000,-144000000,3817,PSX,quarterly
2020-03-31,,,-2478000000,2267000000,-2496000000,1660000000,2438000000,273000000,273000000,163000000,-111000000,,,,-51000000,20878000000,20605000000,18440000000,-2751000000,,-2427000000,-2497000000,3817,PSX,quarterly
2020-12-31,1229000000,,1877000000,,1615000000,1773000000,5037000000,2035000000,2035000000,,-94000000,,,,262000000,6634000000,4599000000,1597000000,-158000000,,1615000000,1615000000,3871,AMGN,quarterly
2020-09-30,1062000000,,2206000000,,2021000000,1346000000,4862000000,2453000000,2453000000,1000000.0,-302000000,,,,185000000,6423000000,3970000000,1561000000,-247000000,,2021000000,2021000000,3871,AMGN,quarterly
2020-06-30,964000000,,2030000000,,1803000000,1295000000,4718000000,2323000000,2323000000,136000000.0,-296000000,,,,227000000,6206000000,3883000000,1488000000,-293000000,,1803000000,1803000000,3871,AMGN,quarterly
2020-03-31,952000000,,2020000000,,1825000000,1316000000,4648000000,2355000000,2355000000,25000000.0,-346000000,,,,195000000,6161000000,3806000000,1513000000,-335000000,,1825000000,1825000000,3871,AMGN,quarterly
2020-12-31,,,190000000,,177000000,832000000,1183000000,351000000,351000000,,-165000000,,,,13000000,3189000000,2838000000,2006000000,-161000000,,177000000,177000000,3875,AMP,quarterly
2020-09-30,,,-184000000,,-140000000,762000000,796000000,34000000,34000000,,-217000000,,,,-44000000,3013000000,2979000000,2217000000,-218000000,,-140000000,-140000000,3875,AMP,quarterly
2020-06-30,,,-526000000,,-539000000,774000000,571000000,-203000000,-203000000,,-321000000,,,,13000000,2730000000,2933000000,2159000000,-323000000,,-539000000,-539000000,3875,AMP,quarterly
2020-03-31,,,2351000000,,2036000000,752000000,3266000000,2514000000,2514000000,,-162000000,,,,315000000,3026000000,512000000,-240000000,-163000000,,2036000000,2036000000,3875,AMP,quarterly
2020-12-27,,,808300000,5700000,622200000,472100000,1833000000,903000000,903000000,91800000,-120700000,,,,186100000,6749400000,5846400000,4916400000,-94700000,,622200000,622200000,3909,SBUX,quarterly
2020-09-27,,,442400000,5700000,392600000,439000000,1625100000,723100000,723100000,100000000,-124900000,,,,49700000,6203100000,5480000000,4578000000,-280700000,,392700000,392600000,3909,SBUX,quarterly
2020-06-28,,,-812000000,-2700000,-678400000,399900000,200300000,-694200000,-694200000,133600000,-120800000,,,,-133900000,4222100000,4916300000,4021800000,-117800000,,-678100000,-678400000,3909,SBUX,quarterly
2020-03-29,,,390200000,-2800000,328400000,406500000,1276600000,418800000,418800000,95000000,-99200000,,,,65400000,5995700000,5576900000,4719100000,-28600000,,324800000,328400000,3909,SBUX,quarterly
2020-12-31,32500000,,171100000,3900000,136800000,147700000,362900000,182700000,182700000,,-9200000,,,,34300000,815000000,632300000,452100000,-11600000,,136800000,136800000,3987,VNT,quarterly
2020-09-25,31600000,,178300000,4300000,141000000,121100000,331300000,178600000,178600000,,-200000,,,,37300000,746700000,568100000,415400000,-300000,,141000000,141000000,3987,VNT,quarterly
2020-06-26,31050000,,55450000,4300000,32100000,117650000,247050000,98350000,98350000,,-300000,,,,23350000,571450000,473100000,324400000,-42900000,,32100000,32100000,3987,VNT,quarterly
2020-03-26,31050000,,55450000,4300000,32100000,117650000,247050000,98350000,98350000,,-300000,,,,23350000,571450000,473100000,324400000,-42900000,,32100000,32100000,3987,VNT,quarterly
2020-12-31,,,-598000000,841000000,-359000000,216000000,276000000,-462000000,-462000000,-55000000,-153000000,,,,-289000000,15298000000,15760000000,15022000000,-136000000,,-309000000,-360000000,3991,VLO,quarterly
2020-09-30,,,-716000000,793000000,-464000000,180000000,122000000,-585000000,-585000000,-57000000,-143000000,,,,-337000000,14470000000,15055000000,14348000000,-131000000,,-379000000,-465000000,3991,VLO,quarterly
2020-06-30,,,1674000000,787000000,1253000000,160000000,2463000000,1798000000,1798000000,-73000000,-142000000,,,,339000000,9613000000,7815000000,7150000000,-124000000,,1335000000,1249000000,3991,VLO,quarterly
2020-03-31,,,-2370000000,843000000,-1851000000,168000000,-1595000000,-2268000000,-2268000000,-77000000,-125000000,,,,-616000000,20734000000,23002000000,22329000000,-102000000,,-1754000000,-1850000000,3991,VLO,quarterly
2020-12-31,,,89000000,,143000000,2565000000,3215000000,198000000,198000000,415000000,-66000000,,,,-54000000,4136000000,3938000000,921000000,-109000000,,143000000,143000000,3996,LNC,quarterly
2020-09-30,,,460000000,,398000000,2565000000,546000000,546000000,546000000,415000000,-66000000,,,,62000000,5361000000,4815000000,4815000000,-86000000,,398000000,398000000,3996,LNC,quarterly
2020-06-30,,,-161000000,,-94000000,2565000000,-63000000,-63000000,-63000000,415000000,-84000000,,,,-67000000,3517000000,3580000000,3580000000,-98000000,,-94000000,-94000000,3996,LNC,quarterly
2020-03-31,,,34000000,,52000000,2565000000,114000000,114000000,114000000,415000000,-68000000,,,,-18000000,4425000000,4311000000,4311000000,-80000000,,52000000,52000000,3996,LNC,quarterly
2020-11-27,558000000,,1197000000,,2250000000,1184000000,2996000000,1215000000,1215000000,,-27000000,,,,-1053000000,3424000000,2209000000,428000000,-18000000,,2250000000,2250000000,4005,ADBE,quarterly
2020-08-28,566000000,,1060000000,,955000000,1122000000,2798000000,1069000000,1069000000,,-28000000,,,,105000000,3225000000,2156000000,427000000,-9000000,,955000000,955000000,4005,ADBE,quarterly
2020-05-29,532000000,,1000000000,,1100000000,1125000000,2713000000,1016000000,1016000000,,-28000000,,,,-100000000,3128000000,2112000000,415000000,-16000000,,1100000000,1100000000,4005,ADBE,quarterly
2020-02-28,532000000,,919000000,,955000000,1128000000,2639000000,937000000,937000000,,-33000000,,,,-36000000,3091000000,2154000000,452000000,-18000000,,955000000,955000000,4005,ADBE,quarterly
2020-12-31,223000000,,-495000000,1494000000,-383000000,635000000,633000000,-423000000,-423000000,-14000000,-102000000,,,,-104000000,920000000,1343000000,287000000,-72000000,,-391000000,-412000000,4012,EXPE,quarterly
2020-09-30,224000000,,-224000000,1480000000,-192000000,663000000,1129000000,20000000,20000000,2000000,-113000000,,,,-24000000,1504000000,1484000000,375000000,-244000000,,-200000000,-221000000,4012,EXPE,quarterly
2020-06-30,255000000,,-953000000,1469000000,-736000000,448000000,177000000,-758000000,-758000000,2000000,-95000000,,,,-213000000,566000000,1324000000,389000000,-195000000,,-740000000,-753000000,4012,EXPE,quarterly
2020-03-31,308000000,,-1479000000,1471000000,-1301000000,1397000000,1580000000,-358000000,-358000000,4000000,-50000000,,,,-82000000,2209000000,2567000000,629000000,-1121000000,,-1397000000,-1301000000,4012,EXPE,quarterly
2020-12-31,54935000,,210592000,,179514000,169470000,478879000,235621000,235621000,,-5924000,,,,31078000,800011000,564390000,321132000,-25029000,,179514000,179514000,4028,RMD,quarterly
2020-09-30,54533000,,215854000,,178372000,156189000,450640000,219696000,219696000,,-6842000,,,,37482000,751944000,532248000,301304000,-3842000,,178372000,178372000,4028,RMD,quarterly
2020-06-30,52521000,,212094000,,177835000,165385000,461353000,223247000,223247000,,-9197000,,,,34259000,770344000,547097000,308991000,-11153000,,177835000,177835000,4028,RMD,quarterly
2020-03-31,51449000,,191655000,,163137000,172441000,461798000,217500000,217500000,,-9968000,,,,28518000,769455000,551955000,307657000,-25845000,,163137000,163137000,4028,RMD,quarterly
2020-12-31,,,611000000,,551000000,6840000000,7737000000,805000000,805000000,,-192000000,,,,60000000,31825000000,31020000000,24088000000,-194000000,,551000000,551000000,4031,ANTM,quarterly
2020-09-30,,,389000000,,222000000,6326000000,8237000000,1818000000,1818000000,,-198000000,,,,167000000,31158000000,29340000000,22921000000,-1429000000,,222000000,222000000,4031,ANTM,quarterly
2020-06-30,,,3149000000,,2276000000,6271000000,9717000000,3353000000,3353000000,,-201000000,,,,873000000,29264000000,25911000000,19547000000,-204000000,,2276000000,2276000000,4031,ANTM,quarterly
2020-03-31,,,2089000000,,1523000000,5765000000,8132000000,2284000000,2284000000,,-194000000,,,,566000000,29621000000,27337000000,21489000000,-195000000,,1523000000,1523000000,4031,ANTM,quarterly
2020-11-30,,,-2237000000,,-2222000000,492000000,-351000000,-1555000000,-1555000000,169000000,-348000000,,,,-15000000,33000000,1588000000,384000000,-682000000,,-2222000000,-2222000000,4039,CCL,quarterly
2020-08-31,,,-2860000000,,-2858000000,262000000,-400000000,-1421000000,-1421000000,208000000,-310000000,,,,-2000000,31000000,1452000000,431000000,-1439000000,,-2858000000,-2858000000,4039,CCL,quarterly
2020-05-31,,,-4385000000,,-4374000000,453000000,-685000000,-2186000000,-2186000000,471000000,-182000000,,,,-11000000,740000000,2926000000,1425000000,-2199000000,,-4374000000,-4374000000,4039,CCL,quarterly
2020-02-29,,,-770000000,,-781000000,678000000,2269000000,243000000,243000000,778000000,-55000000,,,,11000000,4789000000,4546000000,2520000000,-1013000000,,-781000000,-781000000,4039,CCL,quarterly
2020-12-31,,,652000000,,537000000,1063000000,1819000000,708000000,708000000,31000000,-47000000,,,,115000000,5318000000,4610000000,3499000000,-56000000,,537000000,532000000,4042,HIG,quarterly
2020-09-30,,,532000000,,459000000,1079000000,1779000000,682000000,682000000,31000000,-49000000,,,,73000000,5162000000,4480000000,3383000000,-150000000,,459000000,453000000,4042,HIG,quarterly
2020-06-30,,,592000000,,468000000,1125000000,1785000000,642000000,642000000,31000000,-50000000,,,,124000000,5061000000,4419000000,3276000000,-50000000,,468000000,463000000,4042,HIG,quarterly
2020-03-31,,,344000000,,273000000,1176000000,1600000000,405000000,405000000,31000000,-61000000,,,,71000000,4953000000,4548000000,3353000000,-61000000,,273000000,268000000,4042,HIG,quarterly
2020-12-31,142101000,,220408000,,182106000,250888000,658535000,265546000,265546000,,-28234000,,,,38302000,1780390000,1514844000,1121855000,-45138000,,182106000,182106000,4106,DOV,quarterly
2020-09-30,142101000,,250997000,,200300000,376173000,661439000,285266000,285266000,,-27724000,,,,50697000,1748256000,1462990000,1086817000,-34269000,,200300000,200300000,4106,DOV,quarterly
2020-06-30,142101000,,156829000,,124766000,360389000,559155000,198766000,198766000,,-28711000,,,,32063000,1499175000,1300409000,940020000,-41937000,,124766000,124766000,4106,DOV,quarterly
2020-03-31,142101000,,213500000,,176279000,379513000,613785000,234272000,234272000,,-27268000,,,,37221000,1655939000,1421667000,1042154000,-20772000,,176279000,176279000,4106,DOV,quarterly
2020-12-31,,,2106200000,,1684300000,,2228200000,2162400000,2162400000,50800000,-56200000,,,,421900000,11410300000,9247900000,9182100000,-56200000,,1684300000,1677500000,4124,PGR,quarterly
2020-09-30,,,1923500000,,1530800000,,2063300000,1979900000,1979900000,54400000,-56400000,,,,392700000,10942500000,8962600000,8879200000,-56400000,,1530800000,1524100000,4124,PGR,quarterly
2020-06-30,,,2268800000,,1790400000,,3411400000,2325200000,2325200000,52800000,-56400000,,,,478400000,10967200000,8642000000,7555800000,-56400000,,1790400000,1783700000,4124,PGR,quarterly
2020-03-31,,,874700000,225600000.0,699100000,,970200000,922700000,922700000,47500000,-48000000,,,,175600000,9318100000,8395400000,8347900000,-48000000,,699100000,692400000,4124,PGR,quarterly
2020-12-31,,,535000000,31600000,424000000,377100000,1098500000,515000000,515000000,85900000,-41700000,,,,110200000,1098500000,583500000,0,20000000,,424800000,424000000,4129,CME,quarterly
2020-09-30,,,536500000,30800000,411700000,388500000,1077300000,525000000,525000000,45800000,-41700000,,,,125000000,1077300000,552300000,0,11500000,,411500000,411700000,4129,CME,quarterly
2020-06-30,,,661300000,31000000,503300000,389600000,1179200000,637500000,637500000,38800000,-41900000,,,,158000000,1179200000,541700000,0,23800000,,503300000,503300000,4129,CME,quarterly
2020-03-31,,,989300000,31000000,766200000,385900000,1518500000,959900000,959900000,60100000,-40900000,,,,222500000,1518500000,558600000,0,29400000,,766800000,766200000,4129,CME,quarterly
2020-12-31,84600000,,107500000,22400000,49500000,168700000,501400000,248600000,248600000,-500000,-34300000,,,,68600000,1152200000,903600000,650800000,-141100000,8400000,38900000,49400000,4146,FMC,quarterly
2020-09-30,71700000,,148900000,23900000,111400000,173300000,466400000,221300000,221300000,100000,-35500000,,,,18400000,1084600000,863300000,618200000,-72400000,-18400000,130500000,111100000,4146,FMC,quarterly
2020-06-30,64300000,,225000000,28700000,184400000,158000000,522700000,300400000,300400000,100000,-40700000,,,,29200000,1155300000,854900000,632600000,-75400000,-10800000,195800000,183900000,4146,FMC,quarterly
2020-03-31,67300000,,248400000,27300000,206200000,176400000,561500000,317800000,317800000,100000,-40800000,,,,34700000,1250000000,932200000,688500000,-69400000,-7500000,213700000,205700000,4146,FMC,quarterly
2020-12-31,,,348887000,4353033000,281894000,66144000,901146000,413499000,413499000,4437000,-76856000,,,,40880000,1192123000,778624000,290977000,-64612000,,308007000,280470000,4156,PLD,quarterly
2020-09-30,,,344675000,4392132000,302694000,74348000,865464000,387358000,387358000,3020000,-80711000,,,,12154000,1156745000,769387000,291281000,-42683000,,332521000,298695000,4156,PLD,quarterly
2020-06-30,,,501449000,4503281000,406173000,64664000,1006612000,535774000,535774000,7979000,-81298000,,,,46511000,1320266000,784492000,313654000,-34325000,,454938000,404539000,4156,PLD,quarterly
2020-03-31,,,552077000,4516428000,491053000,69689000,792779000,362546000,362546000,14574000,-75642000,,,,30913000,1066971000,704425000,274192000,189531000,,521164000,489418000,4156,PLD,quarterly
2020-12-31,,,303000000,,387000000,,2080000000,703000000,703000000,478000000,-482000000,,,,-50000000,5117000000,4414000000,3037000000,-400000000,,353000000,387000000,4188,SO,quarterly
2020-09-30,,,1572000000,4502000000.0,1251000000,-103000000.0,3028000000,1938000000,1938000000,304000000,-447000000,,,,293000000,5620000000,3682000000,2592000000,-366000000,,1279000000,1251000000,4188,SO,quarterly
2020-06-30,,,622000000,4582000000.0,612000000,-105000000.0,2378000000,1163000000,1163000000,447000000,-448000000,,,,5000000,4620000000,3457000000,2242000000,-541000000,,617000000,612000000,4188,SO,quarterly
2020-03-31,,,982000000,4482000000.0,868000000,-120000000.0,2411000000,1344000000,1344000000,330000000,-460000000,,,,145000000,5018000000,3674000000,2607000000,-362000000,,837000000,868000000,4188,SO,quarterly
2021-01-02,44710000,,-494134000,,-332164000,449694000,735275000,206950000,206950000,,-45980000,,,,-161970000,1800843000,1593893000,1065568000,-701084000,,-332164000,-332164000,4198,HBI,quarterly
2020-09-26,44710000,,125394000,,103278000,446355000,664349000,217994000,217994000,,-45673000,,,,22116000,1808266000,1590272000,1143917000,-92600000,,103278000,103278000,4198,HBI,quarterly
2020-06-27,44710000,,194827000,,161181000,360137000,659546000,299409000,299409000,,-43679000,,,,33646000,1738779000,1439370000,1079233000,-104582000,,161181000,161181000,4198,HBI,quarterly
2020-03-28,44710000,,-9209000,,-7874000,430793000,495545000,64752000,64752000,,-38796000,,,,-1335000,1316462000,1251710000,820917000,-73961000,,-7874000,-7874000,4198,HBI,quarterly
2020-12-31,,,234000000,62000000,227000000,162000000,654000000,323000000,323000000,,-69000000,,,,7000000,3102000000,2779000000,2448000000,-89000000,,227000000,227000000,4206,BLL,quarterly
2020-09-30,,,313000000,67000000,241000000,121000000,663000000,382000000,382000000,,-68000000,,,,73000000,3093000000,2711000000,2430000000,-69000000,,240000000,241000000,4206,BLL,quarterly
2020-06-30,,,115000000,68000000,94000000,111000000,571000000,290000000,290000000,,-67000000,,,,23000000,2801000000,2511000000,2230000000,-175000000,,92000000,94000000,4206,BLL,quarterly
2020-03-31,,,19000000,70000000,23000000,131000000,570000000,270000000,270000000,,-71000000,,,,-4000000,2785000000,2515000000,2215000000,-251000000,,23000000,23000000,4206,BLL,quarterly
2020-12-31,,,-341000000,,-338000000,57000000,530000000,-215000000,-215000000,70000000,-96000000,,,,-3000000,831000000,1046000000,301000000,-126000000,,-338000000,-338000000,4208,MRO,quarterly
2020-09-30,,,-310000000,,-317000000,59000000,452000000,-239000000,-239000000,50000000,-62000000,,,,7000000,764000000,1003000000,312000000,-71000000,,-317000000,-317000000,4208,MRO,quarterly
2020-06-30,,,-765000000,,-750000000,81000000,262000000,-542000000,-542000000,100000000,-69000000,,,,-15000000,496000000,1038000000,234000000,-223000000,,-750000000,-750000000,4208,MRO,quarterly
2020-03-31,,,-49000000,,-46000000,76000000,727000000,113000000,113000000,-136000000,-64000000,,,,-3000000,1031000000,918000000,304000000,-162000000,,-46000000,-46000000,4208,MRO,quarterly
2020-12-31,,,867000000,,671000000,,1294000000,1007000000,1007000000,,-160000000,,,,196000000,2573000000,1566000000,1279000000,-140000000,,671000000,671000000,4234,NSC,quarterly
2020-09-30,,,724000000,,569000000,,1156000000,863000000,863000000,,-155000000,,,,155000000,2506000000,1643000000,1350000000,-139000000,,569000000,567000000,4234,NSC,quarterly
2020-06-30,,,503000000,,392000000,,915000000,633000000,633000000,,-156000000,,,,111000000,2085000000,1452000000,1170000000,-130000000,,392000000,392000000,4234,NSC,quarterly
2020-03-31,,,436000000,,381000000,,1267000000,975000000,975000000,,-154000000,,,,55000000,2625000000,1650000000,1358000000,-539000000,,381000000,380000000,4234,NSC,quarterly
2020-12-31,710000000,,37000000,1721000000,135000000,1099000000,2153000000,394000000,394000000,-50000000,-349000000,,,,-178000000,16419000000,16025000000,14266000000,-357000000,-11000000,215000000,135000000,4246,RTX,quarterly
2020-09-30,642000000,,337000000,1731000000,264000000,1014000000,1885000000,301000000,301000000,-72000000,-356000000,,,,152000000,14747000000,14446000000,12862000000,36000000,113000000,185000000,264000000,4246,RTX,quarterly
2020-06-30,695000000,,-3858000000,1702000000,-3835000000,1260000000,2030000000,147000000,147000000,-72000000,-346000000,,,,-38000000,14061000000,13914000000,12031000000,-4005000000,9000000,-3820000000,-3835000000,4246,RTX,quarterly
2020-03-31,535000000,,1131000000,2619000000,-83000000,777000000,2793000000,1480000000,1480000000,1000000,-339000000,,,,639000000,11360000000,9880000000,8567000000,-349000000,-521000000,492000000,-83000000,4246,RTX,quarterly
2020-11-07,,,834000000,-26000000,631000000,5333000000,6822000000,858000000,858000000,,-129000000,,,,202000000,29723000000,28865000000,22901000000,-24000000,,632000000,625000000,4272,KR,quarterly
2020-08-15,,,1061000000,-27000000,819000000,5439000000,6938000000,882000000,882000000,,-135000000,,,,241000000,30489000000,29607000000,23551000000,179000000,,820000000,809000000,4272,KR,quarterly
2020-05-23,,,1585000000,-28000000,1212000000,7835000000,10095000000,1435000000,1435000000,,-174000000,,,,373000000,41549000000,40114000000,31454000000,150000000,,1212000000,1197000000,4272,KR,quarterly
2020-02-01,,,390000000,-29000000,327000000,5977000000,7240000000,608000000,608000000,,-140000000,,,,71000000,28893000000,28285000000,21653000000,-218000000,,319000000,323000000,4272,KR,quarterly
2020-12-31,,,105000000,187000000,104000000,661000000,1206000000,545000000,545000000,,-87000000,,,,2000000,3316000000,2771000000,2110000000,-440000000,,103000000,104000000,4279,FIS,quarterly
2020-09-30,,,143000000,190000000,20000000,667000000,1093000000,426000000,426000000,,-84000000,,,,121000000,3197000000,2771000000,2104000000,-283000000,,22000000,20000000,4279,FIS,quarterly
2020-06-30,,,25000000,190000000,19000000,674000000,916000000,242000000,242000000,,-88000000,,,,4000000,2962000000,2720000000,2046000000,-217000000,,21000000,19000000,4279,FIS,quarterly
2020-03-31,,,-12000000,190000000,15000000,656000000,989000000,333000000,333000000,,-80000000,,,,-30000000,3078000000,2745000000,2089000000,-345000000,,18000000,15000000,4279,FIS,quarterly
2020-12-31,,,3748000000,,3126000000,1472000000,5514000000,3845000000,3845000000,,-136000000,,,,622000000,5687000000,1842000000,173000000,-97000000,,3126000000,3038000000,4282,V,quarterly
2020-09-30,,,3055000000,,2137000000,1537000000,4910000000,3177000000,3177000000,,-168000000,,,,918000000,5101000000,1924000000,191000000,-122000000,,2137000000,2060000000,4282,V,quarterly
2020-06-30,,,2932000000,,2373000000,1468000000,4665000000,3000000000,3000000000,,-142000000,,,,559000000,4837000000,1837000000,172000000,-68000000,,2373000000,2288000000,4282,V,quarterly
2020-03-31,,,3829000000,,3084000000,1547000000,5671000000,3932000000,3932000000,,-118000000,,,,745000000,5854000000,1922000000,183000000,-103000000,,3084000000,2973000000,4282,V,quarterly
2020-12-31,,,3116000000,2211000000,2212000000,11514000000,15763000000,3517000000,3517000000,,-401000000,,,,764000000,65467000000,61950000000,49704000000,-401000000,,2352000000,2212000000,4288,UNH,quarterly
2020-09-30,,,4256000000,4720000000,3172000000,10174000000,15544000000,4651000000,4651000000,,-395000000,,,,1000000000,65115000000,60464000000,49571000000,-395000000,,3256000000,3172000000,4288,UNH,quarterly
2020-06-30,,,8811000000,4733000000,6637000000,10001000000,19959000000,9241000000,9241000000,,-430000000,,,,2115000000,62138000000,52897000000,42179000000,-430000000,,6696000000,6637000000,4288,UNH,quarterly
2020-03-31,,,4559000000,4627000000,3382000000,10015000000,15734000000,4996000000,4996000000,,-437000000,,,,1094000000,64421000000,59425000000,48687000000,-437000000,,3465000000,3382000000,4288,UNH,quarterly
2020-12-31,,,1641000000,105000000,1329000000,3156000000,5474000000,0,2153000000,165000000,,,,,311000000,5474000000,3321000000,0,-512000000,,1330000000,1228000000,4300,TFC,quarterly
2020-09-30,,,1396000000,106000000,1138000000,3093000000,5151000000,0,1836000000,222000000,,,,,255000000,5151000000,3315000000,0,-440000000,,1141000000,1068000000,4300,TFC,quarterly
2020-06-30,,,1149000000,106000000,955000000,3009000000,5027000000,0,1801000000,217000000,,,,,191000000,5027000000,3226000000,0,-652000000,,958000000,902000000,4300,TFC,quarterly
2020-03-31,,,1287000000,167000000,1060000000,2921000000,4718000000,0,1588000000,209000000,,,,,224000000,4718000000,3130000000,0,-301000000,,1063000000,986000000,4300,TFC,quarterly
2020-12-31,,,202295000,77994000,201234000,12201000,177826000,91330000,91330000,,-45887000,,,,496000,269441000,178111000,91615000,110965000,,201799000,195952000,4306,KIM,quarterly
2020-09-30,,,-37041000,80412000,-38394000,28795000,173778000,73279000,73279000,,-46942000,,,,388000,259792000,186513000,86014000,-110320000,,-37429000,-44999000,4306,KIM,quarterly
2020-06-30,,,748169000,79806000,747893000,22504000,158471000,62408000,62408000,,-48015000,,,,51000,238916000,176508000,80445000,685761000,,748118000,736286000,4306,KIM,quarterly
2020-03-31,,,90432000,80821000,90100000,21017000,204849000,114435000,114435000,,-46060000,,,,43000,289744000,175309000,84895000,-24003000,,90389000,83060000,4306,KIM,quarterly
2021-01-02,136697000,,223516000,,201035000,93139000,537752000,300198000,300198000,7718000,-17453000,,,,22481000,1094834000,794636000,557082000,-76682000,,201035000,201035000,4328,QRVO,quarterly
2020-10-03,156342000,,200078000,,136917000,109372000,491550000,222988000,222988000,2848000,-23486000,,,,63161000,1060292000,837304000,568742000,-22910000,,136917000,136917000,4328,QRVO,quarterly
2020-06-27,130071000,,97000000,,96922000,86604000,325789000,106313000,106313000,2801000,-18849000,,,,78000,787451000,681138000,461662000,-9313000,,96922000,96922000,4328,QRVO,quarterly
2020-03-28,127029000,,64635000,,50390000,85111000,337759000,128690000,128690000,-3071000,-18935000,,,,14245000,787772000,659082000,450013000,-64055000,,50390000,50390000,4328,QRVO,quarterly
2020-12-31,38000000,,1056000000,2265000000,770000000,756000000,3186000000,1153000000,1153000000,47000000,-35000000,,,,253000000,7272000000,6119000000,4086000000,-97000000,1000000,803000000,770000000,4375,LIN,quarterly
2020-09-30,36000000,,995000000,2417000000,700000000,729000000,3020000000,1055000000,1055000000,32000000,-38000000,,,,265000000,6855000000,5800000000,3835000000,-60000000,1000000,730000000,700000000,4375,LIN,quarterly
2020-06-30,34000000,,647000000,2400000000,458000000,715000000,2758000000,914000000,914000000,-29000000,-18000000,,,,164000000,6377000000,5463000000,3619000000,-267000000,1000000,483000000,458000000,4375,LIN,quarterly
2020-03-31,44000000,,771000000,2467000000,573000000,816000000,2896000000,950000000,950000000,-56000000,-23000000,,,,165000000,6739000000,5789000000,3843000000,-179000000,2000000,606000000,573000000,4375,LIN,quarterly
2020-12-31,,,-452000000,,-274000000,3037000000,2849000000,-315000000,-315000000,,-72000000,,,,-178000000,19062000000,19377000000,16213000000,-137000000,,-274000000,-274000000,4408,HUM,quarterly
2020-09-30,,,1790000000,,1340000000,2544000000,4464000000,1792000000,1792000000,,-75000000,,,,450000000,20075000000,18283000000,15611000000,-2000000,,1340000000,1340000000,4408,HUM,quarterly
2020-06-30,,,2611000000,,1828000000,2354000000,4908000000,2435000000,2435000000,,-76000000,,,,783000000,19083000000,16648000000,14175000000,176000000,,1828000000,1828000000,4408,HUM,quarterly
2020-03-31,,,725000000,,473000000,2117000000,3306000000,1074000000,1074000000,,-60000000,,,,252000000,18935000000,17861000000,15629000000,-349000000,,473000000,473000000,4408,HUM,quarterly
2020-12-31,,,387000000,,297000000,258000000,884000000,530000000,530000000,,-101000000,,,,90000000,2279000000,1749000000,1395000000,-143000000,,297000000,297000000,4419,URI,quarterly
2020-09-30,,,275000000,,208000000,232000000,898000000,569000000,569000000,,-119000000,,,,67000000,2187000000,1618000000,1289000000,-294000000,,208000000,208000000,4419,URI,quarterly
2020-06-30,,,251000000,,212000000,222000000,711000000,394000000,394000000,,-130000000,,,,39000000,1939000000,1545000000,1228000000,-143000000,,212000000,212000000,4419,URI,quarterly
2020-03-31,,,226000000,,173000000,267000000,763000000,396000000,396000000,,-136000000,,,,53000000,2125000000,1729000000,1362000000,-170000000,,173000000,173000000,4419,URI,quarterly
2020-12-31,,,1710000000,248000000,1359000000,1041000000,2924000000,1883000000,1883000000,,-95000000,,,,331000000,8900000000,7017000000,5976000000,-173000000,,1379000000,1359000000,4444,HON,quarterly
2020-09-30,,,1148000000,246000000,758000000,852000000,2414000000,1562000000,1562000000,,-101000000,,,,367000000,7797000000,6235000000,5383000000,-414000000,,781000000,758000000,4444,HON,quarterly
2020-06-30,,,1219000000,226000000,1081000000,933000000,2201000000,1268000000,1268000000,,-90000000,,,,120000000,7477000000,6209000000,5276000000,-49000000,,1099000000,1081000000,4444,HON,quarterly
2020-03-31,,,1935000000,7000000,1581000000,1238000000,2929000000,1691000000,1691000000,,-73000000,,,,329000000,8463000000,6772000000,5534000000,244000000,,1606000000,1581000000,4444,HON,quarterly
2020-12-31,,,124700000,,135400000,227200000,669900000,170300000,170300000,272400000,-45600000,,,,-10700000,4273500000,4103200000,3603600000,-45600000,,135400000,135400000,4503,UNM,quarterly
2020-09-30,,,299600000,,231100000,253300000,834600000,349000000,349000000,232300000,-49400000,,,,68500000,2996300000,2647300000,2161700000,-49400000,,231100000,231100000,4503,UNM,quarterly
2020-06-30,,,337600000,,265500000,233200000,874600000,385100000,385100000,256300000,-47500000,,,,72100000,3021200000,2636100000,2146600000,-47500000,,265500000,265500000,4503,UNM,quarterly
2020-03-31,,,202100000,,161000000,239500000,722900000,247800000,247800000,235600000,-45700000,,,,41100000,2871100000,2623300000,2148200000,-45700000,,161000000,161000000,4503,UNM,quarterly
2020-12-31,,,249984000,,204240000,,345738000,271393000,271393000,74345000,-21409000,,,,45744000,1228941000,957548000,883203000,-21409000,,204240000,204240000,4505,GL,quarterly
2020-09-30,,,231538000,,188945000,,328609000,253212000,253212000,66730000,-21674000,,,,42593000,1195042000,941830000,866433000,-21674000,,188945000,188945000,4505,GL,quarterly
2020-06-30,,,212241000,,173048000,,307768000,235054000,235054000,64082000,-22813000,,,,39193000,1180884000,945830000,873116000,-22813000,,173048000,173048000,4505,GL,quarterly
2020-03-31,,,202921000,,165540000,,302311000,227004000,227004000,65951000,-20808000,,,,37381000,1133054000,906050000,830743000,-24083000,,165540000,165540000,4505,GL,quarterly
2020-09-30,1000000,,341000000,,249000000,253000000,775000000,422000000,422000000,,-99000000,,,,92000000,2809000000,2387000000,2034000000,-81000000,,249000000,249000000,4525,NRG,quarterly
2020-06-30,2000000,,414000000,,313000000,208000000,804000000,484000000,484000000,,-96000000,,,,101000000,2238000000,1754000000,1434000000,-70000000,,313000000,313000000,4525,NRG,quarterly
2020-03-31,3000000,,144000000,,121000000,209000000,562000000,241000000,241000000,,-98000000,,,,23000000,2019000000,1778000000,1457000000,-97000000,,121000000,121000000,4525,NRG,quarterly
2019-12-31,2000000,,120000000,20000000.0,3383000000,212000000,541000000,215000000,215000000,,-95000000,,,,-3343000000,2195000000,1980000000,1654000000,-95000000,-78000000.0,3463000000,3383000000,4525,NRG,quarterly
2020-12-31,48887000,,214542000,,158988000,348392000,610463000,213184000,213184000,,,,,,55554000,834520000,621336000,224057000,1358000,,158988000,158988000,4599,ALGN,quarterly
2020-09-30,44527000,,184545000,,139371000,312492000,534088000,177069000,177069000,,,,,,45174000,734144000,557075000,200056000,7476000,,139371000,139371000,4599,ALGN,quarterly
2020-06-30,40361000,,-73493000,,-40602000,256967000,224328000,-73000000,-73000000,,,,,,-32891000,352314000,425314000,127986000,-493000,,-40602000,-40602000,4599,ALGN,quarterly
2020-03-31,41532000,,53355000,,1518131000,282906000,394356000,69918000,69918000,,,,,,-1464776000,550963000,481045000,156607000,-16563000,,1518131000,1518131000,4599,ALGN,quarterly
2020-12-31,,,176900000,,150200000,388800000,557400000,168600000,168600000,,-14000000,,,,26700000,1295300000,1126700000,737900000,8300000,,150200000,150200000,4604,CHD,quarterly
2020-09-30,,,261500000,,216200000,342400000,565200000,222800000,222800000,,-13900000,,,,45300000,1241000000,1018200000,675800000,38700000,,216200000,216200000,4604,CHD,quarterly
2020-06-30,,,236000000,,189700000,302900000,559600000,256700000,256700000,,-16800000,,,,46300000,1194300000,937600000,634700000,-20700000,,189700000,189700000,4604,CHD,quarterly
2020-03-31,,,299400000,,229800000,244400000,532000000,287600000,287600000,,-16300000,,,,69600000,1165200000,877600000,633200000,11800000,,229800000,229800000,4604,CHD,quarterly
2020-12-31,141147000,,200180000,,182958000,84099000,414584000,189338000,189338000,,,,,,17222000,648482000,459144000,233898000,10842000,,182958000,182958000,4617,ANET,quarterly
2020-09-30,128049000,,201619000,,168375000,68518000,384962000,188395000,188395000,,,,,,33244000,605431000,417036000,220469000,13224000,,168375000,168375000,4617,ANET,quarterly
2020-06-30,111544000,,175245000,,144793000,65556000,344089000,166989000,166989000,,,,,,30452000,540570000,373581000,196481000,8256000,,144793000,144793000,4617,ANET,quarterly
2020-03-31,107254000,,161819000,,138431000,69535000,338251000,161462000,161462000,,,,,,23388000,523029000,361567000,184778000,357000,,138431000,138431000,4617,ANET,quarterly
2020-12-31,,,1858000000,,1438000000,3601000000,6859000000,0,1995000000,1263000000,,,,,420000000,9462000000,7467000000,2603000000,-137000000,,1438000000,1414000000,4628,AXP,quarterly
2020-09-30,,,1364000000,,1073000000,3230000000,5823000000,0,1360000000,1233000000,,,,,291000000,8086000000,6726000000,2263000000,4000000,,1073000000,1050000000,4628,AXP,quarterly
2020-06-30,,,622000000,,257000000,2711000000,4563000000,0,624000000,1228000000,,,,,365000000,6120000000,5496000000,1557000000,-2000000,,257000000,238000000,4628,AXP,quarterly
2020-03-31,,,452000000,,367000000,3100000000,4841000000,0,432000000,1309000000,,,,,85000000,7689000000,7257000000,2848000000,20000000,,367000000,333000000,4628,AXP,quarterly
2020-12-31,,,402378000,89390000,308708000,31092000,1269541000,414959000,414959000,689560000,-21823000,,,,94644000,3086935000,2671976000,1817394000,-12581000,,307734000,307714000,4630,UHS,quarterly
2020-09-30,,,323264000,76487000,241279000,28488000,1170784000,349670000,349670000,666665000,-25095000,,,,79172000,2912541000,2562871000,1741757000,-26406000,,244092000,240489000,4630,UHS,quarterly
2020-06-30,,,335658000,77212000,251929000,28186000,1138172000,358031000,358031000,625747000,-25790000,,,,79154000,2729754000,2371723000,1591582000,-22373000,,256504000,251105000,4630,UHS,quarterly
2020-03-31,,,190783000,75787000,142037000,28293000,1079171000,236694000,236694000,689790000,-36381000,,,,46323000,2829667000,2592973000,1750496000,-45911000,,144460000,141664000,4630,UHS,quarterly
2020-12-31,,,-21835000,556227000,146394000,25507000,246060000,73378000,73378000,,-54088000,,,,-2631000,431697000,358319000,185637000,-95213000,169427000,-19204000,146129000,4634,PEAK,quarterly
2020-09-30,,,-35407000,566253000,-63417000,21661000,277861000,82570000,82570000,,-56235000,,,,24174000,597739000,515169000,319878000,-117977000,169427000,-59581000,-63768000,4634,PEAK,quarterly
2020-06-30,,,47703000,570048000,51506000,23720000,266972000,64764000,64764000,,-57550000,,,,-7346000,588440000,523676000,321468000,-17061000,169427000,55049000,51131000,4634,PEAK,quarterly
2020-03-31,,,249496000,576935000,279080000,22349000,194289000,-17336000,-17336000,,-58376000,,,,-33044000,585150000,602486000,390861000,266832000,169427000,282540000,277464000,4634,PEAK,quarterly
2020-12-31,39662000,,257251000,,218311000,153179000,466089000,270561000,270561000,,-11058000,,,,38940000,786658000,516097000,320569000,-13310000,,218311000,218311000,4644,WAT,quarterly
2020-09-26,34971000,,150437000,,126769000,129625000,331442000,164189000,164189000,,-10915000,,,,23668000,593784000,429595000,262342000,-13752000,,126769000,126769000,4644,WAT,quarterly
2020-06-27,31155000,,145363000,,122929000,114626000,306850000,158451000,158451000,,-13018000,,,,22434000,519984000,361533000,213134000,-13088000,,122929000,122929000,4644,WAT,quarterly
2020-03-28,34989000,,57863000,,53562000,129921000,254295000,86760000,86760000,,-14079000,,,,4301000,464939000,378179000,210644000,-28897000,,53562000,53562000,4644,WAT,quarterly
2020-12-31,2579000000,,-10451000000,60000000,-10027000000,2480000000,8833000000,1248000000,1248000000,,-345000000,,,,-424000000,11068000000,9820000000,2235000000,-11699000000,,-10027000000,-10027000000,4648,BMY,quarterly
2020-09-30,2273000000,,2257000000,72000000,1872000000,1694000000,8497000000,2039000000,2039000000,,-336000000,,,,379000000,10540000000,8501000000,2043000000,218000000,,1878000000,1872000000,4648,BMY,quarterly
2020-06-30,2129000000,,1627000000,66000000,-85000000,1614000000,8158000000,2026000000,2026000000,,-347000000,,,,1707000000,10129000000,8103000000,1971000000,-399000000,,-80000000,-85000000,4648,BMY,quarterly
2020-03-31,2299000000,,-304000000,66000000,-775000000,1596000000,8555000000,2378000000,2378000000,,-353000000,,,,462000000,10781000000,8403000000,2226000000,-2682000000,,-766000000,-775000000,4648,BMY,quarterly
2020-12-31,,,-7363000000,1492000000,-6226000000,2291000000,3151000000,860000000,860000000,,-55000000,,,,-1189000000,62599000000,61739000000,59448000000,-8223000000,,-6174000000,-6226000000,4654,MCK,quarterly
2020-09-30,,,655000000,1465000000,577000000,2237000000,3000000000,763000000,763000000,,-50000000,,,,28000000,60808000000,60045000000,57808000000,-108000000,,627000000,577000000,4654,MCK,quarterly
2020-06-30,,,645000000,1621000000,444000000,2097000000,2700000000,603000000,603000000,,-60000000,,,,150000000,55679000000,55076000000,52979000000,42000000,-1000000.0,495000000,444000000,4654,MCK,quarterly
2020-03-31,96000000.0,,1201000000,1619000000,1021000000,2929000000,3336000000,858000000,858000000,,-65000000,,,,129000000,58535000000,57677000000,55199000000,343000000,6000000.0,1072000000,1021000000,4654,MCK,quarterly
2020-12-31,51157000,,153307000,,148538000,254083000,466575000,161335000,161335000,,-10818000,,,,4769000,617355000,456020000,150780000,-8028000,,148538000,148538000,4685,ETSY,quarterly
2020-09-30,45908000,,90393000,,91761000,166841000,331310000,118561000,118561000,,-10615000,,,,-1368000,451478000,332917000,120168000,-28168000,,91761000,91761000,4685,ETSY,quarterly
2020-06-30,45233000,,112316000,,96425000,152391000,317356000,119732000,119732000,,-10026000,,,,15891000,428737000,309005000,111381000,-7416000,,96425000,96425000,4685,ETSY,quarterly
2020-03-31,37782000,,9693000,,12522000,81775000,145639000,26082000,26082000,,-9967000,,,,-2829000,228055000,201973000,82416000,-16389000,,12522000,12522000,4685,ETSY,quarterly
2020-12-31,,,263188000,,209851000,138698000,585877000,294233000,294233000,-1797000,-30329000,,,,53337000,617333000,323100000,31456000,-31045000,,209851000,209851000,4687,FLT,quarterly
2020-09-30,,,235410000,,188817000,137630000,465427000,264532000,264532000,-214000,-31383000,,,,46593000,585283000,320751000,119856000,-29122000,,188817000,188817000,4687,FLT,quarterly
2020-06-30,,,211628000,,158488000,129113000,403856000,212811000,212811000,-230000,-32412000,,,,53140000,525146000,312335000,121290000,-1183000,,158488000,158488000,4687,FLT,quarterly
2020-03-31,,,172299000,,147060000,161969000,427390000,200983000,200983000,-38000,-35679000,,,,25239000,661093000,460110000,233703000,-28684000,,147060000,147060000,4687,FLT,quarterly
2020-12-26,5163000000,,33579000000,,28755000000,5631000000,44328000000,33534000000,33534000000,,-638000000,,,,4824000000,111439000000,77905000000,67111000000,45000000,,28755000000,28755000000,4688,AAPL,quarterly
2020-09-26,4978000000,,14901000000,,12673000000,4936000000,24689000000,14775000000,14775000000,,-634000000,,,,2228000000,64698000000,49923000000,40009000000,126000000,,12673000000,12673000000,4688,AAPL,quarterly
2020-06-27,4758000000,,13137000000,,11253000000,4831000000,22680000000,13091000000,13091000000,,-697000000,,,,1884000000,59685000000,46594000000,37005000000,46000000,,11253000000,11253000000,4688,AAPL,quarterly
2020-03-28,4565000000,,13135000000,,11249000000,4952000000,22370000000,12853000000,12853000000,,-757000000,,,,1886000000,58313000000,45460000000,35943000000,282000000,,11249000000,11249000000,4688,AAPL,quarterly
2020-12-31,,,1225000000,312000000,973000000,9297000000,11709000000,2412000000,2412000000,,-678000000,,,,241000000,69306000000,66894000000,57597000000,-1187000000,-9000000,984000000,973000000,4696,CVS,quarterly
2020-09-30,,,1806000000,305000000,1224000000,8414000000,11516000000,3102000000,3102000000,,-731000000,,,,587000000,66852000000,63750000000,55336000000,-1296000000,-9000000,1219000000,1224000000,4696,CVS,quarterly
2020-06-30,,,3960000000,333000000,2975000000,8598000000,13164000000,4566000000,4566000000,,-765000000,,,,974000000,65157000000,60591000000,51993000000,-606000000,-9000000,2986000000,2975000000,4696,CVS,quarterly
2020-03-31,,,2779000000,334000000,2007000000,8494000000,11859000000,3365000000,3365000000,,-733000000,,,,767000000,66593000000,63228000000,54734000000,-586000000,-9000000,2012000000,2007000000,4696,CVS,quarterly
2020-12-31,305000000,,-70000000,239000000,41000000,631000000,1095000000,-22000000,-22000000,,-10000000,,,,-169000000,3207000000,3229000000,2112000000,-48000000,-56000000,99000000,41000000,4707,CTVA,quarterly
2020-09-30,284000000,,-507000000,240000000,-392000000,504000000,566000000,-384000000,-384000000,,-11000000,,,,-117000000,1863000000,2247000000,1297000000,-123000000,-56000000,-390000000,-392000000,4707,CTVA,quarterly
2020-06-30,273000000,,844000000,240000000,760000000,874000000,2362000000,1039000000,1039000000,,-14000000,,,,78000000,5191000000,4152000000,2829000000,-195000000,-56000000,766000000,760000000,4707,CTVA,quarterly
2020-03-31,280000000,,408000000,254000000,272000000,666000000,1687000000,578000000,578000000,,-10000000,,,,127000000,3956000000,3378000000,2269000000,-170000000,1000000,281000000,272000000,4707,CTVA,quarterly
2020-11-30,,,349600000,,272400000,309500000,663800000,354300000,354300000,,-9000000,,,,77200000,983700000,629400000,319900000,-4700000,,272400000,272400000,4725,PAYX,quarterly
2020-08-31,,,276100000,,211600000,341100000,625100000,284000000,284000000,,-9000000,,,,64500000,932200000,648200000,307100000,-7900000,,211600000,211600000,4725,PAYX,quarterly
2020-05-31,,,291600000,,220700000,323800000,623400000,299600000,299600000,,-9100000,,,,70900000,915100000,615500000,291700000,-8000000,,220700000,220700000,4725,PAYX,quarterly
2020-02-29,,,464200000,,354500000,332300000,802400000,470100000,470100000,,-9300000,,,,109700000,1142700000,672600000,340300000,-5900000,,354500000,354500000,4725,PAYX,quarterly
2021-01-02,112800000,,254400000,,191500000,178200000,571100000,280100000,280100000,,-15600000,,,,62900000,1990900000,1710800000,1419800000,-25700000,,191500000,191500000,4729,AVY,quarterly
2020-09-26,112800000,,196800000,,150500000,258300000,484200000,225900000,225900000,,-15600000,,,,46300000,1729100000,1503200000,1244900000,-29100000,,150500000,150500000,4729,AVY,quarterly
2020-06-27,112800000,,101900000,,79700000,219400000,382900000,163500000,163500000,,-20000000,,,,22200000,1528500000,1365000000,1145600000,-61600000,,79700000,79700000,4729,AVY,quarterly
2020-03-28,112800000,,180500000,,134200000,281000000,485100000,204100000,204100000,,-18800000,,,,46300000,1723000000,1518900000,1237900000,-23600000,,134200000,134200000,4729,AVY,quarterly
2020-12-31,,,57000000,,192000000,630000000,1990000000,389000000,389000000,122000000,-333000000,,,,-100000000,18021000000,17632000000,16031000000,-332000000,324000000,157000000,192000000,4733,MPC,quarterly
2020-09-30,,,-1416000000,8061000000.0,-886000000,679000000,1287000000,-400000000,-400000000,178000000,-344000000,,,,-436000000,17430000000,17830000000,16143000000,-1016000000,371000000,-980000000,-886000000,4733,MPC,quarterly
2020-06-30,,,-1416000000,8076000000.0,0,679000000,0,0,-400000000,178000000,-344000000,,,,0,0,0,0,0,371000000,-980000000,-886000000,4733,MPC,quarterly
2020-03-31,,,-12155000000,8108000000.0,-9234000000,818000000,-755000000,-2786000000,-2786000000,251000000,-321000000,,,,-1937000000,25286000000,28072000000,26041000000,-9369000000,371000000,-10218000000,-9234000000,4733,MPC,quarterly
2020-12-31,,,563000000,44000000,445000000,998000000,1723000000,644000000,644000000,81000000,-42000000,,,,111000000,4161000000,3517000000,2438000000,-81000000,,452000000,445000000,4738,EMR,quarterly
2020-09-30,,,765000000,42000000,723000000,946000000,1887000000,926000000,926000000,15000000,-43000000,,,,35000000,4558000000,3632000000,2671000000,-161000000,,730000000,723000000,4738,EMR,quarterly
2020-06-30,,,458000000,47000000,399000000,934000000,1624000000,622000000,622000000,68000000,-49000000,,,,51000000,3914000000,3292000000,2290000000,-164000000,,407000000,399000000,4738,EMR,quarterly
2020-03-31,,,689000000,46000000,517000000,983000000,1759000000,729000000,729000000,47000000,-42000000,,,,165000000,4162000000,3433000000,2403000000,-40000000,,524000000,517000000,4738,EMR,quarterly
2021-01-31,1145000000,,1470000000,,1457000000,433000000,3249000000,1671000000,1671000000,,-53000000,,,,13000000,5003000000,3332000000,1754000000,-201000000,,1457000000,1457000000,4754,NVDA,quarterly
2020-10-25,1047000000,,1348000000,,1336000000,515000000,2960000000,1398000000,1398000000,,-53000000,,,,12000000,4726000000,3328000000,1766000000,-50000000,,1336000000,1336000000,4754,NVDA,quarterly
2020-07-26,997000000,,609000000,,622000000,627000000,2436000000,812000000,812000000,,-54000000,,,,-13000000,3866000000,3054000000,1430000000,-203000000,,622000000,622000000,4754,NVDA,quarterly
2020-04-26,735000000,,981000000,,917000000,293000000,2004000000,976000000,976000000,,-25000000,,,,64000000,3080000000,2104000000,1076000000,5000000,,917000000,917000000,4754,NVDA,quarterly
2021-01-24,,,277082000,,222283000,196380000,450170000,253790000,253790000,,-8227000,,,,54687000,2461147000,2207357000,2010977000,23292000,,222395000,222283000,4767,HRL,quarterly
2020-10-25,31900000.0,,278732000,4778000.0,234356000,158897000,537765000,346968000,346968000,,-8271000,,,,44207000,2420105000,2073137000,1882340000,-68236000,,234525000,234356000,4767,HRL,quarterly
2020-07-26,31900000.0,,259363000,4322000.0,203119000,181085000,422425000,241340000,241340000,,-5724000,,,,56103000,2381457000,2140117000,1959032000,18023000,,203260000,203119000,4767,HRL,quarterly
2020-04-26,31900000.0,,286488000,4140000.0,227734000,193912000,477352000,283440000,283440000,,-3497000,,,,58873000,2422465000,2139025000,1945113000,3048000,,227615000,227734000,4767,HRL,quarterly
2020-12-31,,,324000000,164000000,275000000,8000000,949000000,453000000,453000000,104000000,-188000000,,,,49000000,3288000000,2835000000,2339000000,-129000000,,275000000,275000000,4774,DTE,quarterly
2020-09-30,,,540000000,165000000,476000000,5000000,1061000000,597000000,597000000,103000000,-178000000,,,,63000000,3284000000,2687000000,2223000000,-57000000,,477000000,475000000,4774,DTE,quarterly
2020-06-30,,,283000000,168000000,277000000,6000000,856000000,416000000,416000000,84000000,-179000000,,,,6000000,2583000000,2167000000,1727000000,-133000000,,277000000,277000000,4774,DTE,quarterly
2020-03-31,,,391000000,166000000,340000000,9000000,1008000000,527000000,527000000,119000000,-175000000,,,,49000000,3022000000,2495000000,2014000000,-136000000,,342000000,339000000,4774,DTE,quarterly
2020-12-31,89000000,,171700000,,146700000,323800000,581000000,168200000,168200000,,,,,,25000000,748000000,579800000,167000000,3500000,,146700000,146700000,4786,FTNT,quarterly
2020-09-30,90000000,,128400000,,123400000,296100000,511900000,125800000,125800000,,,,,,5000000,651100000,525300000,139200000,2600000,,123400000,123400000,4786,FTNT,quarterly
2020-06-30,82100000,,124500000,,114400000,282700000,483300000,118500000,118500000,,,,,,10100000,618400000,499900000,135100000,6000000,,114400000,114400000,4786,FTNT,quarterly
2020-03-31,80300000,,117100000,,104000000,288800000,448200000,79100000,79100000,,,,,,13100000,576900000,497800000,128700000,38000000,,104000000,104000000,4786,FTNT,quarterly
2020-12-31,,,548000000,1321000000,397000000,893000000,1524000000,631000000,631000000,,-111000000,,,,111000000,3675000000,3044000000,2151000000,-83000000,,437000000,397000000,4820,L,quarterly
2020-09-30,,,183000000,1248000000,139000000,866000000,1196000000,330000000,330000000,,-137000000,,,,21000000,3465000000,3135000000,2269000000,-147000000,,162000000,139000000,4820,L,quarterly
2020-06-30,,,-1074000000,1209000000,-835000000,972000000,41000000,-931000000,-931000000,,-123000000,,,,-228000000,2310000000,3241000000,2269000000,-143000000,,-846000000,-835000000,4820,L,quarterly
2020-03-31,,,-1121000000,2212000000,-632000000,1252000000,1049000000,-203000000,-203000000,,-144000000,,,,-77000000,3099000000,3302000000,2050000000,-918000000,,-1044000000,-632000000,4820,L,quarterly
2020-12-31,,,201300000,4900000,235400000,343700000,1112000000,480300000,480300000,20500000,-70600000,,,,-35000000,2573200000,2092900000,1461200000,-279000000,,236300000,235400000,4949,RSG,quarterly
2020-09-30,,,318700000,4000000,260000000,256100000,1036700000,489200000,489200000,20700000,-88900000,,,,58500000,2572100000,2082900000,1535400000,-170500000,,260200000,260000000,4949,RSG,quarterly
2020-06-30,,,300100000,3800000,225500000,260300000,986300000,436100000,436100000,20800000,-91600000,,,,73800000,2454400000,2018300000,1468100000,-136000000,,226300000,225500000,4949,RSG,quarterly
2020-03-31,,,322600000,3000000,246300000,273000000,995800000,433300000,433300000,20900000,-96600000,,,,75800000,2553900000,2120600000,1558100000,-110700000,,246800000,246300000,4949,RSG,quarterly
2020-12-31,,,410440000,427334000,313765000,876050000,1566071000,566888000,566888000,,-15958000,,,,95054000,6910501000,6343613000,5344430000,-156448000,,315386000,313765000,4960,CBRE,quarterly
2020-09-30,,,233902000,41206000,184132000,754527000,1096263000,214011000,214011000,,-17829000,,,,49062000,5645142000,5431131000,4548879000,19891000,,184840000,184132000,4960,CBRE,quarterly
2020-06-30,,,100915000,41057000,81897000,740606000,989247000,132257000,132257000,,-17950000,,,,18803000,5381384000,5249127000,4392137000,-31342000,,82112000,81897000,4960,CBRE,quarterly
2020-03-31,,,224712000,40204000,172195000,790066000,1176494000,272634000,272634000,,-16016000,,,,51182000,5889168000,5616534000,4712674000,-47922000,,173530000,172195000,4960,CBRE,quarterly
2020-12-31,,,219144000,,184453000,581178000,705998000,117820000,117820000,,-15008000,,,,34691000,1403766000,1285946000,697768000,101324000,,184453000,184453000,4967,UA,quarterly
2020-09-30,,,35232000,,38946000,555049000,686320000,131271000,131271000,,-14955000,,,,-3714000,1433021000,1301750000,746701000,-96039000,,38946000,38946000,4967,UA,quarterly
2020-06-30,,,-186032000,,-182895000,484206000,349169000,-135037000,-135037000,,-11336000,,,,-3137000,707640000,842677000,358471000,-50995000,,-182895000,-182895000,4967,UA,quarterly
2020-03-31,,,-568134000,,-589681000,552001000,430984000,-121017000,-121017000,,-5960000,,,,21547000,930240000,1051257000,499256000,-447117000,,-589681000,-589681000,4967,UA,quarterly
2020-11-30,,,1456000000,,1251000000,3160000000,4877000000,1717000000,1717000000,,-76000000,,,,205000000,11243000000,9526000000,6366000000,-261000000,,1251000000,1251000000,4988,NKE,quarterly
2020-08-31,,,1715000000,,1518000000,2835000000,4741000000,1906000000,1906000000,,-72000000,,,,197000000,10594000000,8688000000,5853000000,-191000000,,1518000000,1518000000,4988,NKE,quarterly
2020-05-31,,,-804000000,,-790000000,3191000000,2353000000,-838000000,-838000000,,-61000000,,,,-14000000,6313000000,7151000000,3960000000,34000000,,-790000000,-790000000,4988,NKE,quarterly
2020-02-29,,,881000000,,847000000,3283000000,4473000000,1190000000,1190000000,,-28000000,,,,34000000,10104000000,8914000000,5631000000,-309000000,,847000000,847000000,4988,NKE,quarterly
2020-11-29,,,105700000,,96000000,108700000,315400000,120700000,120700000,,-14600000,,,,8800000,1656500000,1535800000,1341100000,-15000000,-900000,96900000,96000000,4999,DRI,quarterly
2020-08-30,,,32500000,,36100000,116800000,301300000,96900000,96900000,,-16600000,,,,-4800000,1527400000,1430500000,1226100000,-64400000,-1200000,37300000,36100000,4999,DRI,quarterly
2020-05-31,,,-610300000,,-480000000,116600000,10500000,-200500000,-200500000,,-24800000,,,,-130600000,1270100000,1470600000,1259600000,-409800000,-300000,-479700000,-480000000,4999,DRI,quarterly
2020-02-23,,,265100000,,232300000,171900000,538000000,278400000,278400000,,-13200000,,,,31800000,2346500000,2068100000,1808500000,-13300000,-1000000,233300000,232300000,4999,DRI,quarterly
2020-12-31,,,403236000,,308029000,227019000,943491000,536447000,536447000,27377000,-176931000,,,,95207000,2570577000,2034130000,1627086000,-133211000,,308029000,307754000,5004,OKE,quarterly
2020-09-30,,,418871000,,312316000,178148000,908590000,545816000,545816000,31381000,-176371000,,,,106555000,2174264000,1628448000,1265674000,-126945000,,312316000,312041000,5004,OKE,quarterly
2020-06-30,,,177461000,,134321000,194738000,720271000,350791000,350791000,34326000,-218968000,,,,43140000,1660729000,1309938000,940458000,-173330000,,134321000,134046000,5004,OKE,quarterly
2020-03-31,,,-197252000,,-141857000,179696000,859744000,515751000,515751000,31944000,-140616000,,,,-55395000,2136672000,1620921000,1276928000,-713003000,,-141857000,-142132000,5004,OKE,quarterly
2020-12-31,,,219144000,,184453000,581178000,705998000,117820000,117820000,,-15008000,,,,34691000,1403766000,1285946000,697768000,101324000,,184453000,184453000,5007,UAA,quarterly
2020-09-30,,,35232000,,38946000,555049000,686320000,131271000,131271000,,-14955000,,,,-3714000,1433021000,1301750000,746701000,-96039000,,38946000,38946000,5007,UAA,quarterly
2020-06-30,,,-186032000,,-182895000,484206000,349169000,-135037000,-135037000,,-11336000,,,,-3137000,707640000,842677000,358471000,-50995000,,-182895000,-182895000,5007,UAA,quarterly
2020-03-31,,,-568134000,,-589681000,552001000,430984000,-121017000,-121017000,,-5960000,,,,21547000,930240000,1051257000,499256000,-447117000,,-589681000,-589681000,5007,UAA,quarterly
2020-11-30,,,328533000,,284857000,467012000,819884000,352872000,352872000,,-24557000,,,,43676000,1757048000,1404176000,937164000,-24339000,,284857000,282842000,5009,CTAS,quarterly
2020-08-31,,,325220000,,300005000,476495000,826201000,349706000,349706000,,-24550000,,,,25215000,1746575000,1396869000,920374000,-24486000,,300005000,297832000,5009,CTAS,quarterly
2020-05-31,,,181678000,,144585000,491166000,707820000,216654000,216654000,,-25952000,,,,37093000,1619584000,1402930000,911764000,-34976000,,144585000,143291000,5009,CTAS,quarterly
2020-02-29,,,289056000,,234520000,509743000,824395000,314652000,314652000,,-25943000,,,,54536000,1810648000,1495996000,986253000,-25596000,,234520000,232327000,5009,CTAS,quarterly
2020-12-31,,,-110000000,134000000,-102000000,82000000,511000000,2819000000,2819000000,121000000,-64000000,,,,-37000000,1350000000,-1469000000,839000000,-2929000000,-25000000,-73000000,-103000000,5037,DVN,quarterly
2020-09-30,,,-193000000,125000000,-92000000,75000000,409000000,-95000000,-95000000,91000000,-65000000,,,,-90000000,1112000000,1207000000,703000000,-98000000,13000000,-103000000,-94000000,5037,DVN,quarterly
2020-06-30,,,-680000000,126000000,-670000000,79000000,160000000,-608000000,-608000000,381000000,-65000000,,,,-3000000,730000000,1338000000,570000000,-72000000,9000000,-677000000,-670000000,5037,DVN,quarterly
2020-03-31,,,-2107000000,121000000,-1816000000,102000000,477000000,734000000,734000000,-762000000,-65000000,,,,-417000000,1311000000,577000000,834000000,-2841000000,-125000000,-1690000000,-1817000000,5037,DVN,quarterly
2020-12-31,,,304000000,206000000,224000000,442000000,741000000,229000000,229000000,,-99000000,,,,74000000,4087000000,3858000000,3346000000,75000000,,230000000,224000000,5061,FOXA,quarterly
2020-09-30,,,1479000000,325000000,1106000000,388000000,1549000000,1093000000,1093000000,,-99000000,,,,362000000,2717000000,1624000000,1168000000,386000000,,1117000000,1106000000,5061,FOXA,quarterly
2020-06-30,,,200000000,322000000,122000000,494000000,1231000000,643000000,643000000,,-100000000,,,,55000000,2418000000,1775000000,1187000000,-443000000,,145000000,122000000,5061,FOXA,quarterly
2020-03-31,,,145000000,277000000,78000000,464000000,1379000000,858000000,858000000,,-89000000,,,,55000000,3440000000,2582000000,2061000000,-713000000,,90000000,78000000,5061,FOXA,quarterly
2020-12-31,376000000,,2892000000,,2498000000,2067000000,5557000000,3114000000,3114000000,,-132000000,,,,394000000,10550000000,7436000000,4993000000,-222000000,,2498000000,2498000000,5108,TMO,quarterly
2020-09-26,296000000,,2252000000,,1933000000,1647000000,4332000000,2389000000,2389000000,,-149000000,,,,319000000,8521000000,6132000000,4189000000,-137000000,,1933000000,1933000000,5108,TMO,quarterly
2020-06-27,264000000,,1253000000,,1156000000,1668000000,3379000000,1447000000,1447000000,,-139000000,,,,97000000,6917000000,5470000000,3538000000,-194000000,,1156000000,1156000000,5108,TMO,quarterly
2020-03-28,245000000,,828000000,,788000000,1545000000,2742000000,952000000,952000000,,-133000000,,,,40000000,6230000000,5278000000,3488000000,-124000000,,788000000,788000000,5108,TMO,quarterly
2020-12-31,,,6253000000,1430000000,4588000000,8493000000,19870000000,7180000000,7180000000,,-1080000000,,,,1535000000,34692000000,27512000000,14822000000,-927000000,,4718000000,4588000000,5127,VZ,quarterly
2020-09-30,,,5851000000,1461000000,4357000000,7043000000,19209000000,7974000000,7974000000,,-1044000000,,,,1347000000,31543000000,23569000000,12334000000,-2123000000,,4504000000,4357000000,5127,VZ,quarterly
2020-06-30,,,6187000000,1416000000,4700000000,7024000000,18698000000,7493000000,7493000000,,-1089000000,,,,1348000000,30447000000,22954000000,11749000000,-1306000000,,4839000000,4700000000,5127,VZ,quarterly
2020-03-31,,,5676000000,1443000000,4156000000,7289000000,19314000000,7875000000,7875000000,,-1034000000,,,,1389000000,31610000000,23735000000,12296000000,-2199000000,,4287000000,4156000000,5127,VZ,quarterly
2021-01-02,,,53000000,7000000,50000000,185000000,554000000,340000000,340000000,,-267000000,,,,3000000,1108000000,768000000,554000000,-287000000,,50000000,-23000000,5166,TDG,quarterly
2020-09-30,,,76000000,4000000,82000000,167000000,560000000,352000000,352000000,,-267000000,,,,-25000000,1173000000,821000000,613000000,-276000000,-19000000.0,101000000,82000000,5166,TDG,quarterly
2020-06-27,,,34000000,4000000,-6000000,154000000,510000000,314000000,314000000,,-262000000,,,,39000000,1022000000,708000000,512000000,-280000000,-1000000.0,-5000000,-6000000,5166,TDG,quarterly
2020-03-28,,,337000000,4000000,319000000,173000000,820000000,601000000,601000000,,-252000000,,,,14000000,1443000000,842000000,623000000,-264000000,-4000000.0,323000000,319000000,5166,TDG,quarterly
2020-12-31,,,-44000000,218000000,43000000,-79000000,1655000000,582000000,582000000,660000000,-304000000,,,,-93000000,2960000000,2378000000,1305000000,-626000000,,49000000,43000000,5171,ED,quarterly
2020-09-30,,,621000000,217000000,493000000,94000000,2015000000,766000000,766000000,673000000,-231000000,,,,119000000,3333000000,2567000000,1318000000,-145000000,,502000000,493000000,5171,ED,quarterly
2020-06-30,,,211000000,216000000,190000000,94000000,1559000000,385000000,385000000,604000000,-249000000,,,,9000000,2719000000,2334000000,1160000000,-174000000,,202000000,190000000,5171,ED,quarterly
2020-03-31,,,447000000,206000000,375000000,69000000,1916000000,739000000,739000000,638000000,-325000000,,,,55000000,3234000000,2495000000,1318000000,-292000000,,392000000,375000000,5171,ED,quarterly
2020-12-31,,,3302000000,1033000000,2992000000,12641000000,18175000000,0,4083000000,1451000000,,,,,108000000,18175000000,14092000000,0,-781000000,,3194000000,2642000000,5195,WFC,quarterly
2020-09-30,,,2864000000,859000000,2035000000,12461000000,18100000000,0,3589000000,2050000000,,,,,645000000,18100000000,14511000000,0,-725000000,,2219000000,1720000000,5195,WFC,quarterly
2020-06-30,,,-6249000000,736000000,-2379000000,10481000000,8332000000,0,-6032000000,3883000000,,,,,-3917000000,8332000000,14364000000,0,-217000000,,-2332000000,-2694000000,5195,WFC,quarterly
2020-03-31,,,664000000,612000000,653000000,9871000000,13712000000,0,805000000,3036000000,,,,,159000000,13712000000,12907000000,0,-141000000,,505000000,42000000,5195,WFC,quarterly
2020-12-31,228000000,,330000000,191000000,252000000,455000000,1273000000,556000000,556000000,,-75000000,,,,78000000,3350000000,2794000000,2077000000,-226000000,,252000000,227000000,5202,GLW,quarterly
2020-09-30,213000000,,450000000,197000000,427000000,447000000,1125000000,432000000,432000000,,-70000000,,,,23000000,3001000000,2569000000,1876000000,18000000,,427000000,403000000,5202,GLW,quarterly
2020-06-30,218000000,,-49000000,84000000,-71000000,364000000,854000000,244000000,244000000,,-67000000,,,,22000000,2561000000,2317000000,1707000000,-293000000,,-71000000,-96000000,5202,GLW,quarterly
2020-03-31,261000000,,-108000000,89000000,-96000000,382000000,697000000,28000000,28000000,,-64000000,,,,-12000000,2391000000,2363000000,1694000000,-136000000,,-96000000,-120000000,5202,GLW,quarterly
2021-01-02,,,272000000,21700000,208900000,294500000,585700000,291200000,291200000,,-15300000,,,,58200000,1167800000,876600000,582100000,-19200000,,213800000,208900000,5204,SNA,quarterly
2020-09-26,,,239800000,21800000,179700000,280400000,535800000,255400000,255400000,,-13800000,,,,55100000,1027400000,772000000,491600000,-15600000,,184700000,179700000,5204,SNA,quarterly
2020-06-27,,,137800000,21900000,101200000,243000000,403900000,160900000,160900000,,-13400000,,,,31900000,808900000,648000000,405000000,-23100000,,105900000,101200000,5204,SNA,quarterly
2020-03-28,,,185900000,22100000,137200000,277300000,483500000,206200000,206200000,,-11300000,,,,43900000,938100000,731900000,454600000,-20300000,,142000000,137200000,5204,SNA,quarterly
2020-12-31,,,944000000,,738000000,803000000,1944000000,0,1275000000,-134000000,,,,,206000000,1944000000,669000000,0,-331000000,,738000000,728000000,5208,SYF,quarterly
2020-09-30,,,412000000,,313000000,757000000,1479000000,0,456000000,266000000,,,,,99000000,1479000000,1023000000,0,-44000000,,313000000,303000000,5208,SYF,quarterly
2020-06-30,,,59000000,,48000000,723000000,1045000000,0,59000000,263000000,,,,,11000000,1045000000,986000000,0,0,,48000000,37000000,5208,SYF,quarterly
2020-03-31,,,382000000,,286000000,755000000,1384000000,0,382000000,247000000,,,,,96000000,1384000000,1002000000,0,0,,286000000,275000000,5208,SYF,quarterly
2020-12-31,37577000,,263400000,3531000,291387000,504428000,964280000,422275000,422275000,,-38720000,,,,-27930000,2185244000,1762969000,1220964000,-158875000,,291330000,291387000,5210,HSY,quarterly
2020-09-27,37577000,,562508000,2959000,447283000,473395000,1080024000,606629000,606629000,,-38056000,,,,115250000,2219829000,1613200000,1139805000,-44121000,,447258000,447283000,5210,HSY,quarterly
2020-06-28,37577000,,334077000,2484000,268901000,410110000,792552000,382442000,382442000,,-38856000,,,,66035000,1707329000,1324887000,914777000,-48365000,,268042000,268901000,5210,HSY,quarterly
2020-03-29,37577000,,335012000,3310000,271137000,466452000,866622000,400170000,400170000,,-37839000,,,,66229000,2037317000,1637147000,1170695000,-65158000,,268783000,271137000,5210,HSY,quarterly
2020-12-31,96510000,,257872000,,215632000,193524000,567198000,261712000,261712000,,-2444000,,,,42240000,623686000,361974000,56488000,-3840000,,215632000,215632000,5212,ANSS,quarterly
2020-09-30,86616000,,90144000,,75627000,131093000,323491000,91634000,91634000,,-1853000,,,,14517000,366965000,275331000,43474000,-1490000,,75627000,75627000,5212,ANSS,quarterly
2020-06-30,86133000,,112585000,,96564000,128389000,341565000,113116000,113116000,,-3040000,,,,16021000,385661000,272545000,44096000,-531000,,96564000,96564000,5212,ANSS,quarterly
2020-03-31,86112000,,33324000,,46064000,129522000,264421000,35073000,35073000,,-3651000,,,,-12740000,304985000,269912000,40564000,-1749000,,46064000,46064000,5212,ANSS,quarterly
2020-12-31,16466000000,,7787000000,,7222000000,23428000000,46271000000,6873000000,6873000000,-496000000,-414000000,,,,565000000,125555000000,118682000000,79284000000,914000000,,7222000000,7222000000,5215,AMZN,quarterly
2020-09-30,9334000000,,6900000000,,6331000000,23449000000,39039000000,6194000000,6194000000,62000000,-428000000,,,,569000000,96145000000,89951000000,57106000000,706000000,,6331000000,6331000000,5215,AMZN,quarterly
2020-06-30,8945000000,,6227000000,,5243000000,21174000000,36252000000,5843000000,5843000000,290000000,-403000000,,,,984000000,88912000000,83069000000,52660000000,384000000,,5243000000,5243000000,5215,AMZN,quarterly
2020-03-31,9325000000,,3279000000,,2535000000,17811000000,31195000000,3989000000,3989000000,70000000,-402000000,,,,744000000,75452000000,71463000000,44257000000,-741000000,,2535000000,2535000000,5215,AMZN,quarterly
2020-12-31,,,689000000,,582000000,913000000,1817000000,0,743000000,159000000,,,,,114000000,1817000000,1074000000,0,-54000000,7000000,575000000,556000000,5216,KEY,quarterly
2020-09-30,,,484000000,,428000000,852000000,1521000000,0,504000000,165000000,,,,,60000000,1521000000,1017000000,0,-20000000,4000000,424000000,401000000,5216,KEY,quarterly
2020-06-30,,,215000000,,187000000,831000000,1228000000,0,247000000,150000000,,,,,30000000,1228000000,981000000,0,-32000000,2000000,185000000,161000000,5216,KEY,quarterly
2020-03-31,,,168000000,,146000000,771000000,1099000000,0,197000000,131000000,,,,,23000000,1099000000,902000000,0,-29000000,1000000,145000000,119000000,5216,KEY,quarterly
2020-12-31,,,352000000,,332000000,306000000,823000000,521000000,521000000,-4000000,-147000000,,,,20000000,1743000000,1222000000,920000000,-169000000,,332000000,332000000,5241,YUM,quarterly
2020-09-30,,,316000000,,283000000,228000000,723000000,502000000,502000000,-7000000,-161000000,,,,33000000,1448000000,946000000,725000000,-186000000,,283000000,283000000,5241,YUM,quarterly
2020-06-30,,,257000000,,206000000,208000000,549000000,346000000,346000000,-5000000,-132000000,,,,51000000,1198000000,852000000,649000000,-89000000,,206000000,206000000,5241,YUM,quarterly
2020-03-31,,,95000000,,83000000,205000000,597000000,401000000,401000000,-9000000,-118000000,,,,12000000,1263000000,862000000,666000000,-306000000,,83000000,83000000,5241,YUM,quarterly
2020-12-31,,,137000000,142000000,115000000,-31000000,598000000,242000000,242000000,111000000,-108000000,,,,21000000,1272000000,1030000000,674000000,-105000000,,116000000,115000000,5252,AEE,quarterly
2020-09-30,,,432000000,142000000,367000000,-32000000,895000000,526000000,526000000,128000000,-110000000,,,,63000000,1557000000,1031000000,662000000,-94000000,,369000000,367000000,5252,AEE,quarterly
2020-06-30,,,294000000,142000000,243000000,-30000000,744000000,384000000,384000000,119000000,-108000000,,,,50000000,1336000000,952000000,592000000,-90000000,,244000000,243000000,5252,AEE,quarterly
2020-03-31,,,169000000,142000000,146000000,-23000000,621000000,264000000,264000000,125000000,-93000000,,,,21000000,1375000000,1111000000,754000000,-95000000,,148000000,146000000,5252,AEE,quarterly
2020-12-31,100794000,,222926000,,196332000,135525000,449790000,207212000,207212000,508000,-6351000,,,,26594000,758969000,551757000,309179000,15714000,,196332000,196332000,5281,TER,quarterly
2020-09-27,94909000,,263731000,,222718000,115840000,458928000,241869000,241869000,91000,-6237000,,,,41013000,819484000,577615000,360556000,21862000,,222718000,222718000,5281,TER,quarterly
2020-06-28,94102000,,217291000,,188908000,113259000,471473000,254308000,254308000,863000,-6043000,,,,28383000,838661000,584353000,367188000,-37017000,,188908000,188908000,5281,TER,quarterly
2020-03-29,85159000,,197069000,,176191000,111388000,405550000,198757000,198757000,355000,-5551000,,,,20878000,704355000,505598000,298805000,-1688000,,176191000,176191000,5281,TER,quarterly
2020-11-30,,,310503000,,235300000,478800000,807875000,329078000,329078000,-3000,-19462000,,,,75203000,5473444000,5144366000,4665569000,-18575000,,235300000,235300000,5298,KMX,quarterly
2020-08-31,,,388341000,,296696000,490208000,899338000,409130000,409130000,-3000,-22469000,,,,91645000,5652266000,5243136000,4752928000,-20789000,,296696000,296696000,5298,KMX,quarterly
2020-05-31,,,4164000,,4978000,414016000,405133000,-8883000,-8883000,-3000,-23958000,,,,-814000,3511282000,3520165000,3106149000,13047000,,4978000,4978000,5298,KMX,quarterly
2020-02-29,,,276633000,,214934000,484796000,784764000,300036000,300036000,-68000,-22307000,,,,61699000,5245790000,4945754000,4461026000,-23403000,,214934000,214934000,5298,KMX,quarterly
2020-12-31,374000000,,947000000,47000000,780000000,1276000000,2843000000,1200000000,1200000000,-7000000,-130000000,,,,167000000,11235000000,10035000000,8392000000,-253000000,,780000000,780000000,5364,CAT,quarterly
2020-09-30,344000000,,858000000,45000000,668000000,933000000,2370000000,1110000000,1110000000,-17000000,-136000000,,,,187000000,9881000000,8771000000,7511000000,-252000000,,671000000,668000000,5364,CAT,quarterly
2020-06-30,341000000,,686000000,43000000,458000000,1020000000,2245000000,912000000,912000000,-28000000,-135000000,,,,227000000,9997000000,9085000000,7752000000,-226000000,,459000000,458000000,5364,CAT,quarterly
2020-03-31,356000000,,1518000000,42000000,1092000000,606000000,2645000000,1711000000,1711000000,-28000000,-113000000,,,,425000000,10635000000,8924000000,7990000000,-193000000,,1093000000,1092000000,5364,CAT,quarterly
2020-12-31,210100000,,16800000,,36200000,154500000,845800000,249600000,249600000,,-86500000,,,,-19400000,1352100000,1102500000,506300000,-232800000,,36200000,36200000,5370,MCHP,quarterly
2020-09-30,199800000,,88800000,,73600000,145000000,807900000,230200000,230200000,,-93300000,,,,15200000,1309500000,1079300000,501600000,-141400000,,73600000,73600000,5370,MCHP,quarterly
2020-06-30,198000000,,89500000,,123600000,146600000,798300000,218300000,218300000,,-99100000,,,,-34100000,1309700000,1091400000,511400000,-128800000,,123600000,123600000,5370,MCHP,quarterly
2020-03-31,221800000,,45800000,,99900000,166800000,813900000,176800000,176800000,,-115400000,,,,-54100000,1326400000,1149600000,512500000,-131000000,,99900000,99900000,5370,MCHP,quarterly
2020-12-31,486936000,,506417000,,542156000,1038104000,2479282000,954242000,954242000,,-197186000,,,,-35739000,6644442000,5690200000,4165160000,-447825000,,542156000,542156000,5371,NFLX,quarterly
2020-09-30,453802000,,861460000,,789976000,799221000,2567886000,1314863000,1314863000,,-197079000,,,,71484000,6435637000,5120774000,3867751000,-453403000,,789976000,789976000,5371,NFLX,quarterly
2020-06-30,435045000,,1035602000,,720196000,711606000,2504579000,1357928000,1357928000,,-189151000,,,,315406000,6148286000,4790358000,3643707000,-322326000,,720196000,720196000,5371,NFLX,quarterly
2020-03-31,453817000,,795870000,,709067000,755917000,2167990000,958256000,958256000,,-184083000,,,,86803000,5767691000,4809435000,3599701000,-162386000,,709067000,709067000,5371,NFLX,quarterly
2020-12-31,39866000,,269180000,,216295000,223208000,559044000,281313000,281313000,,-9505000,,,,52885000,937985000,656672000,378941000,-12133000,,216295000,216295000,5374,MTD,quarterly
2020-09-30,34656000,,205809000,,161767000,201873000,469608000,218958000,218958000,,-9310000,,,,44042000,807357000,588399000,337749000,-13149000,,161767000,161767000,5374,MTD,quarterly
2020-06-30,31193000,,155255000,,126562000,187182000,397970000,165706000,165706000,,-9582000,,,,28693000,690673000,524967000,292703000,-10451000,,126562000,126562000,5374,MTD,quarterly
2020-03-31,34387000,,118499000,,98115000,195757000,374409000,130267000,130267000,,-10219000,,,,20384000,649162000,518895000,274753000,-11768000,,98115000,98115000,5374,MTD,quarterly
2020-12-31,71700000,,521800000,,405800000,120700000,712800000,520400000,520400000,,,,,,116000000,5568600000,5048200000,4855800000,1400000,,405800000,405800000,5402,PCAR,quarterly
2020-09-30,64700000,,489900000,,385500000,85600000,635600000,485300000,485300000,,-2200000.0,,,,104400000,4936000000,4450700000,4300400000,4600000,,385500000,385500000,5402,PCAR,quarterly
2020-06-30,66500000,,184000000,,147700000,80300000,315900000,169100000,169100000,,-2200000.0,,,,36300000,3062200000,2893100000,2746300000,14900000,,147700000,147700000,5402,PCAR,quarterly
2020-03-31,71000000,,462200000,,359400000,122300000,636700000,443400000,443400000,,-27300000.0,,,,102800000,5161700000,4718300000,4525000000,18800000,,359400000,359400000,5402,PCAR,quarterly
2020-12-31,,,24905000,2343529000,9935000,31053000,324731000,125665000,125665000,,-111991000,,,,0,582380000,456715000,257649000,-100760000,,24905000,7310000,5412,BXP,quarterly
2020-09-30,,,118060000,2365470000,92479000,27862000,424219000,229901000,229901000,,-110993000,,,,0,685951000,456050000,261732000,-111841000,,118060000,89854000,5412,BXP,quarterly
2020-06-30,,,298580000,2365079000,269605000,37743000,408421000,192490000,192490000,,-105607000,,,,0,650513000,458023000,242092000,106090000,,298580000,265830000,5412,BXP,quarterly
2020-03-31,,,577146000,2373017000,500332000,36454000,480169000,272621000,272621000,,-103126000,,,,0,750571000,477950000,270402000,304525000,,577146000,497707000,5412,BXP,quarterly
2020-12-31,,,-15553000000,17567000000,-13883000000,10182000000,22781000000,5620000000,5620000000,,-1894000000,,,,-2038000000,45691000000,40071000000,22910000000,-21173000000,,-13515000000,-13938000000,5430,T,quarterly
2020-09-30,,,3934000000,19503000000,2816000000,8248000000,22501000000,7223000000,7223000000,,-1972000000,,,,766000000,42340000000,35117000000,19839000000,-3289000000,,3168000000,2762000000,5430,T,quarterly
2020-06-30,,,2498000000,17557000000,1281000000,8811000000,22967000000,6871000000,6871000000,,-2041000000,,,,935000000,40950000000,34079000000,17983000000,-4373000000,,1563000000,1229000000,5430,T,quarterly
2020-03-31,,,6265000000,17670000000,4610000000,7773000000,23498000000,8503000000,8503000000,,-2018000000,,,,1302000000,42779000000,34276000000,19281000000,-2238000000,,4963000000,4578000000,5430,T,quarterly
2021-01-01,,,245000000,9000000,197000000,187000000,491000000,302000000,302000000,,-49000000,,,,48000000,3252000000,2950000000,2761000000,-57000000,,197000000,197000000,5432,LDOS,quarterly
2020-10-02,,,214000000,9000000,163000000,200000000,468000000,266000000,266000000,,-44000000,,,,51000000,3242000000,2976000000,2774000000,-52000000,,163000000,163000000,5432,LDOS,quarterly
2020-07-03,,,192000000,9000000,153000000,195000000,383000000,269000000,269000000,,-41000000,,,,38000000,2914000000,2645000000,2531000000,-77000000,,154000000,153000000,5432,LDOS,quarterly
2020-04-03,,,130000000,4000000,115000000,197000000,395000000,198000000,198000000,,-48000000,,,,15000000,2889000000,2691000000,2494000000,-68000000,,115000000,115000000,5432,LDOS,quarterly
2020-12-31,247940000,,224019000,,222116000,206403000,856117000,401774000,401774000,,-40166000,,,,1903000,1289041000,887267000,432924000,-177755000,,222116000,222116000,5434,TWTR,quarterly
2020-09-30,208877000,,29683000,,28659000,309861000,574845000,56107000,56107000,,-39614000,,,,1024000,936233000,880126000,361388000,-26424000,,28659000,28659000,5434,TWTR,quarterly
2020-06-30,215806000,,-289106000,,-1378005000,453523000,395399000,-273930000,-273930000,,-39828000,,,,1088899000,683438000,957368000,288039000,-15176000,,-1378005000,-1378005000,5434,TWTR,quarterly
2020-03-31,200388000,,-15535000,,-8396000,330655000,523600000,-7443000,-7443000,,-33270000,,,,-7139000,807637000,815080000,284037000,-8092000,,-8396000,-8396000,5434,TWTR,quarterly
2020-10-31,,,136493000,,131197000,877857000,1043090000,165233000,165233000,,-29070000,,,,5296000,3754509000,3589276000,2711419000,-28740000,,131197000,131197000,5513,ROST,quarterly
2020-08-01,,,56242000,,22047000,519495000,604592000,85097000,85097000,,-29612000,,,,34195000,2684712000,2599615000,2080120000,-28855000,,22047000,22047000,5513,ROST,quarterly
2020-05-02,,,-469289000,,-305842000,415305000,-47318000,-462623000,-462623000,,-10002000,,,,-163447000,1842673000,2305296000,1889991000,-6666000,,-305842000,-305842000,5513,ROST,quarterly
2020-02-01,,,590616000,,456133000,1415862000,2003191000,587329000,587329000,,-2203000,,,,134483000,4413445000,3826116000,2410254000,3287000,,456133000,456133000,5513,ROST,quarterly
2020-12-31,,,602000000,112000000,476000000,59000000,1422000000,798000000,798000000,381000000,-60000000,,,,119000000,2764000000,1966000000,1342000000,-196000000,,483000000,476000000,5544,WLTW,quarterly
2020-09-30,,,168000000,105000000,121000000,60000000,754000000,191000000,191000000,322000000,-61000000,,,,46000000,2009000000,1818000000,1255000000,-23000000,,122000000,121000000,5544,WLTW,quarterly
2020-06-30,,,177000000,121000000,94000000,59000000,822000000,249000000,249000000,328000000,-62000000,,,,75000000,2113000000,1864000000,1291000000,-72000000,,102000000,94000000,5544,WLTW,quarterly
2020-03-31,,,391000000,126000000,305000000,57000000,1149000000,481000000,481000000,427000000,-61000000,,,,78000000,2466000000,1985000000,1317000000,-90000000,,313000000,305000000,5544,WLTW,quarterly
2020-12-31,,,129585000,,94416000,425162000,514327000,88948000,88948000,,,,,,35169000,1304086000,1215138000,789759000,40637000,,94416000,94416000,5567,RHI,quarterly
2020-09-30,,,102510000,,75749000,390799000,467346000,76213000,76213000,,,,,,26761000,1189897000,1113684000,722551000,26297000,,75749000,75749000,5567,RHI,quarterly
2020-06-30,,,58024000,,46196000,364828000,423077000,57919000,57919000,,,,,,11828000,1108326000,1050407000,685249000,105000,,46196000,46196000,5567,RHI,quarterly
2020-03-31,,,131763000,,89915000,479573000,610717000,130806000,130806000,,,,,,41848000,1506691000,1375885000,895974000,957000,,89915000,89915000,5567,RHI,quarterly
2021-01-30,,,508138000,,325523000,2193101000,3060635000,867534000,867534000,,-47163000,,,,182615000,10943210000,10075676000,7882575000,-359396000,,325523000,325523000,5665,TJX,quarterly
2020-10-31,,,1015992000,,866656000,1986128000,3055004000,1068876000,1068876000,,-54200000,,,,149336000,10117289000,9048413000,7062285000,-52884000,,866656000,866656000,5665,TJX,quarterly
2020-08-01,,,-92019000,,-214220000,1527768000,1493085000,-34683000,-34683000,,-59000000,,,,122201000,6667575000,6702258000,5174490000,-57336000,,-214220000,-214220000,5665,TJX,quarterly
2020-05-02,,,-1342848000,,-887489000,1313920000,-5577000,-1319497000,-1319497000,,-31600000,,,,-455359000,4408888000,5728385000,4414465000,-23351000,,-887489000,-887489000,5665,TJX,quarterly
2021-01-02,,,535100000,6800000,467300000,835300000,1568300000,697800000,697800000,31400000,-53400000,,,,67400000,4407600000,3709800000,2839300000,-162700000,,467700000,458000000,5673,SWK,quarterly
2020-09-26,,,473600000,6400000,394900000,695300000,1383300000,614300000,614300000,66100000,-52700000,,,,78400000,3850200000,3235900000,2466900000,-140700000,,395200000,385500000,5673,SWK,quarterly
2020-06-27,,,121400000,6100000,238400000,633800000,1055300000,353200000,353200000,49300000,-57300000,,,,-117300000,3147400000,2794200000,2092100000,-231800000,,238700000,233700000,5673,SWK,quarterly
2020-03-28,,,146000000,5800000,133200000,708000000,1032200000,238600000,238600000,73800000,-49600000,,,,12900000,3129400000,2890800000,2097200000,-92600000,,133100000,133200000,5673,SWK,quarterly
2020-12-31,,,-558000000,837000000,-53000000,2054000000,1441000000,-613000000,-613000000,,-358000000,,,,-542000000,9282000000,9895000000,7841000000,55000000,,-16000000,-60000000,5706,AIG,quarterly
2020-09-30,,,368000000,499000000,288000000,1891000000,2761000000,870000000,870000000,,-379000000,,,,74000000,10222000000,9352000000,7461000000,-502000000,5000000.0,294000000,281000000,5706,AIG,quarterly
2020-06-30,,,-9661000000,584000000,-7928000000,1953000000,1203000000,-750000000,-750000000,,-365000000,,,,-1896000000,9396000000,10146000000,8193000000,-8911000000,-1000000.0,-7765000000,-7936000000,5706,AIG,quarterly
2020-03-31,,,2558000000,1670000000,1749000000,2063000000,5293000000,3230000000,3230000000,,-355000000,,,,904000000,14437000000,11207000000,9144000000,-672000000,-1000000.0,1654000000,1742000000,5706,AIG,quarterly
2020-12-31,66965000,,1078533000,,839102000,219048000,458255000,172242000,172242000,,-4703000,,,,239431000,789839000,617597000,331584000,906291000,,839102000,839102000,5711,BIO,quarterly
2020-09-30,59546000,,1684461000,,1314824000,199265000,367311000,108500000,108500000,,-5728000,,,,369637000,647263000,538763000,279952000,1575961000,,1314824000,1314824000,5711,BIO,quarterly
2020-06-30,51984000,,1245945000,,966429000,189662000,292988000,51342000,51342000,,-5740000,,,,279516000,536880000,485538000,243892000,1194603000,,966429000,966429000,5711,BIO,quarterly
2020-03-31,49703000,,898699000,,685912000,194592000,315868000,71573000,71573000,,-5690000,,,,212787000,571644000,500071000,255776000,827126000,,685912000,685912000,5711,BIO,quarterly
2020-12-31,732000000,,1859000000,44000000,1567000000,1174000000,2913000000,1007000000,1007000000,,-59000000,,,,292000000,6116000000,5109000000,3203000000,852000000,,1567000000,1567000000,5715,PYPL,quarterly
2020-09-30,674000000,,1144000000,44000000,1021000000,974000000,2644000000,996000000,996000000,,-58000000,,,,123000000,5459000000,4463000000,2815000000,148000000,,1021000000,1021000000,5715,PYPL,quarterly
2020-06-30,631000000,,1799000000,44000000,1530000000,926000000,2555000000,998000000,998000000,,-55000000,,,,269000000,5261000000,4263000000,2706000000,801000000,,1530000000,1530000000,5715,PYPL,quarterly
2020-03-31,605000000,,263000000,44000000,84000000,857000000,1889000000,427000000,427000000,,-37000000,,,,179000000,4618000000,4191000000,2729000000,-164000000,,84000000,84000000,5715,PYPL,quarterly
2020-12-31,295000000,,590600000,,535800000,444400000,1439600000,647000000,647000000,,-30800000,,,,54800000,1591800000,944800000,152200000,-56400000,,535800000,535800000,5716,ALXN,quarterly
2020-09-30,285900000,,666900000,,578100000,334200000,1444000000,770800000,770800000,,-27600000,,,,88800000,1588700000,817900000,144700000,-103900000,,578100000,578100000,5716,ALXN,quarterly
2020-06-30,221100000,,-1352100000,,-1068100000,301400000,1299700000,703500000,703500000,,-23600000,,,,-284000000,1444600000,741100000,144900000,-2055600000,,-1068100000,-1068100000,5716,ALXN,quarterly
2020-03-31,200900000,,663600000,,557600000,319900000,1333100000,738600000,738600000,,-25800000,,,,106000000,1444800000,706200000,111700000,-75000000,,557600000,557600000,5716,ALXN,quarterly
2020-12-31,,,117732000,,190959000,276195000,601683000,131149000,131149000,129886000,-554000,,,,-73227000,1607710000,1476561000,1006027000,-13417000,,190959000,190959000,5728,CMG,quarterly
2020-09-30,,,106501000,,80244000,133150000,580641000,115087000,115087000,268416000,-595000,,,,26257000,1601414000,1486327000,1020773000,-8586000,,80244000,80244000,5728,CMG,quarterly
2020-06-30,,,-4316000,,8175000,100547000,429140000,2547000,2547000,262378000,-595000,,,,-12491000,1364738000,1362191000,935598000,-6863000,,8175000,8175000,5728,CMG,quarterly
2020-03-31,,,73864000,,76388000,101306000,459629000,85657000,85657000,210726000,-595000,,,,-2524000,1410772000,1325115000,951143000,-11793000,,76388000,76388000,5728,CMG,quarterly
2020-12-31,,,1616000000,,1310000000,1142000000,2841000000,1699000000,1699000000,,-83000000,,,,306000000,8397000000,6698000000,5556000000,-83000000,,1310000000,1300000000,5731,TRV,quarterly
2020-09-30,,,986000000,,827000000,1109000000,2182000000,1073000000,1073000000,,-87000000,,,,159000000,8275000000,7202000000,6093000000,-87000000,,827000000,821000000,5731,TRV,quarterly
2020-06-30,,,-85000000,,-40000000,1121000000,1121000000,0,1073000000,,-85000000,,,,-45000000,7401000000,7401000000,6280000000,-85000000,,-40000000,-41000000,5731,TRV,quarterly
2020-03-31,,,720000000,,600000000,1137000000,1941000000,804000000,804000000,,-84000000,,,,120000000,7908000000,7104000000,5967000000,-84000000,,600000000,598000000,5731,TRV,quarterly
2020-12-31,,,171722000,4791000,170051000,265775000,465873000,178768000,178768000,,-11304000,,,,-239000,2912185000,2733417000,2446312000,-7046000,,171961000,170051000,5737,PWR,quarterly
2020-09-30,,,234177000,3616000,162913000,250654000,507514000,237173000,237173000,,-11049000,,,,70477000,3020161000,2782988000,2512647000,-2996000,,163700000,162913000,5737,PWR,quarterly
2020-06-30,,,107784000,3573000,73946000,227852000,355264000,109633000,109633000,,-8654000,,,,32989000,2506231000,2396598000,2150967000,-1849000,,74795000,73946000,5737,PWR,quarterly
2020-03-31,,,57663000,4686000,38686000,230793000,332196000,83495000,83495000,,-14006000,,,,16160000,2764095000,2680600000,2431899000,-25832000,,41503000,38686000,5737,PWR,quarterly
2020-10-30,,,732832000,,574260000,1795110000,2568240000,773130000,773130000,,-40298000,,,,158572000,8199625000,7426495000,5631385000,-40298000,,574260000,574260000,5795,DG,quarterly
2020-07-31,,,1003301000,,787601000,1775608000,2818235000,1042627000,1042627000,,-39326000,,,,215700000,8684241000,7641614000,5866006000,-39326000,,787601000,787601000,5795,DG,quarterly
2020-05-01,,,836291000,,650446000,1728908000,2595692000,866784000,866784000,,-30493000,,,,185845000,8448449000,7581665000,5852757000,-30493000,,650446000,650446000,5795,DG,quarterly
2020-01-31,,,695308000,,535437000,1548288000,2272763000,724475000,724475000,,-25567000,,,,159871000,7157642000,6433167000,4884879000,-29167000,,535437000,535437000,5795,DG,quarterly
2020-12-31,,,2732000000,1936000000,1976000000,1900000000,4872000000,2954000000,2954000000,,-124000000,,,,613000000,7444000000,4490000000,2572000000,-222000000,,2119000000,1971000000,5843,PM,quarterly
2020-09-30,,,3077000000,1847000000,2307000000,1792000000,5030000000,3220000000,3220000000,,-209000000,,,,640000000,7446000000,4226000000,2416000000,-143000000,,2437000000,2302000000,5843,PM,quarterly
2020-06-30,,,2577000000,1877000000,1947000000,1673000000,4472000000,2780000000,2780000000,,-207000000,,,,528000000,6651000000,3871000000,2179000000,-203000000,,2049000000,1942000000,5843,PM,quarterly
2020-03-31,,,2583000000,1881000000,1826000000,1967000000,4751000000,2766000000,2766000000,,-183000000,,,,596000000,7153000000,4387000000,2402000000,-183000000,,1987000000,1821000000,5843,PM,quarterly
2020-12-31,,,503900000,,407000000,1465000000,2128700000,568200000,568200000,16300000,-82800000,,,,96900000,4488800000,3920600000,2360100000,-64300000,,407000000,407000000,5845,SHW,quarterly
2020-09-30,,,875600000,,705800000,1408100000,2455300000,958400000,958400000,10100000,-83300000,,,,169800000,5122200000,4163800000,2666900000,-82800000,,705800000,705800000,5845,SHW,quarterly
2020-06-30,,,747400000,,595900000,1292400000,2208900000,830600000,830600000,8500000,-88100000,,,,151500000,4604000000,3773400000,2395100000,-83200000,,595900000,595900000,5845,SHW,quarterly
2020-03-31,,,392300000,,321700000,1308800000,1889700000,500600000,500600000,2200000,-86200000,,,,70600000,4146700000,3646100000,2257000000,-108300000,,321700000,321700000,5845,SHW,quarterly
2020-12-31,,,433000000,1167000000,451000000,1298000000,1728000000,430000000,430000000,,-59000000,,,,61000000,5341000000,4911000000,3613000000,3000000,124000000,372000000,451000000,5852,JCI,quarterly
2020-09-30,274000000.0,,521000000,1086000000,441000000,819000000,1975000000,882000000,882000000,,-58000000,,,,31000000,5954000000,5072000000,3979000000,-361000000,124000000,490000000,441000000,5852,JCI,quarterly
2020-06-30,274000000.0,,-123000000,1068000000,-182000000,1334000000,1832000000,498000000,498000000,,-58000000,,,,-1000000,5343000000,4845000000,3511000000,-621000000,124000000,-122000000,-182000000,5852,JCI,quarterly
2020-03-31,274000000.0,,249000000,1004000000,213000000,1431000000,1801000000,370000000,370000000,,-62000000,,,,13000000,5444000000,5074000000,3643000000,-121000000,124000000,236000000,213000000,5852,JCI,quarterly
2020-10-31,,,309000000,,240000000,252000000,581000000,325000000,325000000,4000000,-20000000,,,,69000000,985000000,660000000,404000000,-16000000,,240000000,240000000,5854,BF-B,quarterly
2020-07-31,,,366000000,,324000000,211000000,465000000,251000000,251000000,3000000,-20000000,,,,42000000,753000000,502000000,288000000,115000000,,324000000,324000000,5854,BF-B,quarterly
2020-04-30,,,166000000,,128000000,244000000,453000000,218000000,218000000,-9000000,-20000000,,,,38000000,709000000,491000000,256000000,-52000000,,128000000,128000000,5854,BF-B,quarterly
2020-01-31,,,284000000,,231000000,258000000,557000000,299000000,299000000,-9000000,-20000000,,,,53000000,899000000,600000000,342000000,-15000000,,231000000,231000000,5854,BF-B,quarterly
2020-12-31,1719800000,,370900000,-14200000,357900000,813200000,2362000000,-296200000,-296200000,66400000,-56000000,,,,13300000,2852600000,3148800000,490600000,667100000,,357600000,357900000,5869,BIIB,quarterly
2020-09-30,1140900000,,944700000,-14000000,701500000,573100000,2927000000,1076700000,1076700000,73000000,-56300000,,,,240800000,3376100000,2299400000,449100000,-132000000,,703900000,701500000,5869,BIIB,quarterly
2020-06-30,647600000,,2052600000,-19500000,1542100000,541100000,3270500000,1998500000,1998500000,21800000,-56600000,,,,446100000,3681600000,1683100000,411100000,54100000,,1606500000,1542100000,5869,BIIB,quarterly
2020-03-31,476300000,,1684600000,-10000000,1399100000,570100000,3080000000,1890300000,1890300000,71800000,-44300000,,,,292000000,3534300000,1644000000,454300000,-205700000,,1392600000,1399100000,5869,BIIB,quarterly
2020-12-26,199672000,,391466000,,333548000,220045000,790984000,371267000,371267000,,,,,,57918000,1351405000,980138000,560421000,20199000,,333548000,333548000,5874,GRMN,quarterly
2020-09-26,174882000,,336717000,,313417000,176000000,667983000,317101000,317101000,,,,,,23300000,1109194000,792093000,441211000,19616000,,313417000,313417000,5874,GRMN,quarterly
2020-06-27,165740000,,197592000,,184180000,161301000,515430000,188389000,188389000,,,,,,13412000,869867000,681478000,354437000,9203000,,184180000,184180000,5874,GRMN,quarterly
2020-03-28,165392000,,177635000,,161180000,164066000,506940000,177482000,177482000,,,,,,16455000,856108000,678626000,349168000,153000,,161180000,161180000,5874,GRMN,quarterly
2020-12-31,,,457133000,1718066000,441484000,32690000,330546000,120106000,120106000,,-37538000,,,,0,467313000,347207000,136767000,337027000,,457133000,436620000,5879,ARE,quarterly
2020-09-30,,,95799000,1633306000,81056000,36913000,408377000,194633000,194633000,,-43318000,,,,0,548820000,354187000,140443000,-98834000,,95799000,79326000,5879,ARE,quarterly
2020-06-30,,,243561000,1637536000,229654000,31775000,316938000,117136000,117136000,,-45014000,,,,0,440849000,323713000,123911000,126425000,,243561000,226600000,5879,ARE,quarterly
2020-03-31,,,30678000,1591679000,18765000,31963000,315344000,107885000,107885000,,-67560000,,,,0,444447000,336562000,129103000,-77207000,,30678000,18245000,5879,ARE,quarterly
2020-12-31,,,547000000,2000000,438000000,360000000,1567000000,771000000,771000000,,-97000000,,,,109000000,4067000000,3296000000,2500000000,-224000000,,438000000,438000000,5882,WM,quarterly
2020-09-30,,,516000000,2000000,390000000,416000000,1529000000,694000000,694000000,,-97000000,,,,126000000,3861000000,3167000000,2332000000,-178000000,,390000000,390000000,5882,WM,quarterly
2020-06-30,,,395000000,2000000,307000000,377000000,1381000000,590000000,590000000,,-119000000,,,,88000000,3561000000,2971000000,2180000000,-195000000,,307000000,307000000,5882,WM,quarterly
2020-03-31,,,435000000,2000000,361000000,425000000,1400000000,573000000,573000000,,-112000000,,,,74000000,3729000000,3156000000,2329000000,-138000000,,361000000,361000000,5882,WM,quarterly
2020-12-31,197906000,,176132000,,141505000,757063000,1160352000,192819000,192819000,,-29080000,,,,34627000,1395025000,1202206000,234673000,-16687000,,141505000,141505000,5900,CERN,quarterly
2020-09-30,186826000,,459840000,,356676000,742218000,1136784000,194951000,194951000,,-29080000,,,,103164000,1368673000,1173722000,231889000,264889000,,356676000,356676000,5900,CERN,quarterly
2020-06-30,178955000,,171530000,,134748000,779419000,1118386000,146898000,146898000,,-29080000,,,,36782000,1330349000,1183451000,211963000,24632000,,134748000,134748000,5900,CERN,quarterly
2020-03-31,185320000,,183971000,,147159000,736501000,1157325000,218376000,218376000,,-29080000,,,,36812000,1411741000,1193365000,254416000,-34405000,,147159000,147159000,5900,CERN,quarterly
2020-09-30,,,747000000,268700000,748600000,-29700000,1925500000,972900000,972900000,337700000,-291300000,,,,-1200000,4066400000,3093500000,2140900000,-225900000,,748200000,748600000,5905,AEP,quarterly
2020-06-30,,,527100000,334500000,520800000,-29800000,1719700000,752500000,752500000,317500000,-294000000,,,,12600000,3494000000,2741500000,1774300000,-225400000,,514500000,520800000,5905,AEP,quarterly
2020-03-31,,,545800000,344100000,495200000,-29700000,1744900000,781300000,781300000,321100000,-292100000,,,,46500000,3747500000,2966200000,2002600000,-235500000,,499300000,495200000,5905,AEP,quarterly
2019-12-31,,,109100000,346700000,153500000,-30000000,1393800000,481100000,481100000,301800000,-290900000,,,,-43600000,3616000000,3134900000,2222200000,-372000000,,152700000,153500000,5905,AEP,quarterly
2020-12-31,348000000,,563000000,,509000000,597000000,1595000000,650000000,650000000,,-27000000,,,,54000000,2412000000,1762000000,817000000,-87000000,,509000000,509000000,5917,ATVI,quarterly
2020-09-30,274000000,,722000000,,604000000,424000000,1485000000,787000000,787000000,,-27000000,,,,118000000,1954000000,1167000000,469000000,-65000000,,604000000,604000000,5917,ATVI,quarterly
2020-06-30,291000000,,727000000,,580000000,417000000,1463000000,755000000,755000000,,-23000000,,,,147000000,1932000000,1177000000,469000000,-28000000,,580000000,580000000,5917,ATVI,quarterly
2020-03-31,238000000,,604000000,,505000000,410000000,1283000000,635000000,635000000,,-23000000,,,,99000000,1788000000,1153000000,505000000,-31000000,,505000000,505000000,5917,ATVI,quarterly
2020-12-31,242500000,,39200000,,30800000,298700000,717000000,175800000,175800000,,-18500000,,,,8400000,1222600000,1046800000,505600000,-136600000,,30800000,30800000,5920,JNPR,quarterly
2020-09-30,242400000,,111600000,,145400000,289100000,657800000,126300000,126300000,,-19100000,,,,-33800000,1138200000,1011900000,480400000,-14700000,,145400000,145400000,5920,JNPR,quarterly
2020-06-30,241000000,,86100000,,61200000,283300000,619600000,95300000,95300000,,-19300000,,,,24900000,1086300000,991000000,466700000,-9200000,,61200000,61200000,5920,JNPR,quarterly
2020-03-31,232500000,,28300000,,20400000,298500000,579300000,48300000,48300000,,-20100000,,,,7900000,998000000,949700000,418700000,-20000000,,20400000,20400000,5920,JNPR,quarterly
2020-12-31,,,-210527000,1021224000,-194979000,39122000,221255000,75049000,75049000,,-54633000,,,,-1801000,400998000,325949000,179743000,-285576000,,-208726000,-209142000,5948,VNO,quarterly
2020-09-30,,,92517000,1110596000,65700000,32407000,194431000,55011000,55011000,,-57371000,,,,23781000,390076000,335065000,195645000,37506000,,68736000,53155000,5948,VNO,quarterly
2020-06-30,,,-215515000,1151408000,-185220000,35014000,183054000,55235000,55235000,,-58405000,,,,1837000,357479000,302244000,174425000,-270750000,,-217352000,-197768000,5948,VNO,quarterly
2020-03-31,,,-91690000,1079984000,17494000,52834000,233557000,87930000,87930000,,-58842000,,,,12813000,463635000,375705000,230078000,-179620000,,-104503000,4912000,5948,VNO,quarterly
2020-12-31,,,283907000,3590000,198620000,4135000,357761000,281811000,281811000,57476000,,,,,84382000,3169188000,2887377000,2811427000,2096000,,199525000,198620000,5952,EXPD,quarterly
2020-09-30,,,254429000,2444000,191307000,2945000,318282000,251945000,251945000,47541000,,,,,62710000,2464797000,2212852000,2146515000,2484000,,191719000,191307000,5952,EXPD,quarterly
2020-06-30,,,250982000,2480000,183869000,3113000,313109000,247626000,247626000,48261000,,,,,66794000,2580632000,2333006000,2267523000,3356000,,184188000,183869000,5952,EXPD,quarterly
2020-03-31,,,167246000,2339000,122344000,8243000,230572000,159055000,159055000,50614000,,,,,44464000,1901864000,1742809000,1671292000,8191000,,122782000,122344000,5952,EXPD,quarterly
2020-12-31,,,674000000,129000000,526000000,625000000,1671000000,800000000,800000000,,-112000000,,,,146000000,1671000000,871000000,0,-126000000,,528000000,526000000,5954,ICE,quarterly
2020-09-30,,,583000000,125000000,390000000,528000000,1411000000,703000000,703000000,,-89000000,,,,189000000,1411000000,708000000,0,-120000000,,394000000,390000000,5954,ICE,quarterly
2020-06-30,,,673000000,136000000,523000000,492000000,1395000000,746000000,746000000,,-84000000,,,,145000000,1395000000,649000000,0,-73000000,,528000000,523000000,5954,ICE,quarterly
2020-03-31,,,836000000,123000000,650000000,508000000,1559000000,894000000,894000000,,-72000000,,,,178000000,1559000000,665000000,0,-58000000,,658000000,650000000,5954,ICE,quarterly
2020-12-31,,,62832000,770650000,57692000,104992000,657473000,191925000,191925000,641000,-77848000,,,,3322000,1093664000,901739000,436191000,-129093000,,59510000,44178000,5960,DLR,quarterly
2020-09-30,,,14599000,769907000,-138000,91352000,621274000,163782000,163782000,298000,-89499000,,,,16053000,1022612000,858830000,401338000,-149183000,,-1454000,-37370000,5960,DLR,quarterly
2020-06-30,,,87468000,738706000,74831000,94291000,604275000,160797000,160797000,22000,-79874000,,,,11490000,985363000,824566000,381088000,-73329000,,75978000,53676000,5960,DLR,quarterly
2020-03-31,,,235880000,756331000,224014000,63538000,376162000,21053000,21053000,114000,-85800000,,,,7182000,744341000,723288000,368179000,214827000,,228698000,202859000,5960,DLR,quarterly
2020-12-31,,,-34431000,119290000,-19391000,-185105000,75452000,45018000,45018000,60418000,-64080000,,,,-19913000,740961000,695943000,665509000,-79449000,,-14518000,-19391000,5980,PNW,quarterly
2020-09-30,,,428479000,125789000,346372000,78202000,756679000,469126000,469126000,56655000,-61497000,,,,77234000,1254501000,785375000,497822000,-40647000,,351245000,346372000,5980,PNW,quarterly
2020-06-30,,,239520000,120915000,193585000,-14142000,471816000,276016000,276016000,57460000,-62690000,,,,41061000,929590000,653574000,457774000,-36496000,,198459000,193585000,5980,PNW,quarterly
2020-03-31,,,14657000,127414000,29993000,-13911000,252091000,54333000,54333000,57590000,-59234000,,,,-20209000,661930000,607597000,409839000,-39676000,,34866000,29993000,5980,PNW,quarterly
2020-12-31,,,109000000,,88400000,164900000,298200000,133300000,133300000,,-25900000,,,,20600000,910800000,777500000,612600000,-24300000,,88400000,76600000,5992,CTLT,quarterly
2020-09-30,,,67400000,,82400000,164000000,248900000,84900000,84900000,,-25300000,,,,-15000000,845700000,760800000,596800000,-17500000,,82400000,68800000,5992,CTLT,quarterly
2020-06-30,800000.0,,179000000,,154200000,155400000,334600000,178400000,178400000,,-20500000,,,,24800000,947600000,769200000,613000000,600000,,154200000,134300000,5992,CTLT,quarterly
2020-03-31,600000.0,,29700000,,20900000,133200000,238800000,105000000,105000000,,-34400000,,,,8800000,760600000,655600000,521800000,-75300000,,20900000,11800000,5992,CTLT,quarterly
2020-12-31,114191000,,117065000,,87678000,274999000,509638000,120448000,120448000,,,,,,29387000,624617000,504169000,114979000,-3383000,,87678000,87678000,6020,FFIV,quarterly
2020-09-30,120300000,,97523000,,77663000,283936000,502849000,98613000,98613000,,,,,,19860000,614816000,516203000,111967000,-1090000,,77663000,77663000,6020,FFIV,quarterly
2020-06-30,115991000,,87762000,,69872000,273600000,477212000,87621000,87621000,,,,,,17890000,583252000,495631000,106040000,141000,,69872000,69872000,6020,FFIV,quarterly
2020-03-31,109028000,,83557000,,61379000,278085000,482211000,95098000,95098000,,,,,,22178000,583449000,488351000,101238000,-11541000,,61379000,61379000,6020,FFIV,quarterly
2020-12-31,,,311000000,,292000000,123000000,671000000,529000000,529000000,19000000,-144000000,,,,19000000,2063000000,1534000000,1392000000,-218000000,,292000000,292000000,6068,WY,quarterly
2020-09-30,,,392000000,,283000000,127000000,720000000,586000000,586000000,7000000,-111000000,,,,109000000,2110000000,1524000000,1390000000,-194000000,,283000000,283000000,6068,WY,quarterly
2020-06-30,,,132000000,,72000000,112000000,348000000,228000000,228000000,8000000,-103000000,,,,60000000,1631000000,1403000000,1283000000,-96000000,,72000000,72000000,6068,WY,quarterly
2020-03-31,,,147000000,,150000000,105000000,346000000,232000000,232000000,9000000,-85000000,,,,-3000000,1728000000,1496000000,1382000000,-93000000,,150000000,150000000,6068,WY,quarterly
2020-12-31,,,175100000,142000000,112300000,335700000,887700000,478300000,478300000,,-46800000,,,,58100000,2284400000,1806100000,1396700000,-303200000,,117000000,112300000,6158,IPG,quarterly
2020-09-30,,,192200000,190800000,279700000,9900000,377600000,296700000,296700000,,-50800000,,,,-86300000,1954600000,1657900000,1577000000,-104500000,,278500000,279700000,6158,IPG,quarterly
2020-06-30,,,-24900000,195900000,-45600000,4100000,231100000,153900000,153900000,,-49800000,,,,19000000,1853400000,1699500000,1622300000,-178800000,,-43900000,-45600000,6158,IPG,quarterly
2020-03-31,,,19800000,197500000,4700000,22400000,171800000,76600000,76600000,,-44800000,,,,17200000,1972100000,1895500000,1800300000,-56800000,,2600000,4700000,6158,IPG,quarterly
2020-12-31,,,262200000,,196100000,354700000,618800000,264100000,264100000,,-2500000,,,,66100000,1358000000,1093900000,739200000,-1900000,,196100000,196100000,6163,FAST,quarterly
2020-09-30,,,287600000,,221500000,351500000,640600000,289100000,289100000,,-2600000,,,,66100000,1413300000,1124200000,772700000,-1500000,,221500000,221500000,6163,FAST,quarterly
2020-06-30,,,313700000,,238900000,355300000,671600000,316300000,316300000,,-2400000,,,,74800000,1509000000,1192700000,837400000,-2600000,,238900000,238900000,6163,FAST,quarterly
2020-03-31,,,269200000,,202600000,365900000,636800000,270900000,270900000,,-2200000,,,,66600000,1367000000,1096100000,730200000,-1700000,,202600000,202600000,6163,FAST,quarterly
2020-12-31,1611000000,,1289000000,129000000,1356000000,4327000000,10523000000,4735000000,4735000000,-150000000,-317000000,,,,24000000,20368000000,15633000000,9845000000,-3446000000,91000000,1265000000,1356000000,6176,IBM,quarterly
2020-09-30,1515000000,,1827000000,126000000,1698000000,4919000000,8431000000,2120000000,2120000000,-123000000,-323000000,,,,128000000,17561000000,15441000000,9130000000,-293000000,-1000000,1699000000,1698000000,6176,IBM,quarterly
2020-06-30,1582000000,,1571000000,137000000,1361000000,5382000000,8698000000,1929000000,1929000000,-195000000,-322000000,,,,210000000,18121000000,16192000000,9423000000,-358000000,-1000000,1361000000,1361000000,6176,IBM,quarterly
2020-03-31,1625000000,,-50000000,129000000,1175000000,5491000000,7923000000,923000000,923000000,-116000000,-326000000,,,,-1226000000,17571000000,16648000000,9648000000,-973000000,-1000000,1176000000,1175000000,6176,IBM,quarterly
2020-12-31,449000000,,1706000000,64000000,1389000000,1814000000,4246000000,1983000000,1983000000,,-141000000,,,,316000000,8583000000,6600000000,4337000000,-277000000,,1390000000,1389000000,6177,MMM,quarterly
2020-09-30,461000000,,1804000000,63000000,1413000000,1658000000,4047000000,1928000000,1928000000,,-128000000,,,,387000000,8350000000,6422000000,4303000000,-124000000,,1417000000,1413000000,6177,MMM,quarterly
2020-06-30,415000000,,1629000000,58000000,1290000000,1528000000,3426000000,1483000000,1483000000,,-137000000,,,,342000000,7176000000,5693000000,3750000000,146000000,,1287000000,1290000000,6177,MMM,quarterly
2020-03-31,537000000,,1567000000,62000000,1292000000,1751000000,3966000000,1678000000,1678000000,,-123000000,,,,273000000,8075000000,6397000000,4109000000,-111000000,,1294000000,1292000000,6177,MMM,quarterly
2020-12-31,,,5831000000,758000000,4632000000,8352000000,16889000000,0,5831000000,2706000000,,,,,1183000000,16889000000,11058000000,0,0,6000000,4648000000,4341000000,6245,C,quarterly
2020-09-30,,,4076000000,719000000,3230000000,8299000000,15509000000,0,4076000000,3134000000,,,,,815000000,15509000000,11433000000,0,0,-7000000,3261000000,2928000000,6245,C,quarterly
2020-06-30,,,1448000000,680000000,1316000000,8226000000,12039000000,0,1448000000,2365000000,,,,,131000000,12039000000,10591000000,0,0,-1000000,1317000000,1052000000,6245,C,quarterly
2020-03-31,,,3110000000,651000000,2522000000,8270000000,14281000000,0,3110000000,2901000000,,,,,576000000,14281000000,11171000000,0,0,-18000000,2534000000,2210000000,6245,C,quarterly
2020-12-31,,,621000000,1561000000,461000000,,1163000000,739000000,739000000,,-263000000,,,,189000000,3171000000,2432000000,2008000000,-118000000,,432000000,414000000,6247,SRE,quarterly
2020-09-30,,,527000000,1628000000,399000000,48000000.0,855000000,389000000,389000000,,-264000000,,,,99000000,2644000000,2255000000,1789000000,138000000,-7000000.0,428000000,351000000,6247,SRE,quarterly
2020-06-30,,,695000000,1780000000,2276000000,23000000.0,1065000000,630000000,630000000,,-275000000,,,,168000000,2526000000,1896000000,1461000000,65000000,1777000000.0,527000000,2239000000,6247,SRE,quarterly
2020-03-31,,,660000000,1998000000,796000000,-26000000.0,1416000000,1030000000,1030000000,,-280000000,,,,-207000000,3029000000,1999000000,1613000000,-370000000,80000000.0,867000000,760000000,6247,SRE,quarterly
2020-12-26,119000000,,1286000000,140000000,1032000000,622000000,2521000000,1780000000,1780000000,,-328000000,,,,252000000,6939000000,5159000000,4418000000,-494000000,,1034000000,1032000000,6269,KHC,quarterly
2020-09-26,119000000,,906000000,121000000,597000000,839000000,2341000000,1502000000,1502000000,,-314000000,,,,308000000,6441000000,4939000000,4100000000,-596000000,,598000000,597000000,6269,KHC,quarterly
2020-06-27,119000000,,-1703000000,125000000,-1651000000,838000000,2450000000,1612000000,1612000000,,-442000000,,,,-51000000,6648000000,5036000000,4198000000,-3315000000,,-1652000000,-1651000000,6269,KHC,quarterly
2020-03-28,119000000,,541000000,115000000,378000000,862000000,1858000000,996000000,996000000,,-310000000,,,,160000000,6157000000,5161000000,4299000000,-455000000,,381000000,378000000,6269,KHC,quarterly
2021-01-01,221000000,,291000000,,280000000,122000000,696000000,350000000,350000000,,-52000000,,,,11000000,2623000000,2273000000,1927000000,-59000000,,280000000,280000000,6272,STX,quarterly
2020-10-02,223000000,,221000000,,223000000,118000000,596000000,252000000,252000000,,-50000000,,,,-2000000,2314000000,2062000000,1718000000,-31000000,,223000000,223000000,6272,STX,quarterly
2020-07-03,222000000,,160000000,,166000000,112000000,670000000,333000000,333000000,,-50000000,,,,-6000000,2517000000,2184000000,1847000000,-173000000,,166000000,166000000,6272,STX,quarterly
2020-04-03,246000000,,338000000,,320000000,119000000,746000000,378000000,378000000,,-49000000,,,,18000000,2718000000,2340000000,1972000000,-40000000,,320000000,320000000,6272,STX,quarterly
2020-09-30,315000000,,-227000000,,-155000000,984000000,1778000000,282000000,282000000,,-86000000,,,,-72000000,2659000000,2377000000,881000000,-509000000,,-155000000,-169000000,6318,BSX,quarterly
2020-06-30,242000000,,-180000000,,-147000000,798000000,1204000000,-33000000,-33000000,,-91000000,,,,-33000000,2003000000,2036000000,799000000,-147000000,,-147000000,-152000000,6318,BSX,quarterly
2020-03-31,300000000,,23000000,,11000000,978000000,1725000000,246000000,246000000,,-88000000,,,,12000000,2543000000,2297000000,818000000,-223000000,,11000000,11000000,6318,BSX,quarterly
2019-12-31,308000000,,-6000000,,3996000000,1104000000,2114000000,501000000,501000000,,-179000000,,,,-4002000000,2904000000,2403000000,790000000,-507000000,,3996000000,3996000000,6318,BSX,quarterly
2021-01-31,368000000,,22000000,,20000000,804000000,1223000000,1000000,1000000,,-7000000,,,,2000000,1576000000,1575000000,353000000,21000000,,20000000,20000000,6332,INTU,quarterly
2020-10-31,325000000,,210000000,,198000000,531000000,1074000000,209000000,209000000,,-8000000,,,,12000000,1323000000,1114000000,249000000,1000000,,198000000,198000000,6332,INTU,quarterly
2020-07-31,393000000,,486000000,,445000000,617000000,1499000000,483000000,483000000,,-7000000,,,,41000000,1816000000,1333000000,317000000,3000000,,445000000,445000000,6332,INTU,quarterly
2020-04-30,332000000,,1408000000,,1084000000,829000000,2581000000,1413000000,1413000000,,-2000000,,,,324000000,3002000000,1589000000,421000000,-5000000,,1084000000,1084000000,6332,INTU,quarterly
2021-01-23,1527000000,,3255000000,,2545000000,2761000000,7784000000,3457000000,3457000000,,-113000000,,,,710000000,11960000000,8503000000,4176000000,-202000000,,2545000000,2545000000,6402,CSCO,quarterly
2020-10-24,1612000000,,2681000000,,2174000000,2757000000,7581000000,3176000000,3176000000,,-112000000,,,,507000000,11929000000,8753000000,4348000000,-495000000,,2174000000,2174000000,6402,CSCO,quarterly
2020-07-25,1565000000,,3306000000,,2636000000,2704000000,7684000000,3382000000,3382000000,,-119000000,,,,670000000,12154000000,8772000000,4470000000,-76000000,,2636000000,2636000000,6402,CSCO,quarterly
2020-04-25,1546000000,,3444000000,,2774000000,2649000000,7771000000,3542000000,3542000000,,-130000000,,,,670000000,11983000000,8441000000,4212000000,-98000000,,2774000000,2774000000,6402,CSCO,quarterly
2020-12-31,,,-368000000,565000000,-299000000,286000000,1258000000,-199000000,-199000000,834000000,-150000000,,,,8000000,1146000000,1345000000,-112000000,-169000000,,-376000000,-299000000,6413,LVS,quarterly
2020-09-30,,,-748000000,641000000,-565000000,313000000,83000000,-552000000,-552000000,834000000,-137000000,,,,-17000000,586000000,1138000000,503000000,-196000000,,-731000000,-565000000,6413,LVS,quarterly
2020-06-30,,,-1039000000,805000000,-820000000,337000000,-274000000,-917000000,-917000000,834000000,-118000000,,,,-54000000,98000000,1015000000,372000000,-122000000,,-985000000,-820000000,6413,LVS,quarterly
2020-03-31,,,-26000000,968000000,-1000000,398000000,771000000,60000000,60000000,834000000,-131000000,,,,25000000,1782000000,1722000000,1011000000,-86000000,,-51000000,-1000000,6413,LVS,quarterly
2020-12-31,216000000,,156000000,566000000,222000000,529000000,1731000000,458000000,458000000,,-194000000,,,,-123000000,5252000000,4794000000,3521000000,-302000000,-49000000,279000000,222000000,6448,DD,quarterly
2020-09-30,199000000,,20000000,559000000,-79000000,519000000,1704000000,456000000,456000000,,-197000000,,,,92000000,5096000000,4640000000,3392000000,-436000000,-49000000,-72000000,-79000000,6448,DD,quarterly
2020-06-30,209000000,,-2507000000,572000000,-2478000000,533000000,1537000000,267000000,267000000,,-193000000,,,,-36000000,4828000000,4561000000,3291000000,-2774000000,-49000000,-2471000000,-2478000000,6448,DD,quarterly
2020-03-31,236000000,,-566000000,566000000,-616000000,622000000,1903000000,512000000,512000000,,-183000000,,,,44000000,5221000000,4709000000,3318000000,-1078000000,-49000000,-610000000,-616000000,6448,DD,quarterly
2020-12-31,214000000,,1816000000,570000000,1236000000,405000000,1567000000,847000000,847000000,,-210000000,,,,562000000,10706000000,9859000000,9139000000,969000000,,1254000000,1236000000,6459,DOW,quarterly
2020-09-30,193000000,,42000000,578000000,-25000000,346000000,1341000000,702000000,702000000,,-202000000,,,,43000000,9712000000,9010000000,8371000000,-660000000,,-1000000,-28000000,6459,DOW,quarterly
2020-06-30,182000000,,-183000000,560000000,-225000000,357000000,744000000,105000000,105000000,,-200000000,,,,34000000,8354000000,8249000000,7610000000,-288000000,,-217000000,-227000000,6459,DOW,quarterly
2020-03-31,179000000,,396000000,555000000,239000000,334000000,1540000000,927000000,927000000,,-215000000,,,,138000000,9770000000,8843000000,8230000000,-531000000,,258000000,237000000,6459,DOW,quarterly
2021-01-29,215000000,,247000000,,182000000,499000000,975000000,261000000,261000000,,,,,,65000000,1470000000,1209000000,495000000,-14000000,,182000000,182000000,6463,NTAP,quarterly
2020-10-30,212000000,,175000000,,137000000,494000000,933000000,227000000,227000000,,-18000000.0,,,,38000000,1416000000,1189000000,483000000,-52000000,,137000000,137000000,6463,NTAP,quarterly
2020-07-31,233000000,,104000000,,77000000,490000000,872000000,149000000,149000000,,-18000000.0,,,,27000000,1303000000,1154000000,431000000,-45000000,,77000000,77000000,6463,NTAP,quarterly
2020-04-24,212000000,,250000000,,196000000,449000000,941000000,280000000,280000000,,-14000000.0,,,,54000000,1401000000,1121000000,460000000,-30000000,,196000000,196000000,6463,NTAP,quarterly
2020-12-31,,,346000000,943000000,231000000,716000000,1216000000,333000000,333000000,,-12000000,,,,85000000,2414000000,2081000000,1198000000,13000000,,261000000,231000000,6468,NWS,quarterly
2020-09-30,,,72000000,815000000,34000000,683000000,953000000,106000000,106000000,,-8000000,,,,25000000,2117000000,2011000000,1164000000,-34000000,,47000000,34000000,6468,NWS,quarterly
2020-06-30,,,-401000000,807000000,-397000000,757000000,950000000,33000000,33000000,,-12000000,,,,0,1923000000,1890000000,973000000,-434000000,,-401000000,-397000000,6468,NWS,quarterly
2020-03-31,,,-1046000000,736000000,-730000000,742000000,988000000,86000000,86000000,,-9000000,,,,-10000000,2266000000,2180000000,1278000000,-1132000000,,-1036000000,-730000000,6468,NWS,quarterly
2021-01-31,103000000,,312000000,,288000000,407000000,838000000,328000000,328000000,,-19000000,,,,24000000,1548000000,1220000000,710000000,-16000000,,288000000,288000000,6474,A,quarterly
2020-10-31,102000000,,283000000,,222000000,366000000,788000000,320000000,320000000,,-19000000,,,,61000000,1483000000,1163000000,695000000,-37000000,,222000000,222000000,6474,A,quarterly
2020-07-31,92000000,,219000000,,199000000,323000000,669000000,254000000,254000000,,-19000000,,,,20000000,1261000000,1007000000,592000000,-35000000,,199000000,199000000,6474,A,quarterly
2020-04-30,100000000,,121000000,,101000000,330000000,657000000,227000000,227000000,,-20000000,,,,20000000,1238000000,1011000000,581000000,-106000000,,101000000,101000000,6474,A,quarterly
2020-12-31,,,267000000,3000000,225000000,376000000,788000000,359000000,359000000,,-24000000,,,,42000000,1462000000,1103000000,674000000,-92000000,,225000000,225000000,6475,NDAQ,quarterly
2020-09-30,,,357000000,3000000,264000000,318000000,715000000,346000000,346000000,,-24000000,,,,93000000,1414000000,1068000000,699000000,11000000,,264000000,264000000,6475,NDAQ,quarterly
2020-06-30,,,316000000,3000000,241000000,310000000,699000000,339000000,339000000,,-26000000,,,,75000000,1398000000,1059000000,699000000,-23000000,,241000000,241000000,6475,NDAQ,quarterly
2020-03-31,,,273000000,2000000,203000000,352000000,701000000,301000000,301000000,,-26000000,,,,70000000,1353000000,1052000000,652000000,-28000000,,203000000,203000000,6475,NDAQ,quarterly
2020-12-31,,,344368000,155570000,271923000,-10100000,1087446000,467328000,467328000,323025000,-135385000,,,,70565000,2233933000,1766605000,1146487000,-122960000,,273803000,271923000,6500,ES,quarterly
2020-09-30,,,456382000,155570000,346260000,-11000000,1207257000,574130000,574130000,342159000,-134066000,,,,108242000,2343642000,1769512000,1136385000,-117748000,,348140000,346260000,6500,ES,quarterly
2020-06-30,,,329613000,155570000,252232000,-10700000,996441000,449855000,449855000,293373000,-134285000,,,,75501000,1953128000,1503273000,956687000,-120242000,,254112000,252232000,6500,ES,quarterly
2020-03-31,,,428509000,155570000,334753000,-12700000,1155094000,551820000,551820000,329987000,-134715000,,,,91876000,2373726000,1821906000,1218632000,-123311000,,336633000,334753000,6500,ES,quarterly
2020-12-31,,,626000000,88000000,524000000,504000000,1333000000,745000000,745000000,,-82000000,,,,92000000,2965000000,2220000000,1632000000,-119000000,,534000000,524000000,6510,AON,quarterly
2020-09-30,,,363000000,78000000,275000000,422000000,1002000000,488000000,488000000,,-80000000,,,,82000000,2385000000,1897000000,1383000000,-125000000,1000000.0,281000000,275000000,6510,AON,quarterly
2020-06-30,,,495000000,94000000,398000000,425000000,1138000000,614000000,614000000,,-89000000,,,,85000000,2497000000,1883000000,1359000000,-119000000,1000000.0,410000000,398000000,6510,AON,quarterly
2020-03-31,,,981000000,91000000,772000000,508000000,1701000000,1055000000,1055000000,,-83000000,,,,189000000,3219000000,2164000000,1518000000,-74000000,-1000000.0,792000000,772000000,6510,AON,quarterly
2020-12-31,,,54000000,200000000,64000000,24000000,299000000,88000000,88000000,26000000,-70000000,,,,-10000000,817000000,729000000,518000000,-34000000,,64000000,64000000,6512,LNT,quarterly
2020-09-30,,,226000000,200000000,246000000,24000000,455000000,272000000,272000000,27000000,-71000000,,,,-20000000,920000000,648000000,465000000,-46000000,,246000000,246000000,6512,LNT,quarterly
2020-06-30,,,126100000,200000000,134400000,24000000,347300000,168100000,168100000,27100000,-72100000,,,,-8300000,763100000,595000000,415800000,-42000000,,134400000,134400000,6512,LNT,quarterly
2020-03-31,,,151300000,200000000,170000000,24000000,362200000,188300000,188300000,27600000,-71500000,,,,-18700000,915700000,727400000,553500000,-37000000,,170000000,170000000,6512,LNT,quarterly
2020-12-31,,,-1086000000,,-772000000,289000000,1968000000,-1149000000,-1149000000,240000000,-202000000,,,,-314000000,5577000000,6726000000,3609000000,63000000,,-772000000,-772000000,6517,COP,quarterly
2020-09-30,,,-512000000,,-450000000,115000000,1619000000,-275000000,-275000000,243000000,-200000000,,,,-62000000,4421000000,4696000000,2802000000,-237000000,,-450000000,-450000000,6517,COP,quarterly
2020-06-30,,,21000000,,260000000,185000000,649000000,-998000000,-998000000,207000000,-202000000,,,,-257000000,2826000000,3824000000,2177000000,1019000000,,278000000,260000000,6517,COP,quarterly
2020-03-31,,,-1563000000,72000000.0,-1739000000,-11000000,2558000000,655000000,655000000,315000000,-202000000,,,,148000000,6392000000,5737000000,3834000000,-2218000000,,-1711000000,-1739000000,6517,COP,quarterly
2020-11-30,,,-498000000,684000000,-308000000,6144000000,7139000000,995000000,995000000,,-234000000,,,,-199000000,36307000000,35312000000,29168000000,-1493000000,,-299000000,-308000000,6569,WBA,quarterly
2020-08-31,,,565000000,498000000,373000000,6283000000,6803000000,520000000,520000000,,-102000000,,,,208000000,34746000000,34226000000,27943000000,45000000,,357000000,373000000,6569,WBA,quarterly
2020-05-31,,,-1766000000,586000000,-1708000000,6307000000,6438000000,131000000,131000000,,-155000000,,,,-40000000,34631000000,34500000000,28193000000,-1897000000,,-1726000000,-1708000000,6569,WBA,quarterly
2020-02-29,,,1111000000,615000000,946000000,6348000000,7513000000,1165000000,1165000000,,-162000000,,,,160000000,35820000000,34655000000,28307000000,-54000000,,951000000,946000000,6569,WBA,quarterly
2020-09-30,126000000,,241600000,,185700000,615200000,1260200000,519000000,519000000,,-117300000,,,,55900000,2972100000,2453100000,1711900000,-277400000,,185700000,185700000,6624,VTRS,quarterly
2020-06-30,115700000,,20000000,,39400000,606000000,1130600000,408900000,408900000,,-116200000,,,,-19400000,2731200000,2322300000,1600600000,-388900000,,39400000,39400000,6624,VTRS,quarterly
2020-03-31,112300000,,30700000,,20800000,582700000,1027900000,332900000,332900000,,-119900000,,,,9900000,2619200000,2286300000,1591300000,-302200000,,20800000,20800000,6624,VTRS,quarterly
2019-12-31,131200000,,135200000,,20500000,629600000,1326700000,565900000,565900000,,-126000000,,,,114700000,3191800000,2625900000,1865100000,-430700000,,20500000,20500000,6624,VTRS,quarterly
2020-12-31,128000000,,471000000,418000000,374000000,72000000,704000000,504000000,504000000,,-144000000,,,,89000000,5532000000,5028000000,4828000000,-33000000,,382000000,374000000,6642,SLB,quarterly
2020-09-30,137000000,,-54000000,428000000,-82000000,85000000,634000000,412000000,412000000,,-138000000,,,,19000000,5258000000,4846000000,4624000000,-466000000,,-73000000,-82000000,6642,SLB,quarterly
2020-06-30,142000000,,-3627000000,416000000,-3434000000,81000000,431000000,208000000,208000000,,-144000000,,,,-199000000,5356000000,5148000000,4925000000,-3835000000,,-3428000000,-3434000000,6642,SLB,quarterly
2020-03-31,173000000,,-8089000000,422000000,-7376000000,127000000,831000000,531000000,531000000,,-136000000,,,,-721000000,7455000000,6924000000,6624000000,-8620000000,,-7368000000,-7376000000,6642,SLB,quarterly
2020-12-31,,,385370000,,305004000,112398000,503637000,391239000,391239000,,-12769000,,,,80366000,2353606000,1962367000,1849969000,-5869000,,305004000,305004000,6660,NVR,quarterly
2020-09-30,,,321457000,,256466000,105741000,433707000,327966000,327966000,,-11309000,,,,64991000,1994222000,1666256000,1560515000,-6509000,,256466000,256466000,6660,NVR,quarterly
2020-06-30,,,209831000,,164075000,102702000,322599000,219897000,219897000,,-9166000,,,,45756000,1624630000,1404733000,1302031000,-10066000,,164075000,164075000,6660,NVR,quarterly
2020-03-31,,,161375000,,175703000,110167000,277756000,167589000,167589000,,-6214000,,,,-14328000,1590333000,1422744000,1312577000,-6214000,,175703000,175703000,6660,NVR,quarterly
2020-12-31,,,1015000000,,799000000,885000000,2095000000,0,1111000000,99000000,,,,,216000000,2293000000,1182000000,198000000,-96000000,,799000000,795000000,6666,DFS,quarterly
2020-09-30,,,959000000,,771000000,788000000,1853000000,0,959000000,106000000,,,,,188000000,1964000000,1005000000,111000000,0,,771000000,751000000,6666,DFS,quarterly
2020-06-30,,,-461000000,,-368000000,789000000,499000000,0,-402000000,112000000,,,,,-93000000,616000000,1018000000,117000000,-59000000,,-368000000,-364000000,6666,DFS,quarterly
2020-03-31,,,-78000000,,-61000000,921000000,967000000,0,-78000000,124000000,,,,,-17000000,1081000000,1159000000,114000000,0,,-61000000,-78000000,6666,DFS,quarterly
2020-12-31,52459000,,99991000,,75240000,80616000,246531000,113456000,113456000,,-6044000,,,,24751000,524337000,410881000,277806000,-13465000,,75240000,75240000,6671,FLIR,quarterly
2020-09-30,47848000,,79921000,,60663000,94196000,228914000,86870000,86870000,,-7273000,,,,19258000,466414000,379544000,237500000,-6949000,,60663000,60663000,6671,FLIR,quarterly
2020-06-30,56012000,,81894000,,61257000,88676000,252200000,107512000,107512000,,-6962000,,,,20637000,482015000,374503000,229815000,-25618000,,61257000,61257000,6671,FLIR,quarterly
2020-03-31,53847000,,23198000,,15424000,116242000,219368000,49279000,49279000,,-6961000,,,,7774000,450923000,401644000,231555000,-26081000,,15424000,15424000,6671,FLIR,quarterly
2020-12-31,,,1034300000,285100000,791800000,476400000,1503400000,1027000000,1027000000,,,,,,239100000,5933400000,4906400000,4430000000,7300000,,795200000,791800000,6698,DHI,quarterly
2020-09-30,,,1056100000,281500000,829000000,490700000,1553100000,1062400000,1062400000,,,,,,224900000,6400300000,5337900000,4847200000,-6300000,,831200000,829000000,6698,DHI,quarterly
2020-06-30,,,782400000,279100000,630700000,433600000,1222500000,788900000,788900000,,,,,,149500000,5390000000,4601100000,4167500000,-6500000,,632900000,630700000,6698,DHI,quarterly
2020-03-31,,,621300000,276800000,482700000,380900000,978300000,597400000,597400000,,,,,,137300000,4500000000,3902600000,3521700000,23900000,,484000000,482700000,6698,DHI,quarterly
2021-01-31,,,-593000000,6233000000,-2091000000,30231000000,36818000000,6587000000,6587000000,,-524000000,,,,1415000000,152079000000,145492000000,115261000000,-7180000000,,-2008000000,-2091000000,6707,WMT,quarterly
2020-10-31,,,7115000000,6073000000,5135000000,27991000000,34369000000,6378000000,6378000000,,-541000000,,,,1914000000,134708000000,128330000000,100339000000,737000000,,5201000000,5135000000,6707,WMT,quarterly
2020-07-31,,,8646000000,5887000000,6476000000,27094000000,35053000000,7959000000,7959000000,,-658000000,,,,2207000000,137742000000,129783000000,102689000000,687000000,,6439000000,6476000000,6707,WMT,quarterly
2020-04-30,,,5396000000,5870000000,3990000000,26472000000,32596000000,6124000000,6124000000,,-592000000,,,,1322000000,134622000000,128498000000,102026000000,-728000000,,4074000000,3990000000,6707,WMT,quarterly
2020-12-31,,,540000000,156000000,374000000,,1865000000,760000000,760000000,1105000000,-128000000,,,,161000000,4416000000,3656000000,2551000000,-220000000,,379000000,374000000,6751,MMC,quarterly
2020-09-30,,,459000000,161000000,316000000,,1533000000,600000000,600000000,933000000,-128000000,,,,139000000,3968000000,3368000000,2435000000,-141000000,,320000000,316000000,6751,MMC,quarterly
2020-06-30,,,787000000,166000000,572000000,,1823000000,948000000,948000000,875000000,-132000000,,,,207000000,4189000000,3241000000,2366000000,-161000000,,580000000,572000000,6751,MMC,quarterly
2020-03-31,,,1007000000,156000000,754000000,,2183000000,1214000000,1214000000,969000000,-127000000,,,,240000000,4651000000,3437000000,2468000000,-207000000,,767000000,754000000,6751,MMC,quarterly
2020-12-31,,,1217000000,,952000000,1038000000,2316000000,1278000000,1278000000,,-61000000,,,,265000000,5913000000,4635000000,3597000000,-61000000,,952000000,952000000,6766,AFL,quarterly
2020-09-30,,,1153000000,,2456000000,847000000,2063000000,1216000000,1216000000,,-63000000,,,,-1303000000,5665000000,4449000000,3602000000,-63000000,,2456000000,2456000000,6766,AFL,quarterly
2020-06-30,,,1070000000,,805000000,756000000,1889000000,1133000000,1133000000,,-63000000,,,,265000000,5407000000,4274000000,3518000000,-63000000,,805000000,805000000,6766,AFL,quarterly
2020-03-31,,,720000000,,566000000,779000000,1554000000,775000000,775000000,,-55000000,,,,154000000,5162000000,4387000000,3608000000,-55000000,,566000000,566000000,6766,AFL,quarterly
2020-12-31,,,427760000,,337466000,113235000,2801931000,2546159000,2546159000,1188878000,-53121000,,,,90294000,3999648000,1453489000,1197717000,-2118399000,,337466000,337466000,6813,EOG,quarterly
2020-09-30,,,-52555000,,-42467000,124460000,1276567000,68262000,68262000,130788000,-53242000,,,,-10088000,2320438000,2252176000,1043871000,-120817000,,-42467000,-42467000,6813,EOG,quarterly
2020-06-30,,,-1145262000,,-909384000,131855000,278218000,-1099782000,-1099782000,206681000,-54213000,,,,-235878000,1216503000,2316285000,938285000,-45480000,,-909384000,-909384000,6813,EOG,quarterly
2020-03-31,,,31003000,,9813000,114273000,1720029000,41125000,41125000,-1048413000,-44690000,,,,21190000,3495459000,3454334000,1775430000,-10122000,,9813000,9813000,6813,EOG,quarterly
2020-12-31,,,-2809000000,,-2178000000,95000000,-923000000,-2066000000,-2066000000,565000000,-376000000,,,,-631000000,4028000000,6094000000,4951000000,-743000000,,-2178000000,-2178000000,6833,AAL,quarterly
2020-09-30,,,-3095000000,,-2399000000,70000000,-2489000000,-3716000000,-3716000000,659000000,-340000000,,,,-696000000,3173000000,6889000000,5662000000,621000000,,-2399000000,-2399000000,6833,AAL,quarterly
2020-06-30,,,-2659000000,,-2067000000,43000000,-2950000000,-4060000000,-4060000000,568000000,-254000000,,,,-592000000,1622000000,5682000000,4572000000,1401000000,,-2067000000,-2067000000,6833,AAL,quarterly
2020-03-31,,,-2890000000,,-2241000000,305000000,826000000,-1216000000,-1216000000,1177000000,-257000000,,,,-649000000,8515000000,9731000000,7689000000,-1674000000,,-2241000000,-2241000000,6833,AAL,quarterly
2020-11-01,,,88600000,-3000000,69800000,982900000,1101300000,118400000,118400000,,-34400000,,,,19100000,2118100000,1999700000,1016800000,-29800000,,69500000,69800000,6862,PVH,quarterly
2020-08-02,,,-33800000,-2700000,-51400000,850100000,883300000,33200000,33200000,,-32700000,,,,17900000,1580700000,1547500000,697400000,-67000000,,-51700000,-51400000,6862,PVH,quarterly
2020-05-03,,,-1239600000,-2400000,-1096800000,917700000,665900000,-251800000,-251800000,,-22500000,,,,-142400000,1344000000,1595800000,678100000,-987800000,,-1097200000,-1096800000,6862,PVH,quarterly
2020-02-02,,,-125700000,-2000000,-67400000,1396700000,1397900000,1200000,1200000,,-31500000,,,,-57200000,2600800000,2599600000,1202900000,-126900000,,-68500000,-67400000,6862,PVH,quarterly
2020-12-26,,,374300000,,311000000,762600000,1173700000,411100000,411100000,,-19400000,,,,63300000,1685400000,1274300000,511700000,-36800000,,311000000,311000000,6864,TPR,quarterly
2020-09-26,,,185400000,,231700000,601400000,830200000,228800000,228800000,,-20200000,,,,-46300000,1172200000,943400000,342000000,-43400000,,231700000,231700000,6864,TPR,quarterly
2020-06-27,,,-300800000,,-293800000,555000000,507300000,-47700000,-47700000,,-21300000,,,,-7000000,714800000,762500000,207500000,-253100000,,-293800000,-293800000,6864,TPR,quarterly
2020-03-28,,,-705000000,,-677100000,754600000,720200000,-34400000,-34400000,,-16700000,,,,-27900000,1072700000,1107100000,352500000,-670600000,,-677100000,-677100000,6864,TPR,quarterly
2020-12-31,23000000,,277000000,56000000,219000000,305000000,651000000,327000000,327000000,-4000000,-37000000,,,,55000000,3103000000,2776000000,2452000000,-50000000,,222000000,219000000,6912,AMCR,quarterly
2020-09-30,26000000,,261000000,57000000,198000000,326000000,654000000,305000000,305000000,-3000000,-44000000,,,,61000000,3097000000,2792000000,2443000000,-44000000,,200000000,198000000,6912,AMCR,quarterly
2020-06-30,23000000,,241100000,61200000,179100000,321400000,719500000,370900000,370900000,4200000,-50600000,,,,63900000,3142700000,2771800000,2423200000,-129800000,,177200000,179000000,6912,AMCR,quarterly
2020-03-31,24900000,,239700000,63200000,181500000,348600000,652000000,297700000,297700000,-19200000,-44400000,,,,56100000,3141000000,2843300000,2489000000,-58000000,,183600000,181400000,6912,AMCR,quarterly
2021-01-29,601000000,,1220000000,170000000,1270000000,2496000000,5195000000,1694000000,1694000000,-49000000,-143000000,,,,-59000000,7775000000,6081000000,2580000000,-474000000,,1279000000,1270000000,6914,MDT,quarterly
2020-10-30,639000000,,525000000,152000000,489000000,2612000000,4974000000,1134000000,1134000000,146000000,-470000000,,,,31000000,7647000000,6513000000,2673000000,-609000000,,494000000,489000000,6914,MDT,quarterly
2020-07-31,621000000,,584000000,147000000,487000000,2351000000,4029000000,673000000,673000000,-56000000,-171000000,,,,93000000,6507000000,5834000000,2478000000,-89000000,,491000000,487000000,6914,MDT,quarterly
2020-04-24,568000000,,425000000,135000000,816000000,4077000000,3771000000,325000000,325000000,118000000,-171000000,,,,-384000000,5997000000,5672000000,2226000000,100000000,,809000000,816000000,6914,MDT,quarterly
2020-12-31,,,369000000,,290000000,-60000000,1115000000,766000000,766000000,81000000,-251000000,,,,79000000,1929000000,1163000000,814000000,-397000000,,290000000,290000000,6921,PPL,quarterly
2020-09-30,,,490000000,,281000000,-67000000,1095000000,760000000,760000000,79000000,-249000000,,,,209000000,1885000000,1125000000,790000000,-270000000,,281000000,281000000,6921,PPL,quarterly
2020-06-30,,,418000000,,344000000,-67000000,1001000000,682000000,682000000,67000000,-253000000,,,,74000000,1739000000,1057000000,738000000,-264000000,,344000000,343000000,6921,PPL,quarterly
2020-03-31,,,694000000,,554000000,-68000000,1214000000,885000000,885000000,80000000,-248000000,,,,140000000,2054000000,1169000000,840000000,-191000000,,554000000,554000000,6921,PPL,quarterly
2021-01-02,,,215000000,,236000000,264000000,538000000,274000000,274000000,,-36000000,,,,-21000000,3667000000,3393000000,3129000000,-59000000,,236000000,236000000,6935,TXT,quarterly
2020-10-03,,,116000000,,115000000,237000000,398000000,161000000,161000000,,-38000000,,,,1000000,2735000000,2574000000,2337000000,-45000000,,115000000,115000000,6935,TXT,quarterly
2020-07-04,,,-118000000,,-92000000,219000000,271000000,52000000,52000000,,-37000000,,,,-26000000,2472000000,2420000000,2201000000,-170000000,,-92000000,-92000000,6935,TXT,quarterly
2020-04-04,,,69000000,,50000000,242000000,384000000,142000000,142000000,,-34000000,,,,19000000,2777000000,2635000000,2393000000,-73000000,,50000000,50000000,6935,TXT,quarterly
2020-12-31,1513000000,,2469100000,183600000,2116800000,1496600000,5720200000,2710600000,2710600000,,-89200000,,,,352300000,7440000000,4729400000,1719800000,-241500000,,2116800000,2116800000,6946,LLY,quarterly
2020-09-30,1340400000,,1437200000,169100000,1208400000,1455100000,4414200000,1618700000,1618700000,,-89600000,,,,228800000,5740600000,4121900000,1326400000,-181500000,,1208400000,1208400000,6946,LLY,quarterly
2020-06-30,1390200000,,1643700000,179100000,1412000000,1412700000,4277400000,1474500000,1474500000,,-88300000,,,,231700000,5499400000,4024900000,1222000000,169200000,,1412000000,1412000000,6946,LLY,quarterly
2020-03-31,1392100000,,1679900000,118400000,1456500000,1505000000,4644700000,1747600000,1747600000,,-92500000,,,,223400000,5859800000,4112200000,1215100000,-67700000,,1456500000,1456500000,6946,LLY,quarterly
2020-12-31,40000000,,332000000,196000000,259000000,458000000,837000000,356000000,356000000,-17000000,-24000000,,,,71000000,1842000000,1486000000,1005000000,-24000000,,261000000,259000000,6970,CLX,quarterly
2020-09-30,32000000,,526000000,196000000,415000000,420000000,920000000,466000000,466000000,2000000,-25000000,,,,109000000,1916000000,1450000000,996000000,60000000,,417000000,415000000,6970,CLX,quarterly
2020-06-30,42000000,,395000000,196000000,310000000,503000000,929000000,392000000,392000000,-8000000,-25000000,,,,85000000,1983000000,1591000000,1054000000,3000000,,310000000,310000000,6970,CLX,quarterly
2020-03-31,39000000,,297000000,196000000,241000000,453000000,832000000,321000000,321000000,19000000,-24000000,,,,56000000,1783000000,1462000000,951000000,-24000000,,241000000,241000000,6970,CLX,quarterly
2020-12-27,1653000000,,2604000000,,2455000000,567000000,4746000000,2526000000,2526000000,,-141000000,,,,149000000,8235000000,5709000000,3489000000,78000000,,2455000000,2455000000,6995,QCOM,quarterly
2020-09-27,1582000000,,3306000000,,2960000000,551000000,5580000000,3447000000,3447000000,,-166000000,,,,346000000,8346000000,4899000000,2766000000,-141000000,,2960000000,2960000000,6995,QCOM,quarterly
2020-06-28,1520000000,,868000000,,845000000,511000000,2813000000,782000000,782000000,,-143000000,,,,23000000,4893000000,4111000000,2080000000,86000000,,845000000,845000000,6995,QCOM,quarterly
2020-03-29,1468000000,,598000000,,468000000,483000000,2919000000,968000000,968000000,,-146000000,,,,130000000,5216000000,4248000000,2297000000,-370000000,,468000000,468000000,6995,QCOM,quarterly
2020-12-31,1821000000,,-1507000000,21000000,36000000,3099000000,10448000000,5528000000,5528000000,,-629000000,,,,-1545000000,13858000000,8330000000,3410000000,-7035000000,,38000000,20000000,7038,ABBV,quarterly
2020-09-30,1575000000,,2500000000,19000000,2308000000,2752000000,7874000000,3547000000,3547000000,,-630000000,,,,187000000,12902000000,9355000000,5028000000,-1047000000,,2313000000,2291000000,7038,ABBV,quarterly
2020-06-30,1406000000,,-693000000,24000000,-738000000,2367000000,7179000000,3406000000,3406000000,,-632000000,,,,46000000,10425000000,7019000000,3246000000,-4099000000,,-739000000,-756000000,7038,ABBV,quarterly
2020-03-31,1379000000,,3098000000,24000000,3010000000,1649000000,6246000000,3218000000,3218000000,,-563000000,,,,88000000,8619000000,5401000000,2373000000,-120000000,,3010000000,3000000000,7038,ABBV,quarterly
2020-12-31,,,187000000,14000000,153000000,802000000,1580000000,404000000,404000000,42000000,-133000000,,,,34000000,5239000000,4835000000,3659000000,-217000000,,153000000,153000000,7049,IP,quarterly
2020-09-30,,,254000000,3000000,204000000,726000000,1582000000,492000000,492000000,44000000,-148000000,,,,50000000,5123000000,4631000000,3541000000,-238000000,,204000000,204000000,7049,IP,quarterly
2020-06-30,,,333000000,3000000,266000000,683000000,1439000000,403000000,403000000,41000000,-156000000,,,,67000000,4866000000,4463000000,3427000000,-70000000,,266000000,266000000,7049,IP,quarterly
2020-03-31,,,-47000000,4000000,-141000000,819000000,1654000000,469000000,469000000,44000000,-118000000,,,,94000000,5352000000,4883000000,3698000000,-516000000,,-141000000,-141000000,7049,IP,quarterly
2020-12-31,,,122650000,32247000,117931000,16674000,390941000,199226000,199226000,,-78764000,,,,4500000,418076000,218850000,27135000,-76576000,,118150000,117931000,7060,O,quarterly
2020-09-30,,,27735000,29261000,22904000,16514000,379162000,193564000,193564000,,-76806000,,,,4592000,404572000,211008000,25410000,-165829000,,23143000,22904000,7060,O,quarterly
2020-06-30,,,110908000,29470000,107824000,19063000,388184000,200793000,200793000,,-77841000,,,,2838000,414636000,213843000,26452000,-89885000,,108070000,107824000,7060,O,quarterly
2020-03-31,,,149906000,29624000,146827000,17501000,388735000,206649000,206649000,,-75925000,,,,2763000,414341000,207692000,25606000,-56743000,,147143000,146827000,7060,O,quarterly
2021-01-03,4032000000,,1647000000,,1738000000,6714000000,14692000000,3946000000,3946000000,,-87000000,,,,-91000000,22475000000,18529000000,7783000000,-2299000000,,1738000000,1738000000,7064,JNJ,quarterly
2020-09-27,2840000000,,4401000000,,3554000000,5336000000,14142000000,5966000000,5966000000,,-44000000,,,,847000000,21082000000,15116000000,6940000000,-1565000000,,3554000000,3554000000,7064,JNJ,quarterly
2020-06-28,2707000000,,3940000000,,3626000000,4904000000,11779000000,4168000000,4168000000,,-45000000,,,,314000000,18336000000,14168000000,6557000000,-228000000,,3626000000,3626000000,7064,JNJ,quarterly
2020-03-29,2580000000,,6509000000,,5796000000,5130000000,13644000000,5934000000,5934000000,,-25000000,,,,713000000,20691000000,14757000000,7047000000,575000000,,5796000000,5796000000,7064,JNJ,quarterly
2021-01-03,,,141100000,,132100000,168700000,315700000,147000000,147000000,,-3400000,,,,9000000,809300000,662300000,493600000,-5900000,,132100000,132100000,7065,TDY,quarterly
2020-09-27,,,119700000,,93900000,164800000,290500000,125700000,125700000,,-4100000,,,,25800000,749000000,623300000,458500000,-6000000,,93900000,93900000,7065,TDY,quarterly
2020-06-28,,,107900000,,93700000,169700000,291300000,121600000,121600000,,-3700000,,,,14200000,743300000,621700000,452000000,-13700000,,93700000,93700000,7065,TDY,quarterly
2020-03-29,,,101000000,,82200000,184400000,292000000,107600000,107600000,,-4100000,,,,18800000,784600000,677000000,492600000,-6600000,,82200000,82200000,7065,TDY,quarterly
2020-11-01,20000000,,406000000,4000000,309000000,345000000,814000000,467000000,467000000,-18000000,-55000000,,,,97000000,2340000000,1873000000,1526000000,-61000000,,309000000,309000000,7066,CPB,quarterly
2020-08-02,24000000,,107000000,6000000,86000000,434000000,750000000,186000000,186000000,106000000,-61000000,,,,21000000,2108000000,1922000000,1358000000,-79000000,,86000000,86000000,7066,CPB,quarterly
2020-04-26,25000000,,218000000,6000000,168000000,383000000,776000000,332000000,332000000,36000000,-55000000,,,,52000000,2238000000,1906000000,1462000000,-114000000,2000000.0,166000000,168000000,7066,CPB,quarterly
2020-01-26,21000000,,204000000,5000000,1208000000,370000000,744000000,375000000,375000000,-22000000,-149000000,,,,33000000,2162000000,1787000000,1418000000,-171000000,1037000000.0,171000000,1208000000,7066,CPB,quarterly
2021-01-31,939000000,,425000000,,267000000,3206000000,4338000000,193000000,193000000,,,,,,158000000,5817000000,5624000000,1479000000,232000000,,267000000,267000000,7093,CRM,quarterly
2020-10-31,902000000,,1250000000,,1081000000,2899000000,4025000000,224000000,224000000,,-29000000.0,,,,169000000,5419000000,5195000000,1394000000,1026000000,,1081000000,1081000000,7093,CRM,quarterly
2020-07-31,898000000,,839000000,,2625000000,2764000000,3840000000,178000000,178000000,,-29000000.0,,,,-1786000000,5151000000,4973000000,1311000000,661000000,,2625000000,2625000000,7093,CRM,quarterly
2020-04-30,859000000,,47000000,,99000000,2892000000,3611000000,-140000000,-140000000,,-29000000.0,,,,-52000000,4865000000,5005000000,1254000000,187000000,,99000000,99000000,7093,CRM,quarterly
2020-12-26,,,176038000,963912000,142633000,674131000,859711000,185580000,185580000,,-11968000,,,,29409000,3165725000,2980145000,2306014000,-9542000,712000,146629000,142633000,7143,HSIC,quarterly
2020-09-26,,,180818000,931694000,141697000,559636000,754299000,194663000,194663000,,-11111000,,,,29005000,2840146000,2645483000,2085847000,-13845000,-29000,151813000,141697000,7143,HSIC,quarterly
2020-06-27,,,-14802000,909683000,-10797000,445793000,454294000,8501000,8501000,,-10486000,,,,-950000,1684399000,1675898000,1230105000,-23303000,585000,-13852000,-10797000,7143,HSIC,quarterly
2020-03-28,,,171757000,903341000,130261000,567387000,746039000,178652000,178652000,,-7812000,,,,37910000,2428871000,2250219000,1682832000,-6895000,-282000,133847000,130261000,7143,HSIC,quarterly
2020-12-31,,,512000000,,508000000,185000000,991000000,767000000,767000000,-362000000,-168000000,,,,4000000,1493000000,726000000,502000000,-255000000,,508000000,508000000,7168,CCI,quarterly
2020-09-30,,,168000000,,163000000,154000000,999000000,439000000,439000000,-362000000,-168000000,,,,5000000,1486000000,1047000000,487000000,-271000000,,163000000,163000000,7168,CCI,quarterly
2020-06-30,,,206000000,,200000000,164000000,954000000,388000000,388000000,-362000000,-178000000,,,,6000000,1440000000,1052000000,486000000,-182000000,,200000000,172000000,7168,CCI,quarterly
2020-03-31,,,190000000,,185000000,175000000,947000000,373000000,373000000,-362000000,-175000000,,,,5000000,1421000000,1048000000,474000000,-183000000,,185000000,157000000,7168,CCI,quarterly
2020-12-31,,,155568000,1252343000,163729000,27848000,419534000,148953000,148953000,,-121173000,,,,290000,1122016000,973063000,702482000,6615000,,155278000,163729000,7176,WELL,quarterly
2020-09-30,,,396981000,1183281000,325585000,31003000,417492000,130957000,130957000,,-124851000,,,,2003000,1036874000,905917000,619382000,266024000,,394978000,325585000,7176,WELL,quarterly
2020-06-30,,,161449000,1215532000,179246000,34062000,569347000,269914000,269914000,,-126357000,,,,2233000,1188475000,918561000,619128000,-108465000,,159216000,179246000,7176,WELL,quarterly
2020-03-31,,,334822000,1362913000,310284000,35481000,569749000,259467000,259467000,,-142007000,,,,5442000,1258602000,999135000,688853000,75355000,,329380000,310284000,7176,WELL,quarterly
2020-12-31,,,359000000,,284000000,364000000,777000000,0,367000000,46000000,,,,,75000000,777000000,410000000,0,-8000000,,284000000,275000000,7180,ZION,quarterly
2020-09-30,,,215000000,,175000000,353000000,667000000,0,222000000,92000000,,,,,40000000,667000000,445000000,0,-7000000,,175000000,166000000,7180,ZION,quarterly
2020-06-30,,,82000000,,66000000,344000000,519000000,0,89000000,86000000,,,,,16000000,519000000,430000000,0,-7000000,,66000000,57000000,7180,ZION,quarterly
2020-03-31,,,16000000,,14000000,354000000,442000000,0,21000000,67000000,,,,,2000000,442000000,421000000,0,-5000000,,14000000,6000000,7180,ZION,quarterly
2020-12-31,,,216000000,,242000000,114000000,1843000000,340000000,340000000,1069000000,-266000000,,,,4000000,2354000000,2014000000,511000000,-124000000,30000000,212000000,242000000,7195,FE,quarterly
2020-09-30,,,576000000,,454000000,114000000,2246000000,721000000,721000000,1209000000,-258000000,,,,116000000,3022000000,2301000000,776000000,-145000000,-6000000,460000000,454000000,7195,FE,quarterly
2020-06-30,,,373000000,,309000000,114000000,1819000000,515000000,515000000,983000000,-257000000,,,,66000000,2522000000,2007000000,703000000,-142000000,2000000,307000000,309000000,7195,FE,quarterly
2020-03-31,,,-36000000,,74000000,423000000,1865000000,109000000,109000000,1016000000,-256000000,,,,-60000000,2709000000,2600000000,844000000,-145000000,50000000,24000000,74000000,7195,FE,quarterly
2021-01-01,71000000,,253000000,,178000000,182000000,552000000,281000000,281000000,,-32000000,,,,80000000,639000000,358000000,87000000,-28000000,5000000,173000000,178000000,7214,NLOK,quarterly
2020-10-02,63000000,,231000000,,64000000,186000000,536000000,269000000,269000000,,-37000000,,,,65000000,626000000,357000000,90000000,-38000000,-102000000,166000000,64000000,7214,NLOK,quarterly
2020-07-03,65000000,,99000000,,118000000,198000000,528000000,248000000,248000000,,-40000000,,,,-50000000,614000000,366000000,86000000,-149000000,-31000000,149000000,118000000,7214,NLOK,quarterly
2020-04-03,70000000,,257000000,,231000000,247000000,517000000,184000000,184000000,,-50000000,,,,108000000,614000000,430000000,97000000,73000000,82000000,149000000,231000000,7214,NLOK,quarterly
2020-11-01,1182000000,,1137000000,,1324000000,512000000,4714000000,1459000000,1459000000,,-420000000,,,,-187000000,6467000000,5008000000,1753000000,-322000000,,1324000000,1250000000,7239,AVGO,quarterly
2020-08-02,1228000000,,593000000,,688000000,428000000,4284000000,1075000000,1075000000,,-464000000,,,,-96000000,5821000000,4746000000,1537000000,-482000000,-1000000.0,689000000,614000000,7239,AVGO,quarterly
2020-05-03,1269000000,,409000000,,563000000,501000000,4150000000,827000000,827000000,,-487000000,,,,-159000000,5742000000,4915000000,1592000000,-418000000,-5000000.0,568000000,488000000,7239,AVGO,quarterly
2020-02-02,1289000000,,304000000,,385000000,497000000,4222000000,883000000,883000000,,-406000000,,,,-76000000,5858000000,4975000000,1636000000,-579000000,5000000.0,380000000,311000000,7239,AVGO,quarterly
2020-12-31,,,-130000000,113000000,-64000000,21000000,-66000000,-254000000,-254000000,,-51000000,,,,-64000000,263000000,517000000,329000000,124000000,,-66000000,-64000000,7265,HST,quarterly
2020-09-30,,,-389000000,85000000,-313000000,18000000,-96000000,-280000000,-280000000,,-66000000,,,,-73000000,193000000,473000000,289000000,-109000000,,-316000000,-313000000,7265,HST,quarterly
2020-06-30,,,-402000000,86000000,-352000000,25000000,-185000000,-378000000,-378000000,,-40000000,,,,-46000000,78000000,456000000,263000000,-24000000,,-356000000,-352000000,7265,HST,quarterly
2020-03-31,,,-40000000,90000000,-3000000,25000000,182000000,-7000000,-7000000,,-37000000,,,,-37000000,1056000000,1063000000,874000000,-33000000,,-3000000,-3000000,7265,HST,quarterly
2020-12-31,,,4430000000,,3385000000,6595000000,12167000000,0,5572000000,,,,,,1018000000,13640000000,8068000000,1473000000,-1142000000,,3412000000,3266000000,7271,MS,quarterly
2020-09-30,,,3487000000,1424000000.0,2717000000,6079000000,10344000000,0,4265000000,,,,,,736000000,11657000000,7392000000,1313000000,-778000000,,2751000000,2597000000,7271,MS,quarterly
2020-06-30,,,4355000000,1364000000.0,3196000000,6998000000,12109000000,0,5111000000,,,,,,1119000000,13414000000,8303000000,1305000000,-756000000,,3236000000,3047000000,7271,MS,quarterly
2020-03-31,,,2146000000,1368000000.0,1698000000,5229000000,8184000000,0,2955000000,,,,,,366000000,9487000000,6532000000,1303000000,-809000000,,1780000000,1590000000,7271,MS,quarterly
2020-12-31,,,576000000,1901000000,526000000,366000000,1698000000,788000000,788000000,40000000,-252000000,,,,50000000,3157000000,2369000000,1459000000,-212000000,,526000000,526000000,7273,EIX,quarterly
2020-09-30,,,-563000000,1901000000,-288000000,694000000,2301000000,1031000000,1031000000,86000000,-268000000,,,,-275000000,4644000000,3613000000,2343000000,-1594000000,,-288000000,-288000000,7273,EIX,quarterly
2020-06-30,,,322000000,2193000000,318000000,-27000000,1157000000,644000000,644000000,51000000,-259000000,,,,4000000,2987000000,2343000000,1830000000,-322000000,,318000000,318000000,7273,EIX,quarterly
2020-03-31,,,99000000,2193000000,183000000,-27000000,981000000,413000000,413000000,111000000,-255000000,,,,-84000000,2790000000,2377000000,1809000000,-314000000,,183000000,183000000,7273,EIX,quarterly
2020-12-31,,,994000000,9000000,760000000,,1583000000,1236000000,1236000000,,-189000000,,,,234000000,2825000000,1589000000,1242000000,-242000000,,760000000,760000000,7311,CSX,quarterly
2020-09-30,,,968000000,14000000,736000000,,1498000000,1150000000,1150000000,,-187000000,,,,232000000,2648000000,1498000000,1150000000,-182000000,,736000000,736000000,7311,CSX,quarterly
2020-06-30,,,652000000,13000000,499000000,,1201000000,857000000,857000000,,-191000000,,,,153000000,2255000000,1398000000,1054000000,-205000000,,499000000,499000000,7311,CSX,quarterly
2020-03-31,,,1013000000,17000000,770000000,,1532000000,1188000000,1188000000,,-187000000,,,,243000000,2855000000,1667000000,1323000000,-175000000,,770000000,770000000,7311,CSX,quarterly
2020-12-31,,,235900000,326400000,165700000,,384300000,276900000,276900000,17400000,-39100000,,,,69600000,693400000,416500000,309100000,-41000000,,166300000,165700000,7322,KSU,quarterly
2020-09-30,,,238700000,325800000,189800000,,363200000,274000000,274000000,17400000,-39500000,,,,48500000,659600000,385600000,296400000,-35300000,,190200000,189700000,7322,KSU,quarterly
2020-06-30,,,151100000,324500000,109700000,,283700000,190900000,190900000,3500000,-38100000,,,,40800000,547900000,357000000,264200000,-39800000,,110300000,109700000,7322,KSU,quarterly
2020-03-31,,,197500000,323900000,151800000,,389000000,294800000,294800000,4800000,-34200000,,,,45200000,731700000,436900000,342700000,-97300000,,152300000,151700000,7322,KSU,quarterly
2020-12-31,,,1793000000,,1380000000,,3089000000,2019000000,2019000000,513000000,-279000000,,,,413000000,5141000000,3122000000,2052000000,-226000000,,1380000000,1380000000,7335,UNP,quarterly
2020-09-30,,,1773000000,,1363000000,,2897000000,2043000000,2043000000,299000000,-295000000,,,,410000000,4919000000,2876000000,2022000000,-270000000,,1363000000,1363000000,7335,UNP,quarterly
2020-06-30,,,1496000000,,1132000000,,2451000000,1665000000,1665000000,235000000,-289000000,,,,364000000,4244000000,2579000000,1793000000,-169000000,,1132000000,1132000000,7335,UNP,quarterly
2020-03-31,,,1918000000,,1474000000,,2996000000,2151000000,2151000000,298000000,-278000000,,,,444000000,5229000000,3078000000,2233000000,-233000000,,1474000000,1474000000,7335,UNP,quarterly
2020-11-30,1601000000,,2972000000,699000000,2442000000,2160000000,7861000000,3680000000,3680000000,75000000,-601000000,,,,530000000,9800000000,6120000000,1939000000,-708000000,,2442000000,2442000000,7409,ORCL,quarterly
2020-08-31,1589000000,,2595000000,649000000,2251000000,2149000000,7487000000,3388000000,3388000000,16000000,-614000000,,,,344000000,9367000000,5979000000,1880000000,-793000000,,2251000000,2251000000,7409,ORCL,quarterly
2020-05-31,1479000000,,3696000000,643000000,3116000000,2208000000,8470000000,4398000000,4398000000,20000000,-581000000,,,,580000000,10439000000,6041000000,1969000000,-702000000,,3116000000,3116000000,7409,ORCL,quarterly
2020-02-29,1500000000,,3076000000,646000000,2571000000,2337000000,7832000000,3592000000,3592000000,3000000,-457000000,,,,505000000,9796000000,6204000000,1964000000,-516000000,,2571000000,2571000000,7409,ORCL,quarterly
2021-01-31,,,3756000000,,2857000000,6187000000,10831000000,4083000000,4083000000,,-337000000,,,,899000000,32261000000,28178000000,21430000000,-327000000,,2857000000,2857000000,7454,HD,quarterly
2020-11-01,,,4523000000,,3432000000,5663000000,11456000000,5265000000,5265000000,,-340000000,,,,1091000000,33536000000,28271000000,22080000000,-742000000,,3432000000,3432000000,7454,HD,quarterly
2020-08-02,,,5730000000,,4332000000,6355000000,12941000000,6067000000,6067000000,,-346000000,,,,1398000000,38053000000,31986000000,25112000000,-337000000,,4332000000,4332000000,7454,HD,quarterly
2020-05-03,,,2969000000,,2245000000,5829000000,9625000000,3276000000,3276000000,,-324000000,,,,724000000,28260000000,24984000000,18635000000,-307000000,,2245000000,2245000000,7454,HD,quarterly
2020-12-31,,,5541000000,1640000000,4506000000,3172000000,9797000000,0,5561000000,566000000,,,,,1035000000,11448000000,5887000000,1651000000,-20000000,,4506000000,4358000000,7458,GS,quarterly
2020-09-30,,,4299000000,1668000000,3367000000,3720000000,9252000000,0,4555000000,509000000,,,,,932000000,10503000000,5948000000,1251000000,-256000000,,3367000000,3229000000,7458,GS,quarterly
2020-06-30,,,1291000000,1025000000,373000000,5111000000,10415000000,0,4251000000,554000000,,,,,918000000,11705000000,7454000000,1290000000,-2960000000,,373000000,187000000,7458,GS,quarterly
2020-03-31,,,1348000000,1122000000,1213000000,3973000000,6510000000,0,1532000000,568000000,,,,,135000000,7806000000,6274000000,1296000000,-184000000,,1213000000,1116000000,7458,GS,quarterly
2020-12-31,12900000,,118800000,,98400000,71600000,211100000,124700000,124700000,1900000,-2100000,,,,20400000,580200000,455500000,369100000,-5900000,,98400000,98400000,7486,WST,quarterly
2020-09-30,12500000,,103400000,,82300000,75900000,194600000,106700000,106700000,-500000,-2100000,,,,21100000,548000000,441300000,353400000,-3300000,,82300000,82300000,7486,WST,quarterly
2020-06-30,10800000,,107200000,,91200000,77500000,195100000,108200000,108200000,-1400000,-2000000,,,,16000000,527200000,419000000,332100000,-1000000,,91200000,91200000,7486,WST,quarterly
2020-03-31,10700000,,89300000,,74300000,72100000,167000000,84200000,84200000,-3500000,-2000000,,,,15000000,491500000,407300000,324500000,5100000,,74300000,74300000,7486,WST,quarterly
2020-12-31,7022000000,,18689000000,,15227000000,8145000000,30818000000,15651000000,15651000000,,-53000000,,,,3462000000,56898000000,41247000000,26080000000,3038000000,,15227000000,15227000000,7514,GOOGL,quarterly
2020-09-30,6856000000,,13359000000,,11247000000,6987000000,25056000000,11213000000,11213000000,,-48000000,,,,2112000000,46173000000,34960000000,21117000000,2146000000,,11247000000,11247000000,7514,GOOGL,quarterly
2020-06-30,6875000000,,8277000000,,6959000000,6486000000,19744000000,6383000000,6383000000,,-13000000,,,,1318000000,38297000000,31914000000,18553000000,1894000000,,6959000000,6959000000,7514,GOOGL,quarterly
2020-03-31,6820000000,,7757000000,,6836000000,7380000000,22177000000,7977000000,7977000000,,-21000000,,,,921000000,41159000000,33182000000,18982000000,-220000000,,6836000000,6836000000,7514,GOOGL,quarterly
2020-11-29,,,128800000,,96900000,78900000,223500000,144600000,144600000,,-30000000,,,,31900000,896100000,751500000,672600000,-15800000,,96900000,96900000,7517,LW,quarterly
2020-08-30,,,117300000,,89300000,74100000,229800000,155700000,155700000,,-30300000,,,,28000000,871500000,715800000,641700000,-38400000,,89300000,89300000,7517,LW,quarterly
2020-05-31,15400000.0,,-4400000,,-1600000,53700000,158100000,89000000,89000000,,-29200000,,,,-2800000,846900000,757900000,688800000,-93400000,,-1600000,-1600000,7517,LW,quarterly
2020-02-23,15400000.0,,147100000,,111400000,87900000,250400000,162500000,162500000,,-25200000,,,,35700000,937300000,774800000,686900000,-15400000,,111400000,111400000,7517,LW,quarterly
2021-01-01,121600000,,570900000,,509300000,66600000,761700000,570700000,570700000,,,,,,61600000,1510000000,939300000,748300000,200000,,509300000,509300000,7521,SWKS,quarterly
2020-10-02,126200000,,266100000,,246900000,62300000,458900000,267600000,267600000,,,,,,19200000,956800000,689200000,497900000,-1500000,,246900000,246900000,7521,SWKS,quarterly
2020-06-26,117000000,,144000000,,129700000,55000000,357500000,182700000,182700000,,,,,,14300000,736800000,554100000,379300000,-38700000,,129700000,129700000,7521,SWKS,quarterly
2020-03-27,113200000,,203000000,,181100000,58600000,375600000,200700000,200700000,,,,,,21900000,766100000,565400000,390500000,2300000,,181100000,181100000,7521,SWKS,quarterly
2020-12-31,,,216000000,,176200000,107400000,452900000,252300000,252300000,,-35300000,,,,39800000,713400000,461100000,260500000,-36300000,,176200000,176200000,7524,VRSK,quarterly
2020-09-30,,,240000000,,185800000,95900000,462700000,275900000,275900000,,-35300000,,,,54200000,702700000,426800000,240000000,-35900000,,185800000,185800000,7524,VRSK,quarterly
2020-06-30,,,224800000,,179000000,96400000,443000000,259700000,259700000,,-34200000,,,,45800000,678800000,419100000,235800000,-34900000,,179000000,179000000,7524,VRSK,quarterly
2020-03-31,,,216700000,,171700000,112100000,432100000,232900000,232900000,,-33500000,,,,45000000,689800000,456900000,257700000,-16200000,,171700000,171700000,7524,VRSK,quarterly
2020-12-31,5207000000,,13055000000,,11219000000,4880000000,22862000000,12775000000,12775000000,,,,,,1836000000,28072000000,15297000000,5210000000,280000000,,11219000000,11219000000,7538,FB,quarterly
2020-09-30,4763000000,,8133000000,,7846000000,4473000000,17276000000,8040000000,8040000000,,,,,,287000000,21470000000,13430000000,4194000000,93000000,,7846000000,7846000000,7538,FB,quarterly
2020-06-30,4462000000,,6131000000,,5178000000,4433000000,14858000000,5963000000,5963000000,,,,,,953000000,18687000000,12724000000,3829000000,168000000,,5178000000,5178000000,7538,FB,quarterly
2020-03-31,4015000000,,5861000000,,4902000000,4370000000,14278000000,5893000000,5893000000,,,,,,959000000,17737000000,11844000000,3459000000,-32000000,,4902000000,4902000000,7538,FB,quarterly
2020-12-31,,,-309723000,,-269502000,173544000,207410000,-178611000,-178611000,23754000,-149287000,,,,568000,685995000,864606000,478585000,-131112000,,-310291000,-269502000,7638,WYNN,quarterly
2020-09-30,,,-424168000,-417928000.0,-758142000,160896000,149845000,-275707000,-275707000,68705000,-145142000,,,,407365000,370452000,646159000,220607000,-148461000,,-831533000,-758142000,7638,WYNN,quarterly
2020-06-30,,,-653931000,-345321000.0,-637564000,152081000,-142069000,-523016000,-523016000,19067000,-133218000,,,,80938000,85698000,608714000,227767000,-130915000,,-734869000,-637564000,7638,WYNN,quarterly
2020-03-31,,,-374453000,-249610000.0,-402037000,234328000,470056000,-223811000,-223811000,257629000,-128827000,,,,75800000,953716000,1177527000,483660000,-150642000,,-450253000,-402037000,7638,WYNN,quarterly
2020-12-31,,,338936000,2677000,341128000,14621000,334206000,141762000,141762000,,-51589000,,,,-2178000,555453000,413691000,221247000,197174000,,341114000,341128000,7680,AVB,quarterly
2020-09-30,,,147690000,3191000,147703000,13985000,359605000,170272000,170272000,,-53249000,,,,-27000,573015000,402743000,213410000,-22582000,,147717000,147361000,7680,AVB,quarterly
2020-06-30,,,169736000,3369000,170828000,15573000,378955000,187133000,187133000,,-53399000,,,,-1133000,577446000,390313000,198491000,-17397000,,170869000,170438000,7680,AVB,quarterly
2020-03-31,,,168097000,3314000,167971000,17320000,402991000,207760000,207760000,,-55914000,,,,91000,603356000,395596000,200365000,-39663000,,168006000,167544000,7680,AVB,quarterly
2020-12-31,,,254000000,,200000000,26000000,741000000,282000000,282000000,129000000,-119000000,,,,54000000,2054000000,1772000000,1313000000,-28000000,,200000000,151000000,7688,CNP,quarterly
2020-09-30,,,117000000,,121000000,26000000,730000000,302000000,302000000,122000000,-128000000,,,,-10000000,1622000000,1320000000,892000000,-185000000,-6000000.0,127000000,69000000,7688,CNP,quarterly
2020-06-30,,,164000000,,105000000,-10000000,661000000,245000000,245000000,129000000,-135000000,,,,29000000,1575000000,1330000000,914000000,-81000000,-30000000.0,135000000,59000000,7688,CNP,quarterly
2020-03-31,,,-1400000000,,-1199000000,2000000,820000000,400000000,400000000,136000000,-147000000,,,,-347000000,2167000000,1767000000,1347000000,-1800000000,-146000000.0,-1053000000,-1228000000,7688,CNP,quarterly
2020-12-31,,,1146000000,1561700000,783400000,221800000,977700000,755900000,755900000,,,,,,216400000,1732900000,977000000,755200000,390100000,,929600000,762200000,7696,TROW,quarterly
2020-09-30,,,920500000,1340200000,643200000,204300000,933200000,728900000,728900000,,,,,,221900000,1595800000,866900000,662600000,191600000,,698600000,625300000,7696,TROW,quarterly
2020-06-30,,,968800000,1090100000,603000000,211100000,764800000,553700000,553700000,,,,,,240300000,1415400000,861700000,650600000,415100000,,728500000,576800000,7696,TROW,quarterly
2020-03-31,,,206900000,971000000,343100000,207400000,914600000,707200000,707200000,,-397100000.0,,,,40300000,1462600000,755400000,548000000,-500300000,,166600000,343100000,7696,TROW,quarterly
2020-12-31,,,652000000,910000000,497000000,556000000,1364000000,792000000,792000000,,-47000000,,,,151000000,5798000000,5006000000,4434000000,-140000000,,501000000,497000000,7816,WHR,quarterly
2020-09-30,,,541000000,907000000,397000000,501000000,1155000000,638000000,638000000,,-51000000,,,,143000000,5291000000,4653000000,4136000000,-97000000,,398000000,397000000,7816,WHR,quarterly
2020-06-30,,,43000000,907000000,35000000,418000000,631000000,198000000,198000000,,-49000000,,,,18000000,4042000000,3844000000,3411000000,-155000000,,25000000,35000000,7816,WHR,quarterly
2020-03-31,,,219000000,920000000,152000000,420000000,700000000,265000000,265000000,,-42000000,,,,72000000,4325000000,4060000000,3625000000,-30000000,,147000000,152000000,7816,WHR,quarterly
2020-12-31,,,-1337300000,256300000,-1369800000,640700000,895200000,254500000,254500000,,-56800000,,,,36600000,2294300000,2039800000,1399100000,-1591800000,,-1373900000,-1369800000,7827,TAP,quarterly
2020-09-30,,,450400000,262900000,342800000,626900000,1202500000,575600000,575600000,,-70700000,,,,104000000,2753500000,2177900000,1551000000,-125200000,,346400000,342800000,7827,TAP,quarterly
2020-06-30,,,401700000,265100000,195000000,516900000,1046800000,529900000,529900000,,-72500000,,,,204500000,2503400000,1973500000,1456600000,-128200000,,197200000,195000000,7827,TAP,quarterly
2020-03-31,,,-158700000,259400000,-117000000,622200000,623800000,1600000,1600000,,-74600000,,,,-43300000,2102800000,2101200000,1479000000,-160300000,,-115400000,-117000000,7827,TAP,quarterly
2020-12-31,,,193000000,279000000,119000000,464000000,1126000000,318000000,318000000,,-102000000,,,,63000000,3298000000,2980000000,2172000000,-125000000,,130000000,119000000,7842,IQV,quarterly
2020-09-30,,,105000000,261000000,101000000,460000000,986000000,207000000,207000000,,-100000000,,,,-3000000,2786000000,2579000000,1800000000,-102000000,,108000000,101000000,7842,IQV,quarterly
2020-06-30,,,-26000000,261000000,-23000000,431000000,817000000,78000000,78000000,,-108000000,,,,-5000000,2521000000,2443000000,1704000000,-104000000,,-21000000,-23000000,7842,IQV,quarterly
2020-03-31,,,108000000,260000000,82000000,407000000,930000000,207000000,207000000,,-106000000,,,,17000000,2754000000,2547000000,1824000000,-99000000,,91000000,82000000,7842,IQV,quarterly
2020-12-31,1512000000,,1814000000,,1551000000,1499000000,6086000000,3075000000,3075000000,,-267000000,,,,270000000,7421000000,4346000000,1335000000,-1261000000,,1544000000,1551000000,7919,GILD,quarterly
2020-09-30,1158000000,,825000000,26000000.0,360000000,1106000000,5436000000,3172000000,3172000000,,-236000000,,,,472000000,6577000000,3405000000,1141000000,-2347000000,,353000000,360000000,7919,GILD,quarterly
2020-06-30,1299000000,,-2973000000,115000000.0,-3339000000,1239000000,4079000000,1541000000,1541000000,,-240000000,,,,373000000,5143000000,3602000000,1064000000,-4514000000,,-3346000000,-3339000000,7919,GILD,quarterly
2020-03-31,1101000000,,2003000000,112000000.0,1551000000,1076000000,4579000000,2402000000,2402000000,,-241000000,,,,465000000,5548000000,3146000000,969000000,-399000000,,1538000000,1551000000,7919,GILD,quarterly
2020-12-31,,,102211000,222310000,94725000,18739000,147122000,63959000,63959000,,-37543000,,,,0,218108000,154149000,70986000,38252000,,102211000,92467000,7926,FRT,quarterly
2020-09-30,,,-33623000,249946000,-28289000,9308000,134224000,59285000,59285000,,-36228000,,,,0,206576000,147291000,72352000,-92908000,,-33623000,-30548000,7926,FRT,quarterly
2020-06-30,,,10859000,256400000,10507000,9814000,105339000,32741000,32741000,,-34073000,,,,0,172355000,139614000,67016000,-21882000,,10859000,8247000,7926,FRT,quarterly
2020-03-31,,,56441000,257035000,54763000,10251000,157017000,84578000,84578000,,-28445000,,,,0,230393000,145815000,73376000,-28137000,,56441000,52506000,7926,FRT,quarterly
2020-12-26,114802000,,210463000,,183945000,80153000,416422000,216992000,216992000,3532000,-9400000,,,,26518000,628288000,411296000,211866000,-6529000,,183945000,183945000,7952,MXIM,quarterly
2020-09-26,115466000,,194397000,,169514000,82954000,417014000,210247000,210247000,7428000,-9400000,,,,24883000,619357000,409110000,202343000,-15850000,,169514000,169514000,7952,MXIM,quarterly
2020-06-27,110172000,,169499000,,207298000,72893000,362368000,178665000,178665000,-172000,-7897000,,,,-37799000,545369000,366704000,183001000,-9166000,,207298000,207298000,7952,MXIM,quarterly
2020-03-28,109091000,,181725000,,161190000,71643000,366437000,183870000,183870000,1077000,-9300000,,,,20535000,561916000,378046000,195479000,-2145000,,161190000,161190000,7952,MXIM,quarterly
2020-12-31,20000000,,1571000000,369000000,1453000000,202000000,376000000,149000000,149000000,,-26000000,,,,117000000,1591000000,1442000000,1215000000,1422000000,,1454000000,1453000000,7986,CE,quarterly
2020-09-30,19000000,,241000000,376000000,207000000,78000000,327000000,224000000,224000000,,-28000000,,,,30000000,1411000000,1187000000,1084000000,17000000,-2000000.0,211000000,207000000,7986,CE,quarterly
2020-06-30,18000000,,147000000,382000000,107000000,87000000,242000000,132000000,132000000,-1000000.0,-27000000,,,,35000000,1193000000,1061000000,951000000,15000000,-3000000.0,112000000,107000000,7986,CE,quarterly
2020-03-31,17000000,,292000000,388000000,218000000,97000000,348000000,229000000,229000000,-1000000.0,-28000000,,,,65000000,1460000000,1231000000,1112000000,63000000,-7000000.0,227000000,218000000,7986,CE,quarterly
2020-12-31,,,821000000,,750000000,4600000000,11222000000,2403000000,2403000000,,-798000000,,,,71000000,20341000000,17938000000,9119000000,-1582000000,,750000000,750000000,7996,TMUS,quarterly
2020-09-30,,,1660000000,,1253000000,4670000000,11670000000,2850000000,2850000000,,-809000000,,,,407000000,19272000000,16422000000,7602000000,-1190000000,,1253000000,1253000000,7996,TMUS,quarterly
2020-06-30,,,-208000000,,110000000,4507000000,10946000000,2375000000,2375000000,,-839000000,,,,2000000,17671000000,15296000000,6725000000,-2583000000,320000000.0,-210000000,110000000,7996,TMUS,quarterly
2020-03-31,,,1257000000,,951000000,3428000000,6945000000,1799000000,1799000000,,-284000000,,,,306000000,11113000000,9314000000,4168000000,-542000000,320000000.0,951000000,951000000,7996,TMUS,quarterly
2020-12-31,,,347400000,173800000,827900000,110900000,348400000,278100000,278100000,-40600000,-55500000,,,,-480900000,2457400000,2179300000,2109000000,69300000,,828300000,827900000,8023,MOS,quarterly
2020-09-30,,,33500000,171400000,-6200000,97600000,374100000,149500000,149500000,127000000,-50800000,,,,38100000,2381500000,2232000000,2007400000,-116000000,,-4600000,-6200000,8023,MOS,quarterly
2020-06-30,,,43200000,170700000,47400000,95100000,279000000,131800000,131800000,52100000,-57000000,,,,-2700000,2044700000,1912900000,1765700000,-88600000,,45900000,47400000,8023,MOS,quarterly
2020-03-31,,,-337000000,173700000,-203000000,67900000,63400000,-19200000,-19200000,14700000,-50800000,,,,-133000000,1798100000,1817300000,1734700000,-317800000,,-204000000,-203000000,8023,MOS,quarterly
2020-12-31,,,-26613000000,6980000000,-20070000000,2637000000,15973000000,-126000000,-126000000,9087000000,-313000000,,,,-6010000000,46203000000,46329000000,30230000000,-26487000000,,-20603000000,-20070000000,8066,XOM,quarterly
2020-09-30,,,-372000000,7212000000,-680000000,2716000000,14643000000,-596000000,-596000000,7352000000,-279000000,,,,337000000,45696000000,46292000000,31053000000,224000000,,-709000000,-680000000,8066,XOM,quarterly
2020-06-30,,,-1640000000,6970000000,-1080000000,2680000000,11538000000,-1426000000,-1426000000,5154000000,-317000000,,,,-471000000,32502000000,33928000000,20964000000,-214000000,,-1169000000,-1080000000,8066,XOM,quarterly
2020-03-31,,,-258000000,6664000000,-610000000,2848000000,15003000000,-222000000,-222000000,6832000000,-249000000,,,,512000000,55383000000,55605000000,40380000000,-36000000,,-770000000,-610000000,8066,XOM,quarterly
2020-12-31,,,-326000000,69000000,-347000000,235000000,-66000000,-301000000,-301000000,,-19000000,,,,22000000,1327000000,1628000000,1393000000,-25000000,,-348000000,-347000000,8098,NOV,quarterly
2020-09-30,,,-114000000,75000000,-55000000,213000000,139000000,-74000000,-74000000,,-21000000,,,,-61000000,1384000000,1458000000,1245000000,-40000000,,-53000000,-55000000,8098,NOV,quarterly
2020-06-30,,,-134000000,73000000,-93000000,237000000,137000000,-100000000,-100000000,,-22000000,,,,-47000000,1496000000,1596000000,1359000000,-34000000,,-87000000,-93000000,8098,NOV,quarterly
2020-03-31,,,-2205000000,68000000,-2047000000,283000000,224000000,-59000000,-59000000,,-22000000,,,,-156000000,1883000000,1942000000,1659000000,-2146000000,,-2049000000,-2047000000,8098,NOV,quarterly
2020-12-31,,,184900000,,142200000,194800000,424400000,220100000,220100000,,-43700000,,,,47400000,1340900000,1120800000,916500000,-35200000,4700000,137500000,142200000,8124,SEE,quarterly
2020-09-30,,,149200000,,134000000,199400000,404500000,195400000,195400000,,-45300000,,,,17400000,1237200000,1041800000,832700000,-46200000,2200000,131800000,134000000,8124,SEE,quarterly
2020-06-30,,,144900000,,100100000,184900000,389900000,195700000,195700000,,-45400000,,,,44600000,1151200000,955500000,761300000,-50800000,-200000,100300000,100100000,8124,SEE,quarterly
2020-03-31,,,147200000,,126600000,193100000,390500000,188400000,188400000,,-47800000,,,,32700000,1173900000,985500000,783400000,-41200000,12100000,114500000,126500000,8124,SEE,quarterly
2020-12-31,,,15065000000,,12136000000,14705000000,31113000000,0,15341000000,1067000000,,,,,2929000000,31113000000,15772000000,0,-276000000,,12136000000,11698000000,8135,JPM,quarterly
2020-09-30,,,11661000000,,9443000000,14984000000,28536000000,0,12185000000,1367000000,,,,,2218000000,28536000000,16351000000,0,-524000000,,9443000000,9015000000,8135,JPM,quarterly
2020-06-30,,,5565000000,,4687000000,15659000000,22507000000,0,5683000000,1165000000,,,,,878000000,22507000000,16824000000,0,-118000000,,4687000000,4265000000,8135,JPM,quarterly
2020-03-31,,,3116000000,,2865000000,15367000000,19907000000,0,3313000000,1227000000,,,,,251000000,19907000000,16594000000,0,-197000000,,2865000000,2433000000,8135,JPM,quarterly
2020-12-31,,,62400000,-14900000,51000000,-43700000,409700000,141400000,141400000,90000000,-93400000,,,,8400000,1094400000,953000000,684700000,-79000000,,54000000,51000000,8138,EVRG,quarterly
2020-09-30,,,417500000,-17900000,364500000,13700000,859400000,536700000,536700000,91000000,-94800000,,,,50000000,1517600000,980900000,658200000,-119200000,,367500000,364500000,8138,EVRG,quarterly
2020-06-30,,,170000000,-20900000,133400000,13800000,583800000,257500000,257500000,90900000,-99500000,,,,33700000,1184700000,927200000,600900000,-87500000,,136300000,133400000,8138,EVRG,quarterly
2020-03-31,,,82300000,-23800000,69400000,16200000,535300000,208300000,208300000,92300000,-96200000,,,,10100000,1116700000,908400000,581400000,-126000000,,72200000,69400000,8138,EVRG,quarterly
2020-12-31,,,1830000000,,1377200000,698000000,2780200000,1750000000,1750000000,251900000,-308900000,,,,452800000,5313800000,3563800000,2533600000,80000000,,1377200000,1377200000,8147,MCD,quarterly
2020-09-30,,,2217100000,,1762600000,454700000,2904700000,2401200000,2401200000,-27000000,-310100000,,,,454500000,5418100000,3016900000,2513400000,-184100000,,1762600000,1762600000,8147,MCD,quarterly
2020-06-30,,,648700000,,483800000,576000000,1725300000,1002200000,1002200000,76100000,-319100000,,,,164900000,3761500000,2759300000,2036200000,-353500000,,483800000,483800000,8147,MCD,quarterly
2020-03-31,,,1444900000,,1106900000,516300000,2341900000,1752200000,1752200000,-100000,-280000000,,,,338000000,4714400000,2962200000,2372500000,-307300000,,1106900000,1106900000,8147,MCD,quarterly
2020-12-31,,,888623000,,604190000,211843000,958135000,746292000,746292000,,-16288000,,,,284433000,1627820000,881528000,669685000,142331000,,604190000,604190000,8155,VRTX,quarterly
2020-09-30,,,745871000,,667434000,184551000,858592000,674041000,674041000,,-13856000,,,,78437000,1538271000,864230000,679679000,71830000,,667434000,667434000,8155,VRTX,quarterly
2020-06-30,,,824770000,,837270000,191804000,919037000,727233000,727233000,,-13871000,,,,-12500000,1524485000,797252000,605448000,97537000,,837270000,837270000,8155,VRTX,quarterly
2020-03-31,,,657534000,,602753000,182053000,906760000,724707000,724707000,,-14136000,,,,54781000,1515107000,790400000,608347000,-67173000,,602753000,602753000,8155,VRTX,quarterly
2020-12-31,86428000,,216446000,,182248000,238489000,520177000,181253000,181253000,,-141000,,,,34198000,860889000,679636000,340712000,35193000,,182248000,182248000,8192,TTWO,quarterly
2020-09-30,74216000,,117418000,,99321000,202612000,408637000,118118000,118118000,,-82000,,,,18097000,841142000,723024000,432505000,-700000,,99321000,99321000,8192,TTWO,quarterly
2020-06-30,73108000,,90361000,,88505000,186952000,374316000,101838000,101838000,,-82000,,,,1856000,831310000,729472000,456994000,-11477000,,88505000,88505000,8192,TTWO,quarterly
2020-03-31,68718000,,124634000,,122722000,162181000,364901000,121500000,121500000,,-2389000,,,,1912000,760541000,639041000,395640000,3134000,,122722000,122722000,8192,TTWO,quarterly
2020-12-31,,,586897000,213791000,392910000,554626000,1251696000,0,624798000,72272000,,,,,148096000,1251696000,626898000,0,-37901000,,438801000,388316000,8206,SIVB,quarterly
2020-09-30,,,636320000,174445000,446307000,446535000,1097323000,0,613235000,37553000,,,,,162265000,1097323000,484088000,0,23085000,,474055000,441713000,8206,SIVB,quarterly
2020-06-30,,,335658000,148940000,233529000,433170000,815294000,0,342477000,39647000,,,,,87869000,815294000,472817000,0,-6819000,,247789000,228935000,8206,SIVB,quarterly
2020-03-31,,,183006000,148472000,135622000,353648000,582591000,0,188240000,40703000,,,,,49357000,582591000,394351000,0,-5234000,,133649000,132253000,8206,SIVB,quarterly
2020-12-31,,,276500000,192800000,239000000,1200000,676900000,375000000,375000000,51400000,-118200000,,,,37200000,1933400000,1558400000,1256500000,-98500000,,239300000,239000000,8211,WEC,quarterly
2020-09-30,,,313700000,108400000,266800000,-11800000,669500000,382000000,382000000,54300000,-122300000,,,,46900000,1651000000,1269000000,981500000,-68300000,,266800000,266800000,8211,WEC,quarterly
2020-06-30,,,295600000,109000000,241600000,-12300000,631100000,351100000,351100000,49800000,-124700000,,,,53800000,1548700000,1197600000,917600000,-55500000,,241800000,241600000,8211,WEC,quarterly
2020-03-31,,,542300000,140500000,452500000,-12600000,918200000,639200000,639200000,52500000,-129700000,,,,90000000,2108600000,1469400000,1190400000,-96900000,,452300000,452500000,8211,WEC,quarterly
2020-12-31,,,375000000,,316000000,652000000,1131000000,0,402000000,77000000,,,,,59000000,1131000000,729000000,0,-27000000,,316000000,281000000,8233,HBAN,quarterly
2020-09-30,,,358000000,,303000000,656000000,1069000000,0,374000000,39000000,,,,,55000000,1069000000,695000000,0,-16000000,,303000000,275000000,8233,HBAN,quarterly
2020-06-30,,,181000000,,150000000,609000000,855000000,0,200000000,46000000,,,,,31000000,855000000,655000000,0,-19000000,,150000000,131000000,8233,HBAN,quarterly
2020-03-31,,,58000000,,48000000,581000000,710000000,0,78000000,51000000,,,,,10000000,710000000,632000000,0,-20000000,,48000000,30000000,8233,HBAN,quarterly
2020-12-31,,,273577000,6842000,248221000,452079000,760931000,308852000,308852000,,-15898000,,,,25180000,2641764000,2332912000,1880833000,-35275000,,248397000,248221000,8270,MHK,quarterly
2020-09-26,,,248616000,6412000,205117000,434691000,723909000,289218000,289218000,,-14854000,,,,43163000,2574870000,2285652000,1850961000,-40602000,,205453000,205117000,8270,MHK,quarterly
2020-06-27,,,-74951000,6052000,-48257000,417389000,420010000,2621000,2621000,,-12956000,,,,-26363000,2049800000,2047179000,1629790000,-77572000,,-48588000,-48257000,8270,MHK,quarterly
2020-03-28,,,137133000,6275000,110514000,464061000,628222000,164161000,164161000,,-8671000,,,,26668000,2285763000,2121602000,1657541000,-27028000,,110465000,110514000,8270,MHK,quarterly
2020-12-26,,,162200000,,119800000,687300000,937400000,188900000,188900000,1000000,-12200000,,,,42400000,1432800000,1243900000,495400000,-26700000,,119800000,119800000,8292,RL,quarterly
2020-09-26,,,-29100000,,-39100000,595700000,794000000,148000000,148000000,2900000,-12800000,,,,10000000,1193500000,1045500000,399500000,-177100000,,-39100000,-39100000,8292,RL,quarterly
2020-06-27,,,-172600000,,-127700000,465600000,350000000,-174100000,-174100000,2900000,-9600000,,,,-44900000,487500000,661600000,137500000,1500000,,-127700000,-127700000,8292,RL,quarterly
2020-03-28,,,-287200000,,-249000000,711400000,752900000,-45500000,-45500000,2600000,-4800000,,,,-38200000,1274100000,1319600000,521200000,-241700000,,-249000000,-249000000,8292,RL,quarterly
2020-12-31,,,3310000000,,2624000000,1131000000,4590000000,3429000000,3429000000,,-80000000,,,,686000000,12018000000,8589000000,7428000000,-119000000,,2624000000,2598000000,8350,ALL,quarterly
2020-09-30,,,1442000000,,1153000000,1309000000,3059000000,1719000000,1719000000,,-78000000,,,,289000000,11500000000,9781000000,8441000000,-277000000,,1153000000,1126000000,8350,ALL,quarterly
2020-06-30,,,1546000000,,1250000000,1483000000,3929000000,1679000000,1679000000,738000000.0,-79000000,,,,296000000,11197000000,9518000000,7268000000,-133000000,,1250000000,1224000000,8350,ALL,quarterly
2020-03-31,,,661000000,,549000000,1717000000,2701000000,746000000,746000000,210000000.0,-81000000,,,,112000000,10076000000,9330000000,7375000000,-85000000,,549000000,513000000,8350,ALL,quarterly
2020-12-31,,,140532000,15194000,105781000,47193000,403889000,176094000,176094000,219000,-103195000,,,,34347000,535905000,359811000,132016000,-35562000,,106185000,105781000,8358,SBAC,quarterly
2020-09-30,,,13235000,15194000,22568000,47917000,397297000,168656000,168656000,422000,-106189000,,,,-9441000,522940000,354284000,125643000,-155421000,,22676000,22568000,8358,SBAC,quarterly
2020-06-30,,,22953000,14349000,22813000,48868000,391090000,163217000,163217000,299000,-103986000,,,,-165000,507226000,344009000,116136000,-140264000,,23118000,22813000,8358,SBAC,quarterly
2020-03-31,,,-194471000,14478000,-127058000,49390000,397754000,164911000,164911000,874000,-99430000,,,,-66538000,517067000,352156000,119313000,-359382000,,-127933000,-127058000,8358,SBAC,quarterly
2020-12-31,,,1655000000,6476000000,1246000000,-3613000000,1321000000,2525000000,2525000000,,-965000000,,,,254000000,12624000000,10099000000,11303000000,-870000000,,1401000000,1246000000,8369,CHTR,quarterly
2020-09-30,,,1109000000,6806000000,814000000,2430000000,6871000000,2071000000,2071000000,,-946000000,,,,177000000,12039000000,9968000000,5168000000,-962000000,,932000000,814000000,8369,CHTR,quarterly
2020-06-30,,,1042000000,7045000000,766000000,2152000000,6562000000,1982000000,1982000000,,-957000000,,,,166000000,11696000000,9714000000,5134000000,-940000000,,876000000,766000000,8369,CHTR,quarterly
2020-03-31,,,496000000,7094000000,396000000,2218000000,6534000000,1819000000,1819000000,,-980000000,,,,29000000,11738000000,9919000000,5204000000,-1323000000,,467000000,396000000,8369,CHTR,quarterly
2020-12-31,23500000,,590300000,388300000,482000000,182100000,742800000,562500000,562500000,-25300000,-36700000,,,,113900000,2375200000,1812700000,1632400000,27800000,10300000,476400000,482000000,8378,APD,quarterly
2020-09-30,27100000,,594600000,363300000,486800000,182400000,753600000,574600000,574600000,-30500000,-39200000,,,,99900000,2320100000,1745500000,1566500000,20000000,10300000,494700000,486800000,8378,APD,quarterly
2020-06-30,19900000,,566400000,364100000,446500000,166200000,720300000,549400000,549400000,-15200000,-32100000,,,,109300000,2065200000,1515800000,1344900000,17000000,10300000,457100000,446500000,8378,APD,quarterly
2020-03-31,19200000,,653200000,351800000,477800000,192000000,756200000,550700000,550700000,-5700000,-19300000,,,,148500000,2216300000,1665600000,1460100000,102500000,-14300000,504700000,477800000,8378,APD,quarterly
2020-11-30,68600000,,258200000,13900000,200700000,299000000,660700000,293100000,293100000,,-32400000,,,,57500000,1557900000,1264800000,897200000,-34900000,,200700000,200700000,8392,MKC,quarterly
2020-08-31,68600000,,253000000,13300000,206100000,315300000,590300000,275000000,275000000,,-33500000,,,,46900000,1430300000,1155300000,840000000,-22000000,,206100000,206100000,8392,MKC,quarterly
2020-05-31,68600000,,236300000,12400000,195900000,316200000,579500000,263300000,263300000,,-34400000,,,,40400000,1401100000,1137800000,821600000,-27000000,,195900000,195900000,8392,MKC,quarterly
2020-02-29,68600000,,174800000,12700000,144700000,271900000,469900000,198000000,198000000,,-35300000,,,,30100000,1212000000,1014000000,742100000,-23200000,,144700000,144700000,8392,MKC,quarterly
2020-12-31,,,-1366933000,,-1366933000,255532000,-231118000,-804679000,-804679000,,-273089000,,,,0,34139000,838818000,265257000,-562254000,,-1366933000,-1366933000,8402,RCL,quarterly
2020-09-30,,,-1339312000,,-1346756000,253958000,-335118000,-906215000,-906215000,,-259349000,,,,0,-33688000,872527000,301430000,-433097000,,-1339312000,-1346756000,8402,RCL,quarterly
2020-06-30,,,-1631848000,584869000.0,-1639292000,327033000,-479200000,-1125990000,-1125990000,,-218889000,,,,0,175605000,1301595000,654805000,-505858000,,-1631848000,-1639292000,8402,RCL,quarterly
2020-03-31,,,-1437035000,577425000.0,-1444479000,443236000,569277000,-198289000,-198289000,,-92911000,,,,0,2032750000,2231039000,1463473000,-1238746000,,-1437035000,-1444479000,8402,RCL,quarterly
2020-11-30,,,1986867000,519715000,1500276000,2007627000,3898296000,1890669000,1890669000,,-8854000,,,,464810000,11762185000,9871516000,7863889000,96198000,,1522057000,1500276000,8431,ACN,quarterly
2020-08-31,,,1783355000,498637000,1287929000,1895837000,3440540000,1544703000,1544703000,,-14069000,,,,477931000,10835271000,9290568000,7394731000,238652000,,1305424000,1287929000,8431,ACN,quarterly
2020-05-31,,,1680773000,469039000,1228202000,1815955000,3528688000,1712733000,1712733000,,-4961000,,,,428134000,10991305000,9278572000,7462617000,-31960000,,1252639000,1228202000,8431,ACN,quarterly
2020-02-29,,,1509556000,446217000,1234740000,1870226000,3359171000,1488945000,1488945000,,-8567000,,,,257474000,11141505000,9652560000,7782334000,20611000,,1252082000,1234740000,8431,ACN,quarterly
2020-12-31,,,156100000,,119600000,526100000,761300000,178900000,178900000,,-26400000,,,,36500000,1112800000,933900000,351500000,-22800000,,119600000,119600000,8432,IT,quarterly
2020-09-30,,,14167000,,16964000,521508000,664851000,89372000,89372000,,-30538000,,,,-2797000,994618000,905246000,329767000,-75205000,,16964000,16964000,8432,IT,quarterly
2020-06-30,,,58956000,,55077000,495840000,650584000,100808000,100808000,,-40596000,,,,3879000,973135000,872327000,322551000,-41852000,,55077000,55077000,8432,IT,quarterly
2020-03-31,,,96854000,,75097000,497739000,677613000,125178000,125178000,,-26349000,,,,21757000,1018891000,893713000,341278000,-28324000,,75097000,75097000,8432,IT,quarterly
2020-12-31,119200000,,81300000,,355200000,175900000,399100000,104000000,104000000,,-24600000,,,,-273900000,568900000,464900000,169800000,-22700000,,355200000,355200000,8492,DXCM,quarterly
2020-09-30,87700000,,75100000,,72200000,158600000,340400000,94100000,94100000,,-24400000,,,,2900000,500900000,406800000,160500000,-19000000,,72200000,72200000,8492,DXCM,quarterly
2020-06-30,79900000,,46200000,,46300000,136400000,284100000,67800000,67800000,,-20300000,,,,-100000,451800000,384000000,167700000,-21600000,,46300000,46300000,8492,DXCM,quarterly
2020-03-31,73100000,,22400000,,19900000,149800000,256500000,33600000,33600000,,-15400000,,,,2500000,405100000,371500000,148600000,-11200000,,19900000,19900000,8492,DXCM,quarterly
2020-11-30,,,1406000000,,1226000000,,5417000000,1615000000,1615000000,2866000000,-184000000,,,,180000000,20563000000,18948000000,15146000000,-209000000,,1226000000,1224000000,8500,FDX,quarterly
2020-08-31,,,1606000000,,1245000000,,5386000000,1791000000,1791000000,2669000000,-184000000,,,,361000000,19321000000,17530000000,13935000000,-185000000,,1245000000,1243000000,8500,FDX,quarterly
2020-05-31,,,-319000000,,-334000000,427000000.0,3765000000,218000000,218000000,2193000000,-229000000,,,,15000000,17358000000,17140000000,13593000000,-537000000,,-334000000,-333000000,8500,FDX,quarterly
2020-02-29,,,420000000,,315000000,427000000.0,4188000000,579000000,579000000,2701000000,-155000000,,,,105000000,17487000000,16908000000,13299000000,-159000000,,315000000,314000000,8500,FDX,quarterly
2021-01-02,,,263000000,524000000,205000000,749000000,1188000000,439000000,439000000,,-85000000,,,,55000000,3464000000,3025000000,2276000000,-176000000,,208000000,205000000,8510,K,quarterly
2020-09-26,,,417000000,542000000,348000000,790000000,1201000000,411000000,411000000,,-63000000,,,,65000000,3429000000,3018000000,2228000000,6000000,,352000000,348000000,8510,K,quarterly
2020-06-27,,,463000000,536000000,351000000,669000000,1207000000,538000000,538000000,,-69000000,,,,109000000,3465000000,2927000000,2258000000,-75000000,,354000000,351000000,8510,K,quarterly
2020-03-28,,,444000000,538000000,347000000,679000000,1144000000,465000000,465000000,,-64000000,,,,94000000,3412000000,2947000000,2268000000,-21000000,,350000000,347000000,8510,K,quarterly
2020-12-31,,,90289000,,72931000,22543000,125952000,92817000,92817000,,-96000,,,,17358000,171346000,78529000,45394000,-2528000,,72931000,72931000,8533,MKTX,quarterly
2020-09-30,,,87965000,,67776000,21171000,118006000,87803000,87803000,,-1046000,,,,20189000,164006000,76203000,46000000,162000,,67776000,67776000,8533,MKTX,quarterly
2020-06-30,,,104403000,,83854000,22127000,134567000,104135000,104135000,,-1046000,,,,20549000,184795000,80660000,50228000,268000,,83854000,83854000,8533,MKTX,quarterly
2020-03-31,,,91702000,,74816000,20467000,119623000,91089000,91089000,,-1046000,,,,16886000,168978000,77889000,49355000,613000,,74816000,74816000,8533,MKTX,quarterly
2020-12-31,,,370000000,195000000,299000000,309000000,812000000,466000000,466000000,,-39000000,,,,55000000,4212000000,3746000000,3400000000,-96000000,,315000000,283000000,8604,APTV,quarterly
2020-09-30,,,303000000,191000000,299000000,262000000,674000000,376000000,376000000,,-38000000,,,,-2000000,3668000000,3292000000,2994000000,-73000000,,305000000,283000000,8604,APTV,quarterly
2020-06-30,,,-379000000,184000000,-366000000,248000000,43000000,-240000000,-240000000,,-44000000,,,,-14000000,1960000000,2200000000,1917000000,-139000000,,-365000000,-369000000,8604,APTV,quarterly
2020-03-31,,,1577000000,182000000,1572000000,284000000,528000000,208000000,208000000,,-43000000,,,,10000000,3226000000,3018000000,2698000000,1369000000,,1567000000,1572000000,8604,APTV,quarterly
2020-12-31,,,-2208000000,,-2289000000,866000000,2894000000,833000000,833000000,,-396000000,,,,81000000,5125000000,4292000000,2231000000,-3041000000,,-2289000000,-2289000000,8673,LUMN,quarterly
2020-09-30,,,480000000,,366000000,852000000,2931000000,886000000,886000000,,-409000000,,,,114000000,5167000000,4281000000,2236000000,-406000000,,366000000,366000000,8673,LUMN,quarterly
2020-06-30,,,513000000,,377000000,901000000,2960000000,897000000,897000000,,-414000000,,,,136000000,5192000000,4295000000,2232000000,-384000000,,377000000,377000000,8673,LUMN,quarterly
2020-03-31,,,433000000,,314000000,857000000,2993000000,976000000,976000000,,-449000000,,,,119000000,5228000000,4252000000,2235000000,-543000000,,314000000,314000000,8673,LUMN,quarterly
2020-12-31,,,96576000,586463000,72838000,25144000,131239000,49163000,49163000,,-29061000,,,,0,225148000,175985000,93909000,47413000,,96576000,171001000,8694,SLG,quarterly
2020-09-30,,,20677000,633542000,19461000,23602000,132807000,46989000,46989000,,-27267000,,,,0,229212000,182223000,96405000,-26312000,,20677000,13526000,8694,SLG,quarterly
2020-06-30,,,66627000,669940000,62534000,23510000,148311000,70760000,70760000,-12800000.0,-33379000,,,,0,238700000,167940000,90389000,-4133000,,66627000,56361000,8694,SLG,quarterly
2020-03-31,,,127114000,705413000,121205000,19570000,157034000,105785000,105785000,-36600000.0,-40493000,,,,0,264889000,159104000,107855000,21329000,,127114000,114299000,8694,SLG,quarterly
2020-12-31,,,202800000,18800000,152000000,382900000,749500000,274700000,274700000,,-105500000,,,,50300000,4401500000,4126800000,3652000000,-71900000,,152500000,152000000,8718,WRK,quarterly
2020-09-30,,,-1114500000,18200000,-1156000000,365100000,873000000,408900000,408900000,,-164700000,,,,40000000,4471500000,4062600000,3598500000,-1523400000,,-1154500000,-1156000000,8718,WRK,quarterly
2020-06-30,,,199200000,18400000,178500000,364500000,765800000,301700000,301700000,,-98400000,,,,19200000,4236300000,3934600000,3470500000,-102500000,,180000000,178500000,8718,WRK,quarterly
2020-03-31,,,206700000,17200000,148100000,392500000,804800000,312200000,312200000,,-97300000,,,,57800000,4447300000,4135100000,3642500000,-105500000,,148900000,148000000,8718,WRK,quarterly
2020-12-31,605000000,,-8625000000,241000000,-8420000000,1722000000,-4062000000,-6389000000,-6389000000,,-698000000,,,,-186000000,15304000000,21693000000,19366000000,-2236000000,,-8439000000,-8420000000,8729,BA,quarterly
2020-09-30,574000000,,-925000000,268000000,-449000000,881000000,1952000000,497000000,497000000,,-643000000,,,,-459000000,14139000000,13642000000,12187000000,-1422000000,,-466000000,-449000000,8729,BA,quarterly
2020-06-30,625000000,,-3423000000,285000000,-2376000000,1091000000,-326000000,-2042000000,-2042000000,,-553000000,,,,-1028000000,11807000000,13849000000,12133000000,-1381000000,,-2395000000,-2376000000,8729,BA,quarterly
2020-03-31,672000000,,-1503000000,305000000,-628000000,799000000,1074000000,-397000000,-397000000,,-262000000,,,,-862000000,16908000000,17305000000,15834000000,-1106000000,,-641000000,-628000000,8729,BA,quarterly
2020-12-31,,,620522000,,471140000,654539000,1465530000,0,638855000,172136000,,,,,149382000,1465530000,826675000,0,-18333000,,471140000,451863000,8736,MTB,quarterly
2020-09-30,,,486882000,,372136000,645914000,1313656000,0,502917000,164825000,,,,,114746000,1313656000,810739000,0,-16035000,,372136000,353399000,8736,MTB,quarterly
2020-06-30,,,312368000,,241054000,618409000,1119410000,0,330488000,170513000,,,,,71314000,1119410000,788922000,0,-18120000,,241054000,223098000,8736,MTB,quarterly
2020-03-31,,,349749000,,268822000,714120000,1256165000,0,365933000,176112000,,,,,80927000,1256165000,890232000,0,-16184000,,268822000,250701000,8736,MTB,quarterly
2020-12-31,,,570000000,702200000,398100000,101300000,626900000,471800000,471800000,,-19100000,,,,141500000,3757000000,3285200000,3130100000,98200000,,428500000,398100000,8755,OMC,quarterly
2020-09-30,,,455800000,693300000,313300000,90200000,646300000,501400000,501400000,,-54400000,,,,120900000,3206500000,2705100000,2560200000,-45600000,,334900000,313300000,8755,OMC,quarterly
2020-06-30,,,7500000,628200000,-24200000,82100000,479600000,340400000,340400000,,-53700000,,,,21900000,2800700000,2460300000,2321100000,-332900000,,-14400000,-24200000,8755,OMC,quarterly
2020-03-31,,,369100000,681200000,258100000,86800000,564000000,420200000,420200000,,-58500000,,,,97400000,3406900000,2986700000,2842900000,-51100000,,271700000,258100000,8755,OMC,quarterly
2020-09-30,,,66700000,1800000,53800000,340600000,474600000,115300000,115300000,18700000,-14500000,,,,12500000,894800000,779500000,420200000,-48600000,,54200000,53800000,8788,XRAY,quarterly
2020-06-30,,,-119900000,2300000,-95400000,279100000,176100000,-102100000,-102100000,-900000,-12300000,,,,-24000000,490600000,592700000,314500000,-17800000,,-95900000,-95400000,8788,XRAY,quarterly
2020-03-31,,,-129700000,2700000,-139900000,393500000,467800000,72800000,72800000,1500000,-6700000,,,,10200000,874300000,801500000,406500000,-202500000,,-139900000,-139900000,8788,XRAY,quarterly
2019-12-31,131300000.0,,137500000,2400000,102300000,259600000,635900000,237100000,237100000,2100000,-6400000,,,,35000000,1111500000,874400000,475600000,-99600000,,102500000,102300000,8788,XRAY,quarterly
2020-12-31,32105000,,80735000,,61868000,86198000,190553000,72250000,72250000,,,,,,18867000,231663000,159413000,41110000,8485000,,61868000,61868000,8790,ABMD,quarterly
2020-09-30,29809000,,72915000,,62213000,79167000,171028000,62052000,62052000,,,,,,10702000,209764000,147712000,38736000,10863000,,62213000,62213000,8790,ABMD,quarterly
2020-06-30,25556000,,61076000,,44588000,67544000,128867000,35767000,35767000,,,,,,16488000,164850000,129083000,35983000,25309000,,44588000,44588000,8790,ABMD,quarterly
2020-03-31,26786000,,39313000,,31798000,83892000,167290000,56612000,56612000,,,,,,7515000,206658000,150046000,39368000,-17299000,,31798000,31798000,8790,ABMD,quarterly
2020-12-31,,,151853000,,131206000,24534000,249079000,163244000,163244000,-39946000,-10981000,,,,20647000,413157000,249913000,164078000,-11391000,,131206000,131206000,8798,COG,quarterly
2020-09-30,,,-21979000,,-14961000,24262000,166115000,-7564000,-7564000,45868000,-14389000,,,,-7018000,333294000,340858000,167179000,-14415000,,-14961000,-14961000,8798,COG,quarterly
2020-06-30,,,39125000,,30374000,23166000,135702000,53957000,53957000,-40622000,-14543000,,,,8751000,288374000,234417000,152672000,-14832000,,30374000,30374000,8798,COG,quarterly
2020-03-31,,,72124000,,53910000,33429000,209819000,86389000,86389000,-12324000,-14211000,,,,18214000,370395000,284006000,160576000,-14265000,,53910000,53910000,8798,COG,quarterly
2020-12-31,,,305000000,,330000000,1681000000,2090000000,409000000,409000000,,-160000000,,,,-25000000,10212000000,9803000000,8122000000,-104000000,,330000000,330000000,8803,NOC,quarterly
2020-09-30,,,1167000000,,986000000,553000000,1840000000,1287000000,1287000000,,-154000000,,,,181000000,9083000000,7796000000,7243000000,-120000000,,986000000,986000000,8803,NOC,quarterly
2020-06-30,,,1203000000,,1005000000,529000000,1826000000,1297000000,1297000000,,-154000000,,,,198000000,8884000000,7587000000,7058000000,-94000000,,1005000000,1005000000,8803,NOC,quarterly
2020-03-31,,,1053000000,,868000000,486000000,1722000000,1236000000,1236000000,,-125000000,,,,185000000,8620000000,7384000000,6898000000,-183000000,,868000000,868000000,8803,NOC,quarterly
2020-11-30,,,115300000,13800000,151100000,296200000,706900000,260400000,260400000,1000000,-57700000,,,,-35600000,1107200000,846800000,400300000,-145100000,,150900000,151100000,8847,INFO,quarterly
2020-08-31,,,203600000,14000000,162900000,258700000,687600000,282000000,282000000,-700000,-57700000,,,,39900000,1073200000,791200000,385600000,-78400000,,163700000,162900000,8847,INFO,quarterly
2020-05-31,,,75500000,13200000,71700000,267000000,638300000,223100000,223100000,-1200000,-60000000,,,,4700000,1026600000,803500000,388300000,-147600000,,70800000,71700000,8847,INFO,quarterly
2020-02-29,,,488300000,14100000,485000000,337700000,665000000,182800000,182800000,-800000,-61200000,,,,4300000,1080800000,898000000,415800000,305500000,,484000000,485000000,8847,INFO,quarterly
2020-12-31,,,122900000,,87300000,97400000,307100000,163600000,163600000,5600000,-13900000,,,,35600000,844200000,680600000,537100000,-40700000,,87300000,87100000,8855,CBOE,quarterly
2020-09-30,,,163400000,,109900000,95800000,292000000,152200000,152200000,4500000,-9600000,,,,53500000,792700000,640500000,500700000,11200000,,109900000,109600000,8855,CBOE,quarterly
2020-06-30,,,156600000,,113600000,84700000,296900000,171100000,171100000,3100000,-7400000,,,,43000000,868700000,697600000,571800000,-14500000,,113600000,113300000,8855,CBOE,quarterly
2020-03-31,,,217500000,,157400000,86300000,358300000,228200000,228200000,3300000,-8000000,,,,60100000,921500000,693300000,563200000,-10700000,,157400000,157000000,8855,CBOE,quarterly
2020-12-31,,,1021000000,,682000000,,1645000000,856000000,856000000,208000000,-241000000,,,,206000000,3521000000,2665000000,1876000000,165000000,-125000000,815000000,666000000,8873,D,quarterly
2020-09-30,,,2000000,1730000000.0,356000000,31000000.0,1998000000,951000000,951000000,421000000,-306000000,,,,-110000000,3607000000,2656000000,1609000000,-949000000,19000000,112000000,340000000,8873,D,quarterly
2020-06-30,,,2000000,2013000000.0,0,31000000.0,0,0,951000000,421000000,-306000000,,,,0,0,0,0,0,19000000,112000000,340000000,8873,D,quarterly
2020-03-31,,,-258000000,2026000000.0,-270000000,24000000.0,2375000000,1008000000,1008000000,670000000,-407000000,,,,-19000000,4496000000,3488000000,2121000000,-1266000000,19000000,-239000000,-286000000,8873,D,quarterly
2020-12-31,,,1920000000,630000000,1519000000,2878000000,5238000000,0,1739000000,621000000,,,,,395000000,5238000000,3499000000,0,181000000,,1525000000,1425000000,8959,USB,quarterly
2020-09-30,,,1933000000,630000000,1580000000,2876000000,5259000000,0,2026000000,357000000,,,,,347000000,5259000000,3233000000,0,-93000000,,1586000000,1494000000,8959,USB,quarterly
2020-06-30,,,759000000,630000000,689000000,2824000000,4031000000,0,881000000,326000000,,,,,64000000,4031000000,3150000000,0,-122000000,,695000000,614000000,8959,USB,quarterly
2020-03-31,,,1439000000,630000000,1171000000,2782000000,4714000000,0,1581000000,351000000,,,,,260000000,4714000000,3133000000,0,-142000000,,1179000000,1088000000,8959,USB,quarterly
2021-01-01,72200000,,124400000,9500000,96500000,161600000,359000000,125200000,125200000,,-1300000,,,,27600000,778800000,653600000,419800000,-800000,,96800000,96500000,9006,VAR,quarterly
2020-10-02,77200000,,108000000,9300000,76600000,179300000,374700000,118200000,118200000,,-2100000,,,,31500000,850500000,732300000,475800000,-10200000,,76500000,76600000,9006,VAR,quarterly
2020-07-03,65300000,,84800000,9600000,61200000,144500000,298500000,88700000,88700000,,-2900000,,,,23900000,694300000,605600000,395800000,-3900000,,60900000,61200000,9006,VAR,quarterly
2020-04-03,71000000,,52800000,9900000,43200000,174700000,337200000,91500000,91500000,,-4300000,,,,9700000,794500000,703000000,457300000,-38700000,,43100000,43200000,9006,VAR,quarterly
2020-12-31,,,1224600000,,1149200000,398500000,1138600000,885300000,885300000,-145200000,-14800000,,,,75400000,2236200000,1350900000,1097600000,339300000,,1149200000,1149200000,9007,REGN,quarterly
2020-09-30,,,998300000,,842100000,326900000,1335400000,1053100000,1053100000,-44600000,-26300000,,,,156200000,2294000000,1240900000,958600000,-54800000,,842100000,842100000,9007,REGN,quarterly
2020-06-30,,,918900000,,897300000,348300000,954500000,656400000,656400000,-50200000,-9700000,,,,21600000,1952000000,1295600000,997500000,262500000,,897300000,897300000,9007,REGN,quarterly
2020-03-31,,,668600000,,624600000,367300000,1027000000,700100000,700100000,-40400000,-6100000,,,,44000000,1828200000,1128100000,801200000,-31500000,,624600000,624600000,9007,REGN,quarterly
2020-12-31,,,3064000000,,2566000000,3579000000,7073000000,0,3078000000,416000000,,,,,496000000,7073000000,3995000000,0,-14000000,-2000000,2568000000,2462000000,9037,COF,quarterly
2020-09-30,,,3502000000,,2406000000,3145000000,7050000000,0,3565000000,340000000,,,,,1096000000,7050000000,3485000000,0,-63000000,-2000000,2406000000,2319000000,9037,COF,quarterly
2020-06-30,,,3502000000,,0,3145000000,0,0,3565000000,340000000,,,,,0,0,0,0,0,-2000000,2406000000,2319000000,9037,COF,quarterly
2020-03-31,,,-1903000000,,-1340000000,3224000000,1826000000,0,-1812000000,414000000,,,,,-563000000,1826000000,3638000000,0,-91000000,-2000000,-1340000000,-1420000000,9037,COF,quarterly
2020-12-31,,,259000000,265000000,168000000,655000000,1027000000,312000000,312000000,,-21000000,,,,74000000,2941000000,2629000000,1914000000,-53000000,,185000000,168000000,9040,GWW,quarterly
2020-09-30,,,362000000,244000000,240000000,700000000,1074000000,374000000,374000000,,-23000000,,,,106000000,3018000000,2644000000,1944000000,-12000000,,256000000,240000000,9040,GWW,quarterly
2020-06-30,,,184000000,223000000,114000000,810000000,1016000000,206000000,206000000,,-28000000,,,,55000000,2837000000,2631000000,1821000000,-22000000,,129000000,114000000,9040,GWW,quarterly
2020-03-31,,,142000000,220000000,173000000,778000000,1121000000,343000000,343000000,,-21000000,,,,-43000000,3001000000,2658000000,1880000000,-201000000,,185000000,173000000,9040,GWW,quarterly
2020-12-31,,,1503000000,76000000,1156000000,1599000000,2872000000,1222000000,1222000000,,-90000000,,,,344000000,7298000000,6076000000,4426000000,281000000,,1159000000,1156000000,9041,MDLZ,quarterly
2020-09-30,,,1513000000,85000000,1119000000,1446000000,2792000000,1296000000,1296000000,,-104000000,,,,391000000,6665000000,5369000000,3873000000,217000000,,1122000000,1119000000,9041,MDLZ,quarterly
2020-06-30,,,886000000,79000000,544000000,1412000000,2331000000,869000000,869000000,,-108000000,,,,341000000,5911000000,5042000000,3580000000,17000000,,545000000,544000000,9041,MDLZ,quarterly
2020-03-31,,,891000000,78000000,736000000,1499000000,2451000000,909000000,909000000,,-213000000,,,,148000000,6707000000,5798000000,4256000000,-18000000,,743000000,736000000,9041,MDLZ,quarterly
2020-12-31,451000000,,245000000,,211000000,365000000,1072000000,251000000,251000000,,-11000000,,,,34000000,1673000000,1422000000,601000000,-6000000,,211000000,211000000,9058,EA,quarterly
2020-09-30,421000000,,139000000,,185000000,289000000,865000000,149000000,149000000,,-11000000,,,,-46000000,1151000000,1002000000,286000000,-10000000,,185000000,185000000,9058,EA,quarterly
2020-06-30,438000000,,468000000,,365000000,257000000,1171000000,471000000,471000000,,-11000000,,,,103000000,1459000000,988000000,288000000,-3000000,,365000000,365000000,9058,EA,quarterly
2020-03-31,402000000,,414000000,,418000000,309000000,1118000000,401000000,401000000,,-12000000,,,,-4000000,1387000000,986000000,269000000,13000000,,418000000,418000000,9058,EA,quarterly
2020-12-31,395800000,,1541500000,11000000,1240100000,1954800000,3993900000,1643300000,1643300000,,-72300000,,,,301400000,6760300000,5117000000,2766400000,-101800000,,1240100000,1199400000,9059,DHR,quarterly
2020-10-02,342600000,,1021500000,11500000,883500000,1791900000,3642700000,1508200000,1508200000,,-76700000,,,,138000000,5883200000,4375000000,2240500000,-486700000,,883500000,842400000,9059,DHR,quarterly
2020-07-03,322600000,,1220900000,11200000,927300000,1680300000,2852600000,849700000,849700000,,-78600000,,,,293600000,5297400000,4447700000,2444800000,371200000,,927300000,892700000,9059,DHR,quarterly
2020-04-03,287000000,,711100000,11300000,595100000,1445000000,2442800000,710800000,710800000,,-47400000,,,,116000000,4343100000,3632300000,1900300000,300000,,595100000,575500000,9059,DHR,quarterly
2020-12-31,67228000,,117528000,,113370000,278464000,542440000,185854000,185854000,,-17342000,,,,4158000,846287000,660433000,303847000,-68326000,,113370000,113370000,9081,AKAM,quarterly
2020-09-30,66773000,,167424000,,158623000,250063000,509406000,182230000,182230000,,-17324000,,,,8801000,792845000,610615000,283439000,-14806000,,158623000,158623000,9081,AKAM,quarterly
2020-06-30,64090000,,180586000,,161915000,252841000,517911000,190599000,190599000,,-17249000,,,,18671000,794715000,604116000,276804000,-10013000,,161915000,161915000,9081,AKAM,quarterly
2020-03-31,71224000,,137438000,,123146000,251071000,495720000,162991000,162991000,,-17205000,,,,14292000,764302000,601311000,268582000,-25553000,,123146000,123146000,9081,AKAM,quarterly
2020-12-31,,,352432000,18032000,351267000,20453000,571154000,409195000,409195000,100000,-14235000,,,,0,776678000,367483000,205524000,-56763000,,352432000,292166000,9082,PSA,quarterly
2020-09-30,,,325847000,17927000,324867000,21188000,534436000,374815000,374815000,100000,-14282000,,,,0,751897000,377082000,217461000,-48968000,,325847000,246916000,9082,PSA,quarterly
2020-06-30,,,315812000,17507000,314923000,20194000,501333000,343421000,343421000,100000,-14145000,,,,0,726940000,383519000,225607000,-27609000,,315812000,246119000,9082,PSA,quarterly
2020-03-31,,,367136000,17130000,366156000,19964000,521180000,364216000,364216000,1100000,-13621000,,,,0,740050000,375834000,218870000,2920000,,367136000,313134000,9082,PSA,quarterly
2020-12-31,,,2361000000,1985000000,1456000000,2589000000,5033000000,2454000000,2454000000,-10000000,-310000000,,,,887000000,8611000000,6157000000,3578000000,-93000000,,1474000000,1456000000,9092,KO,quarterly
2020-09-25,,,2181000000,1709000000,1737000000,2467000000,5181000000,2714000000,2714000000,-10000000,-660000000,,,,441000000,8652000000,5938000000,3471000000,-533000000,,1740000000,1737000000,9092,KO,quarterly
2020-06-26,,,2197000000,1705000000,1779000000,1941000000,4137000000,2173000000,2173000000,23000000,-274000000,,,,438000000,7150000000,4977000000,3013000000,24000000,,1759000000,1779000000,9092,KO,quarterly
2020-03-27,,,3010000000,1676000000,2775000000,2605000000,5230000000,2625000000,2625000000,23000000,-193000000,,,,215000000,8601000000,5976000000,3371000000,385000000,,2795000000,2775000000,9092,KO,quarterly
2020-12-31,30000000,,1004000000,871000000,824000000,71000000,1777000000,1080000000,1080000000,,-73000000,,,,258000000,3381000000,2301000000,1604000000,-76000000,18000000,746000000,824000000,9102,NEM,quarterly
2020-09-30,39000000,,933000000,959000000,839000000,151000000,1869000000,1043000000,1043000000,,-75000000,,,,305000000,3170000000,2127000000,1301000000,-110000000,228000000,628000000,839000000,9102,NEM,quarterly
2020-06-30,26000000,,579000000,967000000,344000000,77000000,1278000000,630000000,630000000,,-78000000,,,,164000000,2365000000,1735000000,1087000000,-51000000,-68000000,415000000,344000000,9102,NEM,quarterly
2020-03-31,27000000,,816000000,974000000,822000000,66000000,1235000000,542000000,542000000,,-82000000,,,,-23000000,2581000000,2039000000,1346000000,274000000,-15000000,839000000,822000000,9102,NEM,quarterly
2020-12-31,,,399700000,658900000,270300000,116500000,507300000,390800000,390800000,,-67700000,,,,68900000,1630100000,1239300000,1122800000,8900000,,330800000,211100000,9114,IVZ,quarterly
2020-09-30,,,386600000,644800000,250900000,105300000,447300000,342000000,342000000,,-75600000,,,,91900000,1497600000,1155600000,1050300000,44600000,,294700000,191700000,9114,IVZ,quarterly
2020-06-30,,,105400000,568500000,99700000,203300000,392100000,188800000,188800000,,-87300000,,,,43400000,1419000000,1230200000,1026900000,-83400000,,62000000,40500000,9114,IVZ,quarterly
2020-03-31,,,177400000,619600000,140700000,139000000,531500000,392500000,392500000,,-93200000,,,,57400000,1598900000,1206400000,1067400000,-215100000,,120000000,81500000,9114,IVZ,quarterly
2020-12-31,,,311154000,618766000,272317000,84260000,917450000,463187000,463187000,38152000,-197855000,,,,-1572000,1132568000,669381000,215118000,-152033000,,312726000,271483000,9142,SPG,quarterly
2020-09-30,,,171425000,450558000,146760000,57727000,836256000,402124000,402124000,42650000,-201858000,,,,2779000,1058774000,656650000,222518000,-230699000,,168646000,145926000,9142,SPG,quarterly
2020-06-30,,,290486000,493491000,255047000,56075000,858520000,449268000,449268000,29037000,-197061000,,,,-62000,1060441000,611173000,201921000,-158782000,,290548000,254213000,9142,SPG,quarterly
2020-03-31,,,499621000,541548000,438439000,94791000,1104662000,653769000,653769000,27840000,-187627000,,,,-5783000,1352260000,698491000,247598000,-154148000,,505404000,437605000,9142,SPG,quarterly
2020-12-27,84659000,,138474000,64474000,105173000,472029000,828432000,234683000,234683000,,-48428000,,,,32308000,1722971000,1488288000,894539000,-96209000,,106166000,105173000,9163,HAS,quarterly
2020-09-27,62709000,,299198000,57556000,220898000,462768000,904156000,342507000,342507000,,-49400000,,,,79215000,1776623000,1434116000,872467000,-43309000,,219983000,220898000,9163,HAS,quarterly
2020-06-28,58325000,,-43728000,62277000,-33915000,342004000,459022000,23991000,23991000,,-49577000,,,,-10830000,860279000,836288000,401257000,-67719000,,-32898000,-33915000,9163,HAS,quarterly
2020-03-29,53829000,,-71882000,61324000,-69637000,380769000,597908000,126499000,126499000,,-54725000,,,,-4072000,1105570000,979071000,507662000,-198381000,,-67810000,-69637000,9163,HAS,quarterly
2020-12-31,,,737000000,,616000000,749000000,1722000000,0,782000000,191000000,,,,,121000000,1722000000,940000000,0,-45000000,,616000000,588000000,9165,RF,quarterly
2020-09-30,,,634000000,,530000000,714000000,1530000000,0,641000000,175000000,,,,,104000000,1530000000,889000000,0,-7000000,,530000000,501000000,9165,RF,quarterly
2020-06-30,,,-261000000,26000000.0,-214000000,709000000,663000000,0,-243000000,197000000,,,,,-47000000,663000000,906000000,0,-18000000,,-214000000,-237000000,9165,RF,quarterly
2020-03-31,,,204000000,26000000.0,162000000,652000000,1040000000,0,216000000,172000000,,,,,42000000,1040000000,824000000,0,-12000000,,162000000,139000000,9165,RF,quarterly
2020-12-31,,,258000000,,288000000,241000000,1322000000,423000000,423000000,159000000,-212000000,,,,-30000000,2947000000,2524000000,1625000000,-165000000,,288000000,288000000,9297,XEL,quarterly
2020-09-30,,,646000000,,603000000,2000000,1484000000,811000000,811000000,158000000,-221000000,,,,43000000,3182000000,2371000000,1698000000,-165000000,,603000000,603000000,9297,XEL,quarterly
2020-06-30,,,274000000,,287000000,2000000,1041000000,420000000,420000000,146000000,-208000000,,,,-13000000,2586000000,2166000000,1545000000,-146000000,,287000000,287000000,9297,XEL,quarterly
2020-03-31,,,289000000,,295000000,2000000,1067000000,453000000,453000000,149000000,-199000000,,,,-6000000,2811000000,2358000000,1744000000,-164000000,,295000000,295000000,9297,XEL,quarterly
2020-10-31,25500000,,93700000,200000,81200000,264200000,514100000,190200000,190200000,,-6700000,,,,12500000,681600000,491400000,167500000,-96500000,,81200000,81200000,9319,COO,quarterly
2020-07-31,21800000,,66400000,200000,55200000,232800000,360800000,72000000,72000000,,-5700000,,,,11200000,578200000,506200000,217400000,-5600000,,55200000,55200000,9319,COO,quarterly
2020-04-30,23800000,,9000000,200000,11500000,232800000,323500000,33000000,33000000,,-12800000,,,,-2500000,524900000,491900000,201400000,-24000000,,11500000,11500000,9319,COO,quarterly
2020-01-31,22200000,,97400000,200000,90500000,251500000,426500000,117900000,117900000,,-11600000,,,,6900000,646200000,528300000,219700000,-20500000,,90500000,90500000,9319,COO,quarterly
2020-12-31,,,99096000,254410000,387967000,,897431000,162402000,162402000,327000000,-212361000,,,,-288871000,2370101000,2207699000,1472670000,-63306000,,387967000,387967000,9321,ETR,quarterly
2020-09-30,,,670563000,254410000,521119000,76341000.0,1421255000,706136000,706136000,237200000,-212439000,,,,149444000,2903568000,2197432000,1482313000,-35573000,,521119000,521119000,9321,ETR,quarterly
2020-06-30,,,449648000,254410000,360533000,44493000.0,1078667000,401593000,401593000,228812000,-221427000,,,,89115000,2412788000,2011195000,1334121000,48055000,,360533000,360533000,9321,ETR,quarterly
2020-03-31,,,47520000,254385000,118714000,-31449000.0,1060860000,436300000,436300000,256299000,-210217000,,,,-71194000,2427179000,1990879000,1366319000,-388780000,,118714000,118714000,9321,ETR,quarterly
2020-12-31,33769000,,76561000,,76131000,209885000,383554000,139900000,139900000,,-18721000,,,,-40000,711179000,571279000,327625000,-63339000,-470000,76601000,76131000,9391,TFX,quarterly
2020-09-27,29218000,,115654000,,116587000,171673000,329324000,128433000,128433000,,-16652000,,,,-951000,628301000,499868000,298977000,-12779000,-18000,116605000,116587000,9391,TFX,quarterly
2020-06-28,29364000,,23291000,,11456000,191193000,278372000,57815000,57815000,,-15682000,,,,11848000,567034000,509219000,288662000,-34524000,13000,11443000,11456000,9391,TFX,quarterly
2020-03-29,27396000,,142226000,,131150000,194298000,335331000,113637000,113637000,,-15439000,,,,11074000,630642000,517005000,295311000,28589000,-2000,131152000,131150000,9391,TFX,quarterly
2020-12-31,2565000000,,2721000000,1522000000,2636000000,2571000000,6370000000,1234000000,1234000000,,-254000000,,,,163000000,21929000000,20695000000,15559000000,1487000000,81000000,2558000000,2419000000,9403,GE,quarterly
2020-09-30,2565000000,,-1661000000,1524000000,-1144000000,2918000000,2963000000,45000000,45000000,,-313000000,,,,-501000000,19417000000,19372000000,16454000000,-1706000000,-35000000,-1160000000,-1196000000,9403,GE,quarterly
2020-06-30,2565000000,,-2338000000,1579000000,-1987000000,2746000000,1382000000,-1364000000,-1364000000,,-396000000,,,,-199000000,17750000000,19114000000,16368000000,-974000000,7000000,-2139000000,-2314000000,9403,GE,quarterly
2020-03-31,2565000000,,6474000000,1575000000,6199000000,2871000000,3583000000,712000000,712000000,,-370000000,,,,63000000,20524000000,19812000000,16941000000,5762000000,-178000000,6411000000,6156000000,9403,GE,quarterly
2020-12-31,,,1978000000,340000000,1098000000,318000000,955000000,162000000,162000000,,-82000000,,,,875000000,4288000000,4126000000,3333000000,1816000000,,1103000000,1098000000,9425,DXC,quarterly
2020-09-30,,,-306000000,350000000,-244000000,339000000,991000000,127000000,127000000,,-96000000,,,,-60000000,4554000000,4427000000,3563000000,-433000000,,-246000000,-244000000,9425,DXC,quarterly
2020-06-30,,,-225000000,349000000,-205000000,334000000,873000000,47000000,47000000,,-106000000,,,,-26000000,4502000000,4455000000,3629000000,-272000000,,-199000000,-205000000,9425,DXC,quarterly
2020-03-31,,,-3562000000,344000000,-3495000000,74000000,1042000000,442000000,442000000,,-95000000,,,,-61000000,4815000000,4373000000,3773000000,-4004000000,,-3501000000,-3495000000,9425,DXC,quarterly
2020-12-31,,,322600000,19400000,244700000,563400000,950100000,386700000,386700000,,-61900000,,,,72400000,3179100000,2792400000,2229000000,-64100000,-1000000,250200000,244700000,9426,TT,quarterly
2020-09-30,,,500000000,14300000,400600000,566800000,1138000000,571200000,571200000,,-62400000,,,,89900000,3495500000,2924300000,2357500000,-71200000,-5500000,410100000,400600000,9426,TT,quarterly
2020-06-30,,,361800000,22600000,238800000,529000000,986600000,457600000,457600000,,-61300000,,,,83500000,3138800000,2681200000,2152200000,-95800000,-36600000,278300000,238800000,9426,TT,quarterly
2020-03-31,,,103800000,17200000,-29200000,574500000,752800000,178300000,178300000,,-63200000,,,,51000000,2641300000,2463000000,1888500000,-74500000,-79200000,52800000,-29200000,9426,TT,quarterly
2020-10-31,,,121000000,,95000000,1449000000,1620000000,171000000,171000000,,-55000000,,,,26000000,3994000000,3823000000,2374000000,-50000000,,95000000,95000000,9427,GPS,quarterly
2020-08-01,,,-41000000,,-62000000,1044000000,1149000000,105000000,105000000,,-58000000,,,,21000000,3275000000,3170000000,2126000000,-146000000,,-62000000,-62000000,9427,GPS,quarterly
2020-05-02,,,-1259000000,,-932000000,1036000000,503000000,-533000000,-533000000,,-19000000,,,,-327000000,2107000000,2640000000,1604000000,-726000000,,-932000000,-932000000,9427,GPS,quarterly
2020-02-01,41000000.0,,-254000000,,-184000000,2058000000,2181000000,82000000,82000000,,-18000000,,,,-70000000,4674000000,4592000000,2493000000,-336000000,,-184000000,-184000000,9427,GPS,quarterly
2020-12-31,,,800000000,132000000,579000000,436000000,1294000000,835000000,835000000,-3000000,-40000000,,,,191000000,3002000000,2167000000,1708000000,-35000000,,609000000,576000000,9452,DGX,quarterly
2020-09-30,,,768000000,126000000,568000000,389000000,1220000000,804000000,804000000,-3000000,-42000000,,,,177000000,2786000000,1982000000,1566000000,-36000000,,591000000,566000000,9452,DGX,quarterly
2020-06-30,,,259000000,127000000,185000000,346000000,645000000,274000000,274000000,-3000000,-41000000,,,,66000000,1827000000,1553000000,1182000000,-15000000,,193000000,184000000,9452,DGX,quarterly
2020-03-31,,,132000000,122000000,99000000,335000000,560000000,199000000,199000000,1000000,-41000000,,,,26000000,1822000000,1623000000,1262000000,-67000000,,106000000,99000000,9452,DGX,quarterly
2020-12-31,255000000,,671000000,,568000000,1284000000,2773000000,1104000000,1104000000,,-399000000,,,,103000000,4262000000,3158000000,1489000000,-433000000,,568000000,568000000,9454,SYK,quarterly
2020-09-30,242000000,,780000000,,621000000,1188000000,2461000000,917000000,917000000,,-399000000,,,,159000000,3737000000,2820000000,1276000000,-137000000,,621000000,621000000,9454,SYK,quarterly
2020-06-30,233000000,,-87000000,,-83000000,1028000000,1583000000,212000000,212000000,,-399000000,,,,-4000000,2764000000,2552000000,1181000000,-299000000,,-83000000,-83000000,9454,SYK,quarterly
2020-03-31,254000000,,590000000,,493000000,1250000000,2341000000,719000000,719000000,,-399000000,,,,97000000,3588000000,2869000000,1247000000,-89000000,,493000000,493000000,9454,SYK,quarterly
2020-12-31,,,141188000,,114518000,98627000,302741000,194748000,194748000,9366000,-33884000,,,,25273000,1175120000,980372000,872379000,-53560000,-1397000,115915000,114518000,9476,VMC,quarterly
2020-09-30,,,258109000,,199788000,85805000,380498000,292834000,292834000,1859000,-35782000,,,,56984000,1309890000,1017056000,929392000,-34725000,-1337000,201125000,199788000,9476,VMC,quarterly
2020-06-30,,,272309000,,209916000,93499000,396519000,299060000,299060000,3960000,-33954000,,,,61352000,1322575000,1023515000,926056000,-26751000,-1041000,210957000,209916000,9476,VMC,quarterly
2020-03-31,,,72192000,,60258000,88724000,201723000,110508000,110508000,2491000,-30773000,,,,12194000,1049242000,938734000,847519000,-38316000,260000,59998000,60258000,9476,VMC,quarterly
2020-12-31,34000000,,894000000,133000000,853000000,298000000,1225000000,893000000,893000000,,-190000000,,,,39000000,7937000000,7044000000,6712000000,1000000,-2000000,855000000,853000000,9481,LYB,quarterly
2020-09-30,27000000,,-13000000,133000000,112000000,273000000,891000000,591000000,591000000,,-124000000,,,,-125000000,6776000000,6185000000,5885000000,-604000000,-2000000,112000000,111000000,9481,LYB,quarterly
2020-06-30,25000000,,282000000,135000000,313000000,302000000,652000000,325000000,325000000,,-126000000,,,,-32000000,5546000000,5221000000,4894000000,-43000000,-1000000,314000000,312000000,9481,LYB,quarterly
2020-03-31,27000000,,218000000,135000000,142000000,295000000,626000000,304000000,304000000,,-89000000,,,,75000000,7494000000,7190000000,6868000000,-86000000,1000000,143000000,142000000,9481,LYB,quarterly
2020-12-31,,,746000000,,604000000,931000000,1982000000,0,746000000,305000000,,,,,142000000,1982000000,1236000000,0,0,,604000000,567000000,9492,FITB,quarterly
2020-09-30,,,746000000,,581000000,871000000,1918000000,0,758000000,289000000,,,,,165000000,1918000000,1160000000,0,-12000000,,581000000,560000000,9492,FITB,quarterly
2020-06-30,,,244000000,,195000000,840000000,1380000000,0,271000000,269000000,,,,,49000000,1380000000,1109000000,0,-27000000,,195000000,162000000,9492,FITB,quarterly
2020-03-31,,,60000000,,48000000,877000000,1262000000,0,71000000,314000000,,,,,12000000,1262000000,1191000000,0,-11000000,,48000000,29000000,9492,FITB,quarterly
2020-12-31,,,185000000,2814000000,116000000,106000000,1242000000,706000000,706000000,-6000000,-290000000,,,,55000000,2092000000,1386000000,850000000,-521000000,,130000000,115000000,9505,WMB,quarterly
2020-09-30,,,434000000,2833000000,309000000,115000000,1196000000,640000000,640000000,15000000,-292000000,,,,111000000,1933000000,1293000000,737000000,-206000000,,323000000,308000000,9505,WMB,quarterly
2020-06-30,,,432000000,2868000000,303000000,130000000,1175000000,609000000,609000000,6000000,-294000000,,,,117000000,1781000000,1172000000,606000000,-177000000,,315000000,303000000,9505,WMB,quarterly
2020-03-31,,,-774000000,2905000000,-517000000,120000000,1167000000,611000000,611000000,7000000,-296000000,,,,-204000000,1913000000,1302000000,746000000,-1385000000,,-570000000,-518000000,9505,WMB,quarterly
2020-12-31,,,-3810000000,121000000,-2788000000,3304000000,1035000000,-2269000000,-2269000000,,-472000000,,,,-1019000000,35952000000,38221000000,34917000000,-1541000000,,-2791000000,-2788000000,9507,F,quarterly
2020-09-30,,,2756000000,36000000,2385000000,1822000000,4830000000,3008000000,3008000000,,-507000000,,,,366000000,37501000000,34493000000,32671000000,-252000000,,2390000000,2385000000,9507,F,quarterly
2020-06-30,,,1084000000,31000000,1117000000,1273000000,-792000000,-2065000000,-2065000000,,-450000000,,,,-34000000,19371000000,21436000000,20163000000,3149000000,,1118000000,1117000000,9507,F,quarterly
2020-03-31,,,-1146000000,48000000,-1993000000,1981000000,1062000000,-919000000,-919000000,,-250000000,,,,847000000,34320000000,35239000000,33258000000,-227000000,,-1993000000,-1993000000,9507,F,quarterly
2020-12-31,,,884000000,882000000,810000000,1399000000,2417000000,918000000,918000000,5000000,-268000000,,,,158000000,6225000000,5307000000,3808000000,-34000000,103000000,726000000,810000000,9557,VIAC,quarterly
2020-09-30,,,662000000,885000000,615000000,1391000000,2482000000,992000000,992000000,1000000,-259000000,,,,38000000,6116000000,5124000000,3634000000,-330000000,3000000,624000000,615000000,9557,VIAC,quarterly
2020-06-30,,,925000000,950000000,481000000,1240000000,2790000000,1451000000,1451000000,1000000,-263000000,,,,202000000,6275000000,4824000000,3485000000,-526000000,3000000,723000000,481000000,9557,VIAC,quarterly
2020-03-31,,,648000000,342000000,516000000,1359000000,2604000000,1144000000,1144000000,1000000,-241000000,,,,137000000,6669000000,5525000000,4065000000,-496000000,8000000,511000000,516000000,9557,VIAC,quarterly
2021-01-31,366000000,,1532000000,3000000,1224000000,652000000,2683000000,1787000000,1787000000,-122000000,-83000000,,,,308000000,9112000000,7325000000,6429000000,-255000000,,1224000000,1224000000,9576,DE,quarterly
2020-11-01,388000000,,1088000000,7000000,758000000,763000000,2702000000,1540000000,1540000000,11000000,-83000000,,,,330000000,9713000000,8173000000,7011000000,-452000000,,758000000,758000000,9576,DE,quarterly
2020-08-02,370000000,,1268000000,3000000,811000000,615000000,2387000000,1430000000,1430000000,-28000000,-84000000,,,,457000000,8915000000,7485000000,6528000000,-162000000,,811000000,811000000,9576,DE,quarterly
2020-05-03,406000000,,911000000,1000000,666000000,698000000,2139000000,931000000,931000000,104000000,-76000000,,,,245000000,9261000000,8330000000,7122000000,-20000000,,666000000,666000000,9576,DE,quarterly
2020-12-31,,,934000000,785000000,819000000,3719000000,4638000000,919000000,919000000,,,,,,-88000000,16048000000,15129000000,11410000000,15000000,,1022000000,814000000,9582,PRU,quarterly
2020-09-30,,,1457000000,673000000,1487000000,3318000000,4809000000,1491000000,1491000000,,,,,,-50000000,15464000000,13973000000,10655000000,-34000000,,1507000000,1469000000,9582,PRU,quarterly
2020-06-30,,,-2290000000,611000000,-2409000000,3347000000,1015000000,-2332000000,-2332000000,,,,,,115000000,12115000000,14447000000,11100000000,42000000,,-2405000000,-2402000000,9582,PRU,quarterly
2020-03-31,,,-328000000,625000000,-271000000,3522000000,3186000000,-336000000,-336000000,,,,,,-58000000,13464000000,13800000000,10278000000,8000000,,-270000000,-276000000,9582,PRU,quarterly
2021-01-01,,,247000000,,193000000,831000000,1399000000,568000000,568000000,,-68000000,,,,63000000,4660000000,4092000000,3261000000,-321000000,,184000000,193000000,9622,LHX,quarterly
2020-10-02,,,518000000,126000000.0,426000000,691000000,1311000000,620000000,620000000,,-66000000,,,,87000000,4463000000,3843000000,3152000000,-102000000,-1000000.0,431000000,426000000,9622,LHX,quarterly
2020-07-03,,,336000000,124000000.0,283000000,749000000,1286000000,537000000,537000000,,-68000000,,,,58000000,4445000000,3908000000,3159000000,-201000000,-1000000.0,278000000,283000000,9622,LHX,quarterly
2020-04-03,,,221000000,129000000.0,217000000,684000000,1343000000,659000000,659000000,,-68000000,,,,26000000,4626000000,3967000000,3283000000,-438000000,-1000000.0,195000000,217000000,9622,LHX,quarterly
2021-01-30,288150000,,436618000,,388519000,170075000,1045371000,479498000,479498000,,-42479000,,,,48099000,1558458000,1078960000,513087000,-42880000,,388519000,388519000,9637,ADI,quarterly
2020-10-31,280239000,,417310000,,386526000,146219000,1023084000,488619000,488619000,,-48593000,,,,30784000,1526295000,1037676000,503211000,-71309000,,386526000,386526000,9637,ADI,quarterly
2020-08-01,260794000,,373029000,,362665000,144653000,972578000,460054000,460054000,,-45914000,,,,10364000,1456136000,996082000,483558000,-87025000,,362665000,362665000,9637,ADI,quarterly
2020-05-02,252413000,,295061000,,267696000,141775000,846674000,345340000,345340000,,-49985000,,,,27365000,1317060000,971720000,470386000,-50279000,,267696000,267696000,9637,ADI,quarterly
2020-12-31,,,45000000,969000000,-97000000,395000000,1008000000,84000000,84000000,-17000000,-118000000,,,,72000000,1289000000,1205000000,281000000,-39000000,,-27000000,-97000000,9640,HES,quarterly
2020-09-30,,,-178000000,966000000,-243000000,366000000,904000000,-32000000,-32000000,-18000000,-118000000,,,,5000000,1125000000,1157000000,221000000,-146000000,,-183000000,-243000000,9640,HES,quarterly
2020-06-30,,,-272000000,971000000,-320000000,383000000,761000000,-159000000,-159000000,-3000000,-119000000,,,,-9000000,817000000,976000000,56000000,-113000000,,-263000000,-320000000,9640,HES,quarterly
2020-03-31,,,-2445000000,978000000,-2433000000,405000000,934000000,-205000000,-205000000,-16000000,-113000000,,,,-79000000,1312000000,1517000000,378000000,-2240000000,,-2366000000,-2433000000,9640,HES,quarterly
2020-12-31,2828000000,,178000000,,594000000,3481000000,8797000000,1632000000,1632000000,,-347000000,,,,-170000000,11684000000,10052000000,2887000000,-1454000000,257000000,348000000,594000000,9688,PFE,quarterly
2020-09-27,2352000000,,2176000000,236000000.0,2194000000,2923000000,9634000000,3461000000,3461000000,,-416000000,,,,-26000000,12131000000,8670000000,2497000000,-1285000000,257000000,2202000000,2194000000,9688,PFE,quarterly
2020-06-28,1894000000,,3953000000,228000000.0,3426000000,2696000000,9569000000,4074000000,4074000000,,-372000000,,,,519000000,11801000000,7727000000,2232000000,-121000000,257000000,3434000000,3426000000,9688,PFE,quarterly
2020-03-29,1729000000,,3885000000,312000000.0,3401000000,2653000000,9682000000,4415000000,4415000000,,-390000000,,,,475000000,12028000000,7613000000,2346000000,-530000000,257000000,3410000000,3401000000,9688,PFE,quarterly
2020-12-31,,,562000000,2146000000,318000000,47000000,724000000,677000000,677000000,,-297000000,,,,161000000,2560000000,1883000000,1836000000,-115000000,,401000000,318000000,9693,AES,quarterly
2020-09-30,,,-628000000,2129000000,-333000000,41000000,756000000,715000000,715000000,,-290000000,,,,-147000000,2545000000,1830000000,1789000000,-1343000000,,-481000000,-333000000,9693,AES,quarterly
2020-06-30,,,113000000,2240000000,-83000000,41000000,524000000,483000000,483000000,,-218000000,,,,113000000,2217000000,1734000000,1693000000,-370000000,3000000.0,0,-83000000,9693,AES,quarterly
2020-03-31,,,318000000,2238000000,144000000,38000000,507000000,469000000,469000000,,-233000000,,,,89000000,2338000000,1869000000,1831000000,-151000000,3000000.0,229000000,144000000,9693,AES,quarterly
2020-12-31,4000000,,71000000,,106000000,58000000,407000000,278000000,278000000,,-156000000,,,,-35000000,1238000000,960000000,831000000,-207000000,,106000000,106000000,9700,HWM,quarterly
2020-09-30,5000000,,-12000000,,36000000,74000000,241000000,94000000,94000000,,-77000000,,,,-48000000,1134000000,1040000000,893000000,-106000000,,36000000,35000000,9700,HWM,quarterly
2020-06-30,4000000,,-86000000,,-96000000,79000000,334000000,178000000,178000000,,-144000000,,,,-2000000,1253000000,1075000000,919000000,-264000000,-12000000.0,-84000000,-96000000,9700,HWM,quarterly
2020-03-31,4000000,,198000000,14000000.0,215000000,85000000,447000000,301000000,301000000,-14000000.0,-84000000,,,,45000000,1634000000,1333000000,1187000000,-103000000,62000000.0,153000000,214000000,9700,HWM,quarterly
2020-12-31,,,641000000,,537000000,1579000000,2917000000,0,845000000,493000000,,,,,104000000,2917000000,2072000000,0,-204000000,,537000000,498000000,9718,STT,quarterly
2020-09-30,,,681000000,,555000000,1586000000,2784000000,0,755000000,443000000,,,,,126000000,2784000000,2029000000,0,-74000000,,555000000,517000000,9718,STT,quarterly
2020-06-30,,,803000000,,694000000,1548000000,2885000000,0,873000000,464000000,,,,,109000000,2885000000,2012000000,0,-70000000,,694000000,662000000,9718,STT,quarterly
2020-03-31,,,774000000,,634000000,1720000000,3029000000,0,843000000,466000000,,,,,140000000,3029000000,2186000000,0,-69000000,,634000000,580000000,9718,STT,quarterly
2020-12-31,16438000,,139430000,11202000,114501000,170810000,353112000,165864000,165864000,,-8899000,,,,24842000,808924000,643060000,455812000,-26434000,,114588000,114501000,9740,STE,quarterly
2020-09-30,16143000,,133786000,15310000,105858000,171572000,334576000,146861000,146861000,,-8665000,,,,27778000,756132000,609271000,421556000,-13075000,,106008000,105858000,9740,STE,quarterly
2020-06-30,16231000,,106798000,15049000,88190000,155170000,285568000,114167000,114167000,,-9492000,,,,18674000,668932000,554765000,383364000,-7369000,,88124000,88190000,9740,STE,quarterly
2020-03-31,17225000,,148012000,12848000,123316000,186424000,363869000,160220000,160220000,,-9577000,,,,24793000,822991000,662771000,459122000,-12208000,,123219000,123316000,9740,STE,quarterly
2020-12-31,,,-2373000000,,-1897000000,80000000,-749000000,-2284000000,-2284000000,826000000,-334000000,,,,-476000000,3412000000,5696000000,4161000000,-89000000,,-1897000000,-1897000000,9772,UAL,quarterly
2020-09-30,,,-2332000000,,-1841000000,53000000,-1334000000,-2692000000,-2692000000,679000000,-329000000,,,,-491000000,2489000000,5181000000,3823000000,360000000,,-1841000000,-1841000000,9772,UAL,quarterly
2020-06-30,,,-2003000000,,-1627000000,31000000,-1886000000,-3063000000,-3063000000,528000000,-179000000,,,,-376000000,1475000000,4538000000,3361000000,1060000000,,-1627000000,-1627000000,9772,UAL,quarterly
2020-03-31,,,-2114000000,,-1704000000,295000000,1486000000,-877000000,-877000000,1453000000,-150000000,,,,-410000000,7979000000,8856000000,6493000000,-1237000000,,-1704000000,-1704000000,9772,UAL,quarterly
2020-12-31,,,295000000,,238300000,548700000,880900000,332200000,332200000,,-37100000,,,,56700000,4956200000,4624000000,4075300000,-37200000,,238300000,238300000,9829,CDW,quarterly
2020-09-30,,,250100000,,193200000,499200000,825500000,326300000,326300000,,-40200000,,,,56900000,4756400000,4430100000,3930900000,-76200000,,193200000,193200000,9829,CDW,quarterly
2020-06-30,,,245400000,,189100000,463800000,747200000,283400000,283400000,,-39700000,,,,56300000,4365700000,4082300000,3618500000,-38000000,,189100000,189100000,9829,CDW,quarterly
2020-03-31,,,211800000,,167900000,510700000,756500000,245800000,245800000,,-37900000,,,,43900000,4389200000,4143400000,3632700000,-34000000,,167900000,167900000,9829,CDW,quarterly
2020-12-03,647000000,,854000000,,803000000,214000000,1736000000,866000000,866000000,9000000,-48000000,,,,51000000,5773000000,4907000000,4037000000,-12000000,,803000000,803000000,9839,MU,quarterly
2020-09-03,630000000,,1126000000,,988000000,231000000,2068000000,1204000000,1204000000,3000000,-50000000,,,,136000000,6056000000,4852000000,3988000000,-78000000,,990000000,988000000,9839,MU,quarterly
2020-05-28,649000000,,873000000,98000000.0,803000000,216000000,1763000000,892000000,892000000,6000000,-51000000,,,,68000000,5438000000,4546000000,3675000000,-19000000,,805000000,803000000,9839,MU,quarterly
2020-02-27,681000000,,428000000,98000000.0,405000000,223000000,1355000000,450000000,450000000,1000000,-46000000,,,,21000000,4797000000,4347000000,3442000000,-22000000,,407000000,405000000,9839,MU,quarterly
2020-10-31,,,427300000,,330000000,1423500000,1935300000,511800000,511800000,,-38100000,,,,97300000,6177000000,5665200000,4241700000,-84500000,,330000000,330000000,9850,DLTR,quarterly
2020-08-01,,,339900000,,261500000,1419100000,1927600000,508500000,508500000,,-34800000,,,,78400000,6277600000,5769100000,4350000000,-168600000,,261500000,261500000,9850,DLTR,quarterly
2020-05-02,,,325200000,,247600000,1362600000,1794900000,432300000,432300000,,-40200000,,,,77600000,6286800000,5854500000,4491900000,-107100000,,247600000,247600000,9850,DLTR,quarterly
2020-02-01,,,209500000,,123000000,3300200000,3871700000,571500000,571500000,,-38900000,,,,86500000,6315300000,5743800000,2443600000,-362000000,,123000000,123000000,9850,DLTR,quarterly
2020-12-26,3655000000,,7488000000,,5857000000,1757000000,11348000000,5936000000,5936000000,,-148000000,,,,1631000000,19978000000,14042000000,8630000000,1552000000,,5857000000,5857000000,9853,INTC,quarterly
2020-09-26,3272000000,,5041000000,,4276000000,1435000000,9741000000,5034000000,5034000000,,-160000000,,,,765000000,18333000000,13299000000,8592000000,7000000,,4276000000,4276000000,9853,INTC,quarterly
2020-06-27,3354000000,,5935000000,,5105000000,1447000000,10507000000,5706000000,5706000000,,-186000000,,,,830000000,19728000000,14022000000,9221000000,229000000,,5105000000,5105000000,9853,INTC,quarterly
2020-03-28,3275000000,,6614000000,,5661000000,1541000000,12016000000,7200000000,7200000000,,-135000000,,,,953000000,19828000000,12628000000,7812000000,-586000000,,5661000000,5661000000,9853,INTC,quarterly
